# This puzzle is solvable
9
73 18 10 13 40 45 11  7  9
 3 30 39 5 78 2  35  11  5
66 36 60 70 68 15 5 72 64
 2 5 49 14 74 59 41 28 42
76 80 58 43 20 57 63  4 51
48 26 47 38 32 61 33  6 46
65 69 67 27 19 21 12 34 77
24 22  8 53 62 31 16 79 55
71 7 50 23 25 44  0 37 17
