# This puzzle is solvable
8
52 36 15 47  8  2 26  1
 3 38 10 63 13 7 51 12
27 39 61 40 2 1 34 53
22 23 43 17  9 62 50 49
14 46 48 4 45 25 16 60
56  4  5 30  0  7 59  6
58 28 42 3 55 57 19 29
24 18 35  2 54 32 31 40
