# This puzzle is solvable
30
  3 116 119 328 420 330 121 124   9 123 332  12  10  13  15 238  16 132  18 340 134 136 137  24  26  28 250 251 144  32
118   1 110 226 419   8 228   7 120 127 232 128 233 131 337 240 585  17 242 244 243  19 138 344 139 249 143  27  31  30
323 227   6 222   4 502 326 333 329 126 423  11 234 130  14 239 133  23  21  22 432 341  25 343 141 351 438 347 142 348
225 415 224 417   5 325 327 229 230 581 421 422 235 425 334 129 431 339  20 338 434 245 517 436 246 437 345 346  33 146
117 115 501 231   2 416 504 122 424 646 506 236 336 510 335 429 237 515 430 514 241 135 717 140 248  29 252 147 145 148
114 418 320 219   900 413 500 499 503 645 508 648 583 426 511 713 427 512 433 513 516 519 657 593 524 247 442 254  34 350
410 220 113 322 498 221 643 578 331 125 509 428 710 582 708 584 586 342 588 518 520 592 523 435 441 594 439  37 253  35
217 411 414 324 218 223 575 505 579 580 647 507 711 709 761 764 654 587 655 589 591 811 659 719 349 521 352  36 149 256
112 214 319 496 321 573 576 759 705 704 755 649 653 839 712 652 843 714 715 844 660 658 595 771 440 353 150 151  39 255
109 317 111 315 497 574 577 642 703 757 832 707 651 762 650 807 809 765 590 656 718 661 443 596 152 155 522 154  42 257
318 105 316 412 107 702 571 756 644 753 802 800 706 760 763 806 808 812 871 766 716 666 665 444 600 526 360  38 597 153
108 216 494 406 409 701 639 700 754 836 865 758 804 897 840 841 869 842 769 768 767 598 668 663 354 259 356  41 258 355
212 215 637 210 572 569 798 803 641 864 799 805 835 884 881 868 888 813 846 814 845 770 662 525 358 359 527  43  40 260
213 104 106 492 493 313 314 640 699 794 833 801 883 866 838 892 889 772 810 721 720 725 722 664 667 445 357 528 262  44
101 568 103 491 636 635 408 795 752 837 796 862 863 885 886 898 848 890 870 873 815 773 599 603 601 447 449 261 156 263
102 209 312 211 495 489 698 751 407 797 860 834 882 894 887 867 891 849 872 774 775 724 723 604 529 446 450 159  46 157
100 311 567 404 566 487 570 638 696 861 830 857 854 896 893 895 874 851 847 781 816 605 727 361 531 264 448  45 266  47
 98  99 208 488 490 634 697 750 831 748 793 791 859 878 823 852 877 850 778 776 726 669 670 606 533 530 362 363 160  49
405 310 403 485 564 565 633 747 695 790 829 792 827 855 899 824 876 619 820 779 817 728 602 673 532 452 161 265 158 162
207 308 402 401 309 563 632 693 694 749 828 858 741 880 879 821 785 853 780 729 732 733 671 607 451 534 364 267  48  50
 97 206 307 486 400 562 631 692 746 789 687 788 826 856 787 875 782 737 818 678 777 672 674 608 535 453 365 268 164 163
 96 205 306 399 484 561 630 691 745 743 686 740 685 786 825 822 784 783 819 734 731 730 609 610 536 366 270 367 269  51
 95 204 305 398 483 560 629 690 744 689 742 623 553 684 739 738 681 736 735 615 679 677 675 537 538 454 369 455 165  52
 94 203 304 397 482 559 628 627 626 688 624 551 472 471 620 683 682 617 680 616 614 676 613 540 368 456 370 271 166  53
 93 202 303 396 481 558 557 556 555 625 550 622 621 549 470 468 548 546 466 545 543 542 612 461 373 611 457 272 167  54
 92 201 302 395 480 479 478 477 476 552 554 473 385 287 185 382 618 381 377 465 464 463 541 462 539 459 273 274  56 168
 91 200 301 394 393 392 391 390 388 387 475 474 292 469 384 291 182 284 544 379 180  68 375 374 278 174 277 372 169  55
 90 199 300 299 298 297 296 295 389 294 293  76 386 186 547 184 380 285  70 282 376 283 280 279 460  63 371 275 170  57
 89 198 197 196 195 194 193 192 191 190 189 188 289 187 286 383  73 179 183 378 181 281  65 177 458 175 173 276 171  58
 88  87  86  85  84  83  82  81  80  79  78  77 290  74 288  72 467  75  71  69 178  67  66 176  64  62  61 172  60  59
