# This puzzle is solvable
10
 97  72  89  64  34  66  67  15  96  14
 36   2  83  95   100   6  49  11  39  12
 69  87  74   8  13  26  78  91  68  98
 40  60  35  43  86  31  21  20  41  24
 92   9  37   5   3  45  48  61  25  84
 82  55  33  52  50  88   7  30  75  53
 79  32  62   4  29  57  18  17  38  28
 58  42  80  16  59  90  44  54  46  85
 63  65  51  81  73  23  94  93  76  10
 27   1  77  99  56  71  19  47  22  70
