# This puzzle is solvable
12
 50   4  48   3   1  54  17  61   4  51  92  13
131  40  47   2  45   7 114 115  95  11 113  89
 49 110 128  85  75 122  83  10  86  81  53  57
  6  32 119 129  62 139  46  52  98 132 106  69
 76  43  35  82  37 143 133 137  87  66  79 138
108 109 112  38  84  44  55 111  14  91  78  99
126  72 130  59 140   8  15   9 117  21 116  12
 41  80  74  34  27 142  71  64 100 134  18  88
 24 124  77 104  26 121 141  60  94  93  19  63
 39  31  68 107  42  30  16  28   0  90 118  56
 33  65  70 136  36 102  22 101  25  20  96  58
120 127 105  29 103  73  67  23 125 123  97 135
