# This puzzle is solvable
31
  1   2   3   4   5   8 125 128 345 127 130 132  12 348  14  13 134  18 137  19  23 253  24 356  25 143 145 147 150  27  31
120 122 233 123 124   6   7   9 240 129 241 344 131 443 135 136  15 352  20  21  22 252 139 254  26 144 146  28 259  30  34
232 121 336 234 235 339 236 126 238  11 526  10 242 133 245 247 447 350 354 251 450 142 255 355 256 362 258 361  29  33  35
119 337 338 335 432 522 237 341 239 342 527 347 607 441  16 351 138 249 537 535 353 357 140 540 453 358 257 148 261 260 151
118 117 228 116 524 519 340 435 437 438 440 343 444 346 243 244 246  17 250 536 534 448 539 452 541 359 360 363 262  32  36
115 231 229 334 430 601 436 602 525 605 675 530 529 439 528 349 445 248 748 451 615 141 449 538 618 454 543 456 455 149 152
114 333 230 431 434 429 672 600 604 606 677 609 442 680 683 744 532 681 531 613 802 617 616 688 457 619 459 364 263 153  38
223 113 330 433 226 518 736 598 674 739 608 745 682 799 798 803 800 533 611 686 691 751 690 749 689 620 544 368 458  37 264
110 111 597 227 520 426 10000 603 523 737 740 678 742 845 679 446 801 684 614 610 805 750 752 621 542 460 366  40 365 155 156
108 332 221 599 329 521 669 731 671 735 841 738 793 796 741 847 846 612 746 890 804 806 687 547 546 545 370 158 367 265 154
222 427 428 331 425 670 792 733 839 676 789 797 794 844 842 848 888 918 887 849 685 852 692 694 463 461 373 157 266 267 159
112 224 424 516 514 517 734 790 668 882 732 840 913 881 843 743 953 886 747 851 754 756 622 850 626 462  43  41 369  44  42
220 106 515 225 109 665 596 667 878 787 838 795 934 883 915 916 889 917 941 919 809 854 753 807 693 548 371 160 623  39 268
219 327 423 422 595 593 666 836 730 879 837 880 936 884 940 914 885 921 922 891 893 810 757 755 625 628 627 624 464 372 269
107 420 328 510 594 592 512 788 911 791 908 910 937 912 939 954 951 808 894 943 920 853 892 812 695 466 696 550 271 162  45
105 325 511 513 508 323 664 729 786 877 833 875 960 952 956 935 925 957 944 855 923 813 811 552 551 374 377 465 161 163  47
218 216 217 661 509 507 663 728 834 835 907 933 950 938 959 945 942 898 946 924 857 759 758 856 549 629 630  48 270 272  49
104 421 589 324 419 591 590 785 784 726 832 874 902 948 958 947 955 909 895 927 860 814 760 631 468 469  46 553 165 273  50
103 326 321 322 660 662 781 727 876 782 869 932 930 901 949 771 899 928 818 859 862 858 698 554 467 700 633 556 166 168 164
101 214 102 506 418 587 780 830 725 831 906 873 828 931 866 900 867 926 821   0 896 761 763 701 762 697 471 375 276 378 278
100 318 415 588 417 659 585 583 871 783 870 824 825 903 929 823 897 820 768 815 861 702 816 557 555 703 699 379 376 170 274
 99 213 416 505 320 504 722 658 829 776 826 904 905 775 714 773 865 863 864 819 817 764 765 638 632 635 470 476 473 169 277
210 414 212 586 582 319 656 724 872 778 827 718 717 573 822 715 770 568 772 769 707 710 766 563 634 558  52 281 275  51 382
211  98 501 215 499 502 314 723 653 777 779 719 716 647 649 774 868 570 484 711 639 641 560 380 704 279 475 174 381 167  54
 97 206 584 503 721 579 654 720 655 652 651 575 574 489 713 397 648 712 490 709 767 564 482 705 706 474 559 472 173 280  53
209 311 313 412 203 411 581 495 306 580 578 492 491 650 646 395 644 643 569 485 566 708 567 637 636 561 478 172 384 282 171
317 315  95 308 408 316 500 410 497 493 657 577 403 191 572 396 297 571 642 565 640 291 480 388 182 284 288 383 175  55  60
208 207 312 407 413 309 305  83 409 196 576 302 301 399 401 487 189 645 394 391 392 390 479 562 477  67 179 389 385  58  56
 94  96  90 498 202 201 496 204 198 197 304  79 402 488 193 398 296 294 187 483 292 186 481 181  68  69 289 178  59 283  57
 92 205  89 310 405 200  84  85  87 404 303 194  78 400 300 299 190 188 393 295  72 486 290 286 183  64 386 285 176  66 177
 91  88  93  86 199 307  82 494 406  81  80 195  77 192  76 298  75  74  73  71 293  70 185 287 184  65 180  63  62 387  61
