# This puzzle is solvable
24
  1   2   3   4   5   6   7   8   9  10  11  12  13  15 105 189 106  18 110 111  19  21 113  24
 92  93  94  95  96  97  98  99 100 101 102 103 330 188 104  14 264 107 108 267 112  23 194 115
 91 176 177 178 179 181 181 182 183 184 185 186 187 265  17 191 266  20 339 193 114  25 197 196
 90 175 252 253 254 255 257 258 324 325 260 261 329 190 389 391 109 269 192 271 195  22  27  26
 89 251 250 320 321 382 256 383 514 328 259 326 262  16 332 334 442 394 268 336 270  28 276 116
 88 174 249 319 380 322 323 385 386 479 327 388 439 263 485 333 200 444 338 346 119 199  30 118
 87 173 247 318 378 426 381 434 435 436 437 483 517 390 522 484 331 446 272 397 273  29 198 117
248 172 316 317 431 470 379 433 384 477 441 518 482 520 392 396 440 337 335 443 341 340  32 202
171 170 313 314 246 315 432 476 511 478 480 387 516 438 519 521 395 393 486 445 120 274 203 204
 86 169 374 430 513 375 512 541 474 559 572 545 544 564 546 575 345 489 447 448 201 343 275 402
 85 244 539 376 473 373 425 475 509 481 540 558 515 547 548 488 492 523 399 124 122  34 121  31
 84 423 245  83 507 372 510 428 429 471 565 542 562 563 450 487 496 553 277 342 208  37  33  36
377 468  80 466 243 427 560 534 571 573 538 561 543 549 526 566 211 456 490   0 400 205 123 125
242 167 310 303 309 424 535 536 508 557 569 568 449 574 550 527 498 279 404 494  35 280 206 209
311 241  77  82 164 472 312 506 537 555 570 567 530 411 525 458 459 491 278 407 281 401 129 406
239 306 168  76 505 419 371 370 532 556 502 461 452 501 552 499 408 283  38  39 398 524 344 405
 78 307 368 160 165 238 422 467 503 463 529 531 551 554 453 403 289 348 451 285 282 212 131 351
 79  74 161 469 465 231 420 504 533 418 500 462 528 412 497 207 359 495 210 454  40 127 284 349
166  81  73 162 421 163 364 369 417 147 415 413 357 360 460 409 290 353 286 288 132  42 218  43
158 154 159 304 234 366 240 361 363 362 296 414 358 145 293 356 355 457 217 347 133 354 134 126
237 308 230 155 236 302  66 226 464 228 229 223 294 410  54 142 291 220 350 135 128 493 130  46
367 365 153  75 227 301 149  64 416 224 298 297 144 221 222 292 140 215 219 352 287  44  48 214
156  71  71  69 69 232 150 157  68 148  65 152 295  58  57 455 143 213  50 137  51  49 216 136
 72 300 235  67 151 299 233  63  62 225  61  60 146  59  56  55 141  52  53 138 139  41  45  47
