# This puzzle is solvable
9
30 80 58 68 27 71 44 24 76
51  0 49 40 39 75 15 21 37
57  4 22  1 34 78 55 12 66 3
47  7  6 62 65 50 33 10 48
19 14 13 31 43  5 25 17 41
 2 32  9 54 74 73 42 45 63
23 53 8 77 69 70 64 28 18 11
52  8 60  3 79 35 46 36 61
29 56 20 38 72 26 59 67 16
