# This puzzle is solvable
8
1 2
41 17 34 42 30 47  7 51
57  6 50 27  0 22 38 59
12 60 37 44 31 36 23 33
 4 45 40  1 18 54 14  8
19 13 28 39 58  9  2 11
20 21 46 55 15 63 16 24
 3  5 26 43 10 48 32 25
29 49 53 56 62 61 52 35
