# This puzzle is solvable
10
 67  94  79  48  86  37 100  96  59  42  49 
 76   6   0  21  83  64  43  39  93  10
 31  40   1  97  54  84  13   8  82  45
 85   7  38   9   5  12  80  14  50  87
  4  66  99  29  25  11  95  33  36  58
 55  89   3  47  24  62  32  19  16  52
 56  68  63  69  74  81  18  88  65  57
 60  15  91  35   2  71  70  72  41  77
 17  61  27  78  90  28  51  26  44  92
 34  73  23  98  46  30  20  75  22  53
