# This puzzle is solvable
 49 133  45 131 142  42  93  55  11 111  86  51
12
  9  82  84   5  40  14 120  44  54  12  88  56
108 109  80  53   2  79  76 118   6  10  94  52
 77  89  83  90 127 107  70 114  13 113 143 132
104 126  43 125  21   4 106   3   7  50 130  15
123  46 136  17  22  87  72  20  18  47 141 140
 36   1  73  25  35  19  97 119  58  95  92   0
124 103  38  57 110  78  39  99  16  63 112  68
 48 129  75  32  30  98  85  59 134 135  91 121
128  29  37  34  33 105  60  65 139  66  26 115
 74 100  31  67 102 122  81  71  61  69  23  24
101  41 138 116 137  28   8  96  64  27 117  62
