# This puzzle is solvable
   1    2    3    4    5    6    8  131  354   10   12   13   15  137   16  256  139   18   19   20   21   22   23   24   25   26   27   28   29   30   31   32
 124  125  126  127  128  130    7  132  133    9  135  247  134   14  252  254  460  140  257  143  144  145  146  147  148  149  150  151  152  153  154   33
 123  240  241  242  243  129  244  353  246  453  248   11  359  136  361  251  553  362   17  258  259  260  261  262  263  264  373  265  267  155  156   34
 122  239  348  349  350  352  245  454  355  455  357  249  459  250  551  360  462  461  141  366  465  367  368  369  370  371  372  374  376  269  268   35
 121  238  347  448  449  351  451  452  544  545  456  356  358  138  549  364  253  552  363  463  466  557  467  468  469  470  472  562  266  375  158  157
 120  237  346  447  541  450  542  543  627  546  457  458  548  550  775  633  711  142  255  464  556  640  558  559  560  561  563  471  377  271  270   36
 119  236  345  446  540  539  624  702  628  629  706  631  547  707  632  634  778  637  554  365  638  639  641  717  642  643  644  473  474  160   37  159
 235  117  344  445  538  623  625  626  701  769  771  630  773  776  635  636  709  777  779  555  714  715  716  784  718  645  564  475  378  272   39  273
 118  234  343  444  537  622  700  699  770  703  705  831  772  774  708  835  710  837  713  712  781  841  782  783  719  646  565  476  274  162   40   38
 233  342  443  536  621  698  767  768  828  829  704  830  883  834  885  887  931  836  838  780  839  840  842  785  720  566  567  477  275  161   41   42
 116  232  341  442  535  620  697  766  826  880  827  882  926  832  929  886  930  888  889  890  891  892  843  786  721  478  648  479  379  276  163   43
 115  114  340  441  534  619  696  765  879  924  881  925  927  833  928  884  991  932  967  933  934  893  844  787  722  647  568  383  277  380  279   44
 113  231  339  440  533  618  695  764  825  878  923  960  961  962 1009  964 1011  965  994  968  936  935  845  788  650  649  725  570  569  382  164   45
32
 112  230  338  439  532  617  763  824  922  877  921  959  988  989  963  990 1013  966  969  894  937  847  846  791  792  571  485  481  165  381  280   46
 111  229  228  336  337  438  694  692  762  823  920  958  987 1008  992 1021 1012  993  938  898  899  978  895  575  724  789  484  651  387  480  278   48
 110  227  530  531  615  616  691  760  761  876  874  957  986  985 1010 1020 1003  995  970  849  848  850  896  790  793  483  283  385    0  169  652  384
 109  226  335  437  436  529  693  690  873  820  917  956 1006 1005 1007 1019  996 1014  971  999  997  998  853  795  653  723  167  166  656   50  386  168
 108  225  334  435  528  614  613  758  819  822  915  875  980  954  984 1000 1022 1017 1023  973  940  798  852  897  655  574  388  482  389  282  281  171
 107  333  434  433  527  612  689  821  872  871  918  952  955 1002 1018 1015 1001  945  976  972  906  797  939  943  654  572  486  726  577   47  284   51
 105  106  224  223  526  610  611  759  869  817  919  809  981  951  908  946  947  974  900  941 1016  942  730  731  658  729  573  794  576  288   52  170
 104  222  332  432  525  688  685  687  818  756  865  866  909  912  979  975  950  910  982  854  801  802  901  796  728  851  734  390  660   49  173  174
 221  220  331  524  609  608  607  815  816  753  870  813  953  914  746  863 1004  977  805  902  804  858  903  491  799  727  578  394  172  488  287   53
 103  219  330  431  520  430  522  681  868  812  911  676  916  867  948  913  862  907  807  857  944  855  657  732  736  661  733  487  580  285  286  175
 101  102  426  218  429  686  757  754  814  750  513  595  949  864  745  744  983  861  856  740  589  588  905  659  581  391  735  392  290  289  291  177
 328  523  329  519  521  428  684  752  606  600  677  811  810  596  674  672  667  808  592  860  586  666  669  401  393  739  395  490  398  489   56  176
 325  215  427  327  603  518  683  755  679  751  511  598  512  599  747  806  859  673  742  501  741  803  583  500  299  494  662  579  492  400   54   55
 217   98  605  216  682  320  604  601  515  678  675  749  312  509  508  594  503  590  671  587  403  193   75  497  663  665  498  737  664  178   57   61
  99  326  211  100  324  424  516  602  420  748  680  310  418  415   74  507  303  307  593  904  800  499  311  191  585  399  296  298  493  396   60  293
  97  214  322  213  323  423  421  416  514  315  510  199  413  200  597  411  743   76  412  190  405  300  591  197  180  582  397   63  292  297  181   62
  95  210   96  208  321  318  317  419  517   84  201  414  313  309  504  194  410  670  305  407  189  192  409  668   71  184  185  496  584  179  495   58
  94   92  212   90   89  425  206  205  204  314  203   85   79  202   78   77  302  308   73  196  187  406   72   70   68  402  186  301   59  294  182  295
  93   91  422  319  209   88  207   86  417  316   87   82   81   83  198  506   80  304  408  505  306  195  738  188  404  502   67   69   66   65  183   64
