# This puzzle is solvable
  4  65  83  43  72  52  89  57  11  68
  3  37  44  62  78  42  58  48  10  90
 35   6  20  56  18  82  95  70  25  12
 93  64  39  23  69  86   2   7  16  41
10
 34   0  81  36  31  45   8  67  24  71
 47  26  88  38  87   9  46  55  15  99
 33  29   5  27  14  54   1  77  96  76
 40  97  94  49  59  21  19  73  28  13
 30  98  85  32  60  50  79  92  75  91
 80  51  63  84  66  61  17  53  22  74
