# This puzzle is solvable
   1    2    3    4    5    6    7    8    9   10   11   12   13   14   15   16   17   18   19   20   21   22   23   24   25   26   27   28   29   30   31   32   33   34   35   36   37   38   39   40   41   42   43   44   45   46   47   48   49   50   51   52   53   54   55   56   57   58   59   60   61
 240  241  242  243  244  245  246  247  248  249  250  251  252  253  254  255  256  257  258  259  260  261  262  263  264  265  266  267  268  269  270  271  272  273  274  275  276  277  278  279  280  281  282  283  284  285  286  287  288  289  290  291  292  293  294  295  296  297  298  299   62
 239  472  473  474  475  476  477  478  479  480  481  482  483  484  485  486  487  488  489  490  491  492  493  494  495  496  497  498  499  500  501  502  503  504  505  506  507  508  509  510  511  512  513  514  515  516  517  518  519  520  521  522  523  524  525  526  527  528  529  300   63
 238  471  696  697  698  699  700  701  702  703  704  705  706  707  708  709  710  711  712  713  714  715  716  717  718  719  720  721  722  723  724  725  726  727  728  729  730  731  732  733  734  735  736  737  738  739  740  741  742  743  744  745  746  747  748  749  750  751  530  301   64
 237  470  695  912  913  914  915  916  917  918  919  920  921  922  923  924  925  926  927  928  929  930  931  932  933  934  935  936  937  938  939  940  941  942 1150  943  944  946  947  948  949  950  951  952  953  954  955  956  957  958  959  960  961  962  963  964  965  752  531  302   65
 236  469  694  911 1120 1121 1122 1123 1124 1125 1126 1127 1128 1129 1130 1131 1132 1133 1134 1135 1136 1137 1138 1139 1140 1141 1142 1143 1144 1145 1146 1147 1148 1348 1149 1151  945 1152 1154 1155 1156 1157 1158 1159 1160 1161 1162 1163 1164 1165 1166 1167 1168 1169 1170 1171  966  753  532  303   66
 235  468  693  910 1119 1320 1321 1322 1323 1324 1325 1326 1327 1328 1329 1330 1331 1332 1333 1334 1335 1336 1337 1338 1339 1340 1341 1342 1343 1344 1345 1346 1538 1347 1349 1350 1351 1153 1352 1354 1356 1547 1357 1358 1359 1360 1361 1362 1363 1364 1365 1366 1367 1368 1369 1172  967  754  533  304   67
 234  467  692  909 1118 1319 1512 1513 1514 1515 1516 1517 1518 1519 1520 1521 1522 1523 1524 1525 1526 1527 1528 1529 1530 1531 1532 1533 1534 1535 1536 1720 1537 1539 1540 1541 1542 1543 1353 1546 1355 1548 1732 1731 1550 1551 1552 1553 1554 1555 1556 1557 1558 1559 1370 1173  968  755  534  305   68
 233  466  691  908 1117 1318 1511 1696 1697 1698 1699 1700 1701 1702 1703 1704 1705 1706 1707 1708 1709 1710 1711 1712 1713 1714 1715 1716 1717 1718 1719 2220 1721 1722 1723 1724 1725 1727 1545 1544 1728 1730 1906 1549 1733 1734 1735 1736 1737 1738 1739 1740 1741 1560 1371 1174  969  756  535  306   69
 232  465  690  907 1116 1317 1510 1695 1872 1873 1874 1875 1876 1877 1878 1879 1880 1881 1882 1883 1884 1885 1886 1887 1888 1889 1890 1891 1892 1893 1895 1896 1897 1898 2065 1899 1900 1726 1902 1903 1729 1904 1905 1907 1908 1909 1910 1911 1912 1913 1914 1915 1742 1561 1372 1175  970  757  536  307   70
 231  464  689  906 1115 1316 1509 1694 1871 2040 2041 2042 2043 2044 2045 2046 2047 2048 2049 2050 2051 2052 2053 2054 2055 2056 2057 2058 2059 2060 1894 2061 2063 2374 2064 2066 2068 1901 2069 2070 2071 2072 2073 2074 2075 2076 2077 2078 2079 2080 2081 1916 1743 1562 1373 1176  971  758  537  308   71
 230  463  688  905 1114 1315 1508 1693 1870 2039 2200 2201 2202 2203 2204 2205 2206 2207 2208 2209 2210 2211 2212 2213 2214 2215 2216 2217 2218 2219 2062 2372 2221 2373 2223 2224 2067 2227 2228 2229 2230 2231 2232 2233 2234 2235 2236 2237 2238 2239 2082 1917 1744 1563 1374 1177  972  759  538  309   72
 229  462  687  904 1113 1314 1507 1692 1869 2038 2199 2352 2353 2354 2355 2356 2357 2358 2359 2360 2361 2362 2363 2364 2365 2366 2367 2368 2369 2370 2514 2371 2222 2517 2375 2225 2226 2378 2379 2380 2381 2382 2383 2384 2385 2386 2387 2388 2389 2240 2083 1918 1745 1564 1375 1178  973  760  539  310   73
 228  461  686  903 1112 1313 1506 1691 1868 2037 2198 2351 2496 2497 2498 2499 2500 2501 2502 2503 2504 2505 2506 2507 2508 2509 2510 2511 2512 2513 2649 2515 2516 2652 2518 2520 2377 2521 2522 2658 2523 2525 2526 2527 2528 2529 2530 2531 2390 2241 2084 1919 1746 1565 1376 1179  974  761  540  311   74
 227  460  685  902 1111 1312 1505 1690 1867 2036 2197 2350 2495 2632 2633 2634 2635 2636 2637 2638 2639 2640 2641 2642 2643 2644 2772 2645 2647 2776 2650 2651 2778 2779 2653 2519 2655 2782 2785 2524 2659 2660 2662 2663 2790 2664 2665 2532 2391 2242 2085 1920 1747 1566 1377 1180  975  762  541  312   75
 226  459  684  901 1110 1311 1504 1689 1866 2035 2196 2349 2494 2631 2760 2761 2762 2763 2764 2765 2766 2767 2768 2769 2770 2771 2646 2773 2775 2648 2896 2777 2897 2899 2376 2900 3010 2654 2783 2656 2657 2787 2661 2907 2789 2791 2667 2533 2392 2243 2086 1921 1748 1567 1378 1181  976  763  542  313   76
 225  458  683  900 1109 1310 1503 1688 1865 2034 2195 2348 2493 2630 2759 2880 2881 2882 2883 2884 2885 2886 2887 2888 2889 2890 2891 2892 2774 2894 3004 3007 2898 2780 3011 3115 2781 2902 2903 2786 2904 2906 2788 2908 2909 2666 2792 2534 2393 2244 2087 1922 1749 1568 1379 1182  977  764  314  315   77
 224  457  682  899 1108 1309 1502 1687 1864 2033 2194 2347 2492 2629 2758 2879 2992 2993 2994 2995 2996 2997 2998 2999 3000 3001 3002 3003 3106 3005 2895 3006 3008 3112 3009 3012 3013 2901 2784 3014 2905 3122 3017 3019 2910 2793 2668 2535 2394 2245 2088 1923 1750 1569 1380  978  979  765  543  316   78
 223  456  681  898 1107 1308 1501 1686 1863 2032 2193 2346 2491 2628 2757 2878 2991 3096 3097 3098 3099 3100 3101 3102 3103 3104 3105 3201 2893 3108 3205 3109 3110 3111 3113 3114 3116 3117 3015 3119 3118 3016 3121 3021 2794 2669 2795 2536 2395 2246 2089 1924 1751 1570 1381 1183  766  545  544  317   79
 222  455  680  897 1106 1307 1500 1685 1862 2031 2192 2344 2345 2755 2490 2756 2990 2989 3095 3193 3194 3283 3195 3197 3198 3199 3200 3288 3107 3204 3290 3206 3293 3207 3208 3209 3297 3299 3210 3211 3301 3120 3018 2911 3020 2912 2796 2537 2396 2247 2090 1925 1752 1571 1382 1184  980  767  547  546   80
 221  454  896 1105 1306 1499 1498 1684 2030 2029 2190 2191 2489 2626 2627 2877 2875 2988 3192 3279 3281 3282 3280 3284 3285 3286 3287 3367 3203 3202 3371 3372 3292 3294 3296 3298 3212 3376 3377 3217 3214 3213 3123 3215 3022 2913 2914 2538 2397 2248 2091 1926 1753 1572 1383 1185  981  768  548  318   81
 220  453  679  895 1104 1305 1497 1860 1861 2189 2028 2343 2488 2487 2754 3094 3191 2874 3189 3190 3360 3361 3196 3363 3364 3365 3366 3438 3289 3441 3368 3440 3373 3445 3295 3449 3446 3510 3378 3300 3302 3216 3124 3023 2915 2797 2670 2671 2539 2249 2093 2092 1927 1573 1384 1187 1186  769  549  319   82
 452  677  678  894 1103 1304 1682 1683 1859 2027 2188 2342 2624 2625 2753 2876 3093 3092 2987 3278 3276 3433 3362 3434 3435 3436 3437 3501 3439 3291 3369 3370 3442 3563 3374 3375 3448 3450 3381 3379 3218 3380 3125 3024 2917 2798 2540 2542 2398 2399 2250 1928 1754 1574 1385 1188  982  983  770  320   83
 219  451  676  893 1102 1303 1496 1856 1681 1857 2341 2485 2622 2484 2751 2872 2752 3188 3277 3358 3187 3432 3496 3497 3498 3499 3554 3500 3503 3605 3505 3507 3443 3444 3562 3447 3566 3564 3565 3382 3305 3304 3126 2799 3025 2800 2673 2400 2401 2251 2094 1929 1755 1756 1575 1386  984  771  550  321   84
 218  450  675  892 1101 1302 1494 1678 2026 1858 2187 2486 2185 2623 2750 2986 2985 3091 3186 3185 3356 3431 3430 3495 3555 3603 3697 3642 3502 3557 3560 3559 3506 3609 3509 3512 3611 3513 3452 3306 3303 3222 3127 2916 2674 2672 2675 2541 2402 2252 2095 1930 1757 1576 1387 1189 1190  985  551  322   85
 217  216  674  891 1100 1301 1300 1679 1495 1680 2186 2340 2483 2620 2871 2621 3089 3087 3090 3273 3359 3357 3550 3552 3602 3597 3556 3674 3698 3644 3561 3607 3645 3649 3508 3648 3511 3451 3384 3383 3220 3129 3027 3219 2918 2801 2544 2802 2403 2253 2096 1931 1758 1577 1388  986  773  772  552  323   86
 448  449  673  890 1099 1491 1298 1493 2024 2025 2338 2339 2749 2870 2984 2873 3183 2983 3355 3429 3551 3494 3598 3601 3553 3640 3604 3641 3643 3606 3504 3646 3677 3651 3678 3514 3567 3568 3453 3221 3387 3385 3128 3130 3029 2678 3026 2543 2919 2254 2097 1932 1759 1578 1579 1389  987  774  553  324   87
 215  447  672  889 1098 1297 1492 1677 1855 1854 2184 2337 2482 2619 2747 2748 2981 2982 3491 3088 3493 3428 3492 3599 3600 3639 3549 3695 3675 3676 3558 3700 3610 3680 3613 3612 3454 3455 3308 3309 3456 3223 3028 2676 2804 2920 2679 2677 2404 2255 2098 1933 1391 1580 1760  988 1191  775  554  325   88
 214  446  670  671  888 1097 1299 1676 1853 2023 2022 2336 2481 2618 2866 2869 3086 3184 3275 3272 3354 3427 3547 3489 3548 3670 3638 3673 3672 3608 3712 3701 3702 3570 3679 3650 3516 3615 3569 3515 3224 3131 3030 2921 2922 2803 2546 2545 2405 2256 1934 1761 1581 1390 1193 1192  989  776  555  326   89
 213  212  445  887 1096 1489 1488 1675 1852 2182 2183 2181 2480 2616 2617 2867 2868 2980 3182 3353 3271 3352 3426 3596 3595 3637 3696 3671 3713 3711 3699 3715 3614 3653 3652 3681 3386 3460 3457 3520 3307 3310 3134 2923 3031 2805 2680 2547 2259 2101 2406 2099 1935 1762 1392 1194  990  777  556  327   90
 211  444  669  886 1095 1490 1674 1296 2020 2021 2334 2335 2479 2746 2745 2979 3084 3085 3274 3181 3351 3425 3423 3490 3636 3668 3669 3720 3692 3714 3716 3704 3717 3647 3684 3683 3616 3518 3519 3388 3571 3226 3225 3132 2924 2806 2681 2548 2257 2100 2102 1763 1582 1583 1393 1195 1196  778  557  328   91
 210  443  668  885 1094 1295 1673 1850 1851 2019 2180 2333 2478 2615 2744 2865 2978 3083 3180 3270 3350 3424 3486 3545 3546 3487 3694 3710 3719 3708 3688 3718 3705 3682 3654 3572 3573 3574 3390 3391 3313 3136 3227 3133 3032 2682 2684 2550 2408 2407 2103 1936 1764 1584 1394 1197  991  993  558  329   92
 209  442  667  884 1093 1294 1487 1672 1849 2018 2179 2332 2477 2614 2743 2864 2977 3082 3179 3269 3349 3422 3593 3488 3635 3633 3544 3667 3693 3691 3707 3706 3703 3658 3656 3617 3621 3517 3521 3389 3311 3312 3033 2925 2808 2807 2683 2549 2409 2260 1937 1939 1765 1396 1200 1198  992  779  559  330   93
 208  441  666  883 1092 1293 1486 1671 1848 2017 2178 2331 2476 2613 2742 2863 2976 3081 3178 3268 3177 3348 3267 3631 3591 3588 3592 3666 3687 3709 3623 3685 3657 3622 3686 3618 3522 3458 3459 3228 3314 3135 3035 3034 2926 2809 2685 2552 2551 2104 1938 1766 1585 1395 1397 1199  780  781  560  331   94
 207  440  665  882 1091 1292 1485 1846 1670 2016 2177 2330 2475 2612 2741 2862 2975 3080 3176 3266 3542 3485 3347 3421 3537 3634 3594 3663 3628 3661 3662 3659 3660 3620 3655 3619 3575 3461 3392 3229 3393 3230 3137 3036 2927 2810 2261 2553 2410 2263 2262 2105 1940 1767 1586  995  994  782  561  332   95
 206  439  664  881 1089 1090 1484 1669 1668 2014 1847 2176 2474 2611 2861 3078 2974 3079 3265 3541 3484 3345 3420 3690 3590 3664 3665 3629 3534 3627 3689 3626 3624 3580 3578 3579 3523 3462 3464 3395 3315 3138 3040 3037 2928 2811 2686 2411 2258 2412 2106 1941 1768 1587 1398 1201  996  783  562  333   96
 205  438  663  880 1087 1291 1482 1483 2015 1844 2328 2329 2473 2610 2740 2739 3077 2973 3175 3264 3483 3419 3539 3543 3589 3632 3586 3585 3584 3583 3472 3531 3625 3582 3468 3576 3577 3525 3398 3465 3394 3232 3231 3139 2929 2812 2687 2554 2413 2264 2107 1942 1769 1588 1399 1202  997  784  563  334   97
 204  437  662  879 1290 1287 1088 1480 1845 2012 2175 2326 2469 2738 2972 2860 2858 2970 3174 3263 3344 3540 3346 3482 3538 3630 3477 3587 3535 3533 3532 3581 3405 3401 3530 3527 3524 3526 3463 3316 3317 3140 3039 3038 2930 2813 2688 2555 2414 2265 2108 1943 1770 1589 1400 1203  998  785  564  335   98
 203  436  661  878 1086 1288 1666 1667 1289 2013 2172 2174 2609 2472 2471 2859 3074 2971 3173 3343 3341 3417 3481 3418 3479 3414 3478 3536 3475 3407 3474 3473 3469 3528 3403 3467 3466 3399 3234 3318 3320 3233 3141 3041 2814 2689 2556 2415 2266 2109 1944 1945 1771 1590 1401 1204  999  786  565  336   99
 202  434  435  877 1085 1665 1481 1843 2011 2010 2327 2173 2607 2737 2608 2855 3076 3171 3261 3262 3257 3256 3480 3416 3339 3410 3252 3409 3476 3408 3404 3471 3400 3402 3326 3327 3242 3397 3319 3396 3236 3235 2933 3042 2931 2932 2690 2557 2416 2267 2110 1946 1772 1591 1402 1205 1000  787  566  337  100
 201  660  658  659  875  876 1479 1841 1664 2009 2323 2325 2322 2470 2857 2856 3075 3073 3172 3259 3342 3413 3415 3340 3412 3338 3336 3334 3251 3333 3406 3331 3470 3329 3328 3529 3151 3324 3323 3322 3321 3142 3144 3143 2816 2815 2691 2558 2417 2268    0 1947 1773 1592 1403 1206 1001  788  567  338  101
61
 200  433 1084  874 1284 1283 1476 1842 1839 2171 1663 2605 2324 2734 2606 2736 2854 3170 3258 3260 3167 3165 3163 3253 3255 3411 3162 3335 3160 3332 3248 3330 3247 3246 3244 3245 3150 3243 3240 3239 3238 3237 3043 3044 2934 2817 2692 2559 2418 2269 2111 1948 1774 1594 1404 1207 1002  789  568  339  102
 199  432  657 1286 1285 1477 1662 1478 1840 2008 2468 2465 2467 2602 2735 2733 2969 2968 3072 3168 3068 3066 3166 3164 3254 3063 3061 3161 3159 2839 3158 3157 3154 3155 3153 3152 3051 3325 3149 3241 3148 3147 3145 2936 2935 2818 2693 2560 2419 2270 2112 2113 1593 1405 1776 1208 1003  790  569  340  103
 198  431  656  873 1083 1082 1661 1660 1838 2007 2170 2168 2732 2464 2604 2853 2963 2967 3169 2964 3070 2962 3067 3064 3337 2956 2840 2954 3062 3060 3059 3250 3249 3156 3055 3054 3053 3052 3050 3049 3048 3146 3046 2939 2937 2819 2694 2561 2420 2271 2114 1777 1775 1596 1406 1209 1004  791  570  341  104
 197  430  655  872 1081 1282 1475 1837 2166 2006 2169 2167 2603 2321 2730 2852 2850 2965 2849 2966 3071 2960 2844 3065 2959 2957 2717 2955 2715 3058 2835 2950 3057 2949 2834 2947 2946 2944 2943 2942 2941 2940 3045 2823 2938 2820 2695 2562 2421 2272 2115 1949 1950 1407 1595 1210 1005  792  571  342  105
 196  429  654  871 1080 1281 1474 1659 2601 2462 2005 1835 2319 2599 2731 2728 2851 2725 2846 2451 2722 2594 2721 2843 2718 2841 2716 2953 2838 2836 2952 3056 2833 2832 2709 2831 2945 2828 3047 2435 2824 2571 2701 2825 2822 2821 2696 2563 2422 2273 2116 1951 1778 1597 1408 1211 1006  793  572  343  106
 195  428  653  870 1079 1280 1473 1836 1657 2320 2163 2466 2318 2463 2600 2729 2457 2848 2456 2845 2453 2961 2590 2719 2303 2586 2585 2837 2582 2443 2294 2712 2951 2948 2710 2707 2830 2829 2703 2572 2433 2826 2702 2700 2699 2698 2697 2564 2423 2274 2117 1952 1779 1598 1409 1212 1007  794  573  344  107
 194  427  652  869 1078 1279 1472 1658 1833 2004 2317 2003 2316 2460 2311 2597 2727 2595 2306 2847 2726 2592 2300 2724 2452 2589 2588 2445 2444 2714 2713 2581 2578 2579 2576 2708 2575 2436 2827 2574 2704 2432 2570 2569 2568 2567 2566 2565 2424 2275 2118 1953 1780 1599 1410 1213 1008  795  574  345  108
 193  426  651  868 1077 1278 1471 1656 2162 1834 2164 2165 2159 2596 2458 2308 2459 2455 2593 2152 3069 2454 2305 2842 2448 2587 2301 2449 2296 2297 2711 2441 2292 2580 2577 2439 2290 2573 2705 2288 2130 1967 2431 2430 2429 2428 2427 2426 2425 2276 2119 1954 1781 1600 1411 1214 1009  796  575  346  109
 192  425  650  867 1076 1277 1470 1655 1832 2002 2001 2314 2158 2461 2157 2156 2312 2307 2304 2723 1816 2149 2958 2720 2302 2447 2584 2146 2446 2299 2142 2442 2293 2438 2440 2137 1971 2437 2706 2434 2285 2286 2284 2283 2282 2281 2280 2279 2278 2277 2120 1955 1782 1601 1412 1215 1010  797  576  347  110
 191  424  649  866 1075 1276 1469 1654 1831 1829 2000 2315 1264 1995 2309 2598 2154 1822 2155 2153 1639 1988 2450 2147 1448 1983 1814 1980 2144 2298 2141 2295 2583 2291 2136 1974 2135 2134 2133 1798 2287 2132 2129 2128 2127 2126 2125 2124 2123 2122 2121 1956 1783 1602 1413 1216 1011  798  577  348  111
 190  423  648  865 1074 1275 1468 1653 1828 1998 1826 2161 2313 1994 1996 2310 1992 1452 1990 1641 1256 2151 2150 1985 2145 1447 1634 1812 1630 1979 1977 2140 2139 1975 2138 1436 1972 1970 2289 1432 2131 1797 1965 1964 1793 1963 1962 1961 1960 1959 1958 1957 1784 1603 1414 1217 1012  799  578  349  112
 189  422  647  864 1073 1274 1467 1652 1999 1830 1827 2160 1824 1823 1993 1991 1819 1820 1989 1640 2591 1817 2148 1986 1982 1446 1984 2143 1811 1808 1978 1806 1976 1804 1802 1973 1801 1800 1969 1968 1618 1617 1966 1794 1614 1792 1791 1790 1789 1788 1787 1786 1785 1604 1415 1218 1013  800  579  350  113
 421  420  646  863 1273 1466 1651 1464 1650 1649 1825 1459 1458 1645 1644 1821 1642 1818  845 1638 1054 1449 1987 1813 1637 1636 1632 1809 1981 1442 1807 1439 1805 1626 1625 1623 1435 1620 1799 1796 1434 1616 1795 1615 1613 1426 1612 1611 1610 1609 1608 1607 1606 1605 1416 1219 1014  801  580  351  114
 188  862 1071 1072 1070 1465 1463 1462 1267 1461 1648 1997 1646 1266 1460 1455 1456 1457 1259  842 1453 1253 1255 1635 1633 1250 1631 1810 1445 1247 1440 1629 1627 1244 1803 1624 1621 1622 1433 1619 1431 1430 1429 1428 1427 1231 1425 1424 1423 1422 1421 1420 1419 1418 1417 1220 1015  802  581  352  115
 187  419  645  861 1271 1272 1270 1268 1269 1265 1063 1647 1061 1263 1260 1261 1060 1451 1055  843  840 1450 1050  836 1815 1252 1049 1251 1443 1441 1628 1245 1242 1438 1437 1241 1240 1239 1238 1237 1236 1235 1234 1030 1233 1232 1230 1229 1228 1227 1226 1225 1224 1223 1222 1221 1016  803  582  353  116
 186  185  417  644  860 1069 1067  854 1065  855  853  851  849 1262 1057 1056 1643  400 1454  844  624  841  837 1254 1051  619 1249 1046 1045 1043 1041 1246  830 1243 1039  827 1037 1036 1035 1034 1033  820  821 1031 1029 1028 1027 1026 1025 1024 1023 1022 1021 1020 1019 1018 1017  804  583  354  117
 416  183  418  641  859 1068  857 1066  856 1062  632 1064  852  850 1059 1058  165  846  628  627 1258  625 1053  622  838 1047 1444  834 1248  833  613 1042  831 1040 1038  829  826  606  825  823  822  602 1032  819  818  817  816  815  814  813  812  811  810  809  808  807  806  805  584  355  118
 643  184  414  415  858  639  637  636  408  409  634  406  629  404  401  848  166  163  399 1257  395  620  393  617  391  616  615 1048 1044  614  385  832  611  610  828  609  380  607  824  605  603  375  601  600  599  598  597  596  595  594  593  592  591  590  589  588  587  586  585  356  119
 182  640  413  642  412  638  410  175  407  635  172  633  169  631  630  847  398  397  162  164  623  159  839  392  618  157  388  154  387  152  386  612  384  383  382  608  381  379  378  604  377  376  374  373  372  371  370  369  368  367  366  365  364  363  362  361  360  359  358  357  120
 181  180  179  178  177  411  176  173  174  171  405  170  168  403  167  402  626  161 1052  160  394  621  396  158  155  389  156  390  835  153  151  150  149  148  147  146  145  144  143  142  141  140  139  138  137  136  135  134  133  132  131  130  129  128  127  126  125  124  123  122  121
