# This puzzle is solvable
10
 81  65  37  35  44  56  50  40   3   2
  4  34  23  42   5  47  67  29  39  49
 61  58  68   6  80   9  16  38  74  43
 84  51  64  10  73  69  41  71  93  91
 76    11   7  95  60  96  87  77  90
 63  86  62  46  70  25  48  14   8  15
 32  89  55  33  98  22  52  31  66  78
 28  82  45  57  83  92  17  19  12  13
 85  36  30  59   1  54  75   0  94  21
 27  97  26  20  72  53  79  18  88  99
