# This puzzle is solvable
31
120 234   3   1   4 126   9 343   8 129  10 128  13  14 131 135 132  18  19 138 356 143 255 147 256  24  25  28 146 260  31
121 232 233 236   5 124   6   7 524 344  11 440  12 346 245 247 243 248  23  20 353 139 140 253 254 145  26  29 259  32  30
122 117 433 230 435 337 127 341 130 237 438 347 244  15 134 137 136 250 352 249 252 141 459  22  21 257 360 154 149 150 148
229 336 125 119 434 123 340 235 238 239 242 240 345 133 444  16  17 350 687 448 449 142 144 538 537 454 455  33 152 258  35
231 335 115 338 515 672 520 436 437 603 441 442 342 443 348 349 446 351 614 612 534 359 251 451 618 357 363 361  27  38 151
432 226 519 118 430 517 439 339 738 523 241 676 527 529 530 610 531 246 533 450 355 447 539 617 805 262 358  36 261 155 153
116 516 431 227 522 602 601 606 597 525 605 675 796 677 742 445 611 608 613 748 746 616 354 622 689 542 540 453 365  37 266
333 521 113 518 671 600 673 604 596 881 741 526 739 528 800 607 682 609 749 535 747 752 536 688 545 452 541 457 364 156  39
512 334   2 736 427 428 674 840 793 844 735 737 679 678 847 680 681 532 615 686 888 690 543 750 751 362 460 264 267 366  34
112 228 223 225 114 329 792 599 733 794 841 880 797 740 798 799 684 745 803 685 806 683 456 692 852 619 546 367 458 263 157
330 111 331 327 425 426 595 429 669 670 790 795 883 743 845 843 802 744 850 849 808 694 804 691 544 620 461 158 265  40  41
325 332 328 511 423 594 734 791 598 839 879 936 940 913 842 846 887 848 886 851 939 753 462 623 624 463 368 369 268  42  43
110 326 224 593 514 668 667 732 789 837 912 915 916 953 917 938 954 919 891 756 920 754 693 621 889 548 370 371 270 269  44
107 109 424 108 592 664 510 731 788 878 801 838 882 884 885 952 921 853 942 856 755 892 811 695 625 547 550 549 464 159  45
222 219 221 422 513 666 729 508 787 835 908 914 836 937 951 960 941 957 854 893 810 809 757 697 627 626 465 372 373 160 162
104 105 322 220 591 665 730 877 785 909 950 934 910   0 947 956 922 955 943 923 918 855 698 628 696 551 466 272 271 163 161
106 323 421 324 590 420 663 728 786 834 876 871 935 933 911 958 948 894 857 946 807 890 759 630 699 469 552 374 273 164  46
217 218 320 587 589 509 726 662 784 906 875 905 959 949 930 928 924 944 814 815 813 758 896 762 629 468 467 375 274  48  47
102 103 213 507 416 661 727 783 872 833 904 931 907 932 929 900 899 925 760 897 812 859 858 554 763 553 376 275 167 165  49
215 214 417 419 506 725 660 781 832 870 782 f873 874 902 901 927 823 945 926 768 860 761 700 631 555 632 471 379 166 377  50
216 504 318 505 588 586 723 722 724 778 780 831 869 903 868 866 819 821 863 898 816 861 701 764 470 556 378 472 168 277  51
414 211 101 415 585 502 657 659 779 658 830 717 825 776 715 865 864 820 709 767 818 862 704 702 633 557 558 278 276  52  53
319 321 418 317 584 654 412 582 655 721 777 829 775 774 647 714 772 646 711 895 710 817 703 475 765 634 282 473 171 169 281
210  99 316  98 503 413 583 656 720 828 719 824 827 770 572 822 867 769 566 641 707 766 563 706 635 474 383  57 381 170 280
212  97 100 501 315 411 307 579 497 650 575 718 403 492 487 716 771 713 569 644 567 708 637 390 638 636 559 279 380 382  55
410 313 314  94 409 408 495 653 652 494 578 651 648 826  77 773 645 568 570 643 640 483 384 639 705 477 561 172 560 175  56
 95 209 309 406 308 580 498 576 404 574 302 491 490 194 396 571 712 488 642 565 484 481 479 389 476 480 386 174 387 385  54
208  93 581  96 407 199 500 405 496 577 493 402 300  76 299 573 297 485 394 393 293 564  69 482 562 391 182 283 284 176  58
207 312 206  86 499 198 305 200  82  81 400 399 489 649 193 486 397 298 295 294 392 181 291 288 388 292 180 286 173  62 177
205  92  91  88 306 203 310  84 201 303 304 301 401 192 191 190 395 296 188  72 187 290 289 183 478 287  68 179 285  61  59
204  90 311  89 202  87  85  83 196 197  79 195  80  78 189  75 398  74  73  71 185 186 184  70  67  66  64  65 178  63  60
