# This puzzle is solvable
10
 76  94  11  39  97  46  41  10  43  13
 38  65   7  32  36  40  55   2   8  12
f 61  80  29  84  35  56  72  17  16  68
 63  83  60   6  66  85  64   9  70   5
 28  53  54  21  33  49  92  20  57  86
 75  89  44  91  26  69  47  14  45  73
 34  24  31   0  93  98  82  77  99  78
 23  50  74  37  27  81  19  79  87  71
 30  96   4   1   3  51  58 d 25  67  42
 88  95  48  90  22  59  15  52  18  62
