# This puzzle is solvable
30
114 117   3 225   4 226 325   7  11 124  12 127  13  14  15  18 133 132  19  20  21  22 245  23  24 142  26  27  29  30
  1 116 324 227 121   6 123   8 231   9 232 126 235 128 129 131  16 340 341 136 241 137 246 139 141 248 143  28 144  31
  2 118 417 122   5 228 331 420 329 423 422  10 234 333 130 238 431 239 243 432 135 343 244 138 140  25 249 250 145  32
115 224 113 119 120 125 416 330 332 421 505 424 236 336 237 338 430  17 134 242 519 344 436 345 247 346 348 251 146  33
221 220 320 323 326 328 419 229 577 580 504 233 426 425 334 429 511 514 515 433 592 434 595 520 435 347 252 147 148  34
223 322 327 500 501 418 502 503 230 507 506 583 508 582 335 513 337 339 342 591 516 437 517 518 521 349 438 254 439  35
112 219 222 415 499 578 576 579 704 647 801 512 653 587 586 427 711 652 657 240 719 590 659 593 442 660  36 351 350 150
109 218 321 497 414 413 643 644 645 648 650 581 708 428 760 509 588 715 716 656 596 717 661 355 255 594 441 253 353  37
111 216 319 495 498 496 575 646 756 705 649 706 838 584 510 585 805 654 766 589 658 768 664 598 524 526 256 149  39  38
317 217 318 412 411 574 703 642 757 707 758 761 803 709 712 713 710 809 714 810 662 767 523 718 522 257 259 440 151 152
110 215 316 410 572 571 573 702 755 800 759 865 840 651 806 808 655 765 807 722 663 665 525 443 357 356 352 444 354  41
108 107 315 409 494 640 641 701 754 836 802 804 842 864 764 866 762 763 869 720 769 721 527 601 597 445 359 155 358 154
106 104 408 406 407 492 639 753 798 799 837 835 868 890 897 885 843 811 889 770 666 772 600 724 602 446 258 156 262  40
213 105 570 491 404 700 569 699 752 797 896 863 884 870 886 867 839 874 847 888 771 812 725 449 599 360 153 260 263  43
214 103 102 314 490 637 698 638 697 796 860 834 883 878 821 894 848 844 846 871 813 814 723 447 361  45  42 448 160 159
209 313 311 210 493 567 568 750 751 833 832 788 881 895 841 817 892 872 849 815 818 774 668 667 529 264 261 158  46 157 a
101 309 310 212 566 636 403 749 696 695 830 859 862 861 899 873 875 726 823 845 671 669 727 603 452 530 450 162 451  44
207 100 211 488 633 489 565 746 635 794 795 747 857 879 882 891 898 852 780 735 775 773 528 532 605 531 266  48 161  47
 97 312 486 402 405 632 631 634 745 793 748 829 880 831 893 858 784 887 816 607 851 819 606 604 534 453 362 265 269 268
206  98 208 484 487 564 629 694 791 792 686 828 824 853 822 785 876 617 733 679 734 533 777 672 673 364 271 163  49 267
 99 307 308  94 400 692 628 691 744 742 741 856 827 854 826 877 855 783 732 820 670 729 608 778 730 363 535  53 366 365
485  95 396 563 302 561 562 630 622 790 472 687 685 789 825 738 619 850 781 779 674 613 455 675 537 454  52 456  50 165
 93 205 401 392 398 478 306 560 626 693 689 787 621 786 737 468 467 381 466 615 728 611 536 676 610 370  51 270 367 166
 92  96 482 305 397 483 204 627 388 690 554 473 739 740 681 383 736 465 678 544 776 609 540 538 164 457 272 170  54 369
300 304 203 558 557 200 390 553 620 555 743 688 550 469 548 684 618 549 677 616 731 782 546 374 460 169 458 277  58 173
197  90 393 301 399 192 556 295 625 474 623 384 385 551 683 380 545 464 682 547 378 543 278 461 376 459  65 273   0  64
 91 202 298 481 296 193 559 477 475 293 190 291 188 624 288 290 285 382 284 542 614 279  68 368 612  56 539 371 174 274
303 195  88 394 201 479 297 476 191 292 389 386 186 289 471 286 470  71 377 680 281 379 373 175 375 280 172 372 171 275
480 199  89 299 391  83  82  84 387  79 294 189  77 187 185 287 184 181 282 182 463 283 177 176  61 178  63  57 167 168
198  87 194 395  86 196  85  81 552  80  78  76  75  74  73  72 183  70 180  69  66 179 462 276 541  62  59  55  67  60
