# This puzzle is solvable
32
   1  241  127  348    5  244    6    8  130  133   11  136   12   14   15   16   17   18  143   19  145   21   23   24   26   27   28  266   29  153   33   31
 448    2  125    3  128    7  452  129    9  247  134   13  251  252  137  138  140  256  141   20  144  365  264  146  369  149  373  374  265   30  155   32
   4  239  240  126  352  246  131  245  132  135   10  358  250  253  139  254  255  142  258  366  259  260   22  262  147  562  474  150  152  154   35  156
 124  122  349  242  449  351  542  354  455  453  355  456  356  359  461  460  840  363  553  556  261  368   25  367  371  471  370  473  375  151  269  158
 121  123  350  243  450  625  541  451  248  249  357  548  457  549  360  638  361  462  257  364  555  558  465  469  270  643  263  376  372  268   34  472
 347  237  238  236  345  540  446  353  545  704  628  631  458  459  634  551  362  640  557  464  463  466  782  467  148  563  718  564  377   38  157   36
 120  119  626  447  623  624  699  544  627  629  547  546  632  550  707  709  714  639  779  636  711  781  716  644  470  561  648  159  271  267  161   37
 118  234  344  346  539  700  543  538  702  770  703  454  630  832  706  710  774  552  637  633  842  641  559  468  719  717  642  565  378  272  160   39
 235  115  117  444  445  768  621  537  769  829  771  883  705  884  836  835  777  635  775  783  838  933  713  715  646  645  560  476  275  273  274   40
 341  233  620  116  535  619  622  701  828  830  881  831  773  927  708  833  929  778  834  784  891  839  843  841  567  786  475  477  379  380  164   41
 231  113  230  343  443  441  766  767  826  924  824  882  772  962  837  966  965  888  889  892  776  720  894  845  722  566  568  478  381  277  276  162
 114  111  232  342  442  536  697  827  877  825  885  926  990  887  886  994 1013  967  780  931  554  712  724  479  846  650  647  785  382  278  163   42
 112  339  439  340  534  764  698  695  763  765  880  989  958  991  928  964  993  932  890  844  893  935  721  788  649  787  723  384  480  165  166   43
 228  618  533  530  438  531  616  762  878  925  823  923  920  960  963  930  961  992  969  938  968  937  895  790  651  570  482  481  280  279   45   44
 229  337  338  437  691  532  617  692  696  874  879  988  957  919 1022 1016  995 1010 1020 1012  934  971  725  849  652  383  571  569  386  385  167   46
 332  336  335  440  436  529  614  615  822  917  876  922  987 1009  985 1011 1005 1019  996  972  847  791  896  726  789  653  572  483  387  281  168   47
 110  227  109  527  694  690  759  761  693  872  820  921  821 1015 1021 1004 1008 1014 1023  940  939  970  793  795  727  654  573  574  485  484  169   48
 226  107  225  333  435  611  875  758  760  819  986  959  984 1006 1018 1007 1001 1017  973  900  997  897  899  848  792  655  486  575  283  282  170   49
 108  331  525  434  612  609  613  689  757  871  918  955  913  981 1003  949  979  976  941  943  936  902  901  898  728  730  576  389  388  285   51   50
 223  334  222  528  610  526  916  688  953  873  869  954  950  982 1002  947  980  978  977  974  999  975  794  850  729  657  656  390  171  284  172   52
 105  106  432  224  524  686  756  915  914  867  812  983  909  948  951  956 1000  945  806  998  903  942  731  796  732  490  577  391  489  286  174  173
 104  330  430  431  433  608  685  687  818  815  912  952  811  910  862  805  907  908  906  803  944  858  851  852  798  797  658  661  488  487   54  288
 102  103  221  328  684  523  607  753  755  816  754  809  865  863  861  946  675  804  741  739  854  855  802  671  736  659  580  579  392   55  394   53
 100  218  101  429  424  220  814  870  751  679  813  866  748  911  670  859    0  669  589  904  666  853  801  799  856  734  491  660  395  287  292  289
 327   98  329  427  522  682  603  817  605  810  677  747  599  864  673  593  672  905  860  744  740  667  668  735  800  733  662  175  290  396  397  176
 219  428  326  324  606  521  752  750  602  600  680  676  596  506  674  807  746  306  738  857  590  406  503  663  584  737  496  291  393   56  578   57
 325  217   99  426  519  520  517  681  683  749  598  510  511  745  597  202  743  505  594  195  405  499  585  588  494  398  583  493   65  492   59  178
 215   95  216  425  422  518  604  420  514  418  678  414  509  508  808  310  415  595  592  409  410  591  665  498  664  582  400  294  581  180   61  177
  91  213  323  423  321  319  421  512  513  868  515  419  417   81  507   79  407  504  191  501  301  500  742  402  401   70  399  293  295  296   58   62
  97   94  212   96   90  516  206  317  601   84  315  201   80  413  199  197  411  307  408  189  305  304   71  587  502  495   69  179  297  181   64   60
 214   89  322  209  320  318   87  316   85   83  314  313  416   82  309   78  308   76  196  193   72  586  404   73  403  497   68  186   67  298  185  184
  92   93  211   88  210  207  208   86  204  205  312  203  200  311  412   75  198   77  194  303   74  192  299  190  302  187  300  188  182   66  183   63a
