# This puzzle is solvable
12
a 91 126  42 114  50  86  12  98  53 132  96  13
 45 103   5  79  85 110 136  54  44  49  88  52
129  76 138   7 134  11  14  10  47  55   6  15
143   2  81  82 100  99 108 133 111  46  48   8
  3 106   1   4 109 113  84  59 107  56 102 128
 41  43  71  29  63  51  72  70  95  20   9  92
 83 123  40 127  28  36  77 112  68 137  57  87
 32  27  73  80  17 118 115  16  66 105  90  19
 38  97 131  75  31  67 116  37  93  60  62 119
120  58  69 141  26  89  34 130  25  74  18  94
 35  65 104  78 140  22 135 117  61 139  64  23
121 142  33  30   0  21  39 101 122 125 124  24
