# This puzzle is solvable
8
23 52 55  6 47  6 35 14 31
32 17 57  9 33  9 40 26 13
21  7 41 30 46 30  4 12 15
60 37 36 61 20 61 56 53 19
10 24 51  5 48  5  0 29 16
 2 28 39  1 49  1  8 54 27
25 42 58 11 43 11 62 38  3
18 63 34 22 50 22 59 45 44
