# This puzzle is solvable
6
23  8 32 23  8  11 28 20
34 17 29 34 17 25  6 22
 3 10  4  3 10 16 33 26
13  7  0 13  7 30  2 18
21 12  9 21 12 15 24  5
27 31 35 27 31 14 19  1
