# This puzzle is solvable
30
116   2 323   3   4   5 122   7   8 124  11  13 130 131 336 237  18  19 132  20 246 137 138  24 140  28 144 139 143  30
118   1 224 324 226 422   6 123  10  14 127 234  15 129  16 239 240 133  22 136 134 243  25 343 248 142  29  32 147 250
115 119 415 328 117 228 120 231   9 330 125 126 334 238 128 235 338 242 433 515 348 434 245 435  26 247 347  27 251 252
114 225 327 227 325 229 503 421 230 506 332 333 423 233 236 427 429 341 436 589 141  23 135 437 244 145 349 249 149  31
221 223 322 220 329 331 121 419 649 580 420 232 581 335 511 652 512 584 430 339 241 345 516 344 522 520 438 351 146  33
112 222 113 416 500 501 417 418 504  12   0 507 425 424 426 428 510 514 591 431  21 517 346 594 439 595 353 350 440  34
111 413 218 319 643 575 706 756 502 578 647 838 585 508 712  17 651 337 432 513 340 716 519 593 596 521 441  35 253 148
109 321 326 110 576 577 505 704 644 754 648 509 586 582 656 588 587 653 714 592 767 764 660 598 658 523 254 256 352  36
414 216 499 219 494 318 498 646 654 583 707 864 650 839 759 766 715 655 765 713 342 769 590 518 661 354 151 150 255  40
217 107 496 574 493 570 410 645 579 803 757 801 762 708 711 806 657 763 717 721 662 659 768 720 442 443 355 257  37 153
317 316 214 412 497 800 572 835 495 315 758 802 710 896 866 805 761 843 869 774 811 597 809 718 524 258 528  38  39 155
411 408 320 406 103 571 705 642 702 798 755 703 709 868 760 808 870 807 813 664 871 526 770 663 444 260 445 356  42 154
105 108 492 567 573 700 797 641 409 837 862 638 834 865 881 840 874 722 844 804 816 771 602 446 525 719 601 152 261  41
313 212 106 314 490 407 639 640 753 752 701 796 863 883 836 841 773 895 810 842 845 772 599 727 600 449 447 156 259  43
213 104 210 211 489 635 569 698 699 799 833 861 884 894 886 867 887 898 888 848 669 723 665 451 361 264 358 357  44 160
102 215 312 310 566 568 491 637 751 795 748 832 882 885 897 890 899 891 814 815 775 726 529 452 360 603 527 262 157  47
101 209 404 405 487 695 636 746 831 790 749 860 878 889 855 893 872 873 667 817 730 448 668 604 364 533 161 266 605  46
208  98 100 403 697 488 750 694 793 827 829 880 854 879 856 892 875 846 812 725 852 847 666 530 607 531 532  48 267 159
 97  99 308 565 402 309 486 696 747 631 794 877 859 830 784 824 876 851 850 849 779 724 778 670  45 450 534 359 453 263
206  96 207 485 634 564 691 792 826 857 787 788 858 825 785 853 781 821 782 818 777 776 672 606 728 535 158 362  49 163
205 311 307 401 484 630 561 633 632 745 791 685 738 687 823 735 822 736 820 673 674 675 732 609 608 268 269 265 164  50
204  94 399 400 563 560 692 693 744 789 742 741 740 739 737 783 680 681 734 819 671 729 536 731 363 455 454 270 366  52
 93 203 397 562 398 483 629 625 743 556 689 624 684 786 683 682 619 679 677 780 615 678 612 610 537 456 165 365  51 162
305  95 303 395 479 481 628 690 627 828 623 473 686 469 550 551 468 546 614 464 676 541 462 538 611 271 272 367 166  53
202 201 306 559 482 477 557 389 626 555 471 472 553 621 552 620 545 617 616 542 733 613 539 540 460 368 458 369  54 168
302  92 304 396 480 558 478 476 688 554 474 384 470 289 385 618 380 467 286 543 544 376 463 279 371 457 372  55 273 167
 91 200 301 199 394 393 390 388 188 291 293 475  78 187 383 547 549 466 378 284 280 281 180 373 459 370 276 274  56  57
 90  87 297 299 195 194 295 294 191  76 190  75  74  77 382 288 182  71 465 375 283 377 282 374 277 174 175 169 275 171
 89 196 300  86 392  84 296 193  81  79 292 386 622 287 290  72 379 285 548  69  70 179 177  65 176  64 173  61  58 170
 88 198 197  85 298  82  83 391 192  80 189 387 185 186  73 184 183 181 381  68 178 461  67  66 278  63  62 172  60  59
df
