# This puzzle is solvable
11a
 69   6   2  97  28   3  76   9  41  13  46
 40  77  36  73  82  52  72  48  78  57  74
 39  49 120  83   5  27  10 113  20  81  12
111   1 116  94 103 118  61  43  79  92 114
 47  98  38  70  75  96  58  15  17  11  21
 42  87 109  67  16 101  93   8  64 115  99
 71  68 108   4  63  22 112  53   7  86 105
 90  89  51 119  88  32 104  19  26  84  45
 80  95  29 100   0  33 117  62  54  50 110
 35  65  24  23  25  44  56  18  55 102  59
 37  66  31  30 107  91  34  85 106  60  14
