# This puzzle is solvable
ad32
 126    3  351    4  541  244  248    8  453  352  136  357  252   16   17  254  140  141   18   20  145  146  147   23  559   26  373   29  152   30   31   32
 124  123    6  128  353  349  127    9   10   11   13  138  251   14  360   15  139  257   19  259   22  148  262  261   27   28   24  267  374  153  154   33
 451  130    2  125  246  542  347  627  134  454  135    7  359  137  253  362  256  363  258   21  144  366  560  371  264  471  266   25  375  268  155   34
 345  239  240  242  129    5  623  354  133  249  356  545  457  631  459  255  361  142  365  465  368  367  260  151  369  150  263  149  472  269  157   35
 241    1  120  245  348  626  131  250  350  622  358  546  455  632  458  461  462  364  463  143  466  555  557  718  470  468  265  473  376  156  158   36
 446  236  346  538  247  449  625   12  450  702  132  629  633  549  550  551  460  553  637  639  464  640  467  469  372  370  562  377  563  270  159   37
 122  447  119  444  540  445  544  452  543  697  355  704  456  776  708  634  552  635  636  554  712  714  558  642  717  561  645  271  272  273  160   38
 118  441  116  238  121  624  537  700  880  630  707  628  703  548  773  711  710  779  777  713  715  638  641  716  564  646  644  474  475  274  161   39
 233  235  230  243  448  536  701  699  705  830  770  706  774  987  775  709  835  838  887  780  556  781  783  719  785  643  565  476  378  276  379   40
 343  237  117  620  698  443  619  771  535  769  924  772  834  833  994  832  963 1013  778  839  891  782  841  842  784  647  566  477  478  380  275   41
 344  440  234  539  442  765  621  695  547  881  879  826  883  882  886  926  991  888  836  889  934  893  843  786  720  721  649  567  381  165  164  163
 115  339  112  342  341  827  766  694  829  828  960  831  959  961  884  964  993  837  890  840  935  844  892  787  722  648  650  479  382  162    0   42
 231  232  534  439  532  768  533  767  825  877  922  923  925  962  928  885  966  932  931  968  933  894  845  788  723  568  481  570  480  277   44   43
 114  113  338  340  618  763  761  617  696  918  958  876  878  988 1018  989 1010  930  967  971  969  896  848  789  724  651  569  384  278  383  166   45
 229  111  437  336  531  616  764  693  762  824  955 1002  985  929  992 1005 1022  965 1012  938  970  846  790  725  653  571  386  482  385  279  280   46
 227  224  225  614  438  613  821  530  760 1021  921  957  873  990 1007 1011  996  995  997  936  940  937  895  654  795  727  483  484  281  168  167   47
 337  110  228  436  692  334  691  759  822  956  953 1008  920 1009  875 1019 1016 1023  939  975  847  898  899  652  791  572  573  387  388  282  169   48
 109  223  335  332  434  529  615  817  874  823  915  872 1020  986  927 1017 1003  998  972  853  973  897  849  850  851  655  726  574  485  283  170   49
 108  333  222  689  758  611  919  917  756  916  952  954  819  984 1001 1004 1000 1014  941  974  901  728  794  656  793  657  729  486  389  284  171   50
 433  331  435  523  690  528  226  871  818  982  951  949 1006  983  950  979  947  999  944  904  905  900  942  730  792  575  576  390  286  285  172   51
 221  107  610  526  612  757  524  753  815  820  914  816  908  980  912  948 1015  978  976  945  943  902  796  854  579  731  658  487  392  391  173   52
 327  104  330  220  685  525  687  754  688  870  746  981  911  869  910  909  977  946  907  859  798  852  856  797  732  661  577  488  394  174  175   53
 219  527  105  432  684  609  814  605  755  686  865  749  750  913  748  862  860  805  906  857  802  855  733  903  734  659  660  578  287  489  176   54
 326  218  429  106  517  329  607  522  600  867  868  810  811  863  674  864  861  742  804  739  669  803  800  737  799  662  491  393  290  490  288   55
 102  520  426  430  428  521  608  602  752  683  599  676  747  809  866  745  807  806  593  590  858  801  589  736  735  581  580  494  492  289  177   56
 101   98  328  324  325  427  606  416   85  682  513  812  597  594  506  744  672  670  741  503  409  668  740  500  667  664  584  493  395  291  178   57
 424  103  213  320  100  604  313  681  420  751  316  808  598  414   81  675  743  505  504  671  666  585  738  586  665  582  663  397  396  292  179   58
 431   99  216  323  519  518  515  603  421  813  595  678  415  312  418  507  411  673  592  502  588  587  499  404  497  498  583  496  398  293  180   59
 322  321  215  516  317   97  209  204  601  677  680  679  596  508  591  308  509  410  306  408  406  501  405  301  300  402  401  495  399  294  181   60
  96  217   92  422  423   89  319   87   88  315  202  511  417   80  412  309  199  307  195  304  407  303  302  190  299  403  298  400  297  295  182   61
 425  214   94   93  318  210  419   90  206  203  314  510  200   84  413  310  197  196  194  305  193  192   72  191  189  188  186  185  296  184  183   62
  95  211  212   91  514  208  207  201   86  311  205  512   83   82   79  198   78   77   76   75   74   73   71   70   69   68  187   67   66   65   64   63
