# This puzzle is solvable
jk
10fdf
 68  36  12  88  84  82   4  55  39  19
  7  94   9  14  34  22  90  40  47  15
 42  80  70   6   1   3  51  50  49  13
 60  64  66  96  85   5  67  52  81  46
  2  29  99  37  95  28  44  18  31  77
 98  86  30  92  89  33  73  75  16  10
 79  72  63  78  43  20  74  41  65  45
 38  91  56  59  35  87  53  71   8  97
 27  32  26  17  83  58  11  69  54  24
  0  23  61  57  25  48  62  93  76  21
df
