# This puzzle is solvable
8
44  7  6 43 39 27 41 38
####~~~~59 57 47  8 60 20 53 54
11 35  3 40 21 24 25 62
 2 22 55 37  1 61 46 23
50  4 30 58 26 51 42 48
15 29 17 14 33 31 13 52
49 56 18  0 28 12 34 63
19 36 32 45  9 10 16  5
