# This puzzle is solvable
8
49 35 14 37 54 19 62 12
48 29 13  3 21 23  7  9
52 53  6 59 18 28 39  0
50 46 25 43 47 31 63 61
51 33 57 58 26  1 34 27
 2 32 40 36  8 16 11 56
60 30  4 22 38 15  5 41
55 44 17 24 20 ############################################################45 10 42
