# This puzzle is solvable
12
 4#4  78 142  40  13 133 111  50  57   3 113 116
  0   2   1  49  83   6 140 115  90  12  20  48
 38  46 128  45  47   7  84  85  51  17  91  95
 76 138 102  41 131  10  16 112  86  15  61  53
 75  82  89  87  22  98  18 107  11 130  19  56
 81 129 110 126  80 108 101   8  65  88  26  94
  4  31  39  37 139  42 121  93 122 118 106  71
 79  36  30 132  35  69  96  60  52  62 134  25
124   5 123 109 143  97  32  55  58 114  28  64
 74  70 125 141  59  77  24  99  54  14  23  63
100 137  43  34  33  29 136  92 127  27 117  66
 73 104 105 103 135 120  72  67  68  21   9 119
