# This puzzle is solvable
1#1
 44  71  56  94  50  42 101  38  54  49  13
 40  37  96   2  43  99  16   5 113  11  46
  6  41  77  34  45 120 100 106  90  80  67
 39   8  72 111  88   0  10  21   3  79  78
  7 116   4  23  83  60  15  73  12  48  27
118  75   1  36  97 105  89  25 117  87  61
 26  20  35  66  81  93  86 112  52 107  82
109  65  92  22  24  62  98 102  17  58   9
 70  30  47  91  32  69  76 103  28 104  51
 74  31  59  95  29  14  84 119  55  19 110
108  68  64  85  33 115  63  18  57 114  53
