# This puzzle is solvable
21
 80   1 218   2   6  89   7 219  87  86 227 162 160 229  92  97  17  96  18  95  24
 77 151   4  79 156  85 157   8 224 278 163  13 397 330 228  16  11  21  99 169  26
 78 214 217  75  84 269 158 396 323 318 222  10 230 281 161 166  91 232  15 100  19
149 321 275  82   5  88 220 363   9 394 366  14  90 331 164 279 170 165  93  22  20
 81 154 271 213 273 216 272 221 277  12 333 167 326  94 235 285  23 231  98 101 102
  3 152 153 359 155 215 368 432 319 419 223 282 226 328 364 324 172 286 168 104  25
268 365  73 317  76 320 362 361 392 287 225 417 367 374 327 103 238 106  28  27 171
211 150 145 147 270 360 357 416 435 274 325 276 280 234 284 332 369 334 178 288 289
146 266 315 391 358 415 356 395 159 434 402 401 371 329 236 421 292 233  29 105 336
267 148 316  72  83 390 431 413 398 420 400 424 373 338 283 291 370 112 239 175 174
 66 212  70 264 210 313# 411 428 322 399 436 378 437 405 295 107 290 173  35 176 114
144  74 205 354 143 389 386 418 427 433 406 438 372 422 375 335 243 177  33 237 108
206  71 207 142 352 385   0 430 388 439 440 429 376 293 294 337 339 425  30 242 179
 69 209 262 263 203 414 355 308 305 387 347 426 377 423 340 240 296  31 118  45  32
 68 208 139 140 312 265 353 380 309 412 350 404 381 346 249 241 379  37 110  36 111
 67 137 138 258 261 259 348 407 409 384 393 344 403 301 343 300 109 181 341 182  41
132  64 310 314 307  56 349 351 129 255 382 304 408 303 193 298 297 247 244 184 115
141  61  65 201 311 383  54 410 257 302 125  50  49 124 189 188 180 186 245 116  34
135 199  63 136 260 196 200 254 195 126 253 256 191 120 121 122 246 183 119 185 113
 59 202  62  57 204 134 131 130 345 306 251 192 299 250  47 117 248  38 342  39  42
 58  60 128 133 198 127 197  55 252 194  52  53  48 123  51 190 187  46  44  43  40
