# This puzzle is solvable
8
60 30 39 19 48 32 51 33
 4 63 38  6 31  9 44  7
59 49 50 13  3 16  5 18
54 25 34 43 45 55 12 20
36  2 28 22 4##0 24 35 14
17  1 37 6###2 46 42 10  8
52  0 23 57 21 58 29 11
41 61 53 26 47 27 15 56
