# This puzzle is solvable
23
166   6   2 240 303   7 176 307 244  95 175  99  11 101  14  16  20 105 107  19  22  23  24
 89   3 174 242  96  93 308   8 362  10 164  12 178 180 183  15 104 184 109 188 186  21 110
 87  91 170   1  92 449 24####3 411   9  97 177  13  98 102 103  17  18 108 258 254 111  26  25
168  90  94  82 241   5 356 171 246 313 247 100 179 181 182 255 319 256 185 106 259 187  27
 88 238 169 360  83 165 364 309 365 366 368 249 250 314 253 252 373 374 419 114 318 112 189
 86   4 163 301 172 306 245 481 248 310 456 312 416 316 315 369 372 320 190 323 193  28 257
 85  84 304 361 407 450 504 409 414 408 311 251 415 483 418 317 370 420 260 191 113  29  31
167  79 239  78 406 448 173 506 363 477 453 367 454 455 377 458 371 378 421 321 261 192  30
236 300 235 161 404 480 451 410 232 503 422 522 486 510 488 461 491 425 457 322 262 194   0
355 237 359 302  80 305 160 507 413 412 505 495 485 526 508 487 264 376 417 117 375 116 115
 81 299 357 354 162 298 444 446 405 527 479 443 484 523 514 459 325 379 381 263 195 326  32
 77 233 297 447 475 234 501 358 512 452 511 525 521 519 516 382 462 423 428 266 265  34 118
 76 159 158 402 400 515 518 439 478 353 528 490 509 492 463 464 424 380 460 327 119 122  33
 71 221  74 296 445 403 352 476 502 435 283 517 426 520 466 268 489 493 427 270 197 121 267
 73 231 156 228 230 292 294 436 499 471 498 524 431 482 324 465 384 385 196 198 271 269 388
151 227 229 295 157 350 473 401 281 513 433 434 494 274 496 331 329 383 332 125 120 200  39
 66 155 349 351 396 287 399 441 470 474 500 469 341 432 467 468 337 276 124 330 199  35  37
225 290 291 293 226 442 348 440 391 393 497 340 339 395 390 211 429 202 123 207  36 127  40
153  72 346 154 289 286 438 394 437  57 219  59 284 386 279 133  52 272 328 131 201  38 275
 70  75 152 147 398 345 472 343 344 140 138 213 338 392 212 278  51 134 209  46 333  42 128
150  68 224 146 144 397 222 218 285 217 280 282 215 336 389 387 206 335  47 208  45  43 126
 67  69 148 145  62 347 342 143  58 142  56  50  54 137 136 277 132 204  48 130 135 273  41
 65  64 149 223  63  61 216 288 220  60 139  55 141  53 214 334 210 203 205  49 430 129  44
