# This puzzle is solvable
23



#######
##########
####    #####
 ###### 86 166   2   3  91 172  90  10 247 170 103 101 248  20 316 102 183 255  28  18 188  24 109
 8#######5 165   1   4   6 307   7 176   8  97 100  15 364 257 110 181  11 319 108  22  19  23 111
24###    1 169 171  88 173   5 306 504 242 175 243 314 177  12 371   9 254 253  99  27  21  26 260
24###### 0 238  89 362  84 305  13  95 ####### 96  14 367 246 179  17 377 373 114 192 106 105 256 186 115
239 167 356 302  81 361 168 408 245 244###     178 311  98 313 182 107 189 369 191 374 258 187 112
358 303 164  92 412 174  93 249 310 180######  366 315 368 104 250 457 420 323 185 322 193 190  29
 80 237 236 449 448  94 308 451 483 312 370 184 309 365 416 372 421  16 318 491 264 320  25
 82 357  87 409 304 405 410 450 452 509 508 454 456 413 251 317 453 261 418 324  30 113  33
 79 163 299 360 502 503 297 445 363 478 411 484 414 485 486 422 415 459 329 197 321 262 116
162 406 300  83 234 359 447 477 480 519 481 507 523 487 488 252 490 460 194 118 383 195  31
160 233 301 158 407 352 402 479 518 505 482 521 526 496 417 326 419 461 375 489 267 325  32
231  76  78 232 354 295 355 235 506 520 527 524 492 512 510 463 455 458  34 198 259 266  35
159 157 298 403 404 401 443 446 517 440 525 522 528 511 494 427 462 376 327 263 328 120  36
161  77 296 230 229 441 475 353 498 497 500 516 513 514 330 464 423 426 200 117 202 119 123
 75  74 294 293 349 351 395 501 444 473 469 434 515 467 379 269 265 381 121 270 124 424 199
155 154 228 152 400 399 442 499 476 470 468 209 495 433 428 336 493 380  37 331 382 196 201
 73 226 292 290 474 348 350 439 437 471 472 337 432 431 465 425 122 430 334 333 384 268  38
156 151 287 146 398 220 396 394 438 283 341 435 392 466  52 338 387 389 378 271 274 126  41
 70 153   0 224 291  63 345 344 343 391 390 138 429 388 277 386 278 385 276 207 203  43 127
 71 289  65 227 397 219 284 346 217 436 342 340 139 136 279 335 135 332 208 272 204  40  39
 72  69 150 225 145 221 144 285 142 214 216 141 282 339 280 137 210 132 128 273 205 125  42
 68 148 223 347 222  62 288 143  58 286  55 215 140 281 211 133 275 134  47 206 130 129  45
 67 149  64 147  66 218  61  60 393  59  57 213  56  54 212  53  51  50  49 131  48  44  46
