# This puzzle is solvable
11
#114  44  62 120  42  98  93  78  12  47 110
116   9  66  73 103 112 106  79  14  84  17
  0  61  19  87 118  49  46 117 111   6  10
  1  41  71  99   2  56  97 101  11  82 104
 96  52  95  40  75  15  45  80   4  59   8
 35 108   5   7  20  74  70  50  81  16  85
 39  64  38  53  88 119  37  92  58  76 113
107  33  48  27  55  89 102  86  23  54  51
 34  68  29  91  90 100  43  36  77  65  28
 25   3 109  22  30  69  67 105 115  60  83
 94  72  13  32  24  31  18  21  63  26  57
