# This puzzle is solvable
12
109 114 # 27  84  81  60 115  46   8   0  56  18
 76   4 #  5 108 116 136  49 104  90  51 117  54
 83  82 #  3 103 105  91  72  45  10 141   7  55
 77  44 #  2 107 131 129   9 124 121 138  88  11
134 111 # 37 132  52  39  42  14 110  67  53 113
 43  41   1  26 143  78  85  28  50   6  89  87
133  80  33  79 100 140  48  98 126  15  69  20
 70  99  38 102  30  57  17  24 142  86  59  64
 68  40  95  65  63  97 122 112  58  61  16  94
 36  47  71  29  13 127  12 130  25 123  66 119
 31 135 106  34 128 139 137  23 120  19  62 101
 75  32  74 118  21  35 125  73  93  22  92  96
