# This puzzle is solvable
10
 89  35  85  95  30  71  62  33  46  18
 29  40  83  54  81  27  16  68  44   6
 65  42  70  98   1  99   9  64  12  41
 20  36  26  88  14  45  15  79   0  87
 24  10  96  73  13  49  39  50  17  86
 23  60  32  76   5  56  43  97  47  38
 55  57  19   7  37  67  #63  34  78  22
 77  31  72  84  25  52  11   3   4  91
 69  58  21  80  28  51  93   8  82  90
 94  59  61  92   2  48  74  66  53  75
