# This puzzle is solvable
######5########
#18  2  6 10 20#
#17  3 23 22 14#
# 0 12 24  1  7#
# 9  4 13  5 21#
#19  8 16 15 11#
