# This puzzle is solvable
#10
  7  69  34  82  27  84  51  68  11  83
 23  94  63  56  66  53  86  45  72  44
 41  67  18  46  71  89  36  42  38  47
 33   2  37  16  62  24  14  12  49  40
 28  64  10  35  76  95  13   1  75  70
 99  39  85   3  61  17  98  92   5  19
 73  22   6  59  80  74  79  54  48  30
  8  29  88  32  21   9  90  93  96  81
 78  55  25   0  52  57  50  20  97  91
  4  58  60  31  65  26  43  15  77  87
