# This puzzle is solvable
23
 89   3  91   6 170   7  96 243   9  94  12  11 100 313 255 105 101 252 104 257  22  21 187
 87  90   4   2  93 171 173   8  10 177  98 180 315  14  15  16 102 103 108 107 109  23  25
 86  88 240 241 172 308 175  92   5  95  97 248 178 179   0  13 183 184  20 106 110 186  24
169   1 360 362 242 304 247 410 365 411  99 414 312 182 374  19 185 181 189  27 112 111  26
 85 306 167  84 361 244 409 309 364 366 174 246 454 254 188 251 318  18 376 256 258 113 259
 82 166 358 238 300 359 310 483 245 450 250 370 368 314 457 372 319  17 320  28 192 190 373
168 234 239  83 413 408 445 448 449 176 367 484 485 311 416 249 317 316 324 191 115 114 261
303 236 164 301 357 237 363 504 447 412 451 453 369 415 456 253 460 263 423 377 375 262 193
163 356 161 160 232 406 307 479 478 481 508 522 487 455 422 371 419 418 321 322  30  29 196
165 235 298 505 444 407 446 506 452 503 480 507 486 417 461 420 421 260 325  32 264  31 117
162  81 355  78 299 354 352 501 502####### 482 515 524 523 488 489 458 378 459 194 116 326  38 118
158 293 302 405 404 441 477 518 520###     517 516 527 526 509 492 510 424 379 195 119  36 198  33
305  80 295 402 400 296 476 473 442######  528 521 512 511 490 462 330 464 426 267 327  34 122 120
 77  79 353 159 231 403 439 230 475 499 498 497 513 266 270 331 328 383  37 199 121 382  39
 75  76 229 218 294 399 438 401 500 469 434 496 468 525 425 466 389 323 493 123 465 463 200
233 157 154 292  59 474 351 472 470 436 519 433  56 494 432 384 269 491 495 274 265  35 197
155 156 228  73 288 152 443 394 437 395 214 338 390 339 471 386 381 211 467 127 329 427 201
350 153 397  74 297 146 220 290 398 391 392 343 279 278 277 271 332 125 385 124 133 268 202
349  72 223  64 348  65  71 393 346 388 137 435 431 429  53 335 210  52  45 380  42 209  40
148 143 150 226 219 224 217 344 341 514 287 387 430  57 276 334 213  49 333 129  41 205 126
 67  69 225 285 227 151 345 396 342 284 216 282  54 138 212 336 280 130 275 203  48  43 204
149  70 144 291 222  62 145 141  61 347 337 340 215  60  50 272 281 131 428 134 207 273  46
 68  63 147  66 289 221 440 142  58 283 286  55 140 139 136 208 135  51 132 206  47  44 128
