# This puzzle is solvable
21
 82 153  78  80 150 218   6 156  87   7 158 161   9 279 165  96  18  19  23 100 229
  1  81 151   4  85 220 272  86  89  12 221  90 163  16  13  98 280 166 170  95  20
152 320 217  84   2 268 216 159 160 227  88 224  92  94 162 226 228  22 230  99 169
214   5 155  77 154 157 360   8  10 222 364 281 269  14 327  17 232  15  21 103 172
 79 319  83  73 321 361 270 219 323 283 362 278 395  93  11  97 233 325 101  24 102
  3 211 213 215  76 273 317 223 276 326 164 282 332  91 330 284 286  25 371  26  27
147 359 145 391 149 358 318 418 271 324 366 367 370 329 369 289 288 234 231 173 167
148 144 146 390 277 275 363 274 353 393 429 404 368 168 335 399 171 290 237 174 108
 72 210  75 356 212 309 267 410 414 328 333 225 374 285 291 365 396 107  28 177 105
316 209  74 265 355 431 394 435 322 413 420 352 372 397 432 292 287 334 236 176 178
142  71 203 207 421 315 389 ##433 373 357 398 434 400 331 235 293  29 109 241 104  30
 70 141  69 266 308 387 382 392 430 428 439 426 436 422 423 337 336 239  33  31 175
208 143 264 411 305 199 314 313 415 380 417 437 401 438 375 338 240 238 339  37 106
262 307 137  66 386 310 351 412 408 377 403 427 402 424 406  35 376 182 296 110  32
138  65 205 206 259 354 407  53 416 388 379 425 419 340 297 345 247 112 179 300  34
 67 263 139   0 257 311 312 409 302 384 385 344 299 298 124 242 243 180 111 117 113
204  68 135  63 132 201  58 256 348 190  51 303 378 342 248 114 341 294 183 295 115
140 136 200 349 258 194 129 350 252 249 405 304  50 346 189 246 244 121 187  38 181
 62 261 133 260 131 128 254 383 347 192 301 127 123  47 118  43 245 188 184 116  42
 64  60  61 202  56 196  52 306 253 125 251 193 440 250  49 122 120 186  44 185  39
134  57  59  54 130 255  55 195 197 381 198 191  48 343  46 126  36 119  41  45  40
