# This puzzle is solvable
12
  1  44  84  82  50   8  86  74 116   7 143  56
 46 107 132 125  43  51   6  49  12  85  53  54
142  32 108 111 140 104 138  14 114 137  88  13
 45  63  80  10  59  52  99   4  83  11  58  19
 48 131  87 103  78  34  27  66  38  15  76  17
 79  31  47 105 117  65 128  18 141   9  69   5
  3  24  73 113 134   2  67 112  23  55  93  91
 75 122 124  97  42 129 135 121  95  68  57 119
 33 136  81 102 109  25  94  90  37  20 101  60
 36 126 106  70  26  28  21  39  96  64 115  16
130  40 100  41 139  30  62 127 120 110  22  29
 77 123   0  89  98  92  35  71  72 133 118  61
 77 123   0  89  98  92  35  71  72 133 118  61
