# This puzzle is solvable
10
 36  89  64  12  83  20  41  46  54  70
 73  88  17  49  43  11  97  76  51  95
  8  82   1  57  86  39  67  10  65  38
 60  29  31  79   2  26  34  25  52  96
 99  50  87   0  13  85  14  71  42  69
 27   6  18  91  84  37  40  16  55  77
 72  44  35  61   4   9  92  74  58   5
 62  33  32  28  21  90  68  59  63  98
 53  47  66   3  24  48  78   7  45  15
 81  30  93  94  23  19  56  22  80  75
 81  30  93  94  23  19  56  22  80  75
 81  30  93  94  23  19  56  22  80  75
