# This puzzle is solvable
32
   1  347    3  126    4    8    9  245  133  355  132  251   16   10  134   11   14   20  258  260   21   23  369  259  147   27   28  267  152   31   32   33
 127  348  123  242  129    5  128  351  131  248  249  360  549  140  358  137  463  142  143  553  146  637  262  149  261  150  368   26  266  156   30   34
 240    2  539  130  244  135  453  353    7  705  462  771  136  834   13  253   19   18  256  465   17   22  467  714   25  148  265  473  274   29  158  269
 124  125  241  447  243  454  452  356  352  246   12  458  359  139  250  466  252  255  364  713  145   24  367  370  468  372  151  371   35  472  268  154
 122  121  237  120  538  449  451    6  455  548  547  457  632  456  460  138  254  461  363  366  144  638  640  558  264  469  471  470  271  374   36  155
 239  236  537  238  448  349  544  247  542  545  550  702  357  552   15  257  551  554  141  712  636  556  559  716  560  561  474  564  153  375   37  157
 119  346  625  445  541  626  699  701  628  627  354  630  707  546  706  711  779  361  365  555  641  784  639  644  719  718  565  566  377  270  273  159
 117  235  540  543  350  621  624  828  623  767  704  774  629  930  831  464  709  777  459  557  778  782  715  842  263  476  642  562  373  160  376   39
 116  345  344  446  450  622  536  769  700  829  703    0  772  634  885  776  708  362  838  890  781  643  844  649  721  650  475  563  477  161   40  272
 233  234  444  118  343  620  697  768  770  827  882  883  631  886  773  962  635  965  837  893  843  783  845  840  647  277  480  379  646  275   41   38
 115  232  342  443  535  533  534  765  698  880  830  832  833  884  887  710  775  932  839  780  891  841  717  568  720  478  381  648  645  380   42  276
 114  231  340  618  441  442  766  696  826  881  923  926  929 1009  967  835  633  966  933  892  969  935  786  722  723  378  479  570  382  163  162   43
 113  338  341  339  695  619  764  878  694  879  988  918  927  928  888  889  931  992  994  993  934  895  894  785  724  790  569  567  165  164  278  167
 112  230  229  440  531  532  763  824  823  825  959  987  924  957  836  963  964  995  970  968  846  896  788  787  789  726  651  481  383  279  166   46
 111  228  337  439  438  762  617  921  822  876  960  991  984  961 1011 1017 1000  990 1021 1012  937  897  847  849  653  652  571  384  385  280   44  168
 110  227  336  437  530  616  692  693  761  958  820  922  986  989 1008 1023 1010  985 1005 1013  972  791  973  792  387  725  389  484  386  282   48   47
 109  226  335  436  529  615  614  691  760  953  877 1019  955 1003 1007  936 1022  997  938  940  898  850  727  654  728  655  572  482  483  170   49   45
 108  225  334  435  528  613  690  759  920  875  925  873  956 1020 1006  975  909  945  998  939  996 1015  851  794  729  573  574  575  283  169  281   51
 107  224  333  434  527  612  689  819  821  915  871  919  874  982  872  948 1018  976  999  944  974  852  853  971  793  656  657  388  284  285  171   50
 106  223  332  433  526  611  688  758  757  916  954  983  951  981  917 1016 1004  946  979  947  899  903  942  900  730  576  486  485  286  174  173   52
 105  222  331  432  525  610  687  756  818  870  817  952  910  950  912  861 1001  978  905 1014  901  904  795  848  659  732  731  658  172  487  390   53
 104  221  330  431  524  609  686  755  816  869  914  865  810  949  980  977  808  907 1002  943  908  902  855  797  733  796  577  489  488  391  175  394
 103  220  329  430  523  608  685  754  815  868  867  913  809  866  862  911  745  805  941  906  804  802  854  798  734  660  578  490  287  393   54  288
 102  219  328  429  522  607  684  753  814  749  812  811  746  860  863  674  806  859  857  740  858  856  801  737  800  662  579  491  392  396  395   55
 101  218  327  428  521  606  683  752  751  813  750  748  676  595  864  596  807  743  742  803  738  666  799  587  735  580  661  290   58  291  176   56
 100  217  326  427  520  605  682  681  680  679  678  677  747  597  414  592  744  672  741  670  586  501  739  664  585  663  289  177  581  493  397   57
  99  216  325  324  426  604  603  602  601  600  599  598  511  675  506  594  593  671  591  590  669  665  500  667  736  584  582  492  178  180   59  179
  98  215  214  321  519  518  516  419  515  418  415  510  509  673  508  505  507  410  504  503  589  407  502  499  498  497  583  400  292  495  398  181
  96   97  424  210  425  423  517  422  514  313  513  311  201  413  309   81  307  195  409  408  668  588  405  404  403  402  494  496  399  293   61   60
  95  213  323   90  208  209  421   86  312  207  315  314  202  203   79  310  411  308  306  304  303  406  302  301  300  299  401  297  186  294  182   62
 212  322  319   92   88   89  317  512  205  316  420  417   83  198   80  412   77  305   74  192  194  191  190  188  187   69  298  185  296   65  295   63
  94   93  211   91   87  320  318  206  204   85   84  416  200   82  199  196   78  197   76   75  193   73   72  189   71   68   70   67  184   66  183   64
  94   93  211   91   87  320  318  206  204   85   84  416  200   82  199  196   78  197   76   75  193   73   72  189   71   68   70   67  184   66  183   64
