# This puzzle is solvable
12
 81  47 122  78   5  50 141 133  82  55  11  87
  3 120  72 104  12  46   2  44 142  88  51  52
  0  80 107   8  37  59  84  62  48  13   9  14
124  45   1 105  86  83  94 131 110 129  93  95
 69  85  29 109  30  39 125 114  49  61 138 143
101  76 100 137  98 140   4  17  22  53  56  10
 99  38   7  73  60  54  19  91 127  18  90 113
 36  33  68  74 134 112 121 116  58  28 135  77
 66  79  34  67  71  43  92 136  26 102 119  16
 31  97  27 139 126 130 118  23  20  65  75  63
106 103  32  96  35 117  25  70  21  64 115  24
