# This puzzle is solvable
10
 34  97  68  42  84  45   3  46   6  10
 63  60  67  91  70  43  85  11  41  87
 38  58  82  49  33  86  74  78  71  44
  2  40  23  81  62   1  35  16   8  47
 64   4  13  93  48  72  50  69  14  76
 24   7  61  57   5  83  94   0  55  66
 39  32  56  98  12  19  80  52  18  90
 29  28  25  22  54  77  17  30  26  92
 89  27  31  59  53  21  51  73  79  15
