# This puzzle is solvable
31
  1   2   3   5 235   4   7 238 240   8  11  13 131  14  16  17 136 137 252 254 251 450 140  24 144  28 258  27 150 149  29
120 121 122 234 124 123   6 126   9  10 130  12 133  15 244 245 248 138 354  21 141  18  23 255 361 256 146 257 147 260  35
119 232 336 233 435 237 236 125 342 241 129 242 132 347 349 246 135  19 250 139  22 537  26 355 261  25 259 154 151  34  31
231 431 432 230 339 673 340 128 437 239 438 345 443 442 134 243 446 351 449 249 142  20 535 143 451 454 362 360  33  30 153
118 337 334 229 335 602 127 341 436 525 344 526 346 527 348 247 445 532 530 448 613 353 536 356 262 357  36 145 358 152 148
117 116 113 520 338 333 433 434 343 439 440 678 441 528 529 684 350 681 533 447 534 747 616 253 541 455 544 453 457  39  32
115 227 429 601 600 522 523 674 675 524 606 742 680 608 612 444 803 686 748 611 352 540 688 615 539 617 618  37 458 359 264
228 226 430 330 519 517 521 739 603 604 796 740 607 744 682 609 610 847 749 614 621 538 625 452 620 363 542 364 543  38 156
114 112 332 599 672 596 518 736 791 597 795 878 843 797 799 746 531 800 683 802 751 753 622 750 456 689 266 460 159 157 155
329 424 515 516 331 735 737 734 793 738 677 605 679 743 798 915 919 745 685 890 752 687 852 691 690 267 545 619 160 265 367
111 225 224 667 598 593 669 733 794 879 792 842 914 844 884 940 887 845 850 856 891 806 805 694 461 462 459 158 263  41  40
109 326 327 328 668 592 731 790 787 836 880 883 911 937 953 916 886 849 804 853 848 692 807 808 549 623 369 271 366 373 269
220 223 595 422 514 666 729 730 837 665 910 789 913 881 938 939 918 892 920 922 758 809 756 695 550 624 548   0 162  45  43
423 106 222 513 511 788 936 834 840 875 876 909 877 912 935 959 941 956 893 888 942 921 757 627 626 463 464 371 370 273 161
108 323 219 594 664 512 509 785 728 727 786 934 932 951 958 952 943 947 923 857 854 810 696 628 630 551 465 164  46 372  44
107 508 421 506 426 660 507 732 782 784 835 907 908 933 928 954 944 955 813 924 811 759 698 697 699 552 466 467 272  49 163
218 322 105 217 418 663 590 591 833 783 873 874 949 930 957 902 895 960 925 859 858 812 760 553 700 469 554  47 165 274 166
104 216 321 505 510 588 589 662 725 661 832 904 906 868 899 948 927 945 946 896 860 815 814 629 631 468 555 374  48 169 278
102 318 320 324 419 658 587 781 726 831 872 905 931 901 865 903 822 926 898 894 861 762 761 702 632 375 275  53 167 381 168
215 319 103 417 416 585 657 659 780 830 871 870 869 866 929 950 768 864 900 862 897 816 701 764 634 633 379 376 474 377  50
101 100 502 420 586 504 584 656 779 778 829 828 825 867 773 714 772 646 824 818 817 766 763 706 703 276 470 280 277  51 281
212 213 415 214 414 722 724 723 720 777 718 776 827 713 823 820 711 819 863 708 767 641 704 635 378 556 472 471  52 173 170
 99 211 317 316 503 721 582 583 719 652 651 716 826 712 774 821 771 770 769 710 707 566 382 636 765 560 558 473  59 285 476
 98 315 412 413 501 655 405 654 579 653 717 775 573 647 398 572 649 643 568 709 642 565 640 559 562 182 557 283 475 171 477
 96 210 209 411 410 581 498 497 578 494 576 575 715 574 396 571 645 644 486 567 391 705 637 639 481 383 380 282 279  54 172
 97  95 208 314 313 306 406 404 495 197 493 577 492 490 192 488 298 485 570 484 483 563 638 564 288 388 384 289  55  57 284
 93 207  94 499 580 500 407 403 307 196 304 401 300 491 650 648 191 395 569 394 186 482 293 291 480 479 386 561 177 286  58
 92 204  90  88 309 200 496 199  84 305 302  80 400 489 299  75 392  73 487 187 393 292 390 184  69 290 181 174 179 385  56
206  91 312 205 311 202 308  85 198 195 402 194 399  79 301 190 297 296  74 189  71 185  67 389  66 287 175 478  60  61  62
408  89 203 310 409  87  86 201  81  83 303  82  78 193  77 188  76 397 295 294  72  70  68 183  65  64  63 387 176 180 178
