# This puzzle is solvable
20
144   2  80   4   5   9  10 150   8 154 151  11  12  14 218  15  93  22  20  21
  3  79  73   7  81   6 338  84 152 153  13 265  86 158  91  99  97 160 159  19
 77  78 141 256 258 301 208 148 262  85 211 155  87  88 157  17 162  94  92  95
299 140  74  75 149 302 204 210 306 304 263  89  90 270 305 267 216  16  18  23
 76   1 206 203 209 307 145 259 260 261 215 156 212 371 214 310 164 222  24 219
 71 142 201 297 139 335 365 382 339 342 336 269 308 264 314 276  98 272  25 100
197 143 200 296 257 300 136 298 303 379 345 369 315 168 161 316 309 167  96 102
134 199 198 295  72 334 386 396 332 340 367 395 388 349 225 223 311 101 221  27
130 138 328  68 253 363 331 333 383 372 397 391 392 373 377 312  32 224 165  29
 70 137 337 359 133 251 252 294 390 368 385 357 353 313 266 364 226 273  28 169
248 190 250 247 195 361 381 366 380 323 399 355 375 398 347 317  31 277  30 268
 65  67  69 287 358 254 242 193 393 241 285 356 105 321 319 274 170 166 103  35
 66 125 194 196 293 135 326 239 354 325 324 236 384 282 234 320 229 228 104 227
291 245  64 330 188 127 360 180 288 376 318 352 378 106 346 280 171 110 109 275
292 191  59 131 290  49 243 237 387 374  44 348 351 389 173  43  34 350 108  33
128  60  63 122 289  52 240 120 284 181 238 322 283 235 281 329 232 107 279  36
126  61 244 185 249 286 124  53 327 123 183  47   0 278 113 179 175 172 111  38
246 189 192  56  57 129  50  45  54 187 182 184 115 230 174 116 231 176 112  39
 62 132  58  55 118 186 121  51 119 177  48 117 233  46 178  42 114  41  40  37
