# This puzzle is solvable
  1   2   5 125 123 340   7 128  11 131 130  13 442 250 244 246  15 140 141  18 252 254 142  25  26  27  28 147  29  30  31
121 232 236 235 341   6 237 342 129 343  10 242 132  12 136  14  16  21 138 355  23 356 251  24 144 145 146 148 259 149  32
119   3 118 337 126 333 234 124 239 524   8 127   9 241 346 531  17 746 134 139 354  20 143 358  22 256 257 258 260 150  33
339 122 231 230 338 736 435 238 527 240 344 439 444 245  19 350 352 137 248 351 617 536 253 535 255 359 360 361 261 151  34
117 430   4 336 518 432 436 437 440 526 345 243 133 529 348 443 249 532 353 447 449 448 538 450 453 541 454 455 362 152 154
116 334 120 332 431 335 522 523 603 441 347 528 607 609 349 682 681 135 445 534 616 615 620 357 619 540 456 363 153  36  35
226 229 225 519 433 434 672 600 438 675 604 678 606 608 610 744 247 747 530 611 684 750 452 537 545 542 458 263 262 155  37
115 114 330 228 599 670 331 671 601 674 793 605 677 679 745 680 743 446 748 685 852 689 752 539 618 457 460 365 265 264  38
227 517 111 429 520 734 790 525 521 673 738 797 739 800 798 612 613 850 533 749 688 804 623 451 543 459 364 366 266 156  39
222 108 597 426 735 233 428 741 731 516 792 882 795 796 915 845 889 849 686 683 851 806 614 622 687 544 621 367 267 157  40
110 221 113 427 329 602 596 668 794 880 840 676 740 914 847 883 799 801 807 756 751 803 810 690 805 695 461 548 368 158 159
423 112 328 667 515 594 665 593 839 742 879 842 937 938 844 846 884 887 892 885 848 809 802 754 692 691 550 370  42 268  41
109 224 513 595 669 598 666 732 791 737 733 841 912 881 913 917 919 886 854 893 891 624 699 757 271 625 269 462 626 160  44
220 326 327 592 325 514 837 835 729 789 843 838 935 959 916 918 922 941 890 920 808 696 811 628 546 467 753 369 553 464 270
217 107 425 591 512 424 590 783 836 788 876 878 911 909 952 940 927 942 888 857 895 755 627 813 694 161 374 372 274 463 162
219 106 218 324 421 422 786 728 730 834 877 910 934 953 936 928 921 955 954 923 855 812 697 163 371 551 547 373  46 167  43
214 105 103 508 420 510 663 875 787 833 907 906 872 960 957 958 946 956 897 896 856 760 698 759 853 762 375 552   0 164  45
320 323 419 101 509 216 664 659 871 785 832 908 873 951 947 948 926 945 939 943 894 859 629 693 631 466 470 378 272 276 273
505 215 223 511 104 589 727 588 781 933 905 874 830 901 950 822 925 944 863 858 898 702 465 555 549 554 630 377  47  48  49
318 102 319 321 585 784 417 662 661 870 831 904 868 930 929 902 865 899 864 815 761 814 633 468 469 472 168 166 376 165  51
586 213 317 415 322 504 725 660 726 782 869 903 949 932 823 867 900 770 768 769 924 700 758 708 632 471 279 275 277  52 170
416 316 211 506 418 414 658 723 724 828 776 827 826 931 824 773 866 861 860 862 818 816 703 701 635 556 634 381 379 557  53
212  98 314 411 503 587 582 722 780 829 719 777 775 825 774 713 643 821 820 819 764 763 706 817 704 278 558 560 169  55  54
507 100 583 412 210 655 721 654 779 653 778 717 716 714 772 711 710 645 644 709 767 707 705 765 473 636 475 280  50 380 171
 97 209 315 656 413 584 657 579 652 650 718 649 648 715 712 647 572 771 642 567 566 641 640 639 638 637 474 382 173 282 172
 99 206  94 500 501 581 497 580 578 720 651 576 575 574 646 573 570 486 569 483 766 565 564 563 562 559 561 476 383 281  56
208  95 408 207 410 406 496 405 495 577 494 492 491 490 489 571 488 487 568 484 392 482 481 480 479 478 477 384 283 174  57
 90  96 313 502 498 307 200 404 303 403 493 401 400 399 398 397 297 395 485 393 293 391 390 389 388 387 386 385 284 175  58
312 202 407 409 499 308 306  85 305 196 402 302 301 300 299 396 298 296 394 295 294 292 291 290 289 288 287 286 285 176  59
311  93  92 204  87 201  88  84 304 198 197 195 194 193 192 191 190 189 188 187 186 185 184 183 182 181 180 179 178 177  60
 89  91 205 203 310 309  86 199  83  82  81  80  79  78  77  76  75  74  73  72  71  70  69  68  67  66  65  64  63  62  61
