# This puzzle is solvable
 49  10  84 116 123  53   7  57  62 168  96  55  11
  5  51  86  46  91 164  56 146 160  93 125  15 126
131   1  89 145   3   4 108 102  99  14 163 129  13
119 139 167   9  52   8 162 157  59  60  58  12 132
 34  85  48 113  50   2  94  88  69 149 148 141 109
144 120 117 121  18  98 152 136  97 118  92 134  63
 90  83  82 114 138  95 135 130  28  20  16  24  61
 45  79  35   0 133  42 142  54  22  65  17  25  66
 38  47  30 155  74 156 143  70 154  19 100 153  26
122  44  87 158  78  80 128  76 115  31  21  81 101
140  43   6 161 112 104  33 106  72  64 103 127 151
166  40 111  68  73 110 147 107 159 124  67  36  23
165  37  41 150  77  32  75  27  39 137  29 105  71
