# This puzzle is solvable
 41  45  11  99  80  57  40   0   1  55  14 134
 54  43  46   4  78 109 125  15 120 127  51  56
  7 106 111  53 131  79  13  16   6  10  89  84
139  44 108  42  49   9   8  19  82  91  81 116
133  76  75  83   2  32  86 114 142  97  12   5
138 104 105  47  48 123  25  90 118 136  17  52
140   3 107 117  18  87  22  20  88  34  62 110
102  69  85 126 101 128  67  92  77  28 115  50
141  73 143  71  74  38 129 100  59  60  21  95
137  98 103  36 132 122 119  66  94  61 130  26
 35 112  37 121  27  93  31 113  24 135  30  64
 39  72  33  68  65  29  70 124  58  23  63  96
