# This puzzle is solvable
   3  237    5  464    6  469    7    9   10  244   11  473  691   12  252  482  254   17   18  702   19  257  258   25  917   26   27  492   28   30   31   32   33   34   35   36   37   38   39   40   41   42   43   44   45   46   47   48   49   50   51   52   53   54   55   56   57   58   59   60
 465  236  239  685  897    4  687    8  242  247  902  692   13  475   15  697  693  481  253  256   22  259  484  260   23  262  708  490   29  265  266  267  268  269  270  271  272  273  274  275  276  277  278  279  280  281  282  283  284  285  286  287  288  289  290  291  292  293  294   61
   2  466  233    1  241  243  468  689 1300  471  248  249 1487  250  255  477 1304  694   20   21  483  486  704   24  487  261  919  264  491  493  712  713  494  495  497  498  499  500  501  502  503  504  505  506  507  508  509  510  511  512  513  514  515  516  517  518  519  520  295   62
 462  684  683  240  686  896  898  900  245 1107 1299  246  474   16  476   14 1114  480  698  699 1311  703  488  918  915  489  263  710  921  711  923  714  496  716  927  717  718  719  720  721  722  723  724  725  726  727  728  729  730  731  732  733  734  735  736  737  738  521  296   63
 234  238  458 1667  467  899  470 1484 1671  688  904 1308 1105  695  696  251  478 1309  911  700  912  914  485 1121  705 1315 1123  707  709  924 1125  925 1128  926 1129  928  929  930  931  932  933  934  935  936  937  938  939  940  941  942  943  944  945  946  947  948  739  522  297   64
 680  235  461  895 1295 1100 1102 1488 1485 1301 1106 1302 1492  905  907 1306  908  910  909 1115 1112 1117 1118 1680 1120  706  916 1122  920 1686  922 1126 1130 1324  715 1131 1132 1133 1134 1135 1136 1137 1138 1139 1140 1141 1142 1143 1144 1145 1146 1147 1148 1149 1150  949  740  523  298   65
 232  459  682 1103  231  681 1298 1098  903  472 1663 1491 1305 1494 1108 1113  479 1673 1116  913 1312 1111 1314 1498 1502 1682 1317 1318 1124 1506 1320 1323 1127 1510 1325 1326 1327 1328 1329 1330 1331 1332 1333 1334 1335 1336 1337 1338 1339 1340 1341 1342 1343 1344 1151  950  741  524  299   66
 228  229  463  230  893 1104 1836 1303 1296 1489 2156 1665 1672 1307 1490 1110 1674 1496 1495  701 1310 1679 1316 1501 1850 1119 1505 1504 1684 1321 1322 1508 1689 1511 1512 1513 1514 1515 1516 1517 1519 1520 1699 1521 1522 1523 1524 1525 1526 1527 1528 1529 1530 1345 1152  951  742  525  300   67
 460 1097  890 1294 1101 1664 1099  690 1662 1486 1838 1666 2002 1493 1109 1842 2008 1675 1847 1497 1499 1313 1500 1851 1681 1503 1319 1683 1685 1856 1507 2025 1687 1691 1862 1692 1693 1694 1695 1697 1518 1698 1870 1700 1701 1702 1703 1704 1705 1706 1707 1708 1531 1346 1153  952  743  526  301   68
 457  679  892  894 1293 1297 1292  901 1483 1835 2003  906 1840 1839 1843 1676 2007 2004 2009 1677 1848 2014 1849 1852 1853 1854 2017 1855 1509 1859 1688 1857 1860 2023 1690 1863 1864 1866 2029 1696 1868 1869 2033 1871 1872 1873 1874 1875 1876 1877 1878 1709 1532 1347 1154  953  744  527  302   69
 678  227  887 1096 1480  891 1481 1482 1833 1661 1837 1668 2000 2303 1670 1845 1841 2162 2164 1678 2013 2169 2583 2316 2015 2016 2172 2018 2594 2020 2177 2021 2719 2325 2180 2026 2027 2028 1865 1867 2185 2031 2188 2034 2035 2036 2037 2038 2039 2040 1879 1710 1533 1348 1155  954  745  528  303   70
 455  456  677  676 1660 1290 1095 2304 1659 2155 2001 2158 2302 1669 2160 1844 2310 2166 2312 1846 2011 2010 2455 2315 2317 2170 2171 2323 2019 2324 2024 1858 1861 2179 2181 2182 2183 2184 2186 2030 2187 2032 2335 2189 2190 2191 2192 2193 2194 2041 1880 1711 1534 1349 1156  955  746  529  304   71
 451  454  675 1093 1477  889 1479 1831 1832 2301 1998 2154 2159 2576 2161 2006 2308 2012 2449 2313 2167 2165 2314 2168 2586 2318 2320 2173 2460 2321 2176 2175 2463 2178 2327 2328 2329 2330 2331 2332 2333 2334 2474 2336 2337 2338 2339 2340 2195 2042 1881 1712 1535 1350 1157  956  747  530  305   72
 450  225  226 1094 1091 1291 1475 1478 1996 1834 1999 2305 2443 2005 2307 2306 2444 2448 2163 2311 2450 2451 2587 2456 2710 2457 2319 2713 2174 2590 2022 2464 2465 2326 2467 2598 2468 2469 2470 2471 2603 2472 2473 2475 2476 2477 2478 2341 2196 2043 1882 1713 1536 1351 1158  957  748  531  306   73
 671  224  674  673 1289 1090 1286 1657 1658 2157 2442 2441 2445 2577 2816 2700 2309 2447 2580 2581 2705 2453 2584 2452 2824 2711 2589 2458 2716 2461 2322 2718 2595 2596 2597 2466 2599 2600 2601 2602 2727 2726 2605 2606 2607 2608 2479 2342 2197 2044 1883 1714 1537 1352 1159  958  749  532  307   74
 672  453  223  886  222  221 1656 1089 1476 1997 2153 2152 2815 2573 2574 2578 2579 2819 2820 2706 2582 2822 2707 2454 2708 2588 2459 2935 2712 2591 2939 2831 2462 2834 2720 2721 2722 2723 2724 2725 2842 2843 2841 2729 2730 2609 2480 2343 2198 2045 1884 1715 1538 1353 1160  959  750  533  308   75
 220  670  669  888  452 1288 1829 1828 1830 1995 1994 2151 2575 2446 2699 2701 2818 2703 2925 2704 2928 2821 2709 2585 2825 2932 2828 2936 3032 2714 2592 2593 2832 2833 2835 2836 2837 2838 2839 2840 2604 2949 2728 2844 2731 2610 2481 2344 2199 2046 1885 1716 1539 1354 1161  960  751  534  309   76
 219  881  885  883 1472  884 1285 1654 1993 2150 2299 2300 2572 2698 2697 2817 2702 2924 2926 3026 2927 2929 3029 2823 2931 3031 2826 3034 2827 2715 2717 3038 2940 3041 2941 2943 2944 2945 2946 2947 2948 3048 2950 2845 2732 2611 2482 2345 2200 2047 1886 1717 1540 1355 1162  961  752  535  310   77
 218  449  216 1092 1083 1280 1287 1473 1655 2298 2149 1991 2297 2439 2440 2814 2923 3024 3025 3118 3028 2930 3121 3122 3120 2937 3036 2933 2830 3035 2938 3039 3130 3040 2942 3133 3044 3045 3136 3137 3046 3047 2951 2846 2733 2612 2483 2346 2201 2048 1887 1718 1541 1356 1163  962  753  536  311   78
 666  448 1283  882  447 1474 1470 1284 1652 1827 1826 2438 2571 2570 2696 2812 2922 3021 3023 3200 3027 3277 3119 3206 3030 3125 3205 2934 3126 3037 3127 3212 3129 3131 3042 3215 3217 3043 3219 3139 3220 3049 2952 2847 2734 2613 2484 2347 2202 2049 1888 1719 1542 1357 1164  963  754  537  312   79
 445  446  667 1086 1087 1088 1648 1990 1823 2147 1992 2146 2148 2436 2813 2811 3022 3116 3117 3201 3203 3202 3204 3280 3279 3124 3207 2829 3284 3209 3210 3287 3213 3132 3214 3292 3135 3358 3294 3221 3138 3050 2953 2848 2735 2614 2485 2348 2203 2050 1889 1720 1543 1358 1165  964  755  538  313   80
 215  668  880 1281  665 1085 1469 1651 1650 1989 2295 2296 2569 2437 2695 2920 2921 3114 3115 3113 3199 3278 3346 3033 3281 3349 3282 3208 3128 3285 3211 3353 3414 3288 3357 3290 3216 3293 3218 3140 3141 3051 2954 2849 2736 2615 2486 2349 2204 2051 1890 1721 1544 1359 1166  965  756  539  314   81
 443  217  664  879  878 1653 1825 1824 1821 1988 2144 2294 2435 2568 2694 2693 2919 3019 3020 3196 3274 3344 3276 3123 3406 3345 3408 3283 3352 3462 3354 3415 3286 3355 3289 3291 3134 3297 3359 3296 3142 3052 2955 2850 2737 2616 2487 2350 2205 2052 1891 1722 1545 1360 1167  966  757  540  315   82
 444  663  662 1084 1467 1471 1082 1468 1822 2145 1987 2293 2434 2567 2692 2810 2808 3112 3195 3275 3343 3198 3457 3347 3348 3407 3459 3409 3350 3410 3540 3411 3509 3412 3360 3356 3417 3419 3295 3361 3143 3053 2956 2851 2738 2617 2488 2351 2206 2053 1892 1723 1546 1361 1168  967  758  541  316   83
 213  214  877  442 1282    0 1466 1279 1649 1647 2143 2292 2433 2566 2691 2918 2807 2917 3016 3273 3197 3403 3404 3456 3405 3537 3502 3460 3351 3508 3464 3413 3466 3510 3416 3467 3363 3298 3224 3222 3144 3054 2957 2852 2618 2619 2489 2352 2207 2054 1893 1724 1547 1362 1169  968  759  542  317   84
 212  441  661  874  876 1081 1278 1645 1646 1986 2142 2291 2432 2565 2690 2916 2809 3017 3111 3272 3342 3110 3402 3455 3500 3458 3504 3503 3541 3463 3542 3507 3511 3465 3544 3418 3469 3223 3362 3421 3225 3055 2854 2958 2853 2620 2490 2353 2208 2055 1894 1725 1548 1363 1170  969  760  543  318   85
 440  660  439 1079  875 1277 1276 1464 1820 1985 2141 2290 2431 2564 2806 2914 2805 2915 3018 3109 3341 3340 3401 3454 3535 3501 3536 3538 3461 3566 3505 3570 3571 3543 3471 3468 3420 3423 3226 3300 3227 3146 2959 2742 2739 2740 2491 2354 2209 2056 1895 1726 1549 1364 1171  970  761  544  319   86
 209  211  210 1080 1078 1275 1465 1463 1819 1984 1982 2289 2430 2563 2689 2804 3015 3108 3107 3270 3194 3339 3400 3498 3499 3564 3565 3583 3567 3584 3568 3506 3572 3545 3512 3365 3470 3364 3299 3228 2960 3056 2961 2741 2855 2621 2492 2355 2210 2057 1896 1727 1550 1365 1172  971  762  545  320   87
 438  437  659  873 1077 1274 1644 1817 1818 1983 2138 2288 2429 2561 2688 2687 2913 3014 3192 3269 3271 3399 3452 3451 3453 3534 3585 3581 3596 3539 3587 3569 3598 3546 3513 3472 3422 3366 3301 3147 3145 3148 3057 2962 2743 2622 2493 2356 2211 2058 1897 1728 1551 1366 1173  972  763  546  321   88
 436  656  657  872 1076 1273 1462 1643 1980 2140 2139 2287 2560 2686 2562 2803 2912 3013 3106 3193 3191 3268 3337 3398 3497 3495 3563 3582 3496 3562 3586 3588 3547 3548 3514 3473 3424 3367 3303 3229 3150 3058 2857 2856 2744 2623 2494 2357 2212 2059 1898 1729 1552 1367 1174  973  764  547  322   89
 208  658 1074  871  870 1272 1461 1816 1981 1642 2137 2286 2428 2427 2685 2802 2911 3012 3105 3335 3267 3338 3336 3532 3396 3561 3559 3595 3597 3592 3593 3589 3590 3573 3516 3474 3425 3368 3230 3302 3060 3059 2860 2858 2745 2624 2495 2358 2213 2060 1899 1730 1553 1368 1175  974  765  548  323   90
 207  435  206  868 1075 1271 1460 1641 1814 1815 2136 2285 2426 2559 2684 2801 2910 3011 3104 3190 3189 3334 3450 3447 3530 3531 3493 3560 3594 3599 3577 3591 3574 3515 3549 3475 3426 3369 3304 3149 3231 2964 2859 2963 2746 2625 2496 2359 2214 2061 1900 1731 1554 1369 1176  975  766  549  324   91
 654  869  655 1073 1270 1459 1458 1640 1813 1979 2134 2284 2425 2683 2682 2557 2909 3010 3103 3265 3263 3266 3494 3397 3395 3533 3448 3580 3579 3578 3554 3575 3521 3550 3517 3427 3370 3371 3305 3233 3232 3151 3061 3062 2747 2626 2497 2360 2215 2062 1901 1732 1555 1370 1177  976  767  550  325   92
 204  653  205  433  867 1072 1269 1639 1977 1978 1811 2135 2424 2556 2558 2800 2907 3009 2908 3188 3187 3394 3333 3492 3449 3529 3558 3557 3556 3555 3553 3576 3551 3518 3477 3476 3428 3372 3306 3154 3064 3152 2965 2861 2748 2750 2498 2361 2216 2063 1902 1733 1556 1371 1178  977  768  551  326   93
 202  434  652  866 1071 1268 1457 1638 1812 2133 2283 2282 2423 2555 2681 2799 2798 2906 3008 3185 3332 3264 3393 3446 3491 3528 3527 3526 3525 3524 3523 3552 3522 3520 3519 3478 3429 3373 3307 3234 2966 2967 3153 2862 2749 2627 2499 2362 2217 2064 1903 1734 1557 1372 1179  978  769  552  327   94
 200  203  432  865 1070 1267 1456 1637 1810 1976 2132 2280 2281 2422 2680 2796 2797 3101 3100 3102 3186 3262 3392 3445 3490 3489 3488 3487 3486 3485 3484 3483 3482 3481 3480 3479 3431 3430 3308 3235 3155 2968 3063 2863 2864 2628 2500 2363 2218 2065 1904 1735 1558 1373 1180  979  770  553  328   95
 431  651  863  864 1069 1266 1455 1636 1809 1975 1974 2131 2421 2554 2679 2905 3099 3006 3007 3261 3330 3331 3329 3444 3443 3442 3441 3440 3439 3438 3437 3436 3435 3434 3378 3433 3376 3374 3309 3236 3066 3065 2969 2751 2630 2629 2501 2364 2219 2066 1905 1736 1559 1374 1181  980  771  554  329   96
 430  201  429  862 1068 1265 1454 1635 1808 1973 2130 2279 2420 2553 2678 2795 2904 3005 3184 3183 3260 3328 3391 3389 3388 3387 3386 3385 3384 3320 3383 3381 3380 3379 3315 3432 3377 3375 3310 3237 3156 3067 2970 2865 2752 2631 2502 2365 2220 2067 1906 1737 1560 1375 1182  981  772  555  330   97
 428  649  650  861 1067 1264 1453 1634 1807 1972 2129 2278 2419 2552 2677 2794 2903 3004 3098 3182 3259 3327 3390 3326 3325 3324 3323 3322 3321 3249 3382 3319 3246 3317 3244 3314 3313 3312 3311 3238 3157 3068 2971 2866 2753 2632 2503 2366 2221 2068 1907 1738 1561 1376 1183  982  773  556  331   98
 199  198  427  860 1066 1263 1452 1633 1806 1971 2128 2277 2418 2551 2676 2793 2902 3003 3097 3181 3258 3257 3256 3255 3254 3253 3251 3250 3170 3318 3168 3167 3080 3316 3245 3243 3242 3241 3240 3239 3158 3069 2972 2867 2754 2633 2504 2367 2222 2069 1908 1739 1562 1377 1184  983  774  557  332   99
 197  426  648  647 1065 1262 1451 1632 1805 1970 2127 2276 2417 2550 2675 2901 3002 3095 3096 3180 3179 3178 3177 3176 3175 3174 3252 3172 3171 3169 3248 3247 3166 3079 3165 3164 3163 3162 3161 3160 3159 3070 2973 2868 2755 2634 2505 2368 2223 2070 1909 1740 1563 1378 1185  984  775  558  333  100
 196  425  646  859 1064 1261 1450 1631 1804 1969 2126 2275 2416 2549 2674 2792 2791 2900 3094 3093 3092 3091 3090 3089 3088 3087 3173 3086 2989 3085 3082 3081 2986 2985 3078 3077 3076 3075 3074 3073 3072 3071 2974 2869 2756 2635 2506 2369 2224 2071 1910 1741 1564 1379 1186  985  776  559  334  101
 195  424  645  858 1063 1260 1449 1630 1803 1968 2125 2274 2415 2548 2673 2899 2898 3001 2999 2998 2997 2996 2995 2994 2993 2992 2991 2990 2886 3084 3083 2988 2881 2882 2983 2982 2981 2980 2979 2978 2977 2976 2975 2870 2757 2636 2507 2370 2225 2072 1911 1742 1565 1380 1187  986  777  560  335  102
 194  423  644  857 1062 1259 1448 1629 1802 1967 2124 2273 2414 2547 2672 2790 2897 3000 2786 2895 2894 2893 2892 2891 2890 2889 2888 2887 2775 2885 2987 2884 2883 2984 2880 2879 2878 2877 2876 2875 2874 2873 2872 2871 2758 2637 2508 2371 2226 2073 1912 1743 1566 1381 1188  987  778  561  336  103
 193  422  643  856 1061 1258 1447 1628 1801 1966 2123 2272 2413 2546 2671 2789 2788 2785 2896 2784 2783 2782 2781 2780 2779 2778 2658 2777 2776 2774 2773 2772 2771 2770 2769 2768 2767 2766 2765 2764 2763 2762 2761 2760 2759 2638 2509 2372 2227 2074 1913 1744 1567 1382 1189  988  779  562  337  104
 192  421  642  855 1060 1257 1446 1627 1800 1965 2122 2271 2412 2545 2669 2668 2787 2667 2666 2665 2664 2663 2662 2534 2661 2660 2659 2657 2656 2655 2654 2653 2652 2651 2650 2649 2648 2647 2646 2645 2644 2643 2642 2641 2640 2639 2510 2373 2228 2075 1914 1745 1568 1383 1190  989  780  563  338  105
 191  420  641  854 1059 1256 1445 1626 1799 1964 2121 2270 2411 2544 2670 2543 2542 2540 2539 2538 2537 2536 2535 2399 2533 2532 2531 2530 2529 2528 2527 2526 2525 2524 2523 2522 2521 2520 2519 2518 2517 2516 2515 2514 2513 2512 2511 2374 2229 2076 1915 1746 1569 1384 1191  990  781  564  339  106
 190  419  640  853 1058 1255 1444 1625 1798 1963 2120 2269 2410 2409 2408 2407 2541 2405 2262 2403 2259 2402 2401 2256 2398 2397 2396 2395 2394 2393 2392 2391 2390 2389 2388 2387 2386 2385 2384 2383 2382 2381 2380 2379 2378 2377 2376 2375 2230 2077 1916 1747 1570 1385 1192  991  782  565  340  107
 189  418  639  852 1057 1254 1443 1624 1797 1962 2119 2268 2267 2266 2265 2264 2406 2111 2404 2260 2108 2258 2400 2257 2255 2254 2253 2252 2251 2250 2249 2248 2247 2246 2245 2244 2243 2242 2241 2240 2239 2238 2237 2236 2235 2234 2233 2232 2231 2078 1917 1748 1571 1386 1193  992  783  566  341  108
 188  417  638  851 1056 1253 1442 1623 1796 1961 2118 2117 2116 2115 2114 2113 2263 2110 2261 2109 1949 2107 2106 2105 2104 2103 2102 2101 2100 2099 2098 2097 2096 2095 2094 2093 2092 2091 2090 2089 2088 2087 2086 2085 2084 2083 2082 2081 2080 2079 1918 1749 1572 1387 1194  993  784  567  342  109
 187  416  637  850 1055 1252 1441 1622 1795 1960 1959 1958 1957 1956 1955 1954 2112 1953 1952 1950 1782 1948 1947 1946 1945 1944 1943 1942 1941 1940 1939 1938 1937 1936 1935 1934 1933 1932 1931 1930 1929 1928 1927 1926 1925 1924 1923 1922 1921 1920 1919 1750 1573 1388 1195  994  785  568  343  110
 186  415  636  849 1054 1251 1440 1621 1794 1793 1792 1791 1790 1789 1788 1787 1786 1785 1951 1784 1783 1781 1780 1779 1778 1777 1776 1775 1774 1773 1772 1771 1770 1769 1768 1767 1766 1765 1764 1763 1762 1761 1760 1759 1758 1757 1756 1755 1754 1753 1752 1751 1574 1389 1196  995  786  569  344  111
 185  414  635  848 1053 1250 1439 1620 1619 1618 1617 1616 1615 1614 1613 1612 1611 1610 1609 1608 1607 1606 1605 1604 1603 1602 1601 1600 1599 1598 1597 1596 1595 1594 1593 1592 1591 1590 1589 1588 1587 1586 1585 1584 1583 1582 1581 1580 1579 1578 1577 1576 1575 1390 1197  996  787  570  345  112
 184  413  634  847 1052 1249 1438 1437 1436 1435 1434 1433 1432 1431 1430 1429 1428 1427 1426 1425 1424 1423 1422 1421 1420 1419 1418 1417 1416 1415 1414 1413 1412 1411 1410 1409 1408 1407 1406 1405 1404 1403 1402 1401 1400 1399 1398 1397 1396 1395 1394 1393 1392 1391 1198  997  788  571  346  113
 183  412  633  846 1051 1248 1247 1246 1245 1244 1243 1242 1241 1240 1239 1238 1237 1236 1235 1234 1233 1232 1231 1230 1229 1228 1227 1226 1225 1224 1223 1222 1221 1220 1219 1218 1217 1216 1215 1214 1213 1212 1211 1210 1209 1208 1207 1206 1205 1204 1203 1202 1201 1200 1199  998  789  572  347  114
 182  411  632  845 1050 1049 1048 1047 1046 1045 1044 1043 1042 1041 1040 1039 1038 1037 1036 1035 1034 1033 1032 1031 1030 1029 1028 1027 1026 1025 1024 1023 1022 1021 1020 1019 1018 1017 1016 1015 1014 1013 1012 1011 1010 1009 1008 1007 1006 1005 1004 1003 1002 1001 1000  999  790  573  348  115
 181  410  631  844  843  842  841  840  839  838  837  836  835  834  833  832  831  830  829  828  827  826  825  824  823  822  821  820  819  818  817  816  815  814  813  812  811  810  809  808  807  806  805  804  803  802  801  800  799  798  797  796  795  794  793  792  791  574  349  116
 180  409  630  629  628  627  626  625  624  623  622  621  620  619  618  617  616  615  614  613  612  611  610  609  608  607  606  605  604  603  602  601  600  599  598  597  596  595  594  593  592  591  590  589  588  587  586  585  584  583  582  581  580  579  578  577  576  575  350  117
 179  408  407  406  405  404  403  402  401  400  399  398  397  396  395  394  393  392  391  390  389  388  387  386  385  384  383  382  381  380  379  378  377  376  375  374  373  372  371  370  369  368  367  366  365  364  363  362  361  360  359  358  357  356  355  354  353  352  351  118
 178  177  176  175  174  173  172  171  170  169  168  167  166  165  164  163  162  161  160  159  158  157  156  155  154  153  152  151  150  149  148  147  146  145  144  143  142  141  140  139  138  137  136  135  134  133  132  131  130  129  128  127  126  125  124  123  122  121  120  119
