# This puzzle is unsolvable
66
   2    1    3    4    5    6    7    8    9   10   11   12   13   14   15   16   18   19   20  280  281   23  532  283   24  535   25   27  287  289   31   34   32  293  546   36   37   38   39   40   41   42   43   44   45   46   47   48   49   50   51   52   53   54   55   56   57  317   59   60  320   61   62   64   65   66
 260  261  262  263  515  264  266  267  269  520  270  271  274  525  275 1004   17  277  279  772   21  776  282  284   26  539  285   28  286  288   30  785   33  294  543  295  547  297  298  299  300  301  302  303  304  305  306  307  308  309  310  311  312  313  314  315  316  569  812   58  571  321   63  322  323   67
 259  512  513  514  758  265  760  517  268  763  521  522  273  524  276  526  527 1006  771 1005  775  528  774  529  536  537  538 1016  541  290  291   29  544   35  292  296  545  548  549  550  551  552  553  554  555  556  557  558  559  560  561  562  563  564  565  566  567  318  811  319  570  572  573  325  324   68
 258  511  756  757  516 1221  994  759  762  998  999 1227  272  765 1002  768  769 1451  773  530   22  777  534  533  778  779 1015  782 1017  783  542  540  786  787  788  789  790  791  792  793  794  795  796  797  798  799  800  801  802  803  804  805  806  807  808 1044  809  810  568  813  814  815  575  574  326   69
 257  510  755  992  993  518  761  995  997 1000  764  767  523 1229 1007 1660 1232 1234 1452  278 1453  531 1237 1012 1459 1240  780 1014  781 1675  784 1020 1248 1023 1680 1024 1025 1026 1027 1028 1029 1030 1031 1032 1033 1034 1035 1036 1037 1038 1039 1040 1041 1042 1043 1271 1045 1046 1047 1048 1049 1050  816  576  327   70
 256  509  754  991 1220 1652 1440  996  519 1225 1656 1001  766 1228 1003 1231 1230 1868 1009 1665 1008 1238 1457 1013 1011 1461 1460 1462 1463 1244 1018 1467 1247 1022 1249 1251 1252 1253 1254 1255 1256 1257 1258 1259 1260 1261 1262 1263 1264 1265 1266 1267 1487 1268 1269 1270 1272 1273 1274 1275 1276  818  817  577  328   71
 508  753  752  990 1219 1438 1222 1442 1223 1224 1226 1444 1659 1448 1663 1233 1450 1454 1235 1666  770 1236 1239 1010 1873 1670 1241 1674 1877 1246 1464 1677 1019 1021 1468 1469 1471 1472 1685 1473 1686 1476 1477 1478 1479 1480 1481 1482 1483 1484 1485 1486 1698 1488 1489 1490 1491 1492 1493 1494 1277 1051  819  578  329   72
 255  507  506  989 1218 1439 1441 1443 1655 1445 1446 1658 1447 1862 1662 1449 1863 1865 1455 1668 1870 1456 1871 1458 1242 2071 1874 1673 1243 1465 1466 1245 1881 1250 1679 1470 1885 1682 1683 1475 1474 1687 1688 1689 1690 1691 1692 1693 1694 1695 1899 1696 1697 1699 1700 1701 1702 1703 1704 1495 1278 1052 1053  579  330   73
 253  252  751  749 1215 1216 1217 2052 1856 1858 2055 1657 1860 1861 1864 1661 1866 1664 1867 2250 1869 2065 2253 1667 2069 1671 2070 2258 2073 1876 1676 1879 1880 1678 1883 1681 1884 1886 1684 1888 1889 1890 1891 1892 1893 1894 1895 1897 2092 1898 2094 1900 1901 1902 1903 1904 1905 1906 1705 1496 1279 1054  820  580  331   74
 254  505 1214  750 1437 1857 1649 1654 1653 2053 1859 2054 2056 2245 2057 2246 2060 2058 2062 2252 2063 2064 2434 2066 2068 1672 2435 2257 2260 2074 2075 2076 2263 1882 2078 2079 2082 2081 1887 2083 2084 2085 2086 2088 2274 2089 2091 1896 2093 2281 2282 2460 2096 2097 2098 2099 2100 1907 1706 1497 1280 1055  821  582  332   75
 251  504  988  986 1647 1650 1434 1651 1855 2049 1854 2421 2422 2595 2424 2425 2247 2427 2249 2429 2251 2603 2921 2254 1872 1875 2438 2072 2609 1878 2261 2262 2077 2613 2267 2265 2080 2269 2447 2270 2271 2272 2273 2087 2275 2276 2090 2277 2279 2280 2459 2095 2283 2284 2285 2286 2101 1908 1707 1498 1281 1056  581  822  333   76
 250  503  748  987 1435 1433 1436 1648 2239 2419 2243 2420 2756 2059 2596 2594 2061 2248 2428 2600 2432 2431 1669 2430 2067 2256 2606 2437 2259 2439 2440 2441 2442 2264 2443 2444 2446 2268 2619 2448 2449 2450 2451 2452 2453 2456 2628 2278 2457 2458 2631 2461 2462 2463 2464 2287 2102 1909 1708 1499 1282  824  823  825  334   77
 249  502  747  985 1213 1646 1852 2051 2050 2242 2241 2593 2591 2592 2244 2759 2597 2426 2598 2601 2599 2602 3070 2436 2926 2605 2769 2255 2608 2610 2611 2612 2615 2617 2614 2266 2616 2934 2782 2620 2621 2622 2623 2624 2454 2455 2626 2790 2629 2630 2794 2632 2633 2634 2465 2288 2103 1910 1709 1500 1283 1057  584  583  335   78
 248  501  746  984  983 1212 1851 1853 2237 2238 2240 2589 2418 2423 2912 2758 3333 3064 2762 2763 2765 2764 2922 2604 2607 2433 2770 2771 2772 2929 3076 2775 2935 3078 2780 2779 3081 2936 2783 2784 2785 2940 2786 2787 2788 2625 2945 2791 2947 2792 2793 2795 2796 2635 2466 2289 2104 1911 1710 1501 1284 1058  826  585  336   79
 247  500  745  982 1211 1432 1645 1850 2048 2590 2236 2414 2754 2755 2757 2913 2911 2761 2760 2918 2919 2767 3068 3069 2766 2768 3073 3072 3074 2927 2774 2931 3080 2932 2445 3219 2776 3223 2618 2938 3225 2939 2941 2942 2789 2943 2944 2627 2946 2948 2949 2950 2797 2636 2467 2290 2105 1912 1711 1502 1285 1059 1060  586  337   80
 246  499  744  981 1210 1431 1644 1849 2047 2417 2416 2233 2753 2910 3202 2914 2916 3061 3063 3065 3207 2920 2923 3338 3071 3210 2925 2928 3213 2773 3075 2930 3218 3217 2933 2781 3221 2937 3084 3083 3086 3087 3088 3089 3090 3091 3092 3093 3094 3095 3096 2951 2798 2637 2468 2291 2106 1913 1712 1503 1286 1061  827  588  587  338
 245  498  743  980 1209 1430 1643 2045 2046 2235 2415 2413 2751 3200 3058 2915 3060 2917 3205 3067 3066 3206 3460 3209 3208 3341 3344 3467 3215 3077 3347 3214 2777 3350 3472 2778 3220 3082 3222 3085 3226 3480 3481 3227 3229 3230 3231 3232 3233 3234 3097 2952 2799 2638 2469 2292 2107 1914 1713 1504 1287 1063  828  829  339   81
 244  497  742  979 1208 1429 1642 1848 2234 2044 2752 2230 3057 2909 3198 3062 3201 3334 3204 3335 3458 3336 3337 2924 3340 3342 3211 3212 3582 3345 3584 3079 3586 3349 3351 3352 3475 3353 3477 3224 3355 3357 3483 3228 3359 3361 3362 3363 3364 3235 3098 2953 2800 2639 2470 2293 2108 1915 1714 1505 1288  830 1062  589   83   82
 243  496  741  978 1207 1428 1641 1846 1847 2232 2587 2583 2908 2750 2586 3197 3332 3456 3203 3573 3574 3459 3461 3339 3577 3462 3464 3343 3465 3469 3346 3583 3216 3471 3473 3589 3474 3476 3478 3354 3356 3479 3358 3482 3360 3484 3485    0 3486 3236 3099 2954 2801 2640 2471 2294 2109 1916 1715 1506 1289 1064  831  590  340   84
 242  495  740  977 1206 1427 1640 1845 2043 2412 2585 2588 2231 2906 2903 3199 3059 3331 3457 3572 3680 3575 3682 3576 3686 3463 3580 3581 3689 3468 3691 3792 3470 3587 3694 3695 3590 3591 3592 3593 3594 3703 3595 3597 3598 3599 3600 3487 3365 3237 3100 2955 2802 2641 2472 2295 2110 1917 1716 1507 1290 1065  832  591  341  342
 241  494  976 1205 1204 1426 1639 1844 2042 2749 2040 2907 2584 2905 3055 3056 3330 3455 3571 3678 3681 3780 3685 3578 3579 3786 3688 3787 3690 3466 3791 3692 3348 3588 3886 3794 3697 3698 3699 3800 3702 3891 3596 3704 3705 3707 3601 3488 3366 3101 3103 2956 2803 2642 2473 2296 2111 1918 1717 1508 1291 1066  833  592  343   86
 493  738  739  974 1203  975 1638 1843 2041 2228 2229 2411 2748 3195 3054 3196 3328 3454 3570 3569 3679 3873 3781 3784 3684 3687 4035 3878 3788 3790 3880 3693 3793 3883 3795 3796 3887 3797 3798 3701 3700 3802 3893 3803 3706 3804 3489 3240 3367 3104 3238 2957 2804 2643 2474 2297 2112 1919 1718 1509 1292 1067  595  593   85   87
 240  491  737  973 1423 1425 1637 1842 2039 2227 2410 2582 2747 3053 2904 3453 3329 3568 3452 3677 3872 3782 3683 3875 3783 3785 3877 4103 3962 3789 4106 3964 3585 3882 3884 3696 3888 3889 4114 3799 3892 3801 3976 3894 3708 3369 3602 3239 3370 3368 3102 2807 2958 2644 2475 2298 2113 1920 1719 1510 1293 1068  834  344  345  594
 238  239  492 1202 1424 1421 1840 1636 2038 2409 2581 2407 3052 2902 3193 3326 3194 3327 3451 3778 3779 3956 3870 4032 3874 3876 3960 3961 3963 3879 4040 3881 4041 4043 3885 3968 3969 3970 3890 3972 3973 3975 3895 3806 3805 3807 3709 3492 3604 3105 3241 2806 2805 2645 2476 2299 2114 1921 1720 1511 1294 1069  836  837  835   89
 236  237  736  490  735 1422 1635 1841 2037 2226 2408 2745 2744 2901 3051 3192 3325 3450 3567 3676 3777 3953 4034 4101 3959 4158 4104 3958 4102 4038 4039 3966 3967 4042 4044 4170 4045 3971 4046 4115 3974 4050 3977 3896 3710 3372 3490 3242 3603 3371 2961 2960 2959 2646 2477 2300 2115 1922 1721 1512 1295 1070  838   88  597  596
 489  488  734  971  972 1200 1839 2036 2224 2225 2406 2579 2746 3049 3050 3191 3324 3449 3566 3675 3776 4031 3871 4033 3957 4099 4036 4212 4037 4164 4163 4108 3965 4168 4109 4110 4113 4047 4048 4117 4049 4051 3978 3897 3808 3605 3608 3491 3243 3607 2809 2962 2808 2479 2478 2301 2116 1923 1722 1513 1296  598  839  347  346   90
 234  235  733 1199 1201 1420 1634 1632 1838 2035 2405 2580 2578 2743 3048 3190 3323 3448 3564 3565 3954 3955 3867 3869 4097 4098 4160 4161 4162 4165 4216 4105 4167 4219 4169 4112 4111 4223 4172 4173 4116 4052 3979 3898 3809 3493 3711 3375 3494 3107 2648 2964 2647 2649 2302 2303 2118 1723 1724 1514 1297 1071 1072  599  348   91
 233  732  731  970  969 1419 1837 1633 2034 2223 2404 2577 2900 2899 3189 3188 3322 3447 3673 3774 3674 3868 3775 4100 4030 4159 4257 4213 4215 4166 4259 4107 4218 4217 4220 4221 4171 4222 4224 4174 4118 4053 3980 3899 3713 3609 3811 3245 3496 2963 3106 3246 2651 2481 2810 2304 2120 1924 2117 1515 1298 1073  840   93  349   92
 486  487  730  968 1198 1418 1631 1836 2033 2222 2403 2576 2742 2741 2898 3047 3321 3446 3563 3672 3773 3866 3952 4029 3951 4157 4256 4255 4214 4258 4296 4322 4262 4297 4263 4264 4265 4266 4225 4175 4119 4054 3981 3900 3714 3606 3373 3712 3495 3244 3108 3109 2965 2650 2480 2483 2119 1925 1725 1516 1299 1074  841  600  350   94
 232  485  967 1196 1197 1417 1630 1835 2032 2221 2402 2575 2740 2897 3045 3187 3186 3445 3562 3671 3772 3865 3950 4027 4096 4028 4211 4254 4291 4292 4294 4260 4298 4325 4344 4299 4300 4267 4226 4176 4120 4055 3982 3901 3716 3812 3610 3497 3248 3374 3376 3247 2813 2306 2482 2305 1926 1727 1927 1517 1300  842  601  602  351   95
 231  484  729  966 1195 1416 1629 1834 2031 2220 2401 2574 2739 2896 3185 3046 3320 3319 3561 3670 3771 3864 3949 4026 4094 4210 4209 4208 4321 4293 4340 4295 4261 4323 4326 4327 4301 4268 4227 4177 4178 4121 3983 3902 3715 3810 3611 3499 3498 3111 3110 2814 2812 2811 2484 2122 2653 1928 1518 1301 1076 1075  843  603  352   96
 230  483  728  965 1194 1415 1628 1833 2030 2219 2400 2573 2738 2895 3044 3184 3443 3444 3560 3669 3770 3863 3948 4025 4093 4095 4155 4156 4253 4320 4338 4339 4355 4343 4342 4345 4302 4269 4228 4179 4057 4056 3984 3903 3813 3814 3717 3612 3377 3249 3112 2966 2654 2307 2121 2123 1929 1728 1726 1519 1302 1077  845  844  353   99
 229  482  727  964 1193 1414 1627 1832 2029 2218 2399 2572 2737 2894 3043 3317 3318 3442 3559 3668 3769 3862 3947 4024 4207 4206 4250 4319 4290 4317 4352 4324 4341 4349 4354 4328 4270 4271 4229 4123 4122 3985 4059 3815 3816 3718 3613 3500 3378 3250 3114 2967 2816 2968 2652 2309 2308 1930 1729 1520 1303 1078  846  604   97  354
 228  481  726  963 1192 1413 1626 1831 2028 2217 2398 2571 2736 2893 3042 3183 3316 3441 3558 3667 3768 3944 3946 4020 4154 4023 4204 4252 4316 4288 4318 4334 4353 4329 4305 4330 4304 4272 4230 4180 4124 4058 3905 3904 3906 3614 3615 3501 3379 3251 2969 3113 2970 2655 2487 2485 2124 1931 1730 1521 1304 1079  606  355   98  100
 227  480  725  962 1191 1412 1625 1830 2027 2216 2397 2570 2735 2892 3041 3182 3315 3440 3557 3666 3767 3861 3859 4091 4286 4092 4251 4315 4351 4285 4337 4347 4350 4335 4348 4308 4303 4231 4232 4181 4182 3987 3986 3907 3720 3719 3502 3381 3380 3252 3115 2817 2815 2656 2486 2310 2125 1932 1731 1522 1305 1080  605  847  607  356
 226  479  724  961 1190 1411 1624 1829 2026 2215 2396 2569 2734 2891 3040 3181 3314 3439 3556 3665 3766 3860 3858 4021 4153 4152 4205 4249 4284 4333 4289 4336 4287 4281 4346 4331 4273 4274 4233 4125 4126 4060 4062 3817 3818 3721 3616 3503 3382 3253 3116 2971 2818 2657 2488 2311 2126 1933 1732 1523 1306 1081  848  608  358  101
 225  478  723  960 1189 1410 1623 1828 2025 2214 2395 2568 2733 2890 3039 3180 3313 3438 3555 3664 3765 4022 3945 3943 4090 4247 4151 4201 4245 4314 4313 4194 4140 4311 4276 4310 4307 4183 4185 4128 4184 3989 4061 3819 3988 3722 3617 3504 3383 3254 3117 2972 2819 2658 2489 2312 2127 1934 1733 1524 1307 1082  849  609  359  357
 224  477  722  959 1188 1409 1622 1827 2024 2213 2394 2567 2732 2889 3038 3179 3312 3437 3554 3663 3856 3857 3942 4019 4089 4088 4145 4203 4241 4248 4312 4240 4277 4279 4332 4236 4275 4237 4186 4127 4063 3990 3909 3908 3820 3723 3618 3505 3384 3255 3118 2973 2820 2659 2490 2313 2128 1935 1734 1525 1308 1083  850  361  102  360
 223  476  721  958 1187 1408 1621 1826 2023 2212 2393 2566 2731 2888 3037 3178 3311 3436 3553 3662 3764 3763 3941 4018 4087 4150 4199 4198 4243 4244 4280 4139 4195 4309 4278 4306 4190 4235 4234 4129 4130 3991 3992 3910 3821 3724 3619 3506 3385 3256 3119 2974 2821 2660 2491 2314 2129 1936 1735 1526 1309 1084  851  610  105  103
 222  475  720  957 1186 1407 1620 1825 2022 2211 2392 2565 2730 2887 3036 3177 3310 3435 3552 3661 3762 3855 3940 4017 4147 4086 4149 4148 4246 4143 4283 4196 4004 4076 4192 4188 4135 4238 4187 4069 4132 3911 3993 3822 3725 3620 3621 3507 3386 3257 3120 2975 2822 2661 2492 2315 2130 1937 1736 1527 1310 1085  852  611  104  106
 221  474  719  956 1185 1406 1619 1824 2021 2210 2391 2564 2729 2886 3035 3176 3309 3434 3551 3660 3761 3854 3939 4016 4085 4202 4146 4144 3930 4200 4197 4138 4141 4142 4193 4239 4133 4189 3920 4065 4066 4064 3914 3912 3823 3727 3726 3508 3387 3258 3121 2976 2823 2662 2493 2316 2131 1938 1737 1528 1311 1086  853  612  362  107
 220  473  718  955 1184 1405 1618 1823 2020 2209 2390 2563 2728 2885 3034 3175 3308 3433 3550 3659 3760 3853 3938 4015 4084 4083 4082 4009 4079 4080 4007 3925 4136 3924 4073 4072 3834 4001 4070 4134 4131 4068 4067 3994 3913 3824 3622 3509 3388 3259 3122 2977 2824 2663 2494 2317 2132 1939 1738 1529 1312 1087  854  613  363  364
 219  472  717  954 1183 1404 1617 1822 2019 2208 2389 2562 2727 2884 3033 3174 3307 3432 3549 3658 3759 3852 3937 4014 4013 4012 4011 3928 4010 4242 4078 3927 4002 3841 4191 4074 4071 3922 4000 3998 3997 3996 3915 3826 3916 3728 3623 3510 3389 3260 3123 2978 2825 2664 2495 2318 2133 1940 1739 1530 1313 1088  855  614  365  108
 218  471  716  953 1182 1403 1616 1821 2018 2207 2388 2561 2726 2883 3032 3173 3306 3431 3548 3657 3758 3851 3936 3935 3847 3934 3932 3534 4006 4077 4081 4005 3839 3742 4137 3741 3923 3921 3919 3999 3918 3917 3995 3825 3729 3730 3624 3511 3390 3261 3124 2979 2826 2665 2496 2319 2134 1941 1740 1531 1314 1089  856  615  366  109
 217  470  715  952 1181 1402 1615 1820 2017 2206 2387 2560 2725 2882 3031 3172 3305 3430 3547 3656 3757 3850 3849 3848 3933 3751 3846 3645 3747 4075 4008 4282 3840 3743 4003 3836 3835 3833 3738 3832 3831 3735 3830 3829 3828 3731 3625 3512 3391 3262 3125 2980 2827 2666 2497 2320 2135 1942 1741 1532 1315 1090  857  616  367  110
 216  469  714  951 1180 1401 1614 1819 2016 2205 2386 2559 2724 2881 3030 3171 3304 3429 3546 3655 3756 3755 3754 3753 3752 3648 3931 3843 3749 3531 3844 3926 3744 3745 3528 3740 3838 3739 3737 3736 3633 3631 3632 3733 3827 3732 3626 3513 3392 3263 3126 2981 2828 2667 2498 2321 2136 1943 1742 1533 1316 1091  858  617  368  111
 215  468  713  950 1179 1400 1613 1818 2015 2204 2385 2558 2723 2880 3029 3170 3303 3428 3545 3654 3653 3652 3651 3650 3649 3750 3845 3647 3646 3842 3748 3641 3837 3746 3529 3638 3637 3636 3405 3635 3634 3521 3734 3630 3629 3628 3627 3514 3393 3264 3127 2982 2829 2668 2499 2322 2137 1944 1743 1534 1317 1092  859  618  369  112
 214  467  712  949 1178 1399 1612 1817 2014 2203 2384 2557 2722 2879 3028 3169 3302 3427 3544 3543 3542 3541 3540 3539 3538 3537 3536 3416 3535 3644 3533 3532 3640 3639 3527 3526 3525 3524 3406 3523 3522 3402 3520 3519 3518 3517 3516 3515 3394 3265 3128 2983 2830 2669 2500 2323 2138 1945 1744 1535 1318 1093  860  619  370  113
 213  466  711  948 1177 1398 1611 1816 2013 2202 2383 2556 2721 2878 3027 3168 3301 3426 3425 3424 3423 3422 3421 3420 3419 3418 3290 3415 3417 3929 3643 3150 3412 3410 3530 3411 3409 3408 3407 3278 3276 3403 3401 3400 3399 3398 3397 3396 3395 3266 3129 2984 2831 2670 2501 2324 2139 1946 1745 1536 1319 1094  861  620  371  114
 212  465  710  947 1176 1397 1610 1815 2012 2201 2382 2555 2720 2877 3026 3167 3300 3299 3298 3297 3296 3295 3294 3293 3292 3291 3289 3287 3288 3286 3414 3642 3284 3283 3282 3281 3280 3279 3277 3142 3404 3275 3274 3273 3272 3271 3270 3269 3268 3267 3130 2985 2832 2671 2502 2325 2140 1947 1746 1537 1320 1095  862  621  372  115
 211  464  709  946 1175 1396 1609 1814 2011 2200 2381 2554 2719 2876 3025 3166 3165 3164 3163 3162 3161 3160 3159 3158 3157 3156 3155 3154 3152 3413 3151 3285 2856 3148 3147 3146 3145 3001 3144 3143 3141 3140 3139 3138 3137 3136 3135 3134 3133 3132 3131 2986 2833 2672 2503 2326 2141 1948 1747 1538 1321 1096  863  622  373  116
 210  463  708  945 1174 1395 1608 1813 2010 2199 2380 2553 2718 2875 3024 3023 3022 3021 3020 3019 3018 3017 3016 3015 3014 3013 3012 3011 3153 3010 3009 3008 3149 3006 3005 3004 2853 3002 3000 2999 2998 2997 2996 2995 2994 2993 2992 2991 2990 2989 2988 2987 2834 2673 2504 2327 2142 1949 1748 1539 1322 1097  864  623  374  117
 209  462  707  944 1173 1394 1607 1812 2009 2198 2379 2552 2717 2874 2873 2872 2871 2870 2869 2868 2867 2866 2865 2864 2863 2862 2861 2860 2859 2858 2857 3007 2697 2855 2854 3003 2851 2850 2849 2848 2847 2846 2845 2844 2843 2842 2841 2840 2839 2838 2837 2836 2835 2674 2505 2328 2143 1950 1749 1540 1323 1098  865  624  375  118
 208  461  706  943 1172 1393 1606 1811 2008 2197 2378 2551 2716 2715 2714 2713 2712 2711 2710 2709 2708 2707 2706 2705 2704 2703 2702 2701 2700 2699 2531 2698 2696 2694 2693 2852 2692 2691 2690 2689 2688 2687 2686 2685 2684 2683 2682 2681 2680 2679 2678 2677 2676 2675 2506 2329 2144 1951 1750 1541 1324 1099  866  625  376  119
 207  460  705  942 1171 1392 1605 1810 2007 2196 2377 2550 2549 2548 2547 2546 2545 2544 2543 2542 2541 2540 2539 2538 2537 2536 2535 2534 2533 2532 2356 2530 2354 2695 2527 2526 2525 2524 2523 2522 2521 2520 2519 2518 2517 2516 2515 2514 2513 2512 2511 2510 2509 2508 2507 2330 2145 1952 1751 1542 1325 1100  867  626  377  120
 206  459  704  941 1170 1391 1604 1809 2006 2195 2376 2375 2374 2373 2372 2371 2370 2369 2368 2367 2366 2365 2364 2363 2362 2361 2360 2359 2358 2357 2173 2355 2528 2529 2353 2351 2350 2349 2348 2347 2346 2345 2344 2343 2342 2341 2340 2339 2338 2337 2336 2335 2334 2333 2332 2331 2146 1953 1752 1543 1326 1101  868  627  378  121
 205  458  703  940 1169 1390 1603 1808 2005 2194 2193 2192 2191 2190 2189 2188 2187 2186 2185 2184 2183 2182 2181 2180 2179 2178 2177 2176 2175 2174 1982 2171 1980 2170 2352 2168 2167 2166 2165 2164 2163 2162 2161 2160 2159 2158 2157 2156 2155 2154 2153 2152 2151 2150 2149 2148 2147 1954 1753 1544 1327 1102  869  628  379  122
 204  457  702  939 1168 1389 1602 1807 2004 2003 2002 2001 2000 1999 1998 1997 1996 1995 1994 1993 1992 1991 1990 1989 1988 1987 1986 1985 1984 1983 1783 1981 2172 1978 2169 1977 1976 1975 1974 1973 1972 1971 1970 1969 1968 1967 1966 1965 1964 1963 1962 1961 1960 1959 1958 1957 1956 1955 1754 1545 1328 1103  870  629  380  123
 203  456  701  938 1167 1388 1601 1806 1805 1804 1803 1802 1801 1800 1799 1798 1797 1796 1795 1794 1793 1792 1791 1790 1789 1788 1787 1786 1785 1577 1784 1782 1781 1979 1779 1778 1777 1776 1775 1774 1773 1772 1771 1770 1769 1768 1767 1766 1765 1764 1763 1762 1761 1760 1759 1758 1757 1756 1755 1546 1329 1104  871  630  381  124
 202  455  700  937 1166 1387 1600 1599 1598 1597 1596 1595 1594 1593 1592 1591 1590 1589 1588 1587 1586 1585 1584 1583 1582 1581 1580 1579 1578 1576 1575 1360 1574 1780 1572 1571 1570 1569 1568 1567 1566 1565 1564 1563 1562 1561 1560 1559 1558 1557 1556 1555 1554 1553 1552 1551 1550 1549 1548 1547 1330 1105  872  631  382  125
 201  454  699  936 1165 1386 1385 1384 1383 1382 1381 1380 1379 1378 1377 1376 1375 1374 1373 1372 1371 1370 1369 1368 1367 1366 1365 1364 1363 1362 1139 1138 1358 1573 1357 1356 1355 1354 1353 1352 1351 1350 1349 1348 1347 1346 1345 1344 1343 1342 1341 1340 1339 1338 1337 1336 1335 1334 1333 1332 1331 1106  873  632  383  126
 200  453  698  935 1164 1163 1162 1161 1160 1159 1158 1157 1156 1155 1154 1153 1152 1151 1150 1149 1148 1147 1146 1145 1144 1143 1142 1141 1140 1361 1137 1136 1359 1135 1134 1133 1132 1131 1130 1129 1128 1127 1126 1125 1124 1123 1122 1121 1120 1119 1118 1117 1116 1115 1114 1113 1112 1111 1110 1109 1108 1107  874  633  384  127
 199  452  697  934  933  932  931  930  929  928  927  926  925  924  923  922  921  920  919  918  917  916  915  914  913  912  911  910  909  908  907  906  905  904  903  902  901  900  899  898  897  896  895  894  893  892  891  890  889  888  887  886  885  884  883  882  881  880  879  878  877  876  875  634  385  128
 198  451  696  695  694  693  692  691  690  689  688  687  686  685  684  683  682  681  680  679  678  677  676  675  674  673  672  671  670  669  668  667  666  665  664  663  662  661  660  659  658  657  656  655  654  653  652  651  650  649  648  647  646  645  644  643  642  641  640  639  638  637  636  635  386  129
 197  450  449  448  447  446  445  444  443  442  441  440  439  438  437  436  435  434  433  432  431  430  429  428  427  426  425  424  423  422  421  420  419  418  417  416  415  414  413  412  411  410  409  408  407  406  405  404  403  402  401  400  399  398  397  396  395  394  393  392  391  390  389  388  387  130
 196  195  194  193  192  191  190  189  188  187  186  185  184  183  182  181  180  179  178  177  176  175  174  173  172  171  170  169  168  167  166  165  164  163  162  161  160  159  158  157  156  155  154  153  152  151  150  149  148  147  146  145  144  143  142  141  140  139  138  137  136  135  134  133  132  131
