# This puzzle is unsolvable
41
 160    3  164    1    6  166  167    8    9  321   10  468   14  326  325   15   16   17   18   21   20   22   23   24   25  335  184  188  615  189  191   32  192   34   35   36   37   39  198  200   40
 158  161    2  168  163  165  461  320   12  599  322  171  174  469  172  176  175  330  178   19  181  182  185  613   28   26   27  183   31   33   30  190  193  344  194  195  197  199  349   38   41
 312  456  313    4  315    5  318  458    7  319   11  170  169  324  470  467  177  327  472  331  180  332  478  334  739  336  337  186  341   29  340  343  342  621  345  346  196  348  203   43   42
 157  162  159  314  316  459  457  462  843  597   13  464  730  323  603  173  328  605  179  329  609  476  475  738  740  619  860  482  338  618  617  746  747  487  623  489  625  347  201  350  202
 311  156  309  592  840  721  317  463  722  596  598  602  465  728  850  731  604  607  854  473  474  736  333  857  187  477  743  480  484  483  485  622  976  486  750  488  624  493  491   44   45
 455  454  591  593  594  718  460  723  595  724  726  600  466  959  601  849  734  733  963  608  967  610  858  970  612  479  481  339  744  620  866  745  748  627  749  490  626  204  492  352   46
 310  155  453  590  717  720  719  841  842  725  844  727 1060  729  960  471  606  961  735 1163  856  737  969 1072  611  616  614  862  742  863 1174  867  979  870  868  751  353  752  351   48   47
 153  308  307  589  587  839  952 1057  954  847  957  845  958 1063  848  732  851 1068  852 1067 1249  965 1073 1164  972  741  971 1078  973  864  975  865  978  628  869  753  495  354  498  494   49
 306  586  451  452  588  838  951 1155  953  955 1152  956 1156  846 1158 1064  962 1251 1250 1162 1254 1069 1070  968  859 1170  861 1076 1259 1079  974 1080 1083  758  871  755  754  496   51  629  206
 154  152  304  585  716  837  950 1056 1151 1059 1058 1243 1061 1062 1246 1065 1324    0 1161 1461 1329 1252 1253 1071 1168 1074 1075 1169 1260 1077 1173  980  983 1176  872  630  631   50  207  205  210
 301  305  151  714  448  836  949 1153 1055 1320 1154 1244 1157 1159 1160 1325 1245  853  855  964 1401 1166 1331 1167 1333 1255 1257 1171 1258 1082 1175 1081  977  981  497  757  756  357  499  208  355
 449  150  450  302  715  835  948 1054 1240 1150 1319 1242 1241 1323 1396 1326 1066 1398 1400 1248 1330 1404 1165 1256 1466 1524 1335 1337 1338 1172 1261 1178 1084 1177  984  636  982  500  359  209  356
 446  584  303  713  834  712  947 1053 1148 1238 1239 1322 1321 1393 1395 1513 1462 1464 1247  966 1518 1327 1406 1607 1469 1334 1336 1408 1409 1339 1262 1086 1264  874  632 1085  875  501  634   52  358
 300  149  299  447  583  832 1051 1149 1052 1318 1390 1392 1391 1394 1458 1459 1515 1460 1399 1565 1403 1465 1468 1405 1522 1470 1407 1471 1342 1341 1179 1410 1340  985  876  873  759  633  360   54   53
 148  445  582  711  581  945  946 1050 1147 1237 1456 1455 1512 1511 1457 1397 1514 1328 1563 1332 1566 1520 1467 1402 1570 1523 1525 1472 1411 1343 1181 1265 1263 1087 1180  635  502  503  361  211  212
 147  145  580  830  833  442  831  943 1146 1236 1317 1389 1454 1510 1561 1559 1562 1600 1516 1517 1660 1521 1637 1519 1569 1571 1526 1527 1414 1473 1344 1088  878  879  986  761  637  504  213   56   55
 146  444  143  578  709  710 1047  944 1235 1233 1316 1388 1453 1452 1560 1599 1633 1602 1604 1567 1605 1606 1611 1609 1639 1572 1529 1528 1475 1413 1266 1089 1182  880  760  639  763  363  362  214   57
 297  298  443  579  829  827 1048 1049 1232 1145 1143 1315 1451 1508 1509 1601 1632 1603 1564 1636 1658 1463 1568 1635 1610 1640 1474 1412 1476 1346 1268 1183 1090  987  877  762  638  505  364  215   58
 144  295  293  707  708  828  942  941 1229 1234 1313 1387 1386 1507 1557 1631 1656 1655 1629 1667 1674 1634 1608 1573 1477 1417 1530 1415 1270 1269 1267  991  988  989  990  881  764  506  365  216   59
 440  296  294  441  577  940 1046 1045 1144 1312 1314 1385 1450 1556 1558 1598 1657 1654 1672 1661 1678 1659 1638 1663 1574 1532 1531 1348 1418 1345 1185 1184 1091  882  765  640  366  641  367  217   60
 142  141  573  139  706  939 1044 1231 1142 1311 1230 1384 1449 1506 1555 1596 1597 1630 1671 1680 1642 1675 1641 1613 1576 1614 1577 1416 1479 1272 1186 1092 1093  992  883  766  507  368  218   61   62
 138  140  576  705  826  824  825 1043 1141 1310 1309 1383 1448 1505 1554 1595 1628 1653 1662 1670 1673 1676 1664 1643 1582 1478 1612 1480 1575 1271 1347 1188 1094  993  884  767  642  508  369  219   63
 290  292  437  704  574  935  936 1140  937 1227 1228 1382 1447 1503 1552 1504 1553 1627 1652 1668 1679 1647 1677 1665 1644 1615 1534 1533 1350 1419 1187 1349 1095  994  885  768  643  509  510  220   64
 575  436  434  438  703  823  938 1042 1139 1039 1308 1381 1446 1501 1551 1594 1626 1651 1669 1649 1666 1648 1646 1645 1617 1578 1579 1535 1352 1420 1273 1274 1096  995  769  887  644  511  370  221   65
 136  291  137  439  699  821 1040 1041 1137 1307 1380 1306 1502 1445 1550 1593 1625 1624 1622 1650 1623 1620 1618 1583 1616 1581 1481 1422 1482 1276 1190 1189 1097  996  888  886  645  512  372  371  222
 572  435  933  702  700 1037  818  698 1136 1226 1225 1305 1444 1499 1592 1549 1591 1589 1588 1587 1621 1586 1619 1541 1580 1483 1539 1536 1421 1351 1353 1191 1098  998  997  770  771  513  373  223   66
 432  571  289  701  567  819  820  822 1138 1304 1377 1379 1442 1500 1496 1590 1546 1369 1494 1543 1490 1585 1542 1540 1538 1486 1427 1359 1484 1275 1355 1192 1099  999  889  772  646  647  514  224   67
 132  288  570  286  697 1135 1134 1222 1036 1223 1376 1224 1439 1498 1547 1495 1437 1435 1545 1544 1492 1491 1489 1584 1431 1429 1360 1537 1425 1277 1354 1278 1193 1100  890  773  648  515  374  225   68
 135  134  433  568  431  934  696  931 1038 1302 1378 1303 1443 1441 1370 1438 1548 1209 1434 1493 1365 1366 1432 1430 1488 1487 1284 1485 1426 1423 1356 1194 1103 1101  891  774  649  516  375  226   69
 285  284  429  569  695  932  816 1035 1133 1132 1221 1300 1299 1440 1211 1123 1296 1212 1293 1119 1290 1291 1364 1363 1113 1428 1285 1199 1283 1424 1357 1280 1195 1000 1001  775  650  517  376  227   70
 287  430  133  694 1033  817  926 1131  930 1220 1217 1373 1374 1298 1436 1497 1367 1371 1292 1208 1433  794 1115 1289 1362 1287 1201 1358 1110 1111 1279 1102 1197 1002  892  776  651  518  377  228   71
 131  282  130  428  813  563  809  928 1130 1218 1219 1127 1301 1124 1216 1297 1295  797  544 1368  910 1116 1206 1015  909 1361 1202 1010 1200 1281 1106 1003 1004  894  893  778  652  519  378  229   72
 129  427  280  566  693  565 1031  815  929 1028 1032 1375 1126 1026 1214 1372 1121 1023 1120  913 1117  674 1207 1018 1205 1288 1286 1112 1196 1282 1198 1107 1105 1104  777  895  653  520  379  230   73
 283  426  281  564  561  814  927  924 1129 1029 1128 1027 1215  918 1213  802 1025  801 1294 1210 1019 1017  912 1114 1013 1203 1012  790 1009 1109 1108 1007 1006 1005  896  779  654  521  380  231   74
 128  126  425  279  691  812 1034  923 1030  922  807  921  805 1125  675  914 1024 1021  800 1122 1118  795  537 1014  905  791  907 1204  902  901 1008  900  899  898  897  780  655  522  381  232   75
 125  127  424  690  811  692  925  687  810  808  684  920  803  678  917  409  677  799  915 1022  796  911  669  540  906  903  789  665  788  787  786  785  784  783  782  781  656  523  382  233   76
 124  278  423  562  558  689  688  686  553  685  682  806  919  681  679 1020  547  916  676  798  539  792  668  667  908  399 1011  666  904  664  663  662  661  660  659  658  657  524  383  234   77
 275  277  560  420  559  557  556  555  415  414  554  413  551  804  548  546  406  405  545  256  793  673 1016  402  538  536  671  535  534  533  532  531  530  529  528  527  526  525  384  235   78
 123  422  276  119  118  417  270  416  268  411  683  264  680  550  408  549  407  543  104  670  255  400  252  253   98  398  397  396  395  394  393  392  391  390  389  388  387  386  385  236   79
 122  120  421  117  419  272  418  269  112  552  111  412  263  262  107  410  260  403  102  257  542  672  404  254  401  251  250  249  248  247  246  245  244  243  242  241  240  239  238  237   80
 121  274  273  116  271  115  114  113  267  266  110  265  109  108  106  261  105  103  259  101  541  258   97  100   99   96   95   94   93   92   91   90   89   88   87   86   85   84   83   82   81
