# This puzzle is unsolvable
8
58 29  2 40 25 37 14  8
20 52 28 45  7 62 26 19
39 23  6  0 54 32 33 47
18  9 34 59 42 46 12 36
49 57 53  5 15 31 38 11
61 30  3 41 51  1 16 10
22 21 43 35 55 27 13 17
56 44 50 63 48 24  4 60
