# This puzzle is unsolvable
63
   2    1    3    4    5  254  257    8  255  256   10   11   12   13   14   15   17   18   19   20   21   22   23   24   25   26   28   29   30   31   32   34  281   33  520   37  284  285   38   39   40  289   42  529   43   44  762   49  296   51  298   52   55   54   57  303   58   59   60  545  308   61  307
 248  249  250  251  491    6    7  495    9  496  258  259  260  261  262   16  264  265  266  267  268  269  270  271  272  273   27  275  514  276  518  278  750  280   35  753  978   36  286  287   41  288  290  760  531  291   45  987  297  534   50  300   53  773  301  304  302   56  306  547   63  546   62
 247  488  489  490  253  252  493  723  726  497  728  498  499  500  501  263  502  503  504  505  507  508  509  510  511  512  274  513  745  516  971  519  277  283  522  523 1192  524  525  526  527  528  984 1198   48   47  292 1411  535  536  538  299  770  539  541  772  305  998  544  778   65  775  309
 246  487  720  721  722  724  492  494  725  727  951  729  730  731  732  733  734  735  736  506  737  738  740  741  742  743  970 1182  515  279  517  749  752  975  973  282  754  755  756  757  982  530  759  985   46  764  294  989  765  990  537  767  769  993  540  542  774  543  776  311  548  312   64
 245  486  719  944  945  946  947  948  949  950 1166  952  953  954  955  956  957  958  959  960  961  739  962  963  964  965  966  744  968 1184 1185  972  748  974  751  976  977  979 1403 1194  981 1196 1200  295 1197  761  532 1204 1609  766  768  992 1208 1209  771 1211 1212  999  777  550  313  781   66
 244  485  718  943 1160 1161 1162 1163 1164 1165 1373 1167 1168 1169 1170 1171 1172 1173 1174 1175 1176 1177 1178 1179 1180 1181 1183  967  969  746 1393 1186 1188 1398  521 1191 1399 1193  980 1604  983 1404 1406 1795 1607  293 1407 1203 1612 1206 1413 1207  991  994  995 1418 1617  996  779 1002  310  780   67
 243  484  717  942 1159 1368 1369 1370 1371 1372 1572 1374 1375 1376 1377 1378 1379 1380 1381 1382 1383 1384 1385 1386 1387 1388  747 1390 1392 1591 1187 1786 1394 1395 1190 1597 1598 1400 1401  758 1195 2150 1402 1410  533  986  763 1412 1201 1205 1614 1417 1415 1416 1210  997 1806 1000 1001 1215  784  549   68
 242  483  716  941 1158 1367 1568 1569 1570 1571 1763 1573 1574 1575 1576 1577 1578 1579 1580 1581 1582 1583 1585 1776 1586 1590 1588 1780 1964 1593 1391 1594 1968 1396 1397 1596 1599 1600 1601 1603 1793 1602 1199 1979 1606 1408 1409 1608 1202 1801 1414 1611 1615 1988 1616 1618 1421 1420  782  314   72  552   69
 241  482  715  940 1157 1366 1567 1760 1761 1762 1946 1764 1765 1766 1767 1768 1769 1770 1771 1772 1773 1775 1584 1958 1777 1587 1779 1389 1592 1966 1965 2470 1970 1783 1189 2145 1788 1973 1790 1791 1794 1976 1405 2154 1610 1798 1800 1981 1984 1802 1803 1613 1804 1989 2163 1619  783 1419 1214  553 1218  551   71
 240  481  714  939 1156 1365 1566 1759 1944 1945 2121 1947 1948 1949 1950 1951 1952 1953 1954 1955 1956 1774 1957 1960 2136 1778 1589 1962 2306 1782 1781 2140 1784 1785 2311 2146 1789 1972 1974 1977 2153 1975 1605 1978  988 2156 1799 1982 2325 2484 1985 2164 2329 2162 1990 1219 1003 1811 1425   73   70  316  315
 239  480  713  938 1155 1364 1565 1758 1942 1943 2120 2122 2123 2124 2125 2126 2127 2128 2129 2130 2131 2132 2133 2134 1961 1959 2301 2304 2138 2139 2142 2141 1969 2143 1595 2144 2314 2149 2148 2147 2151 2152 1797 2322 2633 2157 2483 1983 2327 2330 2160 2161 1424 1807 1004 1808 1006 1216 1213 1222   74  785  318
 238  479  712  937 1154 1363 1564 1757 1941 2119 2288 2289 2290 2291 2292 2293 2294 2295 2296 2297 2298 2299 2300 2460 2135 2302 2465 1963 2137 2307 2308 2468 2469 1787 1967 2315 1971 2624 2316 1792 2478 2318 1980 2477 2155 2323 1796 2159 2488 2328 1986 2332 1987 1809 1007 1422 1217 1221  554 1005  557  556  555
 237  478  711  936 1153 1362 1563 1756 2118 2117 2287 2448 2449 2450 2451 2452 2453 2454 2455 2456 2457 2458 2459 2612 2461 2614 2303 2305 2464 2760 2466 2763 2467 2310 2473 2313 2767 2766 2768 2317 2626 2479 2321 2320 2910 2481 2326 2778 2324 2158 2486 2487 1991 1805 1620 1621 1810 1625  317  560 1009  319   75
 236  477  710  935 1152 1360 1361 1562 1755 1940 2286 2447 2600 2601 2602 2603 2604 2605 2606 2607 2608 2609 2611 2613 2462 2463 2757 2615 2616 2897 2622 2617 2619 2620 2471 2901 2900 2475 2627 2629 2319 2774 2631 2480 2635 2634 2482 2779 2485 2489 2331 1993 1992 1626 1813 1814 1622 1423  788  558  786  320  321
 235  476  709  934 1151 1359 1561 1938 1754 2116 2285 2446 2599 2744 2745 2746 2747 2748 2749 2750 2751 2752 2610 2754 2755 2756 2892 2758 2896 2895 2762 3023 2309 3024 2621 2472 2474 3031 2904 2628 2773 2630 2772 2776 2632 2780 2913 2637 2777 2636 2167 1994 1812 1623 2165 1225 1223 1427 1224  559  790  322   76
 234  475  708  933 1150 1560 1559 1753 1939 2115 2284 2445 2598 2743 2880 2881 2882 2883 2884 2885 2886 2887 2753 2889 2890 2891 3020 2759 2894 3022 2899 2618 2761 2312 3146 2765 3029 2903 2905 2476 2771 2625 2907 2908 3035 2775 2911 2639 2781 2333 2170 2166 2334 1995 1624 2169 1426 1220 1008 1010  561  325   77
 233  474  707  932 1149 1358 1558 1752 1937 2114 2283 2444 2597 2742 2879 3008 3009 3010 3011 3012 3013 3015 2888 3016 3017 3018 3019 3021 3140 2893 3144 2898 2623 2764 3026 3027 3148 2902 2769 3151 2906 3149 3034 3157 3037 3038 2912 2916 2784 2490 2168 2335 1816 1627 1428 1430 1429  787 1012 1011   79  324  323
 232  473  706  931 1148 1357 1557 1751 1936 2113 2282 2443 2596 2741 2878 3007 3128 3129 3130 3131 3132 3014 3134 3135 3136 3137 3138 3250 3139 3141 3253 3143 3142 3254 3145 3147 3025 3363 3033 2770 3261 3153 3036 3367 3041 2909 2782 2640 1998 2914 2172 2491 2638 2000 1817 1997 1432  789 1226  791  562   78   80
 231  472  705  930 1147 1356 1750 1748 1749 2112 2281 2442 2595 2740 2877 3006 3127 3240 3241 3242 3243 3133 3244 3245 3349 3248 3249 3448 3252 3353 3355 3357 3359 3256 3255 3028 3259 3458 3030 3032 3263 3461 3267 3369 3040 2642 3159 2783 2493 2915 2336 2171 2337 1996 1819 1815 1628 1431 1013  792  563  326   81
 230  471  704  929 1146 1355 1556 1935 1934 2111 2280 2441 2594 2739 2876 3005 3126 3239 3344 3345 3346 3347 3348 3247 3246 3445 3352 3533 3251 3449 3358 3356 3361 3257 3258 3362 3543 3260 3150 3152 3364 3154 3155 3158 3156 3039 3270 3042 2643 2785 2641 2918 2492 1818 1629 1433 1434 1227 1014  793  564  327   82
 470  703  469  928 1145 1554 1353 1555 2108 1933 2110 2279 2593 2738 2875 3004 3125 3238 3343 3440 3528 3532 3530 3443 3350 3531 3351 3535 3450 3452 3537 3451 3453 3454 3455 3457 3693 3459 3365 3262 3366 3627 3551 3265 3162 3043 3268 2919 2917 2496 2340 2173 2644 2339 1630 1822 1435 1228 1015  794  565  328   83
 228  702  700  927 1144 1354 1553 1747 1930 2109 2278 2440 2439 2737 2874 3003 3124 3237 3342 3439 3526 3441 3442 3610 3444 3612 3447 3446 3534 3354 3689 3538 3360 3541 3542 3456 3625 3547 3550 3545 3464 3271 3468 3045 3467 3161 3044 3160 2787 2786 2497 2495 2338 2494 2174 1820 1632 1229 1016  795  566  329   84
 229  468  467  701 1143 1351 1352 1932 1745 2437 1931 2438 2592 2736 2873 3002 3123 3236 3341 3438 3529 3609 3527 3608 3611 3683 3686 3614 3536 3616 3688 3617 3540 3620 3621 3622 3695 3757 3549 3626 3368 3463 3465 3264 3163 3048 3371 3165 2920 2646 2645 2341 2175 1999 1631 1821 1230 1231 1017  796  567  330   85
 227  466  226 1141 1142 1350 1552 2276 1746 2107 2277 2589 2591 2735 2872 3001 3122 3235 3340 3437 3525 3607 3680 3681 3682 3613 3687 3684 3749 3615 3618 3690 3619 3691 3692 3624 3696 3546 3548 3462 3697 3460 3469 3373 3269 3274 3273 3046 2921 2499 2647 2176 2002 2003 2001 1633 1437 1436 1232 1018  568  331   86
 225  699  925  926  924 1551 1550 1744 2106 2275 2436 2590 2588 2734 2870 3000 3121 3234 3339 3436 3524 3606 3679 3744 3745 3746 3748 3803 3750 3751    0 3539 3753 3754 3755 3623 3812 3698 3760 3630 3629 3272 3376 3628 3276 3370 3374 3047 3164 2791 2648 2342 2004 2178 1823 1634 1440 1233 1019  797  569  332   87
 224  465  698  923 1140 1349 1549 1743 1929 1928 2274 2433 2435 2871 2733 2999 3120 3233 3338 3435 3605 3604 3678 3743 3801 3685 3802 3804 3805 3752 3806 3807 3808 3810 3857 3811 3544 3756 3694 3759 3699 3552 3466 3266 3375 3275 3049 2922 2788 2924 2498 2500 2006 2005 1824 1635 1439 1234 1020  798  570  333   88
 223  464  697  922 1139 1348 1548 1742 1927 2272 2103 2273 2587 2732 2869 2998 3119 3232 3337 3434 3523 3677 3742 3799 3848 3747 3849 3850 3851 3852 3853 3854 3855 3809 3895 3897 3858 3814 3758 3813 3632 3631 3377 3554 3372 3050 2345 2923 2650 2789 2501 2343 2177 2181 2344 1438 1441 1022 1021  799  571   89  335
 222  463  696  921 1138 1346 1347 1741 2105 1926 2434 2104 2586 2731 2868 2997 3118 3231 3336 3433 3522 3603 3741 3798 3800 3847 3888 3889 3890 3891 3892 3893 3894 3856 3896 3859 3816 3762 3761 3701 3556 3633 3553 3166 3470 3471 3168 2926 2790 2649 2792 2179 2180 2347 1826 1825 1636  574 1442 1025  800  801  334
 221  462  694  695  920 1345 1547 1740 1925 2102 2271 2432 2585 2730 2867 2996 3117 3230 3335 3432 3521 3602 3676 3740 3797 3846 3887 3920 3921 3922 3923 3924 3925 3926 3927 3817 3860 3899 3763 3700 3702 3555 3379 3169 3378 3277 3051 2927 2925 2652 2183 2503 2502 1829 1639 1237 1235 1637 1236  803  336   91  337
 220  461  693  919 1137 1136 1546 1738 1739 2101 2270 2431 2584 2729 2866 2995 3116 3229 3334 3431 3520 3601 3675 3739 3796 3845 3886 3919 3944 3945 3946 3947 3948 3949 3928 3898 3861 3819 3863 3703 3634 3635 3279 3472 3167 3278 3052 2928 2794 2651 2504 2654 2793 2182 1831 1827 1638 1640 1023  572  573   90  802
 219  460 1135  692 1134 1344 1543 1545 1924 2100 2269 2430 2583 2728 2865 2994 3115 3228 3333 3430 3519 3673 3674 3738 3795 3844 3885 3918 3943 3960 3961 3963 3950 3951 3929 3900 3815 3862 3764 3704 3473 3558 3557 3559 3280 3170 3054 3053 2653 2507 2008 2346 2009 2348 2011 1443 2013 1024 1238 1026  575   92  338
 218  459  918  917 1132 1343 1544 1737 1923 2099 2268 2429 2582 2727 2864 2993 3114 3227 3332 3429 3599 3600 3672 3737 3794 3843 3884 3917 3942 3959 3964 3955 3962 3965 3930 3901 3864 3765 3766 3818 3705 3636 3382 3380 3281 3171 3055 2795 2655 2506 2656 2007 1830 2010 1641 1239 1644  805  576  577  804  339   93
 217  458  916 1133 1340 1342 1542 1921 1922 2098 2267 2428 2581 2726 2863 2992 3113 3226 3331 3428 3518 3598 3671 3736 3793 3842 3883 3916 3941 3957 3968 3966 3952 3953 3931 3902 3865 3820 3767 3706 3560 3475 3381 3474 3172 3173 2797 2796 2929 2351 2349 2505 2184 1643 1832 1240 1444 1445 1027  578  806  340   94
 216  456  457  690 1736 1541 1131 1735 1920 2097 2266 2427 2580 2725 2862 2991 3112 3225 3330 3427 3517 3597 3670 3735 3792 3841 3882 3915 3940 3967 3958 3956 3954 3933 3903 3866 3821 3768 3708 3561 3638 3562 3476 3283 3383 3282 2931 2930 2798 2657 2350 2186 1828 2185 2012 1642 1446 1241  808  579  341   96   95
 215  455  915  691  914 1339 1341 1734 1919 2096 2265 2426 2579 2724 2861 2989 2990 3224 3329 3426 3516 3596 3669 3734 3791 3840 3881 3914 3939 3938 3937 3935 3907 3932 3934 3904 3867 3822 3769 3637 3640 3639 3477 3385 3174 3057 3056 2932 2658 2509 2508 2352 2014 2188 1833 1447 1244 1028 1031  807 1029  342   97
 213  688  689  913 1130 1338 1540 1733 1918 2095 2264 2425 2578 2723 2860 2988 3111 3223 3328 3513 3515 3595 3668 3733 3790 3839 3880 3913 3912 3911 3910 3936 3909 3908 3906 3905 3868 3823 3770 3707 3709 3563 3384 3478 3284 3176 3058 2933 2799 2801 2659 2510 2354 2187 2015 1646 1645 1242 1243 1449  343  344   98
 454  214  687  686 1129 1539 1732 1731 1917 2094 2263 2424 2577 2722 2859 2987 3110 3222 3424 3326 3425 3594 3667 3732 3789 3838 3879 3878 3877 3876 3875 3874 3873 3872 3871 3870 3869 3824 3771 3710 3641 3564 3479 3386 3285 3059 2935 3175 2800 2660 2511 2189 2353 2016 1834 1647 1448 1245 1030  809  581  346  345
 212  453  911  912 1128 1337 1538 1730 1916 2093 2262 2423 2576 2721 2858 3109 3325 3220 3327 3512 3514 3593 3666 3731 3788 3837 3836 3835 3834 3833 3832 3831 3830 3829 3828 3827 3826 3825 3772 3711 3642 3565 3480 3387 3286 3177 2934 3060 2802 2661 2512 2355 2190 2017 1835 1836 1450 1451  580 1033  811  582   99
 211  452  685  910 1127 1336 1537 1915 1914 2092 2261 2422 2575 2720 2986 3107 3221 3219 3422 3423 3511 3592 3665 3730 3787 3786 3785 3784 3783 3782 3781 3780 3779 3778 3777 3776 3775 3774 3773 3712 3643 3566 3481 3388 3287 3178 3061 2936 2803 2662 2513 2356 2191 2018 1837 1648 1452  812  583 1032  584  810  102
 210  451  684  909 1126 1335 1536 1729 2091 2090 2260 2421 2574 2719 2857 2985 3108 3106 3324 3421 3510 3591 3664 3729 3728 3727 3726 3725 3724 3723 3722 3721 3720 3719 3718 3717 3716 3715 3714 3713 3644 3567 3482 3389 3288 3179 3062 2937 2804 2663 2514 2357 2192 2020 2019 1838 1649 1246 1035  813  347  100  101
 209  450  683  908 1125 1334 1535 1728 1912 1913 2573 2259 2572 2855 2856 2984 3105 3218 3323 3420 3509 3590 3663 3662 3661 3660 3659 3658 3657 3656 3655 3654 3653 3652 3651 3650 3649 3648 3647 3646 3645 3568 3483 3390 3289 3180 3063 2938 2805 2664 2515 2358 2193 2021 1651 1839 1453 1247 1248 1034  814  585  348
 208  449  682  907 1124 1333 1534 1727 2089 2258 2420 2571 2717 2718 2854 2983 3104 3217 3322 3419 3508 3589 3588 3587 3586 3585 3584 3583 3582 3581 3580 3579 3578 3577 3576 3575 3574 3573 3572 3571 3570 3569 3484 3391 3290 3181 3064 2939 2806 2665 2516 2359 2022 1840 1842 1653 1650 1249 1036  586  350  587  103
 207  448  681  906 1123 1332 1533 1726 1911 2088 2257 2419 2570 2716 2853 2982 3103 3216 3321 3418 3507 3506 3505 3504 3503 3502 3501 3500 3499 3498 3497 3496 3495 3494 3493 3492 3491 3490 3489 3488 3487 3486 3485 3392 3291 3182 3065 2940 2807 2666 2517 2360 2194 2023 1454 1841 1455 1250  817 1037  105  104  349
 206  447  680  905 1122 1331 1532 1725 2087 2256 1910 2418 2417 2715 2852 2981 3102 3215 3320 3417 3416 3415 3414 3413 3412 3411 3410 3409 3408 3407 3406 3405 3404 3403 3402 3401 3400 3399 3398 3397 3396 3395 3394 3393 3292 3183 3066 2941 2808 2667 2518 2361 2195 2196 1654 2024 1251 1038 1039  588  815  351  106
 205  446  679  904 1121 1330 1531 1724 1909 2086 2255 2416 2569 2714 2851 2980 3101 3214 3319 3318 3317 3316 3315 3314 3313 3312 3311 3310 3309 3308 3307 3306 3305 3304 3303 3302 3301 3300 3299 3298 3297 3296 3295 3294 3293 3184 3067 2942 2809 2668 2519 2362 2197 1843 1652 1457 1456 1253  818  816  589  352  107
 204  445  678  903 1120 1329 1530 1723 1908 2085 2254 2415 2568 2713 2850 2979 3100 3213 3212 3211 3210 3209 3208 3207 3206 3205 3204 3203 3202 3201 3200 3199 3198 3197 3196 3195 3194 3193 3192 3191 3190 3189 3188 3187 3186 3185 3068 2943 2810 2669 2520 2363 2198 2025 1844 1655 1458 1040 1252  819  590  353  108
 203  444  677  902 1119 1328 1529 1722 1907 2084 2253 2414 2567 2712 2849 2978 3099 3098 3097 3096 3095 3094 3093 3092 3091 3090 3089 3088 3087 3086 3085 3084 3083 3082 3081 3080 3079 3078 3077 3076 3075 3074 3073 3072 3071 3070 3069 2944 2811 2670 2521 2364 2199 2026 1845 1656 1459 1254 1041  820  591  354  109
 202  443  676  901 1118 1327 1528 1721 1906 2083 2252 2413 2566 2711 2848 2977 2976 2975 2974 2973 2972 2971 2970 2969 2968 2967 2966 2965 2964 2963 2962 2961 2960 2959 2958 2957 2956 2955 2954 2953 2952 2951 2950 2949 2948 2947 2946 2945 2812 2671 2522 2365 2200 2027 1846 1657 1460 1255 1042  821  592  355  110
 201  442  675  900 1117 1326 1527 1720 1905 2082 2251 2412 2565 2710 2847 2846 2845 2844 2843 2842 2841 2840 2839 2838 2837 2836 2835 2834 2833 2832 2831 2830 2829 2828 2827 2826 2825 2824 2823 2822 2821 2820 2819 2818 2817 2816 2815 2814 2813 2672 2523 2366 2201 2028 1847 1658 1461 1256 1043  822  593  356  111
 200  441  674  899 1116 1325 1526 1719 1904 2081 2250 2411 2564 2709 2708 2707 2706 2705 2704 2703 2702 2701 2700 2699 2698 2697 2696 2695 2694 2693 2692 2691 2690 2689 2688 2687 2686 2685 2684 2683 2682 2681 2680 2679 2678 2677 2676 2675 2674 2673 2524 2367 2202 2029 1848 1659 1462 1257 1044  823  594  357  112
 199  440  673  898 1115 1324 1525 1718 1903 2080 2249 2410 2563 2562 2561 2560 2559 2558 2557 2556 2555 2554 2553 2552 2551 2550 2549 2548 2547 2546 2545 2544 2543 2542 2541 2540 2539 2538 2537 2536 2535 2534 2533 2532 2531 2530 2529 2528 2527 2526 2525 2368 2203 2030 1849 1660 1463 1258 1045  824  595  358  113
 198  439  672  897 1114 1323 1524 1717 1902 2079 2248 2409 2408 2407 2406 2405 2404 2403 2402 2401 2400 2399 2398 2397 2396 2395 2394 2393 2392 2391 2390 2389 2388 2387 2386 2385 2384 2383 2382 2381 2380 2379 2378 2377 2376 2375 2374 2373 2372 2371 2370 2369 2204 2031 1850 1661 1464 1259 1046  825  596  359  114
 197  438  671  896 1113 1322 1523 1716 1901 2078 2247 2246 2245 2244 2243 2242 2241 2240 2239 2238 2237 2236 2235 2234 2233 2232 2231 2230 2229 2228 2227 2226 2225 2224 2223 2222 2221 2220 2219 2218 2217 2216 2215 2214 2213 2212 2211 2210 2209 2208 2207 2206 2205 2032 1851 1662 1465 1260 1047  826  597  360  115
 196  437  670  895 1112 1321 1522 1715 1900 2077 2076 2075 2074 2073 2072 2071 2070 2069 2068 2067 2066 2065 2064 2063 2062 2061 2060 2059 2058 2057 2056 2055 2054 2053 2052 2051 2050 2049 2048 2047 2046 2045 2044 2043 2042 2041 2040 2039 2038 2037 2036 2035 2034 2033 1852 1663 1466 1261 1048  827  598  361  116
 195  436  669  894 1111 1320 1521 1714 1899 1898 1897 1896 1895 1894 1893 1892 1891 1890 1889 1888 1887 1886 1885 1884 1883 1882 1881 1880 1879 1878 1877 1876 1875 1874 1873 1872 1871 1870 1869 1868 1867 1866 1865 1864 1863 1862 1861 1860 1859 1858 1857 1856 1855 1854 1853 1664 1467 1262 1049  828  599  362  117
 194  435  668  893 1110 1319 1520 1713 1712 1711 1710 1709 1708 1707 1706 1705 1704 1703 1702 1701 1700 1699 1698 1697 1696 1695 1694 1693 1692 1691 1690 1689 1688 1687 1686 1685 1684 1683 1682 1681 1680 1679 1678 1677 1676 1675 1674 1673 1672 1671 1670 1669 1668 1667 1666 1665 1468 1263 1050  829  600  363  118
 193  434  667  892 1109 1318 1519 1518 1517 1516 1515 1514 1513 1512 1511 1510 1509 1508 1507 1506 1505 1504 1503 1502 1501 1500 1499 1498 1497 1496 1495 1494 1493 1492 1491 1490 1489 1488 1487 1486 1485 1484 1483 1482 1481 1480 1479 1478 1477 1476 1475 1474 1473 1472 1471 1470 1469 1264 1051  830  601  364  119
 192  433  666  891 1108 1317 1316 1315 1314 1313 1312 1311 1310 1309 1308 1307 1306 1305 1304 1303 1302 1301 1300 1299 1298 1297 1296 1295 1294 1293 1292 1291 1290 1289 1288 1287 1286 1285 1284 1283 1282 1281 1280 1279 1278 1277 1276 1275 1274 1273 1272 1271 1270 1269 1268 1267 1266 1265 1052  831  602  365  120
 191  432  665  890 1107 1106 1105 1104 1103 1102 1101 1100 1099 1098 1097 1096 1095 1094 1093 1092 1091 1090 1089 1088 1087 1086 1085 1084 1083 1082 1081 1080 1079 1078 1077 1076 1075 1074 1073 1072 1071 1070 1069 1068 1067 1066 1065 1064 1063 1062 1061 1060 1059 1058 1057 1056 1055 1054 1053  832  603  366  121
 190  431  664  889  888  887  886  885  884  883  882  881  880  879  878  877  876  875  874  873  872  871  870  869  868  867  866  865  864  863  862  861  860  859  858  857  856  855  854  853  852  851  850  849  848  847  846  845  844  843  842  841  840  839  838  837  836  835  834  833  604  367  122
 189  430  663  662  661  660  659  658  657  656  655  654  653  652  651  650  649  648  647  646  645  644  643  642  641  640  639  638  637  636  635  634  633  632  631  630  629  628  627  626  625  624  623  622  621  620  619  618  617  616  615  614  613  612  611  610  609  608  607  606  605  368  123
 188  429  428  427  426  425  424  423  422  421  420  419  418  417  416  415  414  413  412  411  410  409  408  407  406  405  404  403  402  401  400  399  398  397  396  395  394  393  392  391  390  389  388  387  386  385  384  383  382  381  380  379  378  377  376  375  374  373  372  371  370  369  124
 187  186  185  184  183  182  181  180  179  178  177  176  175  174  173  172  171  170  169  168  167  166  165  164  163  162  161  160  159  158  157  156  155  154  153  152  151  150  149  148  147  146  145  144  143  142  141  140  139  138  137  136  135  134  133  132  131  130  129  128  127  126  125
