# This puzzle is unsolvable
21
  5   1   3 152  85   7   8   9 160  12  90 166  13  89 280  96 168  94  99  21  23
 82  80   6   2 217 220 157 158  10  11 159 162  92 170  14 226  19 230 101 169 174
150 271 215 214  83 222 155 275  88 225 164 161  97 235  17  95 236 330  24 173  98
 78 153   4 154 221  86 151 326  87 363 416 165 232 228 284  93 286 167 172  22 103
 79 213 148 322  84 274 324 323 223 278 163 234 328 281 283 175 369  18 331  20 100
272  77 270  81 219 432 218 362 418 279 361 397 329 333  91 285 229  32  26 177  27
317 216 149 320 360 321 276 414 393 325 224 327  16 417 282 400 227 335 372 171 105
 76 211 146 212 318 269 209 395 273 359 357 415 420 368 433  15 104 233 179 288 237
 75 147 267 358 268 319 394 156 356 434 431 398 364 401 289 336 178 334 231 102  28
144 207 315 210 309 313 429 391 430 399 435 332 337 290 370 374 108 287  29 241  30
 73  72  71 386 392 277   0 390 427 355 367 423 421 402 293 181 106 240 371  34 239
145  70 353 204 316 387 396 388 409 440 302 366 438 294 180 242 436  25  33 110  31
 74 263 266 142 314 310 385 422 365 346 428 381 412 425 291 378 408 296 292 109 339
143 206 311 265 349 354 380 410 389 439 406 405 301 375 424 338 437 238 376 182 107
 66 205 208 262 352 139 203 384 350 419 303 253 345 342 373 111 187 246  35 404 340
138 312 264 260  68 413 383 411 426 407 298 300 379 249 250 184 183  45 297  39  36
 69 135 141 257 199 308  52  57 197 304 348 248 344 343 299 403 176  38 377  40 112
 67  64  63 351 202 140 261 305 306 196 194 193 382  49  50 188 121 245 185 244 295
 65 200 136  61 259 307 254  53 129 127 191 190 125  48 252 247 341 118 114 120 116
 60  62  59 132 256 131  55 255 347 258  54  51 189 124 122  47  44 186 113  41 243
134 201 133  58  56 130 198 137 123 126 128 251 192 195  46 119  42 117 115  43  37
