# This puzzle is unsolvable
65
   2    1    3    4    5    6    7    8    9   10   11   12   13   14   15  271   17   18   19  525   20  277   23  279   26   27  282   28  285  532  774  535  534   32   36   37  292   38   39   40  296   43   46  786  303   47  549  301  789  553   51   52   53   54   55   56   57   58   59   60   61   62   63   64   65
 256  257  258  259  260  261  262  263  264  265  266  267  268    0  269  755  272  275  522  276  762   21  765  527  280  281  529  284   29   30  287  288 1005   35  537  776  290  293  294  295  298   42  546   45   44  547  550  552  551   50  555  307  308  309  310  311  312  313  314  315  316  317  318  319   66
 255  504  505  506  507  508  509  510  511  512  513  514  985  754  270   16  758  273  989  760  274  761  526   24   25  767  283  531   33   31  772  771 1227  536 1006 1008  291  539  541  542  543   41  297  299  300  545  548   49   48  304  306 1024  554  556  557  558  559  560  561  562  563  564  565  320   67
 254  503  744  745  746  747  748  749  750  751  752  753  986  515  516  521 1212  757  518  523  524  278  764  766  528   22  768  530  770 1002  286 1442   34 1650  775  773  538  780  540  782  783  785 1015 1016  787 1018  302  788  790  791  305 1025  794  795  796  797  798  799  800  801  802  803  566  321   68
 253  502  743  976  977  978  979  980  981  982  983  984  987  988  756 1427  519  517  759  992  993  763  995  996  997 1220  999  769 1003 1004 1443 1440  289  533 1009  777  778 1010  779 1235 1236  544 1660 1014 1240  784 1019 1020 1021 1022  792 1247  793 1026 1027 1028 1029 1030 1031 1032 1033  804  567  322   69
 252  501  742  975 1200 1201 1202 1203 1204 1205 1206 1207 1208 1209 1210  991 1426 1211  990 1215 1216  994 1217 1219 1435  998 1437 1222 1223 1645 1001 1228 1649 1230 1229 1007 1232 1233  781 1450 1237 1013 1017 1453 1239 1456 1241 1243 1244 1460 1023 1248 1249 1250 1465 1251 1252 1253 1254 1255 1034  805  568   72  324
 251  500  741  974 1199 1416 1417 1418 1419 1420 1421 1629 1422 1633 1634 1832  520 1213 1214 1431 1638 1432 1218 1433 1434 1221 1843 1439 1000 1225 1847 1647 1445 1849 1444 1447 1652 1234 1012 1011 1451 1658 1238 1452 1454 1455 1242 1457 1458 1667 1461 1463 1671 1464 1672 1466 1467 1468 1256 1257 1035  806  569  323   70
 250  499  740  973 1198 1415 1624 1625 1626 1627 1628 1424 1425 1423 1830 1632 1428 1429 1834 1430 1639 1839 1436 1841 2032 1643 1842 1844 1646 1226 1224 2038 1851 2043 1651 1446 1853 1852 1448 1449 1657 1858 1659 1661 1662 1663 1664 1666 1459 1245 1868 1246 1869 1670 1673 1872 1674 1470 1469 1258 1036  807  570  325   71
 249  498  739  972 1197 1414 1623 1824 1825 1826 1827 1828 1630 1631 1635 2022 1833 1636 1637 2027 1837 1640 1840 1641 1642 2031 2034 1438 1644 1848 2220 2039 1850 2042 2044 1231 1653 1854 1655 1855 1656 1859 1860 2051 1861 1864 1863 1665 2241 1867 1669 1462 2058 2060 2063 1873 1676 1675 1472 1471 1037  808  571   73  327
 248  497  738  971 1196 1413 1622 1823 2016 2017 2018 2019 1829 2020 1831 2207 2023 2024 2026 1836 2028 1838 2029 2215 2214 2217 1845 2036 2221 2219 1441 2223 1654 2041 2225 2226 2046 2047 2229 2048 1857 2049 2050 2052 2053 1862 2055 2237 2056 1865 1668 2242 2059 1870 1871 2062 1874 1677 1473 1259 1038  809  572  326   74
 247  496  737  970 1195 1412 1621 1822 2015 2200 2201 2202 2203 2021 2205 2206 2208 2025 2209 1835 2211 2212 2030 2213 2033 2216 1846 2035 1648 2037 2040 2396 2398 2224 2227 2401 2228 2045 2231 1856 2406 2232 2233 2411 2234 2236 2054 2057 2414 1866 2416 2243 2061 2245 2246 2064 1875 1678 1474 1260  810  811  573  328   75
 246  495  736  969 1194 1411 1620 1821 2014 2199 2376 2377 2378 2379 2204 2380 2381 2383 2386 2210 2553 2387 2388 2389 2390 2391 2392 2393 2218 2395 2397 2222 2565 2399 2400 2729 2568 2403 2230 2404 2405 2407 2408 2409 2235 2578 2412 2239 2582 2240 2585 2418 2244 2420 2247 2065 1876 1679 1261 1040 1039  812  329   76   77
 245  494  735  968 1193 1410 1619 1820 2013 2198 2375 2544 2704 2546 2547 2707 2548 2549 2385 2552 2862 2554 2555 2556 2716 2717 2558 2561 2394 2721 2562 2564 2724 2876 2567 2566 2402 2570 2571 2572 2573 2574 2735 2736 2410 2738 2413 2238 2739 2581 2417 2743 2419 2741 2583 2066 1877 1680 1475 1262 1041  813  574   78   79
 244  493  734  967 1192 1409 1618 1819 2012 2197 2374 2543 2703 2545 2706 2859 2708 2709 2550 2384 2712 2864 2863 2866 2557 2715 2718 2559 2719 2720 2563 2722 2723 2725 2727 2878 2569 2880 2730 2731 2733 2734 2885 2887 2576 2575 2580 2579 2740 2415 2587 2742 2893 2744 2421 2067 1681 1476 1477 1263 1042  576  330  333  575
 243  492  733  966 1191 1408 1617 1818 2011 2196 2373 2542 2856 2705 3000 2382 2857 2861 2711 3006 2865 2714 2867 3011 3008 3010 2869 2560 2871 2872 2873 2874 3017 2877 2726 3021 2728 2879 3024 2881 2732 2883 3163 2577 3164 3031 2889 3033 2890 2892 2894 2584 2422 2586 2248 2249 1878 1682 1478 1264 1043  814  577  332  578
 242  491  732  965 1190 1407 1616 1817 2010 2195 2372 2541 2702 2855 2858 3001 3002 3267 2551 3004 3141 3007 3009 3389 2713 3012 3147 2870 3015 3149 3151 3016 3018 2875 3019 3020 3022 3023 3025 3026 2882 2884 2886 3166 3028 2888 3032 3168 3034 2895 2745 2588 2423 2250 2068 1879 1880 1683 1479 1265 1044  815  579   82  331
 241  490  731  964 1189 1406 1615 1816 2009 2194 2371 2540 2701 2999 3136 3137 3138 3139 3005 2710 3268 3144 3388 3272 3145 2868 3274 3014 3148 3277 3150 3152 3153 3154 3155 3156 3157 3158 3159 3160 3161 3162 3289 3029 2737 3165 3294 3167 3169 2891 3035 2746 2589 2424 2251 2070 2069 1881 1684 1480 1045  816  334   80   81
 240  489  730  963 1188 1405 1614 1815 2008 2193 2370 2700 2853 2854 2998 3134 3265 3140 2860 3142 3266 3143 3387 3273 3502 3146 3275 3013 3394 3276 3278 3279 3280 3281 3282 3283 3284 3285 3286 3287 3288 3027 3291 3292 3409 3293 3030 3171 3296 3036 2896 2590 2591 2425 2252 2072 2071 1685 1267 1266  818 1047  580  337  817
 239  488  729  962 1187 1404 1613 2007 2006 2367 2369 2539 2538 2997 2851 3264 3135 3003 3386 3498 3601 3269 3392 3500 3270 3504 3606 3506 3395 3396 3397 3398 3399 3400 3401 3402 3403 3404 3405 3406 3407 3408 3290 3412 3295 3523 3297 3413 3172 3037 2897 2748 2747 2426 2253 1884 1882 1686 1481 1268 1046  582  819  581  336
 238  487  728  961 1186 1403 1612 1814 2191 2192 2537 2536 2699 2852 3133 3132 3262 3384 3385 3497 3499 3697 3602 3390 3271 3501 3393 3505 3609 3507 3508 3509 3510 3511 3512 3616 3513 3514 3515 3517 3518 3519 3624 3625 3411 3298 3628 3170 3039 3040 2898 2899 2749 2750 2427 2073 1883 1687 1482 1269 1049 1048  820   84   83
 237  486  727  960 1185 1402 1611 1813 1812 2190 2695 2365 2368 2366 2996 3261 3131 3263 3383 3381 3598 3600 3603 3604 3391 3503 3607 3703 3608 3610 3611 3612 3613 3614 3615 3617 3712 3618 3516 3621 3715 3622 3522 3521 3524 3416 3525 3415 3173 3038 2593 2751 2428 2592 2254 2074 1885 1689 1688 1271 1270  583  339  335   85
 236  485  726  959 1184 1401 1610 1811 2005 2188 2189 2698 2850 2697 2995 3130 3260 3382 3496 3495 3493 3599 3698 3786 3699 3605 3700 3701 3704 3705 3706 3707 3708 3709 3710 3711 3800 3713 3619 3620 3717 3804 3410 3623 3520 3627 3526 3414 3174 3041 2900 2752 2594 2429 2255 2076 1886 1273 1483 1272 1050 1051  584  338   86
 235  484  725  958 1183 1400 1609 1810 2004 2187 2534 2535 2849 2696 2994 2848 2993 3380 3494 3694 3696 3597 3784 3785 3787 3788 3702 3789 3790 3792 3793 3794 3795 3796 3797 3799 3714 3950 3803 3952 3716 3882 3720 3626 3721 3719 3300 3299 3175 3042 2901 2753 2596 2256 2595 1888 2430 2077 1484 1887  822  821  585  340   87
 234  483  724  957 1182 1399 1608 1809 2003 2364 2532 2694 2846 2847 2992 3129 3259 3379 3492 3596 3595 3695 3864 3865 3866 3867 3868 3869 3791 3871 3872 3873 3874 3875 3876 3801 3880 3802 3881 4014 3883 3805 3718 3629 3528 3418 3417 3301 3176 3043 2902 2754 2431 2259 2258 2075 1691 2257 1690 1485 1052  823  586  341   88
 233  482  723  956 1181 1398 1808 2002 2000 2001 2533 2691 2531 2693 2991 3128 3258 3257 3378 3491 3782 3783 3936 3862 3937 3938 3939 3940 3870 3941 3943 3944 3945 3946 3947 3798 3879 3878 4069 4015 3953 3884 3806 3807 3529 3527 3419 3302 3177 3044 2904 2903 2597 2435 2432 2078 1692 1487 1486 1274 1053  824  587  342   89
 232  481  722  955 1180 1397 1607 1606 1999 2184 2186 2363 2990 2692 2989 3127 3254 3377 3490 3594 3693 3781 3863 3935 4000 4001 4002 4003 4004 3942 4006 4007 4008 4009 4065 3948 4114 4012 3951 3877 3885 3808 3722 3723 3530 3532 3420 3303 3178 3045 2905 2755 2433 2598 2260 2434 1693 1889 1488 1275 1054  825  588  343   90
 231  480  721  954 1179 1396 1603 1807 1805 2185 2529 2362 2360 2845 2988 3256 3126 3255 3376 3691 3692 3934 3780 3999 4056 4057 4104 4144 4058 4005 4061 4062 4063 4011 4113 4010 4013 4066 3949 4068 4016 3954 3725 3632 3724 3630 3421 3304 3179 2756 2600 2906 2599 2261 2079 1891 1890 1694 1489 1276 1055  826  589  344   91
 230  479  719  720 1178 1602 1604 1605 2182 2361 1806 2690 2843 2844 2987 3125 3253 3375 3488 3489 3690 3861 3933 3860 3998 4053 4055 4059 4107 4060 4147 4109 4110 4064 4111 4067 4153 4183 4115 4070 3886 3955 3887 3811 3631 3633 3531 3422 3180 3046 2758 3047 2262 2263 2081 1892 1696 1695 1491 1278 1057 1277  590  345   92
 229  478  718  953  952 1395 1177 1804 2183 2530 1998 2359 2689 2841 2842 3124 3252 3592 3689 3593 3779 3688 3778 3932 3859 4103 4106 4145 4105 4108 4146 4148 4149 4150 4151 4205 4118 4152 4018 4017 3957 3809 3810 3634 3728 3635 3305 3181 3048 3049 2907 2757 2601 2436 2264 2080 2267 1893 1492 1279 1056 1490  591  346   93
 228  477  951 1175 1393 1394 1995 1601 1997 2358 2527 2526 2687 2688 3123 3373 3486 3374 3487 3589 3591 3858 3857 3930 4054 3997 4102 4175 4176 4177 4178 4179 4180 4181 4182 4112 4157 4071 4072 4019 3956 3888 3812 3726 3534 3423 3533 3306 3050 3182 2908 2759 2437 2084 2438 2082 1894 1697 1494 1281  830  828  592  347   94
 227  476  717  950 1176 1391 1801 1802 1996 2356 2528 2357 2686 2984 2986 2985 3251 3122 3485 3484 3590 3855 3929 3931 3996 4052 4142 4143 4141 4200 4216 4217 4220 4202 4204 4156 4119 4117 4074 4073 3958 3889 3814 3727 3428 3183 3308 3309 3307 2909 2910 2760 2603 2602 2085 2440 2083 1698 1280 1059  827  831  349   96  348
 226  475  716  949 1174 1600 1803 1392 2181 2177 2180 2525 2685 2840 2983 3121 3250 3249 3372 3686 3776 3777 3685 3856 4050 4101 4051 4099 4174 4201 4199 4224 4219 4203 4184 4154 4155 4116 3959 4020 3891 3890 3813 3729 3426 3731 3424 3535 3184 3051 2761 2911 2265 2266 1896 2086 1895 1493 1897 1495 1060  832 1283   95   97
 225  474  715  948 1173 1390 1599 1800 2179 1994 2355 2524 2838 2839 2982 3120 3370 3371 3483 3588 3687 3774 3775 3928 3995 3992 4049 4100 4173 4198 4215 4223 4218 4186 4206 4185 4158 4120 4021 3960 4022 3961 3815 3425 3637 3537 3536 3186 3427 3185 3052 2605 2604 2606 1899 2268 1700 1699 1062 1058  829 1282  351  594  350
 224  473  714  947 1172 1389 1598 1799 1993 2354 2178 2522 2523 2684 2837 3119 3248 3369 3482 3587 3684 3773 3854 3991 3994 3993 4098 4140 4172 4197 4214 4222 4210 4221 4209 4187 4121 4076 4075 4023 3892 3963 3893 3638 3636 3730 3311 2765 3310 2912 2762 2607 2444 2441 1898 2087 1704 1701 1496 1284 1063  833 1061  593   98
 223  472  713  946 1171 1388 1597 1798 1992 2176 2353 2521 2683 2836 2981 3118 3247 3368 3481 3586 3683 3772 3853 3927 3926 4047 4097 4139 4138 4171 4213 4212 4211 4208 4207 4159 4160 4122 4077 4024 3962 3817 3896 3816 3639 3538 3430 3429 3187 3053 2914 2764 2270 2439 2443 1702 2088 1900 1497  834  597  595  596  352   99
 222  471  712  945 1170 1387 1596 1797 1991 1990 2352 2520 2682 2835 2980 3117 3246 3367 3480 3585 3682 3771 3852 3925 4048 3990 4096 4137 4168 4196 4167 4193 4191 4188 4163 4190 4189 4123 4078 4025 3894 3964 3818 3732 3640 3539 3188 3312 3313 2913 2915 3054 2608 2442 2269 2272 1901 2089 1285 1498 1064  599  835  353  100
 221  470  711  944 1169 1386 1595 1796 1989 2175 2174 2351 2681 2834 2979 3116 3245 3366 3479 3584 3681 3770 3851 3924 3989 4046 4095 4136 4194 4195 4166 4131 4192 4165 4128 4162 4161 4124 4026 3965 3895 3966 3819 3733 3642 3641 3540 3431 3055 3056 3189 2766 2609 2917 2271 2763 2090 1705 1703 1065 1066  598  600  101  102
 220  469  710  943 1168 1385 1594 1795 1988 2173 2350 2519 2680 2833 2978 3115 3244 3365 3478 3583 3680 3769 3850 3923 3988 4045 4094 4135 4170 4169 4134 4088 4130 4164 4086 4127 4126 4125 4079 4080 4027 3897 3820 3734 3643 3541 3432 3314 3190 3315 3058 2916 3057 2767 2445 2091 1902 1500 1499 1286 1067  836  601  355  354
 219  468  709  942 1167 1384 1593 1794 1987 2172 2349 2518 2679 2832 2977 3114 3243 3364 3477 3582 3679 3768 3849 3922 3987 4044 4042 4092 4091 4090 4133 4038 4035 3978 4129 4084 4083 4082 4081 4028 3967 3898 3821 3735 3736 3542 3433 3316 3191 2918 3059 2769 2610 2611 2273 2092 1903 1706 1501 1288  837  838  602  356  103
 218  467  708  941 1166 1383 1592 1793 1986 2171 2348 2517 2678 2831 2976 3113 3363 3362 3476 3581 3678 3767 3848 3921 3986 4043 3983 4093 4040 4039 4132 3911 4087 4037 4085 4033 4032 4031 4030 4029 3968 3899 3822 3737 3644 3543 3434 3318 3317 3192 2919 2612 2446 2447 2274 2093 1904 1707 1502 1289 1287 1068  839  357  104
 217  466  707  940 1165 1382 1591 1792 1985 2170 2347 2516 2677 2830 2975 3112 3241 3242 3475 3580 3677 3766 3847 3920 3985 3984 3982 4041 3981 3980 4089 3979 3835 4036 4034 3974 3973 3972 3971 3970 3969 3900 3823 3738 3645 3545 3544 3319 3193 3060 2920 2768 2613 2448 2275 2094 1905 1708 1503 1290 1069  840  603  358  105
 216  465  706  939 1164 1381 1590 1791 1984 2169 2346 2515 2676 2828 2829 3111 3239 3240 3361 3474 3579 3676 3846 3919 3918 3917 3916 3915 3914 3913 3912 3977 3909 3976 3975 3907 3906 3905 3904 3903 3902 3901 3824 3739 3646 3546 3435 3436 3194 3062 3061 2770 2614 2449 2276 2095 1906 1709 1504 1291 1070  841  604  359  106
 215  464  705  938 1163 1380 1589 1790 1983 2168 2345 2514 2674 2675 2974 2973 3110 3360 3473 3578 3675 3765 3845 3844 3843 3842 3841 3840 3839 3838 3836 3910 3834 3833 3908 3832 3831 3830 3829 3828 3827 3826 3825 3740 3648 3647 3437 3320 3195 2921 2772 2771 2615 2450 2277 2096 1907 1710 1505 1292 1071  842  605  360  107
 214  463  704  937 1162 1379 1588 1789 1982 2167 2343 2344 2513 2827 2972 3109 3238 3359 3472 3577 3674 3764 3762 3761 3760 3759 3758 3757 3756 3755 3837 3753 3752 3751 3750 3749 3748 3747 3746 3745 3744 3743 3742 3741 3649 3547 3438 3321 3196 3063 2922 2773 2616 2451 2278 2097 1908 1711 1506 1293 1072  843  606  361  108
 213  462  703  936 1161 1378 1587 1788 1981 2166 2342 2512 2673 2826 2971 3237 3358 3357 3471 3576 3673 3763 3672 3670 3669 3668 3667 3666 3665 3664 3754 3662 3661 3660 3659 3658 3657 3656 3655 3654 3653 3652 3651 3650 3550 3548 3439 3322 3197 3064 2923 2774 2617 2452 2279 2098 1909 1712 1507 1294 1073  844  607  362  109
 212  461  702  935 1160 1377 1586 1787 1980 2165 2511 2510 2672 2825 2970 3108 3107 3235 3470 3575 3572 3465 3671 3571 3570 3569 3568 3567 3566 3565 3663 3564 3562 3561 3560 3559 3558 3557 3556 3555 3554 3553 3552 3551 3443 3549 3440 3323 3198 3065 2924 2775 2618 2453 2280 2099 1910 1713 1508 1295 1074  845  608  363  110
 211  460  701  934 1159 1376 1585 1786 1979 2341 2340 2671 2670 2824 2968 2969 3106 3236 3356 3468 3573 3574 3467 3349 3225 3464 3461 3460 3458 3457 3456 3563 3455 3454 3453 3452 3451 3450 3449 3448 3447 3446 3445 3444 3442 3327 3441 3324 3199 3066 2925 2776 2619 2454 2281 2100 1911 1714 1509 1296 1075  846  609  364  111
 210  459  700  933 1158 1375 1584 1785 1978 2164 2339 2509 2669 2823 2967 3105 3234 3355 3469 3353 3352 3466 3350 3348 3463 3223 3224 3346 3459 3343 3342 3341 3340 3339 3338 3337 3336 3335 3334 3332 2939 3208 3331 3330 3205 3328 3326 3325 3200 3067 2926 2777 2620 2455 2282 2101 1912 1715 1510 1297 1076  847  610  365  112
 209  458  699  932 1157 1374 1583 1784 1977 2163 2508 2338 2668 2822 2966 3104 3233 3231 3354 3230 3229 3351 3227 3095 3226 3462 3092 3345 3344 3087 3219 3218 3217 3216 3215 3214 3212 3211 3081 3333 3209 3207 3329 3075 3206 3204 3203 3202 3201 3068 2927 2778 2621 2456 2283 2102 1913 1716 1511 1298 1077  848  611  366  113
 208  457  698  931 1156 1373 1582 1783 1976 2162 2161 2667 2821 2820 2964 3102 3101 3232 3100 3099 3098 3228 2957 3096 3093 2954 3222 3091 3220 3090 3088 3089 3086 2947 3084 3083 3213 3082 3080 2940 3210 3079 3076 2936 3074 3073 3072 3071 3070 3069 2928 2779 2622 2457 2284 2103 1914 1717 1512 1299 1078  849  612  367  114
 207  456  697  930 1155 1372 1581 1782 1975 2160 2337 2506 2666 2818 2819 3103 2963 2962 2960 2814 2959 3097 2958 3094 2956 2955 3347 2807 3221 2950 2949 2948 2946 2945 2643 2797 2944 2942 2941 2639 2794 3077 3078 2937 2935 2934 2933 2932 2931 2930 2929 2780 2623 2458 2285 2104 1915 1718 1513 1300 1079  850  613  368  115
 206  455  696  929 1154 1371 1580 1781 1974 2158 2507 2336 2665 2505 2817 2815 2660 2497 2659 2961 2813 2811 2810 2809 2808 2806 2953 2952 2951 2803 2802 2801 3085 2800 2798 2478 2943 2796 2795 2793 2792 2938 2790 2789 2788 2787 2786 2785 2784 2783 2782 2781 2624 2459 2286 2105 1916 1719 1514 1301 1080  851  614  369  116
 205  454  695  928 1153 1370 1579 1780 1972 1973 2159 2504 2965 2664 2662 2663 2816 2326 2658 2656 2812 2492 2320 2491 2654 2652 2651 2805 2649 2648 2647 2646 2645 2799 2644 2480 2642 2640 2638 2636 2637 2791 2635 2634 2633 2632 2631 2630 2629 2628 2627 2626 2625 2460 2287 2106 1917 1720 1515 1302 1081  852  615  370  117
 204  453  694  927 1152 1369 1578 1778 1779 2334 2335 2503 2501 2330 2329 2661 2498 2496 2657 2495 2322 2655 2653 2318 2490 2489 2488 2316 2804 2650 2485 2484 2483 2482 2481 2309 2641 2477 2476 2475 2474 2473 2472 2471 2470 2469 2468 2467 2466 2465 2464 2463 2462 2461 2288 2107 1918 1721 1516 1303 1082  853  616  371  118
 203  452  693  926 1151 1367 1777 1576 1971 2157 2156 2154 2502 1964 2499 2500 2327 2325 2146 1958 2494 2145 2493 2319 2139 2317 2138 2315 2486 2487 2313 2312 2311 2310 2308 2479 2307 2306 2305 2304 2303 2302 2301 2300 2299 2298 2297 2296 2295 2294 2293 2292 2291 2290 2289 2108 1919 1722 1517 1304 1083  854  617  372  119
 202  451  692  925 1150 1366 1368 1776 1970 2155 2332 2333 2151 2331 2150 2149 2328 2147 1959 2143 2324 2323 2321 2142 2140 1952 1951 2136 2135 2314 2134 2133 2132 2131 2130 2129 2128 2127 2126 2125 2124 2123 2122 2121 2120 2119 2118 2117 2116 2115 2114 2113 2112 2111 2110 2109 1920 1723 1518 1305 1084  855  618  373  120
 201  450  691  924 1365 1148 1577 1969 1968 1967 1966 2152 2153 1770 1962 2148 1961 1960 1764 1560 1957 2144 2141 1955 1953 1757 1950 2137 1949 1948 1947 1946 1945 1944 1943 1942 1941 1940 1939 1938 1937 1936 1935 1934 1933 1932 1931 1930 1929 1928 1927 1926 1925 1924 1923 1922 1921 1724 1519 1306 1085  856  619  374  121
 200  449  689  690 1147 1575 1775 1573 1774 1773 1772 1567 1769 1965 1356 1963 1564 1766 1765 1763 1762 1956 1760 1954 1758 1756 1553 1754 1551 1753 1752 1751 1750 1749 1748 1747 1746 1745 1744 1743 1742 1741 1740 1739 1738 1737 1736 1735 1734 1733 1732 1731 1730 1729 1728 1727 1726 1725 1520 1307 1086  857  620  375  122
 199  448  923  922 1574 1363 1572 1362 1571 1359 1569 1771 1568 1565 1768 1563 1767 1562 1561 1349 1559 1761 1556 1759 1555 1554 1552 1755 1340 1550 1549 1548 1547 1546 1545 1544 1543 1542 1541 1540 1539 1538 1537 1536 1535 1534 1533 1532 1531 1530 1529 1528 1527 1526 1525 1524 1523 1522 1521 1308 1087  858  621  376  123
 198  447  688  920 1149  921 1146 1364 1570 1360 1139 1358 1137 1566 1355 1353 1352 1351 1350 1348 1347 1558 1557 1345 1344 1342 1122 1341 1121 1339 1338 1337 1336 1335 1334 1333 1332 1331 1330 1329 1328 1327 1326 1325 1324 1323 1322 1321 1320 1319 1318 1317 1316 1315 1314 1313 1312 1311 1310 1309 1088  859  622  377  124
 197  446  687 1145 1144 1143 1142 1361 1140  914  912 1357 1138 1135 1354 1134 1133 1132 1131 1130 1129 1128 1346 1126 1125 1343  897  896 1123 1120 1119 1118 1117 1116 1115 1114 1113 1112 1111 1110 1109 1108 1107 1106 1105 1104 1103 1102 1101 1100 1099 1098 1097 1096 1095 1094 1093 1092 1091 1090 1089  860  623  378  125
 196  445  686  919  918  917  680  915  679 1141  913  911  910 1136  907  906  905  904  669  903  902  901 1127  899  663  898 1124  895  894  893  892  891  890  889  888  887  886  885  884  883  882  881  880  879  878  877  876  875  874  873  872  871  870  869  868  867  866  865  864  863  862  861  624  379  126
 195  444  685  684  683  682  916  681  678  435  677  676  675  909  908  672  671  670  426  668  667  666  900  664  662  419  661  660  659  658  657  656  655  654  653  652  651  650  649  648  647  646  645  644  643  642  641  640  639  638  637  636  635  634  633  632  631  630  629  628  627  626  625  380  127
 194  443  442  441  440  439  186  437  436  434  433  432  431  674  673  429  177  428  425  175  424  171  665  172  420  168  418  417  416  415  414  413  412  411  410  409  408  407  406  405  404  403  402  401  400  399  398  397  396  395  394  393  392  391  390  389  388  387  386  385  384  383  382  381  128
 193  192  191  190  189  188  438  187  185  184  183  182  181  180  430  179  178  427  176  174  173  423  421  422  170  169  167  166  165  164  163  162  161  160  159  158  157  156  155  154  153  152  151  150  149  148  147  146  145  144  143  142  141  140  139  138  137  136  135  134  133  132  131  130  129
