# This puzzle is unsolvable
39
   2    1    3    4    5    6    7    9  159   10  162   11  165   15  164   16  311   17   19   20   21   22   23   25  175   26   27   29   30   32  323  184   33  186   37   39   38   40   41
 152  153  154  155  156  157  158    8  303  160  443  305   12  309   13  168  170  447  169  173  315  316  174   24  176  178  320   28  182   31  325  183  328  185   35   34   36  189  188
 151  296  297  298  299  300  301  437  302  304  568  161  569  307  167  310   18  446  171  314  450  578  172  318  453  177  321  322  458  459  324  327  588  329  333  463  187  192  190
 150  295  432  433  434  435  436  564  438  685  439  567  306  163  166  445  691  312  313  449  451    0  317  452  581  455  319  460  584  181  179  462  326  330  590  332  591  331   42
 149  294  431  560  561  681  562  565  684  441  686  570  442  308  444  804  573  448  574  576  577  579  699  700  454  701  456  457  919  705  587  180  708  461  592  191  467  334   43
 148  293  430  559  680  563  794  682  566  440  797  688  903  571  572   14  575  907  693  696  807  697  580  811  812  582  583  704  586  816  920  707  818  589  335  465  193  194   44
 147  292  429  558  679  793  896  683  795  796  899  687  799  689  690  800 1002  692  695  805  806  808  810  912  698  915  702  703  585  817 1014  709  464  472  819  710  466  196   45
 146  291  428  557  678  792  897  895  898  994  900  798  901  998 1167 1166  999  906  908  694  910  911 1007  809 1010  916  814  918  815 1015  921  706  712  593  715  468  336   46  195
 145  290  427  556  677  791  893  992 1080  996 1083 1161 1084 1165  802  801 1089 1001  803 1091 1005 1008 1006  913 1009 1012  813  917 1013  922  923  711  820  469  594  821  595  197   47
 144  289  426  555  894  991  789  990  995  993 1082 1085  902 1086  997  904 1004 1168 1170 1242  909 1094 1092  914 1096 1011 1097 1099 1098 1101 1103  925  714  716  596  597  713   48  339
 143  288  554  553  676  989  790  787 1079 1081 1232 1162 1297  905 1000 1088 1087 1003 1090 1240 1093 1305 1171 1174 1095 1310 1365 1176 1247 1249  924  600 1179  473  340  200   49  471   51
 142  287  425  674  788  675  785 1158 1159 1231 1160 1077 1234 1235 1354 1236 1237 1304 1239 1169 1407 1303 1244 1448 1175 1248 1246 1177 1100 1253 1102 1104  926  825  822  823  342  337  470
 286  423  424  552  673  891  892 1076 1074 1296 1352 1230 1295 1299 1163 1404 1355 1164 1302 1358 1357 1307 1173 1306 1245 1308 1181 1311 1017 1178 1182 1016 1019  599  824  474  199  598  477
 141  549  421  672  671  786  987  988 1078 1233 1156 1072 1349 1294 1300 1298 1238 1356 1359 1301 1172 1405 1409 1363 1309 1364 1366 1251 1106 1312 1021 1018  927  718  601  201  341   52  198
 139  284  140  422  670  784  890  889 1075  888 1157 1292 1399 1400 1351 1402 1403 1443 1360 1408 1241 1406 1411 1362 1412 1367 1250 1183 1313 1180  928 1020  717  476  343  478  338   50   55
 138  551  285  283  419  783  986  985 1227 1229 1154 1293 1350 1398 1401 1442 1445 1473 1475 1500 1243 1479 1451 1501 1410 1368 1314 1184 1108  826 1107  827  929  720  719  202  344  345   53
 137  420  280  550  545  668  669 1151  984 1155 1224 1073 1440 1439 1496 1353 1441 1472 1444 1446 1449 1502 1514 1450 1413 1369 1315 1254 1252 1023 1022 1105  931  721  602  346  475  479   54
 279  133  548  418  981  780  782  781  982 1152 1397 1291 1226 1344 1396 1497 1438 1498 1512 1478 1361 1477 1447 1415 1452 1316 1255 1186 1187 1109  930  828  831  829  603  205  204  206   56
 135  282  546  778  777  884  983 1070 1146  886 1228 1225 1289 1437 1471 1470 1474 1495 1515 1476 1499 1480 1481 1453 1414 1370 1256 1185 1257 1111 1024  932  830  722  604  203  348  480   57
 281  134  544  416  663 1071  887  779 1153 1393 1223 1150 1287 1286 1395 1436 1494 1513 1520 1516 1507 1503 1482 1416 1371 1372 1258 1317 1189 1110 1026 1025  933  723  347  605  207   58   59
 547  136  276  665  885 1068  977  979  882 1290 1067 1347 1288 1348 1346 1493 1511 1510 1519 1488 1504 1517 1483 1454 1417 1373 1318 1319 1188 1112 1028  934  833  606  832  607  481  349  208
 543  132  666  417  415  667  881  978  876 1147 1069 1392 1222 1345 1469 1394 1467 1492 1508 1487 1518 1485 1505 1455 1484 1418 1320 1259 1190 1114  935 1027  834  483  724  482  350  209   60
 131  128  541  414  411  883  662  277 1149 1064 1220 1342 1221 1343 1435 1468 1491 1509 1490 1489 1506 1486 1456 1457 1419 1375 1374 1260 1191 1029 1113  936  835  725  726  608  484  351   62
 413  278  275  410  542  878  980  880 1218 1063 1065 1285 1390 1434 1148 1465 1464 1463 1462 1461 1460 1459 1458 1420 1377 1376 1321 1261 1192 1115 1030  937  836  727  609  485  352   61   64
 130  271  272  775  664  771  772  774  975  976 1283 1060 1433 1466 1432 1431 1430 1385 1384 1426 1424 1423 1271 1422 1323 1324 1378 1262 1193 1116 1031  938  837  728  610  611   63  210  355
 539  273  660  412  129  776 1061 1062 1216  974 1066 1389 1340 1391 1336 1387 1427 1429 1428 1331 1383 1381 1380 1421 1327 1268 1322 1263 1194 1117 1032  939  838  729  612  486  353   65  211
 269  124  274  409  661  879  874  773  877 1145 1219 1217 1284 1341 1337 1335 1275 1334 1333 1425 1329 1270 1330 1201 1379 1326 1325 1264 1195 1118 1033  940  839  731  487  490  213  214  354
 659  127  408  538  535  973  875  657  537 1143 1138 1282 1144 1388 1338 1277 1386 1332 1274 1382 1202 1203 1204 1127 1199 1267 1200 1265 1196 1119 1034  941  840  613  730  614  212  489  215
 540  267  126  405  768  407 1059  968 1214 1142 1139 1339 1212 1279 1280 1210 1209 1276 1207 1272 1273 1048 1129 1130 1126 1125 1266 1198 1197 1120 1035  942  841  732  491  615  488   67   66
 123  268  658  533  766  536  972  969 1141 1140  967 1281 1213 1136 1278 1135 1133 1208 1050 1049 1206 1132 1128 1131 1269 1042 1124 1123 1122 1121 1036  943  842  733  616  357  217  216   68
 266  122  534  270  769  763  872 1058  970 1215  964 1056 1053 1055 1052 1211 1051  959 1134  955  956 1045 1044  954 1328  953 1040 1041 1039 1038 1037  944  734  617  492  356  358  218   69
 121  406  656  770  655  871  767  966  873  965 1054  865 1057  867  963  961  960  860  958 1047 1205  855 1046  747  952  949 1043  850  948  947  946  844  843  735  618  360   70  220  219
 120  402  125  404  532  529  971  762  868  866  869 1137  864  962  755  862  863  753  859  957  856  748  632  854  746  951  852  950  849  847  846  945  739  736  619  493  359  361   72
 264  265  403  401  648  765  530  395  870  761  646  759  641  643  640  861  754  637  752  858  857  749  508  509  853  631  743  742  741  626  848  738  622  620  495  494  362   71  221
 400  654  651  653  528  531  764  255  647  760  645  644  520  758  756  517  639  636  635  751  750  633  511  745  507  851  506  625  373  503  502  624  845  501  623  621  496  222   73
 119  399  398  262  526  527  394  650  649  523  522  521  757  248  516  642  515  638  514  382  634  512  379  744  374  236  504  628  235  232  372  370  740  498  368  497  363  223   74
 118  116  259  263  396  652  392  393  106  391  390  389  388  387  518  386  385  384  383  381  513  241  240  378   91  629  630  377  233  627   83  737  369  499   81  365  364  224   75
 261  117  113  397  111  257  256  107  108  525  252  253  250  519  101  247  246  245  244  243  242   95  510  380   89  239  375  505  234  371  231  500  230   82  227  366  226  225   76
 115  114  258  260  112  110  109  254  105  524  104  251  103  249  102  100   99   98   97   96   92   94  238   90   93  376   88  237   87   86   85   84  229  367  228   80   79   78   77
