# This puzzle is unsolvable
32
 126  124    2    4    6    7  128    9  133   11   14  359  250   12  137   17  138   19   21  142   22   23   24  148   25   26  150  152  263   30   31   32
 123    1    3  349  241    8    5   10  130  134   13  249  253  252   15  255   16  257  140  144  259  260  147  264  370  372   29  376   27   33  269  155
 240  125  242  127  350  243  129  451  131  247  356  248  358  136  254  139   18  363   20  364  145  258  368  261  149  371  151  270  373  471  154   35
 122  238  348  447  239  244  246  132  352  245  455  135  357  458  361  141  362  256  464  466  146  262  560  565  473  562  561  374  266  268  271  159
 120  121  347  237  449  450  544  452  354  353  456  355  251  457  459  360  460  554  462  143  557  366  367  468  265  470  563   28  472  158  153  156
 119  235  345  448  540  351  626  545  543  453  546  630  548  549  550  551  461  553  463  365  637  555  467  558  267  718  369  475  381  157   37   34
 346  344  446  445  538  537  542  701  703  454  547  628  629  632  633  634  552  635  713  711  638  556  559  640  643  469  477   42  645  375  161   38
 236  117  234  343  541  539  623  768  627  704  705  706  631  773  708  709  710  636  837  780  465  639  714  642  564  379   36  380  273  566  272   41
 118  115  444  443  700  827  625  697  702  828  770  771  707  775  776  777  836  930  712  781  892  785  716  784  648  721  474  377   43  160   40   39
 116  342  341  699  535  624  622  698  769  829  830  833  774  884  835  885  778  931  890  888  840  841  783  720  787  646  644  480  384  378  277  164
 114  232  233  620  695  621  619  766  826  765  881  772  832  882  834  928  779  887  839  889  782  838  724  722  641  476  717  163  279  165  162  275
 113  340  442  338  533  440  617  767  696  877  923  925  927  831  883  886  929  932  967  933  891  715  786  893  478  649  719  568  482  567  274  276
 230  231  339  532  536  824  441  762  922  880  823  924  926  962  963  964  965  966  968  969  934  845  846  843  844  278  842  647  281  569  383   44
 112  229  337  228  615  618  534  879  764  988  825  958  921  960  989  991  992  993  994  971  788  850  896  723  848  570  847  483  479  481  168  280
 111  110  336  438  439  614  694  616  959  876  878  961  987 1009 1006  990 1021 1012  970  935  895  936  789  791  651  650  790  382  571  387  284   45
 227  334  435  437  528  693  531  759  763  822  919  985 1003 1008 1010 1007 1016 1000  997  894  995  940  849  725  726  792  652  572   50  166   47  167
 226  225  108  530  691  761  690  821  692  760  874  984  956 1017  982  957  998 1023  937  939  897  898  793  728  729  576  573  484  653  385   46   48
 109  105  436  335  434  613  872  917  873  818  953  820  875  983  980 1002 1005  999 1013  938  972  794  901  902  654  727  657  574  171  388  169  283
 224  107  222  525  612  529  758  817  749  954  756  920  976 1020 1018 1011 1019  945  948  899  996  942  851  655  575  943  390  658  282  386  285   49
 223  331  433  333  609  819  871  611  526  955  918  986  951  979 1022  981 1001 1015 1014  973  900  857  659  798  799  853  656  485  174   52  172  486
 106  221  332  527  757  688  687  686  870  915  913  952  978 1004  909  910  977  907  941  974  944  852  855  797  795  487  579  577  289  173  287  389
 104  430  608  330  523  754  689  755  811  610  813  912  950  864  911  859  949  947  946  975  905  730  802  904  663  796  286  488  392   51  170   54
 102  520  431  522  432  607  685  814  678  868  914  866  916  865  861  863  743  805  860  906  739  858  591  800  903  581  491  660  288  177   55  176
 220  329  103  428  521  429  605  524  869  816  679  867  809  746  807  908  674  804  803  738  667  732  856  734  731  489  733  494  395  393  493  175
 219  328  326  218  606  751  752  604  753  748  812  810  511  676  675  862  671  806  670  742  801  666  582  736  664  584  735  661  398  580   56  178
  99  100  101  325  682  683  684  681  815  598  416  599  509  594  593  745  744  592  741  590  588  589  854  397  391  490  583  290  496  492  394   58
 327  215  217  426  519  518  602  601  750  512  747  600  597  673  596  595  808  506  672  740  669  502  662  665  497  585  578  187  294  180  495   53
  98  324  216  427  423  517  603  420  680  515  514  417  677  510  508  412  507  504  503  668  408  586  302  500  399  298  405  296  291  396  179   57
  97  214  323  425  321  320  516  421  419  513  418  313  414  312  413  198  411  505  409  501  737  407  406  498  404  400  401   66  293  183  181   59
  96  213  322  424  319  318  422  317  315   85  202   83  415  311  310  309  410  307  305  195  587  303   72  304  191  299  300  185  295   64   60   61
  95  212  211  210  209  208  207  206  316   86  314    0  201  200   79  197  306  308   76  194  193  190  192  189  499  186  292  297  184  182   65   62
  94   93   92   91   90   89   88   87  205  203  204   84   82   81  199   80   77  196   78   75   74   73   70  188  402  403   71   69   68  301   67   63
