# This puzzle is unsolvable
42
   2    1    3  167    4    5    6  171    8   10   11   12   13   14   15   16   17   19   21  184   22  341   23   24   26  189   27   28   29   30   31   32   33   34   36  199   37   38   39   40   41   42
 164  165  166  322  168  169    7  170    9  173  174  175  176  177  178  179  180   18  183   20  185  342  340  188   25  344  190  191  192  193  194  195  196  197  198   35  200  201  202  203  204   43
 320  319  468  323  326  611  473  172  327  328  329  477  330  479  332  334  335  181  337  182  485  338  186  489  343  491  345  346  347  348  349  350  351  499  352  354  355  356  357  358  205   44
 163  467  317  469  472  471  610  612  474  475  615  476  331  333  621  484  624  336  623  339  487  625  626  488  759  881  628  492  493  495  496  498  891  768  638  353  502  503  504  359  206   45
 161  160  162  321  608  324  470  325  743  613  614  478  748  619  481  620  482  483  755  876  627  758  187  760  763  629  632  887  494  634  635  497  637  500  770  501  640  642  505  360  207   46
 159  318  466  607  609  864  866  865  742  745  746  617  618  750  480  753  752  622  754  486 1200  882  757  995  490  762  761 1002  885  764  767  636  766  892  769  639  771  643  506  361  208   47
 158  315  316  606  739  738  741  981  744  868  616  869  871  749  988  751  991  877  992  993 1101  880  994  997  630  884  631 1000 1109  888  765 1007 1004  893  895  772  774  644  507  362  209   48
 464  462  314  463  604  740  861  980  867 1089  984  747 1093  986  989  874  875 1098 1198  878 1201  756 1103  883  996  999 1107  889  633 1114 1003 1006 1112  896 1009  897  641  645  508  363  210   49
 157  465  311  605  978  863  735 1088  983 1190 1091  985 1192  872 1096 1097 1099 1100  873  879 1291 1102 1202  998 1106 1205 1208  886 1383  890 1211 1111 1110 1008  894  773  775  646  509  364  211   50
 156  461  602  313  737  460 1279  979  982 1086 1092  870 1284  987 1095 1196 1369 1288  990 1290 1289 1204 1292 1294 1104 1299 1207 1298 1300 1381 1301 1113 1005 1115 1010  776  648  777  366  647  365  212
 155  734  459  603  736  732  862 1087 1090 1282 1365 1280 1193 1285 1366 1195 1286 1371 1197 1199 1449 1451 1376 1377 1108 1296 1206 1001 1382 1302 1209 1210 1212 1117 1116 1011  899  511  649   52   53   51
 154  312  601  860  976 1187  859 1186 1364 1189 1278 1438 1509 1287 1442 1194 1370 1447 1446 1374 1375 1378 1518 1454 1105 1456 1523 1524 1380 1386 1384 1303 1213 1118 1012  778  898  512  510  213  367  214
 153  310  458  733  977 1084 1188 1184 1363 1440 1441 1191 1367 1094 1444 1510 1445 1372 1514 1515 1450 1452 1203 1517 1295 1455 1579 1297 1581 1522 1457 1304 1215 1305 1013  900  779  650  513  368  215   54
 308  858  975  974  600  856  973 1085 1277 1185 1439 1362 1506 1283 1437 1368 1511 1571 1373 1575 1516 1628 1293 1379 1578 1521 1580 1585 1459 1387 1385 1214 1217 1216 1119 1014  780  651  514  369  216   55
 151  152  150  857  599  855 1082 1083 1081 1183 1361 1281 1508 1569 1443 1568 1621 1512 1572 1573 1625 1453 1519 1672 1630 1706 1527 1458 1583 1460 1388 1306 1120 1121 1016  901  781  652  515  370  217   56
 149  457  730  731  598  729  971 1182 1275 1276 1359 1507 1360 1567 1570 1620 1513 1624 1623 1704 1671 1703 1448 1577 1629 1528 1707 1582 1584 1525 1461 1307 1219 1218 1018  902  903  653  372  219  218   57
 306  455  309  456  597  854  972  970 1180 1181 1358 1436 1505 1566 1619 1664 1665 1667 1574 1668 1627 1576 1673 1734 1626 1632 1735 1462 1529 1464 1389 1308 1220 1122 1017 1015  782  783  517  220  373   58
 148  305  454  307  596  728 1079 1179 1080 1274 1273 1435 1504 1565 1618 1663 1666 1622 1749 1729 1731 1701 1520 1708 1674 1631    0 1526 1586 1392 1390 1125 1123  906 1019  905  904  518  371  516  221   59
 147  304  594  727  595  853  969 1078 1272 1177 1357 1434 1503 1564 1617 1662 1698 1700 1726 1702 1732 1669 1736 1670 1733 1635 1636 1633 1675 1463 1465 1309 1221 1223 1020  654  785  656  655  521  222   60
 303  452  453  726  852  725  968 1176 1178 1271 1356 1433 1502 1563 1616 1661 1728 1730 1745 1761 1751 1762 1676 1705 1677 1634 1637 1589 1530 1588 1310 1391 1312 1124  658  784  788  659  519  374  520   62
 146  302  450  850  593  849  851 1077 1075 1355 1500 1431 1501 1561 1562 1615 1697 1699 1723 1760 1753 1737 1752 1709 1711 1710 1678 1531 1467 1587 1222 1311 1126 1127  908  660  909  662  786   61  376   63
 145  300  451  723  967 1269 1076 1073 1266 1353 1270 1432 1499 1614 1612 1658 1660 1748 1727 1725 1750 1757 1754 1679 1712 1713 1640 1532 1466 1394 1393 1395 1225 1224  907  525 1021  523  657  223  375  224
 144  301  590  592  966  724  964  965 1172 1354 1174 1430 1560 1498 1613 1659 1724 1696 1742 1746 1759 1758 1741 1755 1714 1680 1590 1639 1638 1468 1470 1313 1314 1025  910 1023  792 1022  790  225  379   65
 299  143  591  589  721  722  847 1074 1072 1268 1428 1175 1497 1267 1558 1657 1694 1744 1747 1695 1743 1720 1756 1739 1738 1681 1591 1592 1534 1533 1469 1315 1129 1128 1024  664  522  787  377  526  661  226
 142  449  298  588  719  848  720  846  962 1265 1352 1429 1496 1559 1611 1692 1693 1652 1651 1722 1719 1763 1740 1717 1716 1682 1641 1535 1397 1471 1396 1227 1226 1132  911  912  913  663  789  378   64   66
 137  448  447  140  587  586 1070 1071 1173 1351 1427 1495 1556 1557 1656 1655 1605 1691 1689 1688 1687 1718 1646 1686 1715 1683 1642 1593 1538 1536 1398 1316 1130 1131 1026  793  527  381  228  229  380  524
 443  141  139  583  295  845  963  960 1264 1349 1348 1350 1555 1608 1610 1607 1654 1690 1721 1650 1648 1647 1685 1645 1684 1643 1596 1594 1473 1472 1537 1317 1230 1228 1133  791 1027  382  383   68  227  230
 136  297  445  446  585  843  961 1068 1171 1347 1426 1425 1493 1494 1609 1552 1653 1606 1604 1603 1649 1601 1600 1597 1542 1644 1595 1539 1400 1474 1399 1318 1232 1229 1029  914  916  794  528  384   67   70
 296  582  293  584  959  844 1069  957  842 1263 1346 1424 1345 1554 1553 1551 1550 1549 1548 1484 1602 1414 1546 1599 1481 1543 1598 1406 1476 1540 1401 1319 1028 1231  917 1030  915  529  665  231   69   71
 294  138  292  441  718  955 1067  715 1169 1065 1168 1260 1492 1490 1489 1487 1416 1417 1486 1413 1547 1483 1545 1482 1544 1479 1541 1405 1403 1477 1475 1321 1320 1134 1135  919  667  668  666  234  385  233
 442  291  717  444  716  958 1170 1064  956 1262 1257 1423 1421 1491 1420 1488 1339 1419 1336 1415 1485 1412 1410 1409 1480 1408 1478 1328 1239 1325 1402 1322 1233 1031  918  795  797  796  530  532   72  232
 134  440  579  841  581 1066  840  948 1261 1344 1259 1161 1342 1254 1340 1418 1156 1250 1337 1335 1334 1332 1411 1331 1330 1329 1404 1407 1327 1326 1324 1323 1234 1136 1137  798  799  669  386   73   75   74
 135  290  131  714  289  713  835  954 1061 1166 1343 1256 1341 1422 1253 1053 1251 1252 1248 1155 1247 1333 1151 1244 1242 1147 1042 1241 1144 1238 1236 1141 1235 1138 1032  920  921  670  387  388  531  237
 439  577  580  838  837  834  836  712  711 1167 1162 1160 1255 1159 1157 1249  940 1154 1338 1052 1153 1152 1246 1245 1150 1243 1044 1041 1240 1237 1143 1142 1140 1139 1033  800  671  534  533  389  235   76
 133  435  578  437  951  436 1165 1063 1258  949  947 1059 1058 1056  944 1054  942 1051  822 1050  816  937 1047 1149 1046 1146 1148 1043 1145 1040 1039 1038 1037 1035 1034  922  801  672  536  535  390  236
 132  288  432  431  839  831 1062  706  950  571 1164  568  945  698 1158  946 1055  941  819  939  818  817 1048  935  936 1045  932  931  930  929  928  808  926 1036  924  802  674  673  537  391  238   77
 576  287  285  119  953  286  833  952 1163 1060  702  827 1057  699  824  943  694  821  823  693 1049  692  938  815  934  933  813  812  811  810  809  681  927  925  806  923  677  676  392  239  240   78
 130  128  280  708  438  575  832  707  830  829  828  567  825  701  420  826  563  559  695  558  555  691  688  687  552  814  686  685  684  683  682  680  807  679  805  542  543  803  675  393  241   79
 127  709  430  434  281  710  429  703  276  424  570  426  425  700  561  697  696  267  560  415  820  556  690  689  554  409  551  550  549  548  547  546  545  544  678  804  398  540  538  539  394   80
 129  284  572  574  123  428  573  569  272  274  564  704  270  565  269  266  109  562  416  264  414  413  412  411  553  410  408  407  406  405  404  403  402  401  541  400  247  397  246  395  242   81
 126  282  278  283  124  277  279  118  116  275  112  566  421  110  111  422  419  417  265  263  103  557  261  260  259  258  257  256  255  254  253  252  251  250  249  399  248  245  396  244  243   82
 125  433  120  122  121  705  117  115  427  114  273  423  113  271  418  108  107  268  106  105  262  104  102  101  100   99   98   97   96   95   94   93   92   91   90   89   88   87   86   85   84   83
