# This puzzle is unsolvable
44
   2    1    3    5  176    6    7  180    8  182  344  186   12  185   16  350   15   18   19   20  192   21   22   23  196   24   25   28   29   30   31   32   33   34   35   36   37   38   39   40   41   42   43   44
 172  173  174    4  339  177  340  496  181    9  497   11  184   14   13  188   17  189  354  190  191  193  195  359   26  198   27  199  201  364  202  203  204  205  206  207  208  209  210  211  212  213  214   45
 171  336  338  494  341  495  641  643  342  346  501  183  645  503  187  505  347  654  352  509  355  356  194  358  360  197  361  200  363  519  365  366  367  368  369  370  371  372  373  374  375  376  215   46
 492  170  337  175  493  178  179  644  499  500  502   10  650  348  653  504  351  507  353  508  511  658  357  512  514  515  516  362  517  518  520  521  522  523  524  525  526  527  528  529  530  377  216   47
 335  168  333  334  490  642  498  784  343  345  349 1040  789  787  652  791  506  793  926  510  657  659  660  513  661  662  663  664  665  666  667  668  669  670  671  672  673  674  675  676  531  378  217   48
 169  166  491  639  640  779  781  783  786  648  647  649  651  919  790  792 1046  655  656  796 1050  797  795  799  800  801  802  803  804  805  806  807  808  809  810  811  812  813  814  677  532  379  218   49
 167  332  489  780  911  912 1037  782  785  917 1039 1041 1042  788  922 1045  923  794  925  927  928  929  798  930  931  932  933  934  935  936  937  938  939  940 1064  941  943  944  815  678  533  380  219   50
 165  331  637  636  638  778  914  913 1151  915  916  918 1264  920 1158 1047 1366 1162 1048 1049 1165 1052 1167 1053 1054 1055 1056 1057 1058 1059 1060 1061 1063 1285 1179  942 1066  945  816  679  534  381  220   51
 164  329  910  633 1033 1035 1036 1152 1153  646 1154 1155  921 1156 1043 1044 1160 1163  924 1164 1272 1166 1051 1168 1169 1170 1171 1172 1173 1174 1175 1176 1062 1178 1286 1065 1180  946  817  680  535  382  221   52
 328  634  163  488  777  635  908 1038 1257 1261 1453 1262 1362 1265 1159 1267 1269 1161 1270 1271 1273 1372 1274 1275 1276 1277 1278 1279 1280 1281 1282 1283 1177 1384 1287 1182 1181  948  818  681  536  383  222   53
 774  330  775  487  486  909 1030 1150 1260 1258 1452 1361 1535 1363 1266 1364 1457 1268 1368 1370 1371 1463 1373 1374 1375 1376 1377 1378 1379 1380 1381 1382 1284 1288 1183  947 1068 1067  819  682  537  384  223   54
 632  326  482 1034  776 1149 1031 1259 1359 1263 1360 1454 1157 1540 1539 1365 1367 1369 1543 1460 1618 1462 1464 1465 1466 1467 1468 1469 1470 1471 1472 1473 1383 1290 1386 1069  950 1070  820  683  538  385  224   55
 485  483  630  484 1032 1356  907 1450 1255 1148 1358 1538 1455 1612 1456 1615 1458 1542 1461 1544 1545 1546 1547 1548 1549 1550 1551 1552 1553 1554 1555 1556 1474 1385 1291 1072 1184  949  821  684  539  386  225   56
 162  628  770  327  906 1536 1357 1354 1146 1029 1355 1256 1680 1617 1614 1740 1684 1616 1683 1459 1620 1621 1622 1623 1624 1625 1626 1627 1628 1629 1630 1557 1186 1475 1289 1185 1071  951  822  685  540  387  226   57
 159  161  160  158  631  773  904 1147  902 1613 1451 1537 1534 1681 1611 1541 1682 1743 1686 1619 1687 1688 1689 1690 1691 1692 1693 1753 1694 1696 1558 1559 1387 1389 1388 1187 1073  952  823  686  541  388  227   58
 157  325  481  480 1145  772  905 1253 1143 1252 1449 1448 1532 1610 1679 1741 1742 1744 1685 1745 1746 1797 1747 1749 1750 1751 1752 1804 1695 1697 1631 1560 1477 1476 1292 1188 1074  953  824  687  542  389  228   59
 319  629  324  478  322  901  771 1028 1144 1447 1446 1533 1609 1678 1739 1792 1793 1794 1795 1796 1798 1799 1748 1800 1801 1802 1803 1754 1756 1755 1633 1479 1478 1390 1293 1189 1075  954  825  688  543  390  229   60
 479  769  156  903 1027  768 1025 1254 1251 1350 1353 1531 1677 1738 1737 1791 1836 1837 1838 1839 1840 1841 1842 1843 1844 1845 1846 1805 1757 1698 1632 1634 1562 1391 1190 1295 1076  955  826  689  544  391  230   61
 321  323  155  627 1141  476 1020 1026 1142 1024 1530 1352 1608 1675 1676 1790 1835 1872 1873 1874 1875 1876 1877 1878 1879 1880 1847 1806 1758 1699 1635 1480 1482 1481 1392 1294 1077  956  827  690  545  392  231   62
 153  318  475 1023  764  477  898 1137 1349 1606 1444 1529 1604 1607 1736 1789 1834 1871 1900 1901 1902 1903 1904 1906 1881 1848 1807 1808 1702 1700 1636 1561 1563 1393 1296 1191 1078  957  828  691  546  393  232   63
 625  154  897  765  767  900  766 1249  899 1351 1443 1445 1674 1735 1734 1788 1833 1870 1899 1921 1919 1922 1923 1905 1924 1907 1849 1884 1759 1701 1637 1564 1483 1394 1297 1192 1079  958  829  692  547  394  233   64
 150  472  762  315  316 1021  763 1140 1442 1348 1526 1528 1603 1673 1605 1786 1787 1869 1898 1920 1932 1933 1934 1925 1883 1882 1851 1809 1760 1703 1638 1565 1484 1395 1298 1193 1080  959  830  693  548  395  234   65
 151  317  895  320  626  623 1139 1248 1250 1247 1527 1522 1602 1671 1732 1733 1832 1831 1868 1897 1918 1935 1926 1909 1908 1850 1852 1810 1761 1704 1639 1566 1485 1396 1299 1194 1081  960  831  694  549  396  235   66
 624  621  896  152  618  893 1138 1022 1136 1347 1441 1601 1672 1730 1670 1785 1830 1867 1896 1917 1915 1930 1931 1927 1910 1885 1853 1763 1811 1705 1640 1567 1486 1397 1300 1195 1082  961  832  695  550  397  236   67
 473  148  149  761  892  622  894 1135 1346 1246 1345 1525 1435 1729 1668 1784 1866 1895 1916 1891 1862 1913 1928 1912 1911 1886 1812 1813 1762 1706 1641 1568 1487 1398 1301 1196 1083  962  833  696  551  398  237   68
 474  758  146 1017  314  760  470 1244 1018 1440 1436 1245 1524 1731 1783 1829 1865 1894 1863 1893 1929 1775 1914 1889 1857 1887 1856 1854 1764 1707 1642 1569 1488 1399 1302 1197 1084  963  834  697  552  399  238   69
 469  616  310  617  619 1134 1019 1242 1343 1344 1341 1438 1667 1598 1782 1827 1828 1826 1864 1823 1821 1860 1859 1888 1858 1816 1855 1814 1765 1708 1643 1570 1489 1400 1303 1198 1085  964  835  698  553  400  239   70
 311  312  471  147  759  620  468  467 1241 1523 1599 1519 1600 1666 1439 1781 1779 1777 1722 1825 1892 1861 1820 1819 1818 1817 1815 1768 1766 1709 1644 1571 1490 1401 1304 1199 1086  965  836  699  554  401  240   71
 753  145  313  756 1015  890  891 1016 1133 1437 1669 1521 1597 1728 1518 1727 1780 1723 1660 1718 1776 1824 1773 1774 1771 1715 1769 1770 1713 1710 1645 1572 1491 1402 1305 1200 1087  966  837  700  555  402  241   72
 144  466  465  889  615 1013 1132 1243 1130 1429 1239 1340 1664 1517 1725 1663 1724 1661 1778 1721 1772 1658 1655 1717 1654 1653 1651 1714 1767 1711 1646 1573 1492 1403 1306 1201 1088  967  838  701  556  403  242   73
 141  143  888  757  754  464 1131 1240 1011 1520 1516 1514 1334 1726 1595 1665 1590 1587 1589 1509 1890 1657 1652 1716 1582 1581 1650 1579 1712 1648 1647 1574 1493 1404 1307 1202 1089  968  839  702  557  404  243   74
 306  309  307  463  755 1014 1129  886 1434 1342 1433 1336 1515 1593 1596 1662 1659 1510 1507 1588 1586 1719 1822 1656 1503 1502 1580 1578 1649 1577 1576 1575 1494 1405 1308 1203 1090  969  840  703  558  405  244   75
 140  613  462  614 1010 1012 1127 1339 1238 1237 1235 1338 1430 1228 1427 1592 1591 1328 1508 1720 1506 1585 1583 1584 1504 1415 1501 1500 1499 1498 1497 1496 1495 1406 1309 1204 1091  970  841  704  559  406  245   76
 611  308  300  305  460  612  885 1125 1121 1432 1428 1126 1594 1431 1513 1423 1227 1512 1329 1511 1505 1419 1418 1321 1416 1414 1413 1318 1412 1411 1410 1409 1408 1407 1310 1205 1092  971  842  705  560  407  246   77
 610  461  138  609  749  887 1008 1128 1122 1337 1236 1232 1333    0 1425 1330 1424 1225 1421 1422 1220 1420 1323 1417 1322 1218 1319 1215 1317 1316 1315 1314 1313 1312 1311 1206 1093  972  843  706  561  408  247   78
 304  750  142  303  751  882 1123  877 1001 1234  874 1231  871 1335  996 1116 1226  995 1223 1326 1325 1221 1109 1219 1217 1320 1105 1216 1214 1213 1212 1211 1210 1209 1208 1207 1094  973  844  707  562  409  248   79
 301  139  457  752  884 1009 1004  879 1002 1119  742  873 1120 1331  998  591  997 1327 1114 1112  992 1324 1111  863  990 1106  986 1104 1103 1102 1101 1100 1099 1098 1097 1096 1095  974  845  708  563  410  249   80
 458  136  608  135  880 1124  883  876  748 1003 1229 1332 1230  735 1118 1426 1224  866  994  989 1113  862 1222  861 1108  859  987  985  984  983  982  981  980  979  978  977  976  975  846  709  564  411  250   81
 133  302  605  459  603 1006  881 1007  745 1233  598  872 1117  870  590  875 1115  112  437 1110  732  991  725  726  988  432  860  858  857  856  855  854  853  852  851  850  849  848  847  710  565  412  251   82
 455  134  137  456  604  747  744  447  878  741  596  740  739  593  594  736  999  734  867  276  586  731  730  584 1107  582  724  723  722  721  720  719  718  717  716  715  714  713  712  711  566  413  252   83
 298  297  607  299  602  451  746 1005  448 1000  119  597  281  445  441  869  442  868  733  438  588  865  585  864  583  271  581  580  579  578  577  576  575  574  573  572  571  570  569  568  567  414  253   84
 132  130  127  606  601  452  600  599  446  283  290  288  286  592  117  589  738  114  439  729  116  728  436  433  727  431  272  429  428  427  426  425  424  423  422  421  420  419  418  417  416  415  254   85
 129  296  454  453  126  124  449  291  289  743  737  118  122  285  284  115  443  280  993  587  435  275  434  274  273  430  104  270  269  268  267  266  265  264  263  262  261  260  259  258  257  256  255   86
 295  131  294  128  293  292  450  125  121  123  120  595  287  440  444  111  282  113  279  110  277  278  109  108  107  106  105  103  102  101  100   99   98   97   96   95   94   93   92   91   90   89   88   87
