# This puzzle is unsolvable
9
29 12 58 13  7  3 32 75 11
48 44 14 71 39 16 42 59 28
72 52 23  4 33 18 61 43 56
24 78 40 34 70  1 27  6 45
26 30 66 35  2 57 62 36 15
31 73 19 63 49  5 37 10 22
60 79  9 67 74 21 46  8  0
69 65 76 54 17 68 41 38 64
50 55 80 47 77 53 51 20 25
