# This puzzle is unsolvable
60
   2    1    3    4    5    6    7    8    9   10   11   12   13   14   15   16   17   18   19  256  255   23  259   24  258   26   25   27  490   29  265   30   33  270   34   35   36   38   39   40   41   43  278   44   45   46   47   48   49   50   51   52   53   54   55   56   57   58   59   60
 236  237  238  239  240  241  242  243  244  245  246  247  248  249  250  251  252  253  254   20  483   22   21  705    0  260  262  263   28  492   31   32  267  269  497  271   37  272  274  275  276  277   42  279  280  281  282  283  284  285  286  287  288  289  290  291  292  293  294   61
 235  464  465  466  467  468  469  470  471  472  473  474  475  476  477  478  479  480  481  482  257  484  485  486  488  708  261  709  264  491  266  712  268  495  715  498  499  273  501  722  502  504  505  506  507  508  509  510  511  512  513  514  515  516  517  518  519  520  295   62
 234  463  684  685  686  687  688  689  690  691  692  693  694  695  696  697  698  699  700  701  702  703  704  916  487  706  919  489  710  711  494  493  714  496  928  717  720  500 1135  503  933  723  724  725  726  727  728  729  730  731  732  733  734  735  737  948  738  521  296   63
 233  462  683  896  897  898  899  900  901  902  903  904  905  906  907  908  909  910  911  912 1117  914 1312  917 1120  707 1123  920  921  922  923  713  925 1130  716  927  719  718  930  932  934 1137  935  936  937  938  939  940  941  942  943 1147  944  946 1150  736  739  522  297   64
 232  461  682  895 1100 1101 1102 1103 1104 1105 1106 1107 1108 1109 1110 1111 1112 1113 1309 1114 1115 1313 1116 1314 1119  918 1316 1122 1124 1319 1127 1324  924 1129  926 1131  721 1133 1134 1330  931 1136 1138 1139 1140 1141 1142 1143 1144 1145 1146  945 1530 1148  950 1151  947  740  298   65
 231  460  681  894 1099 1296 1297 1298 1299 1300 1301 1302 1303 1304 1305 1306 1307 1308 1498  913 1311 1118  915 1502 1503 1315 1506 1317 1318 1685 1125 1509 1128 1325 1514 1694 1132 1328 1517 1696 1331 1332 1333 1334 1335 1336 1337 1338 1340 1341 1342 1343 1149 1344 1152  949  741  523  299   66
 230  459  680  893 1098 1295 1484 1485 1486 1487 1488 1489 1490 1491 1492 1493 1494 1495 1496 1310 1677 1497 1500 1501 1504 1682 1121 1684 1507 1321 1126 1688 1320 1323 1511 1512  929 1327 1693 1329 1518 1519 1520 1521 1522 1523 1524 1525 1339 1527 1528 1531 1346 1347 1345  524  743  742  300   67
 229  458  679  892 1097 1294 1483 1664 1665 1666 1667 1668 1669 1670 1671 1672 1673 1674 1847 1846 1676 1499 1850 1680 1853 2015 1505 2171 1857 1687 1858 1508 1689 1861 1326 1513 1691 1516 1864 1695 1867 1698 1699 1700 1701 1702 1703 1704 1526 1705 1707 1709 1529 1708 1153  951  952  525  526  301
 228  457  678  891 1096 1293 1482 1663 1836 1837 1838 1839 1840 1841 1842 1843 1844 1845 2009 1675 1848 1678 1851 2014 1849 1679 1683 2019 1855 2021 2024 1686 1322 1862 1860 1690 1865 1515 1866 1868 1697 1869 1870 1871 1872 1873 1874 2038 1875 1876 1534 1878 1532 1348 1154  953  744  527  302   68
 227  456  677  890 1095 1292 1481 1662 1835 2000 2001 2002 2003 2004 2005 2006 2007 2008 2011 2010 2167 2166 1854 2170 1681 1852 2174 2173 2590 2321 1859 1856 1510 2327 1692 2027 1863 2028 2029 2030 2031 2032 2033 2034 2035 2036 2037 2193 2039 1706 1877 1879 1710 1533 1155  954  745  528  303   69
 226  455  676  889 1094 1291 1480 1661 1834 1999 2156 2157 2158 2159 2160 2161 2162 2163 2164 2165 2314 2012 2013 2168 2169 2317 2017 2016 2018 2176 2023 2020 2326 2022 2328 2025 2026 2183 2184 2185 2186 2187 2188 2189 2337 2190 2191 2192 2194 2041 1535 1880 1711 1349 1156  955  746  529  304   70
 225  454  675  888 1093 1290 1479 1660 1833 1998 2155 2304 2305 2306 2307 2308 2309 2310 2450 2311 2312 2453 2315 2316 2456 2318 2715 2462 2319 2718 2325 2181 2593 2466 2180 2720 2182 2330 2331 2332 2333 2334 2335 2336 2476 2338 2339 2340 2040 2195 2042 1881 1712 1350 1157  956  747  530  305   71
 224  453  674  887 1092 1289 1478 1659 1832 1997 2154 2303 2444 2445 2446 2447 2448 2449 2581 2313 2582 2452 2454 2587 2455 2457 2172 2175 2320 2458 2463 2177 2464 2598 2595 2469 2179 2597 2470 2471 2472 2473 2474 2606 2475 2477 2478 2341 2196 2043 1882 1713 1536 1351 1158  957  748  306   73   72
 223  452  673  886 1091 1288 1477 1658 1831 1996 2153 2302 2443 2576 2577 2578 2579 2580 2704 2707 2451 2584 2585 2586 2710 2588 2713 2589 2714 2460 2322 2178 2465 2596 2721 2836 2600 2329 2601 2602 2603 2604 2605 2607 2730 2608 2479 2342 2197 2044 1883 1714 1537 1352 1159  958  749  531  532  307
 222  451  672  885 1090 1287 1476 1657 1830 1995 2152 2301 2442 2575 2700 2701 2702 2703 2705 2583 2821 2708 2709 2824 2712 2591 3125 2461 2717 2323 2830 2459 2833 2941 2835 2599 2468 2723 2724 2725 2726 2842 2727 2728 2729 2609 2480 2343 2198 2045 1884 1715 1538 1353 1160  959  750  533   75   74
 221  450  671  884 1089 1286 1475 1656 1829 1994 2151 2300 2441 2574 2699 2816 2817 2818 2819 2706 3118 2822 2823 2825 2932 2826 2711 3209 2828 2936 2831 2592 2716 2938 3042 2943 2837 2838 2839 2840 2841 2949 2843 2844 2731 2610 2481 2344 2199 2046 1885 1716 1539 1354 1161  960  751  309  308   76
 220  449  670  883 1088 1285 1474 1655 1828 1993 2150 2299 2440 2573 2698 2815 2924 2925 2926 2820 2929 2928 3030 3029 2933 2827 2934 3036 3211 3127 3037 2719 2594 2722 2940 2467 3132 3044 3045 3046 2946 2947 2845 2846 2732 2611 2482 2345 2200 2047 1886 1717 1540 1355 1162  752  535  534   77   78
 219  448  669  882 1087 1284 1473 1654 1827 1992 2149 2298 2439 2572 2697 2814 2923 3024 3025 3026 3201 2930 2927 2931 3031 3124 3032 2829 3284 2939 2937 3038 3130 2834 3041 3133 2945 2944 3218 2948 3049 2950 2951 2847 2733 2612 2483 2346 2201 2048 1887 1718 1541 1356 1163  961  753  536  310   79
 218  447  668  881 1086 1283 1472 1653 1826 1991 2148 2296 2297 2571 2696 2813 2922 3023 3022 3117 3200 3028 3120 3027 3122 3280 3208 3126 3349 3283 3128 2832 3215 3129 3214 3043 3134 3136 3137 3047 3138 3048 2953 2952 2734 2613 2484 2347 2202 2049 1888 1719 1542 1357 1164  962  963  537  311  313
 217  446  667  880 1085 1282 1471 1652 1825 1990 2146 2147 2438 2570 2695 2812 2921 3021 3199 3116 3202 3277 3203 3119 3033 3281 3035 3034 2935 3352 2324 3212 3039 3353 2942 3358 3217 3292 3135 3219 3051 3220 2954 2848 2735 2614 2485 2348 2203 2050 1890 1889 1543 1358 1165  964  754   83  538  312
 216  445  666  879 1084 1281 1470 1651 1824 1989 2145 2295 2435 2437 2694 2811 2920 3020 3115 3114 3276 3404 3279 3121 3406 3206 3459 3123 3282 3354 3210 3412 3288 3290 3291 3131 3216 3293 3294 3140 3221 3050 2955 2849 2736 2615 2486 2349 2204 2051 1891 1720 1544 1359 1166  965  755  539   81   82
 215  444  665  878 1083 1280 1469 1823 1822 1649 2294 2292 2293 2436 2693 2810 2919 3019 3113 3198 3274 3275 3278 3347 3342 3204 3409 3207 3408 3505 3351 3289 3356 3040 3357 3416 3359 3361 3295 3360 3222 3052 2850 2851 2737 2616 2487 2350 2205 2052 1721 1722 1545 1360 1167  542  757  314   80  541
 214  443  664  877 1082 1279 1650 1821 1988 1987 2143 2433 2568 2569 2692 2809 2918 3018 3112 3197 3272 3345 3346 3344 3457 3458 3405 3462 3466 3350 3285 3286 3509 3413 3355 3417 3418 3223 3142 3297 3139 3053 2957 2956 2738 2617 2488 2351 2208 2206 2053 1724 1723 1546 1168  540  758  756  317  315
 213  442  663 1080 1081 1278 1468 1648 1819 1820 2144 2434 2432 2567 2566 2808 2916 3111 3196 3194 3273 3343 3403 3205 3502 3463 3460 3503 3504 3348 3540 3569 3508 3213 3467 3468 3419 3362 3296 3225 3141 3224 3144 2958 2852 2618 2489 2207 2352 2054 1892 1893 1547 1361 1169  967  968  316  966   85
 212  441  662  876  875 1277 1467 1647 1985 1986 2141 2142 2291 2565 2691 2690 2807 2917 3110 3109 3195 3341 3454 3455 3407 3498 3456 3411 3538 3464 3465 3287 3415 3510 3511 3469 3470 3298 3226 3227 3055 3143 2853 3054 2739 2740 2353 2354 2209 2055 1894 1725 1548 1362 1170  969  759  543   84  318
 211  440  661  874 1079 1276 1466 1465 1646 1984 2290 2289 2431 2564 2915 2806 3016 3015 3017 3270 3340 3401 3499 3500 3535 3537 3564 3584 3585 3507 3410 3542 3414 3571 3543 3421 3423 3363 3300 3299 3145 3056 2855 2959 2741 2619 2620 2490 2210 2056 1895 1726 1549 1363 1171  761  760  544  545  319
 210  439  660  873 1078 1275 1464 1645 1818 1983 2140 2430 2563 2562 2689 2688 2805 2913 3013 3193 3192 3271 3452 3338 3339 3402 3501 3567 3566 3506 3461 3541 3546 3544 3512 3420 3514 3471 3364 3228 3057 3059 2960 2854 2742 2621 2356 2491 2057 2058 1896 1550 1365 1364 1172  970  971  763  320   86
 209  438  659  872 1077 1274 1463 1644 1817 1982 2139 2288 2428 2429 2687 2804 3108 2914 3014 3269 3399 3397 3398 3451 3534 3533 3536 3568 3539 3586 3587 3570 3598 3547 3513 3473 3474 3365 3422 3229 3147 3146 2961 2856 2622 2493 2494 2492 2355 1898 2059 1727 1551 1366 1173  972  762  546  321   87
 208  437  658  871 1076 1273 1462 1643 1816 1981 2285 2138 2561 2686 2685 2803 2912 3012 3191 3107 3268 3400 3337 3453 3563 3562 3495 3583 3565 3597 3590 3588 3572 3472 3545 3424 3367 3301 3302 3230 3058 3148 3060 2962 2857 2743 2623 2357 2211 2212 1897 1728 1552 1367 1174  973  764  322   90   88
 207  436  657  870 1272 1270 1461 1641 1642 1980 2287 2427 2286 2559 2560 2802 2911 3105 3106 3190 3267 3449 3396 3450 3494 3496 3497 3561 3596 3582 3599 3573 3548 3515 3425 3516 3366 3368 3304 3303 3149 2963 2858 2745 2744 2359 2358 2213 2214 1730 1899 1729 1553 1368 1175  974  765  547   89  549
 206  435  656  869 1074 1075 1271 1814 1812 1815 2137 2425 2284 2426 2684 2801 2910 3011 3104 3189 3335 3336 3334 3448 3531 3560 3532 3581 3594 3595 3593 3589 3592 3550 3574 3549 3427 3426 3369 3231 3150 3061 2965 2964 2624 2625 2360 2495 1900 2060 1902 1731 1554 1369 1176  975  766  323  548   91
 205  434  654  655  868 1073 1460 1979 1978 1813 2135 2283 2558 2683 2800 2799 2909 3010 3103 3332 3266 3395 3264 3447 3493 3559 3556 3558 3557 3578 3577 3576 3591 3575 3517 3475 3476 3370 3305 3232 3151 3062 2859 2860 2746 2747 2496 2215 2064 2216 2061 1732 1555 1177 1178  976  767  550  324   92
 203  204  433  867 1072 1269 1458 1459 1640 1976 1977 2136 2424 2557 2556 2907 2798 3009 3102 3188 3187 3333 3265 3394 3446 3529 3530 3580 3579 3555 3524 3553 3552 3551 3518 3477 3428 3371 3306 3233 3152 2966 2861 2862 2627 2498 2748 2497 2063 1901 2062 1556 1371 1372 1370  977  768  551  325  326
 202  432  653  866 1071 1268 1457 1638 1639 1975 2134 2282 2423 2681 2682 2797 2908 3008 3101 3262 3186 3331 3393 3491 3492 3528 3527 3526 3525 3523 3554 3522 3521 3481 3519 3478 3429 3372 3307 3235 3153 3063 3064 2749 2628 2361 2626 2363 2217 1904 1734 1733 1373 1179  978  769  770  327   95   93
 431  430  652  865 1070 1267 1456 1637 1811 2133 2280 2132 2422 2555 2680 2796 2906 3007 3099 3185 3100 3263 3445 3490 3443 3489 3488 3487 3486 3485 3484 3483 3520 3433 3479 3432 3430 3373 3308 3154 3234 3065 2967 2968 2863 2499 2630 2362 2218 1903 1905 1735 1557 1558 1180  979  553  552   94  328
 201  651  650  864 1069 1266 1454 1455 1810 1636 1974 2281 2421 2554 2679 2905 2795 3006 3183 3261 3330 3329 3391 3392 3444 3442 3441 3440 3439 3438 3437 3380 3480 3435 3379 3377 3431 3374 3309 3236 3155 2969 2864 2970 2751 2501 2503 2500 2065 2066 2219 1736 1559 1374 1181  980  771  554  329   96
 200  429  649  863 1068 1265 1634 1808 2277 1809 2130 2129 2420 2553 2678 2792 3003 3098 2904 3258 3182 3260 3389 3326 3388 3323 3385 3322 3384 3382 3436 3482 3378 3434 3244 3314 3376 3375 3310 3237 3156 3066 2971 2865 2750 2364 2629 2220 2067 2365 2502 1737 1560 1375 1182  981  772  555  330   97
 199  427  428  862 1067 1264 1635 1971 1972 1973 2131 2279 2551 2419 2794 2793 2903 3184 3095 3178 3257 3327 3390 3325 3324 3386 3387 3251 3320 3383 3321 3318 3317 3315 3166 3243 3313 3312 3311 3238 3157 3067 2867 2753 2631 2633 2222 2366 2367 1907 1906 1738 1561 1376 1183  982  773  556  331   98
 426  197  648  861 1065 1263 1066 1807 1806 1632 2128 2278 2418 2552 2550 3004 3097 3002 3096 3094 3259 3256 3177 3255 3253 3172 3086 3171 3319 3250 3246 3080 3381 3245 3316 3164 3242 3241 3240 3239 3158 3068 3069 2754 2868 2635 2632 2221 2223 2068 1908 1739 1562 1377 1184  983  774  557  332   99
 647  646  860  858 1064 1450 1453 1633 1451 1804 2276 2416 2417 2677 2676 2902 2900 3001 3005 3091 3328 3179 3175 3174 3254 2888 3173 3252 3170 3249 3247 3248 3168 3167 3165 3077 3163 3162 3161 3160 3072 2973 2755 2972 2634 2507 2368 2506 2369 2069 1909 1740 1563 1378 1185  984  775  558  333  100
 198  195  425  859 1262 1261 1452 1805 1969 1970 2126 2127 2415 2549 2897 2673 2790 2901 3000 3181 3180 3090 3176 3088 3087 2990 2777 3083 3085 2986 3169 3081 3079 3078 2982 2879 3076 3075 3074 3073 3070 3071 2873 2866 2752 2757 2224 2072 2505 1911 1741 1742 1564 1379 1186  985  776  559  334  101
 194  196  424  645 1063 1062 1449 1631 1803 1968 2125 2275 2274 2548 2674 2675 2999 2998 2791 3092 2895 2996 3089 2995 2994 2991 2992 2988 3084 2987 3082 2884 2985 2984 2880 2983 2980 2979 2876 2978 2976 3159 2974 2871 2869 2756 2504 2070 2071 1910 1912 1743 1565 1380 1187  986  777  560  335  102
 193  423  644  857 1259 1260 1447 1630 1802 1967 2124 2273 2414 2547 2672 2787 2899 2898 2896 3093 2997 2894 2892 2893 2993 2890 2778 2989 2531 2528 2885 2883 2882 2881 2768 2981 2648 2877 2765 2874 2977 2872 2761 2975 2870 2637 2636 2225 2373 2371 2227 2073 1566 1381 1188  987  778  561  336  103
 422  643  642 1060 1258 1448 1446 1629 1628 1966 2123 2272 2413 2546 2671 2789 2668 2786 2785 2784 2782 2781 2399 2891 2779 2889 2775 2887 2658 2886 2774 2773 2771 2770 2769 2649 2767 2878 2646 2875 2763 2762 2760 2641 2758 2759 2508 2638 2074 2370 1913 1744 1567 1382 1189  988  779  562  337  104
 192  421  855  856 1256 1625 1061 1800 1801 1965 2122 2271 2412 2545 2670 2788 2541 2667 2666 2664 2536 2783 2663 2780 2533 2660 2776 2530 2529 2656 2654 2772 2652 2651 2650 2521 2766 2384 2386 2764 2644 2643 2642 2514 2640 2639 2510 2509 2372 2076 2075 1914 1745 1385 1384 1190  780  563  338  105
 420  854  641 1257 1254 1058 1445 1627 1799 1964 2121 2270 2411 2544 2543 2669 2542 2540 2665 2538 2535 2402 2662 2537 2398 2532 2659 2657 2655 2527 2526 2391 2653 2388 2245 2522 2387 2524 2647 2645 2382 2516 2515 2513 2376 2375 2229 2374 2228 2226 1915 1746 1568 1569 1383  989  991  990  107  339
 640  190  853 1059  639 1057 1626 1444 1798 1963 2120 2269 2410 2409 2408 2407 2406 2405 2404 2403 2534 2258 2661 2401 2255 2397 2396 2395 2251 2393 2392 2525 2389 2523 2244 2092 2385 2519 2090 2517 2239 2381 2380 2379 2378 2377 2512 2511 2230 2077 1916 1747 1570 1386 1191  781  565  564  340  106
 191  419  417 1255 1056 1055 1443 1624 1797 1962 2119 2268 2267 2266 2265 2264 2263 2262 2261 2260 2539 2257 2400 2256 2105 2254 2253 2252 2250 2249 2098 2248 2390 2246 1935 2094 1932 2520 2518 1930 2238 2383 1926 2237 2235 2234 2233 2232 2231 2078 1917 1748 1571 1193 1192  992  782  783  566  341
 188  418  638  852 1253 1442 1623 1622 1796 1961 2118 2117 2116 2115 2114 2113 2112 2111 2110 2109 2259 2107 2106 1779 2103 1777 2101 2394 2100 2099 2097 2096 2247 2095 1934 2242 2243 2091 2088 2241 1929 2087 2085 2236 2084 2083 2081 2080 1921 2079 1749 1573 1572 1387 1194  784  567  568  109  108
 189  415  416  637 1252  849 1441 1621 1795 1960 1959 1958 1957 1956 1955 1954 1953 1952 1951 1950 2108 1949 1948 1945 1602 1944 2102 1941 1774 1940 1939 1938 1937 1936 1768 2093 1764 1931 1766 2240 2089 1927 1759 2086 1925 1924 2082 1922 1920 1578 1918 1388 1750 1195  994  993  785  343  342  110
 187  186  636  851  850 1054 1251 1440 1794 1793 1792 1791 1790 1789 1788 1787 1786 1785 1784 1783 1782 1606 1946 1421 2104 1780 1600 1943 1942 1773 1771 1596 1770 1769 1933 1590 1591 1765 1589 1588 1763 1761 1762 1758 1583 1757 1923 1580 1754 1919 1753 1389 1751 1574 1196  995  786  569  344  111
 185  414  635  848 1053 1250 1439 1620 1619 1618 1617 1616 1615 1614 1613 1612 1611 1610 1609 1608 1607 1947 1781 1604 1778 1603 1776 1775 1599 1598 1597 1772 1595 1594 1593 1767 1408 1216 1405 1213 1402 1928 1760 1584 1582 1581 1397 1579 1577 1752 1755 1576 1575 1390 1197  996  787  570  345  112
 184  413  634  847 1052 1249 1438 1437 1436 1435 1434 1433 1432 1431 1430 1429 1428 1427 1426 1425 1424 1423 1232 1230 1419 1418 1601 1417 1416 1415 1414 1413 1412 1411 1219 1407 1592 1409 1404 1403 1016 1585 1586 1401 1400 1399 1756 1398 1394  798 1204 1393 1392 1391 1198  997  788  571  346  113
 183  412  633  846 1051 1248 1247 1246 1245 1244 1243 1242 1241 1240 1239 1238 1237 1236 1235 1234 1233 1422 1605 1231 1229 1228 1227 1226 1225 1224 1223 1222 1221 1220 1218 1410 1018 1215 1406 1214 1587 1212 1211 1210 1209 1208 1207 1205 1005 1206 1203 1202 1201 1200 1199  998  789  572  347  114
 182  411  632  845 1050 1049 1048 1047 1046 1045 1044 1043 1042 1041 1040 1039 1038 1037 1036 1035 1034 1033  825 1032 1420 1030 1028 1027 1026 1025 1024 1023 1022 1021 1020 1019  810  811 1217 1015 1014 1013 1012 1011 1010 1009 1008 1007 1395 1396 1004 1003 1002 1001 1000  999  790  573  348  115
 181  410  631  844  843  842  841  840  839  838  837  836  835  834  833  832  831  830  829  828  612  827  609  386  823 1029  821  819  605  818  817  816  815  814  813  812  596 1017  809  808  807  806  805  804  803  802  801  800 1006  799  797  796  795  794  793  792  791  574  349  116
 180  409  630  629  628  627  626  625  624  623  622  621  620  619  618  617  616  615  614  613  826  157 1031  607  824  822  384  383  820  603  602  601  600  599  375  598  597  594  371  593  592  591  590  589  588  587  586  585  584  583  582  581  580  579  578  577  576  575  350  117
 179  408  407  406  405  404  403  402  401  400  399  398  397  396  395  394  393  392  391  390  156  610  611  387  608  385  153  606  604  381  380  379  378  376  144  374  595  373  372  370  369  368  367  366  365  364  363  362  361  360  359  358  357  356  355  354  353  352  351  118
 178  177  176  175  174  173  172  171  170  169  168  167  166  165  164  163  162  161  160  159  389  158  388  155  154  152  151  382  150  149  148  147  377  146  145  143  142  141  140  139  138  137  136  135  134  133  132  131  130  129  128  127  126  125  124  123  122  121  120  119
