# This puzzle is unsolvable
15
  7  51  55 180 202 152 182 150 177 156 184 112  19  14  20
  1 103 145   4   5 105 107  65 111  11 114  13  12 118  15
 52  57  54   8 181  56  62  61 207  10  16 109  70  67  17
 60 146  53 138 210  59  63  68  66  74 154 155 110  71   9
199 104  98 136 144   2 219 148 147  64 124 153 117 116  18
101   3  50 100  58 185 108   0 151  21 201 115 205 206  24
173 102 174 198 200 175 149 204 221 178  69  72  22  31 159
 99 137 141 132 179 143 203  83 212 187  73 188  23 157 119
133   6  45 106 113 142 197 214 222 220 160 208 183 121 163
171 176  85 223 216 169  97  81 195  76 215 172 120 126  25
 47 134  38 190 193  89  86 186  37 224  27 125  82 122  77
 49 165  95  88 168 166  92 164 131 218 127  33 189  80  32
 41 140  40  36 167 213 130  39  87  28 139 217  30 158  29
 46  93  43  91  44 196  96  34  79 128 211 209 123  75 161
 94  42 170 135  90 192  35  48 129  84  26 194 191  78 162
