# This puzzle is unsolvable
16
 62 112  60 118  61   8 161 119 223  69  10  12 163  74  15  17
 59   1  57  65 158   5  67 116  76 166   9 225  70  20 125  73
109 114  63  64 197 117 160 243   6 222 199  11 124  16  14 122
220 111   3   2 155  54   7 121 209  13 234  68 165  79 127  18
153 105   4 156 224  58 159 126 188 226  66 198 120 254  71 128
 56 108 162 240 194 164 255 195 123 173  78  82  24  75  77 172
 52 190 110 192 193 115 215 228 207 210 244 200 129  72  19  25
113  49 221  55 187 157 252 239 202 196 167 176 169  22  21 227
151 152 191 229 154 178 248 246 237 218 201 241 168  23  26 203
102 213  50 219 189 238 253 232  89 206 205  83 204  28 230 132
214 103  51 235 182 106 107 177 146 217  41 175 179  80 171  85
 53 100  47  40 131 186 137 242 247 133  91 140 170 233  32 130
101 150 181 184  97 208  88 141 138  94 136  27 174  35  84   0
 45  46 147 185 104 139 250 148 142 245  31 231 236  86 135  81
 48  43 145 183  38  98 211  92  96 180 212 249 216 134  34  33
 99  93 144 149  95  44 143  42  36  39 251  90  30  37  87  29
