# This puzzle is unsolvable
69
   2    1    3    4    5    6    7    8    9   10   11   12   13   14   15   16   18  289   21  290  292   22   23  295   24  296   28  561   29   31   32  303   33   34   35   36   38  309   39  572   43  576   42  317   44   45   47   49  320  322  585   52   53   54   56   57  328   58  332   59  333   61   63   64   65   66  339   67   68
 272  273  274  275  276  277  278  279  280  281  282  283  284  285  286  287   17   20   19  291  555  293  558  294  298   26   27  300  562   30  302  821  565  305  306   37  574   40  311  313   41  312  315  580  318  581  319   48  321   51  323  586  324  325   55  845  327  329  594  331   62  596  334  335  336  600  337   71   69
 271  536  537  538  539  540  541  542  543  544  545  546  548  549  550  804  288  551  553  809  554 1059  815   25  297  560  816  299  563  301  566  304  568  822  825  307  570  310  828  832  577  831 1080   46  834 1318  579  582  583   50  584  841  589  587  326 1091  591  330  848 1098  595  597  598  599 1101  855  338   70  340
 270  535  792  793  794  795  796  797  798  799  800  801  547  803 1051  806  807  552  808  810 1295  812  556  813 1060 1063 1062  818  819  564  820 1068  567  827  569 1072  571 1079 1073 1076 1077  575 1550  833  578  316  836  837  838  839  840  842 1089  590  588 1092  847  592   60 1095 1099  593  852 1339 1340  853  601  341   72
 269  534  791 1040 1041 1042 1043 1044 1045 1046 1047 1048  802 1049 1289  805 1053 1054 1055 1057  811  557 1058 1300 1301  814 1061  817 1064 1066 1067 1069  823 1070 1071  824  573  308 1545  829 1317 1319  830 1988 1081 1082 1083 1084 1085 1086 1087 1088 1328  843 1330  844  846 1093 1333 1097 1094  849  851 1100  854  856  602   73   74
 268  533  790 1039 1280 1281 1282 1283 1284 1285 1286 1287 1743 1290 1288 1052 1292 1293 1294 1056 1528 1299 1297  559 1531 1298 1533 1303 1065 1304 1306 1307 1308 1540 1309 1311  826 1074 1544 1075 1314 1316 1078 1986  835 1321 1322 1323 1324 1325 1326 1327 1090 1560 1329 1331 1332 1564 1334 1336 1096 1337 1567  857 1569  858  603  342  344
 267  532  789 1038 1279 1512 1513 1514 1515 1516 1517 1518 1519 1520 1522 1050 1523 1524 1525 1526 1296 1751 1966 1530 1754 1302 1532 1534 1535 1305 1536 1537 1538 1539 1310 1541 1313 1312 1982 1984 1772 1547 1549 1775  314 1774 1551 1553 1555 1556 1558 1780 1559 1783 1561 1562 1563 1787 1565 2005 1335 1566 1338 1570 1104  604 1102  605  606
 266  531  788 1037 1278 1511 1736 1737 1738 1739 1740 1956 1741 1521 1291 1745 1746 1962 1748 1749 1527 1752 1529 1968 1753 1755 1756 1757 1758 1759 1760 1761 1762 1763 1980 2186 1981 1765 1768 1315 1543 1548 1771 2396 1320 1990 1552 1777 1554 1779 2401 1557 1781 1782 1784 1785 1786 1788 1789 1790 2006  850 1791 1568 1341  860  345   76  343
 265  530  787 1036 1277 1510 1735 1952 1953 1954 1955 1742 1957 2166 1744 1959 1961 1963 1747 1964 1750 1965 1967 2175 1969 1970 1971 1972 1973 1974 1975 1976 1977 1978 1764 2385 1542 1766 1983 1546 1770 2392 1769 1987 1773 1989 1776 2199 1994 1778 1995 1996 1997 1998 1999 2000 2001 2209 2003 2004 1793 1794 1571  348 1342  859  608   75  346
 264  529  786 1035 1276 1509 1734 1951 2160 2161 2162 2163 2164 2364 1958 2165 1960 2168 2368 2170 2171 2173 2372 2373 2565 2177 2178 2179 2180 2380 2181 2182 2184 2185 2576 1979 2188 2388 1767 2189 2191 1985 2193 2195 2196 2197 2586 1992 1991 2202 2203 2593 2204 2205 2206 2207 2208 2408 2002 2211 1344 1103 1343 1105  607  349  347   77   79
 263  528  785 1034 1275 1508 1733 1950 2159 2360 2361 2362 2363 2555 2365 2167 2169 2367 2370 2561 2172 2371 2564 2174 2176 2376 2377 2378 2379 2572 2382 2183 2383 2384 2386 2187 2387 2579 2190 2390 2583 2393 2194 2584 2585 2587 2198 2398 1993 2399 2200 2402 2403 2404 2405 2406 2407 2409 2210 2212 1572 1574 1792 1573 1106  609 1109   78   80
 262  527  784 1033 1274 1507 1732 1949 2158 2359 2552 2553 2554 2556 2739 2366 2557 2558 2559 2743 2562 2563 2375 2374 2750 2749 2567 2569 2571 2381 2756 2755 2573 2575 2934 2577 2578 2389 2581 2582 2391 2192 2767 2394 2769 2395 2770 2589 2590 2592 2201 2776 2595 2777 2596 2597 2598 2412 2411 2410 2600 2215 1346  861  862  613 1107  863   81
 261  526  783 1032 1273 1506 1731 1948 2157 2358 2551 2736 2737 2738 2914 2740 2741 2560 2742 2369 2744 2745 2746 2748 2566 2925 2568 2927 2570 2929 2754 2757 2574 2758 2759 2760 2761 2762 2580 2763 2766 2765 2942 2768 2588 2772 2397 2773 2774 2400 2775 2951 2594 2953 2778 2780 2781 2599 2007 2413 2213 1796 1108 1575 1345  351  350  610  611
 260  525  782 1031 1272 1505 1730 1947 2156 2357 2550 2735 2912 2913 3081 2915 2916 2917 2918 2919 2920 2922 2747 2923 2924 3092 2751 2752 2753 3095 2930 2931 2932 2933 2935 3102 2936 2937 2938 2764 2939 2940 2941 2943 2944 2945 2946 2948 3115 2591 2950 3118 2952 3119 2779 2954 2955 2782 2414 2216 2214 2008 1576 1347 1110  864  866  612   82
 259  524  781 1030 1271 1504 1729 1946 2155 2356 2549 2734 2911 3080 3082 3083 3242 3085    0 3086 3087 2921 3088 3089 3090 3091 3093 2926 3254 2928 3097 3098 3099 3100 3101 3103 3104 3263 3105 3106 3107 3108 3109 3110 3111 3112 2771 3114 2949 2947 3116 3117 3278 3120 3121 2956 2601 2009 1797 1800 1795 2217 1577 1578 1111  865  352  353   83
 258  523  780 1029 1270 1503 1728 1945 2154 2355 2548 2733 2910 3079 3239 3240 3241 3084 3244 3245 3246 3247 3248 3249 3250 3251 3252 3094 3253 3096 3256 3257 3258 3259 3260 3261 3262 3264 3415 3265 3266 3267 3268 3269 3270 3272 3113 3568 3274 3276 3277 3428 3426 3279 3122 2957 2783 2602 2603 2010 2219 1798 2011 1349 1348 1112  867  614   84
 257  522  779 1028 1269 1502 1727 1944 2153 2354 2547 2732 2909 3078 3238 3392 3393 3243 3538 3396 3397 3398 3399 3400 3401 3402 3403 3404 3407 3255 3549 3408 3409 3410 3411 3412 3413 3557 3414 3416 3418 3561 3419 3420 3421 3271 3422 3423 3275 3703 3429 3569 3123 3282 2785 2959 2958 2604 2784 2012 2415 1799 1579 1350 1113  868  615  354   85
 256  521  778 1027 1268 1501 1726 1943 2152 2353 2546 2908 2907 3077 3391 3390 3536 3395 3394 3539 3540 3541 3542 3543 3544 3545 3546 3547 3405 3683 3550 3686 3551 3687 3556 3555 3691 3558 3693 3559 3417 3696 3562 3563 3564 3565 3566 3273 3567 3424 3704 3570 3571 3427 3280 3281 2787 2605 2419 2417 2013 1802 1801 1351 1114  617  869  355   86
 255  520  777 1026 1267 1500 1725 1942 2151 2352 2544 2731 3075 3076 3236 3535 3672 3537 3673 3674 3675 3676 3677 3678 3679 3680 3681 3810 3548 3406 3684 3812 3814 3552 3553 3554 3819 3692 3694 3695 3560 3697 3698 3699 3700 3701 3828 3425 3702 3707 3705 3572 3431 3430 3124 2960 2606 2218 2786 2221 2220 2416 1580 1115  870  619  616  356   87
 254  519  776 1025 1265 1499 1724 1941 2150 2351 2730 2545 2905 2906 3234 3237 3534 3671 3800 3801 3802 3803 3804 3805 3806 3807 3808 3809 3682 3811 3932 3688 3934 3816 3689 3690 3817 3937 3820 3938 3821 3942 3824 3825 3826 3946 3827 3830 3831 3706 3708 3573 3285 3283 3125 2961 2962 2420 2418 2018 2788 2014 1581 1803  618  871  357   88   90
 253  518  775 1024 1498 1266 1723 1939 1940 2149 2350 2729 2543 3074 3073 3389 3533 3670 3799 3920 3921 3922 3923 3924 3925 3926 3927 3928 3685 3930 4041 4043 4045 3813 3815 4047 3936 3818 3940 3941 3822 3943 3823 3944 3945 4057 3947 3829 3950 3949 3832 3574 3284 3432 3126 2789 2608 2222 2609 2223 2015 2017 1354 1352 1116 1118  620  358  872
 252  517  774 1023 1022 1497 1722 2148 2147 2349 2542 2728 2727 3072 3235 3388 3532 3669 3798 3919 4032 4033 4034 4035 4036 4037 4038 4039 3929 4042 4146 3931 4044 3933 3935 4046 4048 4049 4153 3939 4051 4052 4054 4055 4056 4058 4161 3948 4059 3575 3577 3434 2964 3129 3127 3128 2790 2607 2421 2224 1805 1583 1582 1353 1117 1355  873   89  359
 251  516  772 1263 1264 1496 1721 1938 2348 2347 2541 2902 2904 2903 3233 3387 3385 3668 3797 3918 4031 4136 4137 4138 4139 4140 4141 4142 4143 4040 4144 4145 4147 4148 4149 4150 4151 4152 4335 4050 4154 4053 4156 4157 4159 4255 4160 4060 3951 3833 3435 3433 3287 3440 3286 2963 2791 2610 2611 2422 2016 1806 1586 1356 1119  874  621  360  361
 250  515 1021  773 1262 1495 1720 1937 2146 2540 2539 2901 2726 3232 3384 3230 3386 3531 3796 3917 4030 4135 4232 4233 4234 4235 4236 4237 4238 4239 4240 4241 4242 4243 4244 4245 4246 4247 4248 4336 4250 4155 4251 4158 4254 4162 4061 3952 4062 3834 3709 3579 3436 3437 3288 2965 2792 2612 2423 2225 2019 1804 1584 1585 1120  875  622   92   91
 249  514  771 1020 1261 1494 1719 1936 2145 2346 2723 2538 2725 3070 3071 3530 3666 3667 3795 3916 4029 4134 4231 4320 4321 4322 4323 4324 4325 4326 4327 4328 4329 4330 4331 4332 4333 4334 4414 4416 4249 4339 4252 4340 4253 4256 4163 4164 3837 3835 3576 3438 3836 3130 3289 3131 2966 2793 2226 2021 2020 1587 1357 1359 1358  876  623  362   93
 248  513  770 1019 1260 1493 1718 1935 2144 2537 2724 2721 2900 3069 3068 3231 3529 3665 3794 3915 4028 4133 4230 4319 4400 4401 4402 4403 4404 4405 4406 4407 4408 4409 4410 4411 4412 4413 4415 4486 4337 4338 4417 4418 4341 4343 4342 4063 3954 3711 3710 3953 3580 2968 3290 2967 2794 2613 2425 2424 2022 1807 1124 1808 1588 1122  877  624   94
 247  512  769 1018 1259 1492 1717 1934 2143 2345 2722 2899 3067 3382 3383 3527 3528 3664 3793 3914 4027 4132 4229 4318 4399 4472 4473 4474 4475 4476 4477 4478 4479 4480 4481 4482 4483 4484 4485 4487 4604 4488 4489 4420 4258 4419 4257 4064 3838 3712 3713 3439 3134 3578 3132 2795 2796 2614 2426 2227 2024 1121 1589 1361 1123  878  625  363   95
 246  511  768 1017 1258 1491 1716 1933 2142 2344 2343 2536 2898 3228 3229 3381 3526 3663 3792 3913 4026 4131 4228 4317 4398 4471 4536 4537 4538 4539 4540 4541 4542 4543 4544 4545 4546 4547 4548 4549 4550 4551 4490 4421 4344 4259 4065 3956 3955 3839 3714 3291 3441 3135 3133 2969 2797 2615 2230 2025 2023 1809 1360 1362  879  627  364  366   96
 245  510  767 1016 1257 1490 1715 1932 2141 2342 2535 2720 2897 3066 3227 3380 3525 3662 3791 3912 4025 4130 4227 4316 4397 4470 4534 4535 4592 4594 4596 4643 4597 4598 4599 4600 4601 4602 4603 4605 4606 4492 4423 4345 4260 4167 4168 4165 4066 3840 3715 3581 3582 3293 3292 2971 2970 2616 2427 1810 1812 1363 1590 1126 1129  880  626  365   97
 244  509  766 1015 1256 1489 1714 1931 2140 2341 2534 2719 2896 3065 3226 3379 3524 3661 3790 3911 4024 4129 4226 4315 4396 4469 4591 4639 4593 4642 4595 4644 4683 4645 4646 4647 4648 4649 4650 4651 4607 4422 4491 4346 4347 4262 4261 4166 4067 3957 3841 3716 3583 3294 3138 3136 2798 2618 2428 2228 2229 1811 1592 1125  881 1364  629  628   98
 243  508  765 1014 1255 1488 1713 1930 2139 2340 2533 2718 2895 3064 3225 3378 3523 3660 3789 3910 4023 4128 4225 4314 4395 4468 4533 4590 4640 4679 4641 4680 4684 4715 4685 4686 4687 4688 4689 4652 4553 4552 4495 4424 4348 4170 4068 3959 3958 3842 3717 3584 3442 3585 3295 2800 2430 2617 2972 1813 2232 2027 1366 1814 1591  882  631  368   99
 242  507  764 1013 1254 1487 1712 1929 2138 2339 2532 2717 2894 3063 3224 3377 3522 3659 3788 3909 4022 4127 4224 4313 4394 4466 4467 4532 4638 4681 4678 4682 4713 4738 4716 4717 4718 4719 4690 4653 4608 4493 4494 4349 4496 4425 4169 4069 3960 3961 3718 3586 3443 2619 3137 2799 2802 2233 2429 2026 2231 1816 1127  630  367 1130  883  369  100
 241  506  763 1012 1253 1486 1711 1928 2137 2338 2531 2716 2893 3062 3223 3376 3521 3658 3787 3908 4021 4126 4223 4312 4393 4465 4531 4589 4588 4637 4712 4736 4737 4739 4754 4740 4741 4720 4691 4609 4556 4554 4427 4497 4265 4263 4171 4070 3844 3843 3719 3446 3444 3296 2975 2973 2801 2431 2235 2029 1815 2030 1594 1593 1367 1365  884  370  101
 240  505  762 1011 1252 1485 1710 1927 2136 2337 2530 2715 2892 3061 3222 3375 3520 3657 3786 4020 3906 4124 4125 4222 4464 4463 4530 4587 4635 4677 4711 4710 4752 4751 4714 4742 4743 4721 4692 4654 4557 4555 4498 4426 4428 4264 4172 4071 3845 3846 3587 3721 3445 3298 2974 3139 2803 2620 2624 2234 2028 2236 1128 1596 1131  885  632  371  102
 239  504  761 1010 1251 1484 1709 1926 2135 2336 2529 2714 2891 3060 3221 3374 3519 3656 3785 3907 4019 4221 4310 4392 4391 4311 4529 4586 4676 4709 4735 4753 4759 4734 4758 4744 4755 4722 4693 4655 4610 4611 4350 4351 4267 4268 4173 4072 3962 3965 3720 3300 3297 3299 3140 3141 2977 2804 2621 2032 2433 1595 1597 1598 1368  887  633  372  103
 238  503  760 1009 1250 1483 1708 1925 2134 2335 2528 2713 2890 3059 3220 3373 3518 3655 3784 3905 4018 4122 4123 4309 4389 4390 4528 4585 4634 4636 4707 4733 4748 4757 4760 4747 4745 4694 4657 4656 4559 4558 4429 4430 4266 4073 4075 3966 3963 3847 3722 3447 3301 3448 3142 2976 2623 2622 2432 2435 2031 2238 1370 1817  886 1132  634  373  104
 237  502  759 1008 1249 1482 1707 1924 2133 2334 2527 2712 2889 3058 3219 3372 3517 3654 3783 3904 4017 4121 4219 4307 4308 4462 4527 4584 4633 4708 4675 4750 4732 4749 4756 4746 4726 4723 4724 4658 4612 4500 4353 4269 4352 4355 4074 4174 3964 3849 3848 3589 3588 3144 3145 2805 2434 2626 2436 1818 2033 1819 1369 1599 1133  888  635  374  105
 236  501  758 1007 1248 1481 1706 1923 2132 2333 2526 2711 2888 3057 3218 3371 3516 3653 3782 3903 4016 4218 4119 4220 4388 4461 4526 4583 4632 4674 4705 4706 4731 4728 4727 4700 4725 4696 4695 4660 4560 4499 4613 4431 4270 4356 4175 3968 4178 3967 3724 3449 3450 3143 2979 2980 2806 2627 2241 2237 2034 1820 1601 1600 1134  889  636  375  106
 235  500  757 1006 1247 1480 1705 1922 2131 2332 2525 2710 2887 3056 3217 3370 3515 3652 3781 3901 3902 4120 4217 4306 4387 4459 4460 4582 4631 4673 4672 4669 4730 4703 4729 4701 4699 4698 4697 4614 4502 4615 4562 4501 4433 4177 4076 4176 3851 3850 3723 3590 3591 3302 3303 2625 2978 2437 1821 2629 1603 2036 1373 1823  890  891  637  376  107
 234  499  756 1005 1246 1479 1704 1921 2130 2331 2524 2709 2886 3055 3216 3369 3514 3651 3780 3900 4015 4118 4216 4304 4305 4458 4525 4629 4671 4670 4627 4626 4704 4702 4666 4665 4664 4663 4662 4661 4659 4563 4561 4434 4354 4432 4271 4077 3969 3726 3593 3592 3451 3146 3304 2807 2982 2439 2240 2242 1824 2239 2035 1371 1135 1372  638  377  108
 233  498  755 1004 1245 1478 1703 1920 2129 2330 2523 2708 2885 3054 3215 3368 3513 3649 3650 3779 4014 4013 4215 4303 4386 4385 4523 4524 4581 4628 4576 4625 4668 4667 4624 4623 4621 4620 4619 4618 4616 4617 4564 4435 4357 4272 4179 4078 3852 3727 3725 3594 3453 3452 2981 2809 2628 2438 2441 2440 1822 1602 1374 1136 1138  892  639  378  109
 232  497  754 1003 1244 1477 1702 1919 2128 2329 2522 2707 2884 3053 3214 3367 3512 3648 3778 3899 4012 4117 4214 4302 4301 4383 4457 4630 4578 4577 4575 4574 4515 4573 4572 4622 4570 4569 4568 4567 4566 4565 4503 4504 4358 4273 4181 4079 3970 3853 3728 3595 3454 3305 2983 3148 2810 2808 2243 2037 1825 2039 1604 1137 1377  893  640  379  110
 231  496  753 1002 1243 1476 1701 1918 2127 2328 2521 2706 2883 3052 3213 3366 3511 3647 3777 3898 4011 4116 4213 4384 4455 4522 4520 4579 4519 4518 4517 4516 4514 4513 4446 4571 4511 4510 4509 4508 4507 4506 4505 4436 4359 4274 4080 4180 3971 3854 3729 3596 3455 3306 3147 3150 2985 2811 2245 2244 2040 1826 2038 1606 1375  894  641  380  111
 230  495  752 1001 1242 1475 1700 1917 2126 2327 2520 2705 2882 3051 3212 3365 3510 3646 3776 3897 4010 4115 4212 4382 4456 4580 4521 4453 4452 4451 4450 4449 4448 4447 4445 4512 4444 4443 4442 4441 4365 4440 4439 4437 4360 4275 4182 4081 3972 3855 3730 3597 3456 3307 3149 2813 2631 2984 2630 2246 1827 1378 1139 1605 1376  896  642  112  114
 229  494  751 1000 1241 1474 1699 1916 2125 2326 2519 2703 2704 2881 3050 3211 3364 3509 3775 3896 4009 4114 4211 4300 4381 4380 4454 4378 4377 4376 4375 4374 4373 4372 4371 4370 4369 4368 4367 4366 4191 4282 4438 4363 4362 4276 4183 4082 3973 3856 3731 3598 3457 3308 3151 2986 2812 2442 2443 2041 1828 1607 1608 1141  895  643  113  381  383
 228  493  750  999 1240 1698 1915 1914 2124 2517 2324 2518 2880 3049 3210 3363 3508 3645 3774 3895 4008 4113 4210 4208 4297 4296 4379 4295 4204 4293 4292 4291 4290 4289 4288 4287 4286 4285 4284 4283 4190 4364 4280 4279 4361 4277 4184 4083 3974 3857 3599 3458 3310 3309 3152 2987 2814 2632 2444 2247 2042 1829 1379 1380 1140 1142  897  644  115
 227  492  749  997  998 1239 1473 1472 2123 2325 2702 2878 2879 3048 3209 3362 3507 3644 3773 3894 4007 4112 4209 4298 4299 4206 4205 4203 4294 4202 4201 4200 4199 4198 4197 4196 4195 4194 4193 4192 4281 4091 4189 4187 4278 4186 4084 4085 3858 3733 3732 3600 3459 3311 3153 2988 2815 2633 2445 2248 2043 1830 1609 1144 1143  645  382  385  384
 226  491  748  996 1238 1470 1913 1911 2122 2323 2701 2516 3046 2877 3208 3361 3506 3643 3772 4006 4004 3888 4111 4109 4207 4107 4106 4105 4104 4103 4102 4101 4100 4099 4098 4097 4096 4095 4094 4093 4092 3868 4089 4188 4088 4086 4185 3976 3975 3860 3859 3602 3460 3461 3154 2989 2816 2634 2635 2446 2044 1832 1610  899  900  898  646  386  116
 225  490  747 1471 1696 1910 1697 1694 2699 2513 2512 2322 2700 3047 3207 3360 3505 3642 3771 3893 4005 4110 4002 4001 4108 4000 3999 3998 3997 3996 3995 3994 3993 3992 3991 3990 3989 3988 3987 3986 3985 3984 4090 3983 3982 4087 3980 3979 3863 3977 3734 3735 3462 3601 3312 2990 2817 2636 2447 2249 2250 2046 1831 1382  901 1146  387  647  117
 224  745  995 1235 1237 1695 1236 2121 1912 2321 2515 2698 2876 3045 3206 3359 3504 3641 3891 3892 3766 3890 4003 3887 3886 3885 3884 3883 3882 3881 3880 3879 3878 3877 3876 3875 3874 3873 3872 3871 3870 3869 3867 3866 3865 3981 3864 3862 3978 3861 3736 3603 3463 3313 3155 2991 2818 2637 2448 2045 1833 1147 1611 1145 1381 1384  904  650  118
 223  746  489 1234  993 1469 1693 2119 2514 2120 2319 2697 2875 3044 3205 3358 3503 3640 3770 3768 3767 3889 3765 3764 3763 3762 3761 3760 3759 3758 3757 3756 3755 3754 3753 3752 3751 3750 3749 3748 3747 3746 3745 3613 3743 3744 3742 3740 3739 3607 3738 3737 3314 3315 3156 2992 2819 2638 2449 2251 2047 1148 1612 1834 1383  648  902  649  119
 222  488  994  744 1233 1468 1467 1909 2320 2118 2511 2874 2873 3043 3204 3357 3502 3639 3769 3636 3498 3635 3634 3633 3632 3631 3630 3629 3628 3627 3626 3625 3624 3623 3622 3621 3620 3619 3618 3617 3616 3615 3614 3612 3610 3472 3741 3470 3471 3608 3606 3604 3465 3464 3157 3158 2820 2639 2253 2252 2049 2048 1613 1615 1149  651  390  120  388
 221  487  486  992  991 1466 1692 1691 2117 2318 2510 2696 3042 3203 3356 3501 3354 3499 3638 3355 3637 3496 3495 3494 3493 3492 3491 3490 3489 3488 3487 3486 3485 3484 3483 3482 3481 3480 3479 3478 3477 3476 3475 3474 3611 3326 3324 3609 3323 3468 3467 3605 3466 3316 3159 2993 2821 2640 2450 2451 1836 1614 1386 1152 1385  903  652  121  389
 220  485  743  742 1232 1465 1690 1908 2115 2116 2317 2695 2872 3041 3202 3200 3199 3352 3198 3351 3497 3349 3348 3347 3346 3345 3344 3343 3342 3341 3340 3339 3338 3337 3336 3335 3334 3333 3332 3331 3330 3329 3328 3327 3473 3325 3168 3005 3469 3321 3320 3319 3318 3317 3160 2994 2822 2452 2255 2254 2050 1616 1835 1151 1388 1150  392  905  391
 219  484  741  990 1231 1464 1689 1907 1906 2316 2509 2694 2871 3039 3040 3201 3036 3500 3197 3353 3350 3194 3193 3192 3191 3190 3189 3188 3187 3186 3185 3184 3183 3182 3181 3180 3179 3178 3177 3176 3175 3174 3173 3172 3171 3007 3170 3006 3322 3166 3165 3164 3163 3162 3161 2995 2823 2641 2453 2256 2454 1389 1390 1837 1387  654  907  124  122
 218  483  740  989 1230 1463 1688 1905 2114 2315 2508 2693 2870 2868 3038 3037 2865 3035 3034 3196 3195 3031 3030 3029 3028 3027 3026 3025 3024 3023 3022 3021 3020 3019 3018 3017 3016 3015 3014 3013 3012 3011 3010 3009 3008 2836 3167 2835 2833 3003 3002 3001 3000 2999 2997 2996 2826 2642 2643 2052 1839 1617 1618 1838 1153  653  906  123  125
 217  482  739  988 1229 1462 1687 1904 2113 2314 2507 2692 2869 2689 2867 2866 2499 2864 3033 2861 3032 2681 2859 2858 2857 2856 2855 2854 2853 2852 2851 2850 2849 2848 2847 2846 2845 2844 2843 2842 2841 2840 2839 2838 2837 3169 3004 2655 2834 2831 2652 2830 2829 2462 2828 2648 2825 2644 2455 2051 2257 2053 1619 1620 1154  908  909  656  394
 216  481  738  987 1228 1461 1686 1903 2112 2313 2506 2691 2503 2690 2688 2686 2684 2683 2863 2862 2860 2682 2680 2679 2678 2677 2676 2675 2674 2673 2672 2671 2670 2669 2668 2667 2666 2665 2664 2663 2662 2661 2660 2659 2658 2657 2656 2654 2467 2832 2651 2650 2998 2461 2266 2824 2827 2645 2456 2258 2259 1840 1391 1621 1157 1155  655  126  395
 215  480  737  986 1227 1460 1685 1902 2111 2312 2505 2504 2502 2501 2500 2687 2498 2685 2497 2496 2495 2494 2493 2492 2491 2490 2489 2488 2487 2486 2485 2484 2483 2482 2481 2480 2479 2478 2477 2476 2475 2474 2473 2472 2471 2470 2469 2468 2466 2653 2465 2464 2463 2649 2646 2647 2459 2458 2457 2260 2054 1841 1622 1624 1392  130  910  393  127
 214  479  736  985 1226 1459 1684 1901 2110 2311 2310 2309 2308 2307 2306 2305 2304 2303 2302 2301 2300 2299 2298 2297 2296 2295 2294 2293 2292 2291 2290 2289 2288 2287 2286 2285 2284 2283 2282 2281 2280 2279 2278 2277 2276 2275 2274 2273 2272 2271 2270 2269 2268 2267 2265 2460 2264 2262 2059 2056 2055 2057 1843 1842  659  911  658  128  396
 213  478  735  984 1225 1458 1683 1900 2109 2108 2107 2106 2105 2104 2103 2102 2101 2100 2099 2098 2097 2096 2095 2094 2093 2092 2091 2090 2089 2088 2087 2086 2085 2084 2083 2082 2081 2080 2079 2078 2077 2076 2075 2074 2073 2072 2071 2070 2069 2068 2067 2066 2065 2064 2063 2062 1850 2263 1847 1849 2261 1846 1393 1845 1156  912  657  399  129
 212  477  734  983 1224 1457 1682 1899 1898 1897 1896 1895 1894 1893 1892 1891 1890 1889 1888 1887 1886 1885 1884 1883 1882 1881 1880 1879 1878 1877 1876 1875 1874 1873 1872 1871 1870 1869 1868 1867 1866 1865 1864 1863 1862 1861 1860 1859 1858 1857 1856 1855 1854 1853 1852 1851 2060 2061 1630 1844 1395 2058 1625 1623 1159  913  660  131  398
 211  476  733  982 1223 1456 1681 1680 1679 1678 1677 1676 1675 1674 1673 1672 1671 1670 1669 1668 1667 1666 1665 1664 1663 1662 1661 1660 1659 1658 1657 1656 1655 1654 1653 1652 1651 1650 1649 1648 1647 1646 1645 1644 1643 1642 1641 1640 1639 1638 1637 1636 1635 1634 1633 1632 1631 1848 1629 1628 1400 1627 1396 1394 1160  914  661  397  400
 210  475  732  981 1222 1455 1454 1453 1452 1451 1450 1449 1448 1447 1446 1445 1444 1443 1442 1441 1440 1439 1438 1437 1436 1435 1434 1433 1432 1431 1430 1429 1428 1427 1426 1425 1424 1423 1422 1421 1420 1419 1418 1417 1416 1415 1414 1413 1412 1411 1410 1409 1408 1407 1406 1405 1404 1403 1402 1401 1626 1399 1398 1158 1397  915  662  401  402
 209  474  731  980 1221 1220 1219 1218 1217 1216 1215 1214 1213 1212 1211 1210 1209 1208 1207 1206 1205 1204 1203 1202 1201 1200 1199 1198 1197 1196 1195 1194 1193 1192 1191 1190 1189 1188 1187 1186 1185 1184 1183 1182 1181 1180 1179 1178 1177 1176 1175 1174 1173 1172 1171 1170 1169 1168  923 1167 1165  921 1162  920  916  663  403  133  132
 208  473  730  979  978  977  976  975  974  973  972  971  970  969  968  967  966  965  964  963  962  961  960  959  958  957  956  955  954  953  952  951  950  949  948  947  946  945  944  943  942  941  940  939  938  937  936  935  934  933  932  931  930  929  928  927  926  925  922  924 1166  669 1164  668 1161  407  918  136  134
 207  472  729  728  727  726  725  724  723  722  721  720  719  718  717  716  715  714  713  712  711  710  709  708  707  706  705  704  703  702  701  700  699  698  697  696  695  694  693  692  691  690  689  688  687  686  685  684  683  682  681  680  679  678  677  676  675  674  673  672  671  670  667  408  919  404  137  664  138
 206  471  470  469  468  467  466  465  464  463  462  461  460  459  458  457  456  455  454  453  452  451  450  449  448  447  446  445  444  443  442  441  440  439  438  437  436  435  434  433  432  431  430  429  428  427  426  425  424  423  422  421  420  419  418  417  416  415  414  413  412 1163  411  142  406  665  917  139  135
 205  204  203  202  201  200  199  198  197  196  195  194  193  192  191  190  189  188  187  186  185  184  183  182  181  180  179  178  177  176  175  174  173  172  171  170  169  168  167  166  165  164  163  162  161  160  159  158  157  156  155  154  153  152  151  150  149  148  147  146  145  144  410  143  140  409  666  141  405
