# This puzzle is unsolvable
18
128   1  66   3  74 176 185   9   7  76  12  78 234  87  13  19  17  82
130  68  67  73   2   5  77 260   8  75 184  79 190  20 233  16  14  89
  4 179 257 133 310 129 132 135 188 140  10 139 230  15  80  84  85  18
177  69 126 181 224  71   6 131 289 229 293  86  11 146  24  81 141 191
223  64 127 125 220 226 187 292 183 231 189 138 136 236 147   0 193 238
286  62  70 178 287 262 227 291 123 137 144 270 271 269  21  22 196 192
 63 308 124 180 306 186 225 182 134 232 228 311 142 322 235 237  83  90
171  65 307 258  72 261 263 298 121 303 314 267 143 148  26  88 194  91
 57 172 254 259 175 219 222 290 319 295 313 294 266 301 145  92 268  23
122  59 174 323 118 264 265 164 309 299 318 200 244 195 272  93 150 199
 58  60 114 283 285 321 302 288 305 304 239 275 250 276 296 151 197  25
169 113  61 255 315 173 216 281 274 278 249 203 300 243 297  32 198  29
120 111  53 168  55 221 251 279 277 166 152 162 242 100 206  34  28  27
117  52 256 320 215 280 253 207 115 106 159  45  40 316  35 201  96  31
119  51 165 217 213  54 282 211 208 161 248 247 202 157 240  95  94  97
116 252 112  46  56 170 107 104 317 246  44 160 241 102  33 273 101  30
 48 210  49  43 108 212 214 103 284 205 156 209 155  39  38 149 153  37
 50  47 110 167 312  42 163 218 158 105 204 109  41 245  98  36 154  99
