# This puzzle is unsolvable
42
   2    1    3    6    7    9   10  173  172   11  175   12   14  331  177   16   17   18   19   20   21   22   23   24   25   26   28  190   30   32  196  498   33  195   35   36  202  355  201  203  505   42
 164  166  167    4    5  169  170    8  328  475  478  174   13  330  176  179  180  181  182  183  339  184  185  187  188  189   27  191   29  192  348   31  194  351  501  198  354  504  358  357  503  205
 163  165  320  323  168  324  741  326  327  329  477   15  476  178  334  333  482  335  336  337  338  340  186  342  343  344  346  493  347  193  349  497  350  197   34  637   37  199  200   40  204  206
 162  319  321  608  322  469  742  473  474  472  613  615  479  480  619  481  483  622  484  485  486  487  341  488  489  491  345  763  494  495  496  767  499  352  890  639   38   41  356   43   47   45
 161  318  468  607  864  171  610  744  611  745  614  616  332  618  620  751  753  876  623  624  626  757  627  629  490  630  631  492  632  634  889  635  768  888  502  353  772   39  360  359   46  361
 160  317  467  466  470  740  471  612  325  868  746  870  617  749  750  752  877  621  754  625  993  881  880  628  759  760  761  884  633  766  636  765  638 1005  893  646  771  506   44  507  641   48
 159  316  465  606  739  609  863  743  867  747  869  871  748  872  873  874 1098  875  991  755  994  995  756  882  758  998  999  886  887 1108 1003  892  891 1006  640 1115  643  642  508  362  509  208
 158  315  464  605  738  980  865  866  982  984  985 1093  986 1094  987  990 1096 1097  879  878  992  996 1202 1104 1000 1106  762 1001 1109  764 1210  770 1007 1211  645  895  644  776  207  209   49   50
 157  314  463  604  737  862  979  981 1088  983 1090 1092 1282  988 1095  989 1196 1289 1198 1099 1103 1102 1105  997 1204  885  883 1107 1110 1002 1004 1113  500  769 1116  773  896  364  210  363   52   51
 156  313  462  603  736  861  978 1188 1089 1189 1091 1366 1192 1193 1286 1285 1195 1100 1288 1101 1199 1200 1293 1203 1205 1296 1206 1382 1207 1300 1112 1212 1213 1114  894  897  775  649  512  212  211  370
 155  312  461  602  735  860  977 1087 1086 1280 1191 1190 1364 1283 1284 1194 1287 1197 1373 1291 1374 1292 1201 1294 1295 1297 1381 1298 1299 1111 1208 1209 1302  774 1010 1118  648  898  511  647  367  365
 154  311  460  601  734  859  976 1085 1187 1186 1279 1281 1365 1367 1368 1369 1444 1370 1290 1448 1517 1450 1375 1377 1378 1379 1380 1456 1383 1301 1303 1214 1117 1009 1013 1008  777  650  510  215   55   53
 153  310  459  600  733  858  975 1084 1185 1278 1363 1440 1441 1442 1510 1443 1371 1445 1514 1372 1519 1376 1452 1453 1579 1454 1455 1459 1387 1384 1385 1304 1012  778 1014 1011  515  899  214  366  213  217
 152  309  458  599  732  857  974 1083 1184 1277 1362 1439 1508 1509 1511 1621 1570 1513 1516 1515 1705 1449 1451 1520 1578 1521 1523 1524 1458 1457 1460 1305 1215 1119  900 1308  781  779  513  369   54  368
 151  308  457  598  731  856  973 1082 1183 1276 1361 1438 1507 1568 1569 1512 1572 1573 1624 1446 1518 1576 1628 1629 1577 1632 1580 1522 1525 1583 1388 1217 1216 1219 1218  654  901  780  514  372   57   56
 150  307  456  597  730  855  972 1081 1182 1275 1360 1437 1506 1567 1665 1620 1571 1622 1626 1447 1575 1574 1627 1670 1631 1582 1633 1526 1393 1527 1221 1220 1307  902 1015  905  904  651 1016  371  216  655
 149  306  455  596  729  854  971 1080 1181 1274 1359 1436 1505 1566 1619 1664 1667 1666 1625 1623 1669 1706 1672 1673 1630 1674 1634 1581 1386 1306 1462 1120 1020 1529 1018  652  906  783  653  221  516   58
 148  305  454  595  728  853  970 1079 1180 1273 1358 1435 1565 1503 1618 1617 1700 1701 1728 1703 1704 1671 1707 1709 1734 1675 1636 1585 1584 1392 1389 1390 1126 1124 1222  785  903  373  656  220   59  219
 147  304  453  594  727  852  969 1078 1179 1272 1357 1434 1504 1616 1662 1663 1699 1702 1668 1730 1731 1733 1752 1708 1635 1710 1586 1528 1391 1461 1463 1019 1121  907  784 1017  782  518   61  375  376  218
 146  303  452  593  726  851  968 1077 1178 1271 1356 1433 1502 1564 1563 1661 1698 1747 1729 1748 1751 1732 1753 1711 1736 1676 1678 1677 1587 1464 1310 1311 1309 1125 1021 1224  517   60  659  224  223  374
 145  302  451  592  725  850  967 1076 1177 1270 1355 1432 1501 1562 1615 1660 1697 1727 1746 1760 1749 1754 1763 1737 1735 1637 1588 1531 1312 1468 1465 1123 1223 1127  786 1122 1022  519  660  226  520   64
 144  301  450  591  724  849  966 1075 1176 1269 1354 1430 1431 1561 1614 1659 1724 1758 1726 1761 1750 1756 1762 1738 1712 1679 1638 1466 1530 1395 1469 1467 1226 1313 1128 1023  908  521  788  787  222   63
 143  300  449  590  723  848  965 1074 1174 1175 1268 1500 1560 1559 1613 1658 1696 1725 1743 1744 1745 1757 1755 1739 1713 1680 1639 1589 1590 1315 1314 1316 1130 1129 1225  909  789  657  377  378  379  790
 142  299  448  589  722  847  964 1073 1173 1267 1352 1428 1353 1558 1655 1612 1694 1723 1721 1759 1742 1718 1741 1740 1714 1640 1591 1533 1394 1396 1471 1227 1397 1024  911  910  663  658  662  523   67  225
 141  298  447  588  721  846  963 1072 1172 1266 1351 1496 1429 1499 1493 1656 1497 1695 1722 1720 1719 1717 1687 1716 1715 1681 1641 1593 1532 1535 1399 1473 1131  912 1027  522  913  661  381   62   65  228
 140  297  446  587  720  845  962 1071 1264 1265 1424 1350 1495 1498 1654 1653 1657 1693 1651 1689 1649 1688 1685 1684 1645 1682 1683 1594 1537 1534 1592 1470 1026 1025 1228  525  380  915  382  229  526  227
 139  296  445  719  718  844  961 1069 1070 1263 1348 1491 1611 1427 1557 1610 1652 1606 1691 1546 1603 1648 1647 1646 1686 1598 1642 1643 1405 1472 1317 1398 1229 1133  914  794  793  791  792  529   69   66
 138  295  444  586  843  960  957 1170 1169 1426 1494 1556 1555 1609 1608 1554 1690 1605 1692 1607 1600 1485 1601 1545 1543 1644 1596 1536 1540 1595 1319 1231 1318 1132 1030  528  665  664  524  796  230   68
 136  137  584  585  717  842  959 1068 1171 1349 1425 1347 1421 1490 1420 1550 1552 1549 1650 1602 1547 1482 1412 1599 1542 1597 1541 1539 1474 1401 1400 1320 1230 1134  916 1028  795  667  384  666  527   70
 135  293  294  583  716  958  841 1067 1422 1262 1261 1423 1492 1417 1553 1252 1551 1604 1548 1484 1333 1481 1483 1544 1480 1479 1478 1477 1402 1538 1321 1135 1322 1137 1232 1031 1029  531   71   72  231  232
 134  292  443  582  715  840 1065 1260 1168 1345 1346 1344 1418 1489 1158 1488 1416 1487 1486 1415 1413 1334 1243 1410 1411 1409 1407 1408 1404 1476 1327 1233 1136 1234  668  671  532  386  233  383  387  234
 290  440  442  441  581  839 1066  956 1167 1257 1343 1419 1342 1341 1340 1339 1338 1250 1337 1335 1249 1336 1246 1245 1330 1329 1328 1406 1241 1325 1324 1037 1039 1323  798  918  535  534  237  917   73   76
 133  291  439  580  714  712  838 1166  953 1259 1162 1256 1255 1254 1253 1157 1251 1155 1248 1414 1332 1149 1247 1331 1242 1146 1240 1239 1475 1143 1403 1034 1033 1032  921  920  669   74  670   75  235  238
 289  438  579  711  837  954  713  955 1064 1258 1163 1161 1159  946 1056 1055 1156 1154 1050 1153 1151 1150 1047 1046 1147 1043  814 1326  813  929 1237 1142 1140  919 1138 1139  799  797  923  385  673  388
 132  131  288  578  710  836 1062 1063 1060  703 1059  949 1160 1057 1054  943 1053 1052 1051  939 1152 1048  936  933  935 1244  932 1044 1041 1144 1040 1036  922 1236  925 1035  537  236  674  530  390  389
 130  287  437  435  577  707  952  951 1061 1165  947 1058  827  700  944  824  942  941  938 1049  937  818  817 1148 1045 1145  550 1042  810 1238  928 1235  926  924  800  397  672  803  675  533   79  536
 129  285  286  709  436  835  833 1164  706  832  948  274  701  828  826  945  823  821  694  940  820  819  554  689  816  687  409  934  931  681  685 1141 1038  807  678  802  804  398  391   78  392   77
 434  127  575  708  573  576  834  569  273  704  702  564  699  698  825  697  696  822  559  693  691  413  411  259  815  549  811  258  930  405  254  927  805  808  679  676  541  539  246  801  393  239
 128  284  125  432  574  572  570  705  950  426  831  567  422  565  563  562  561  695  558  557  692  415  556   98  686  553  407  683  551  684  809  546  545  680  677  543  542  248  394  396  538  240
 122  283  280  431  429  571  428  830  829  275  566  424  114  111  421  268  418  560  416  264  414  408  101  690  555  688  404  812   96  682    0  403  402  251  400  247   89   87  242  243   82   81
 282  126  433  121  430  279  277  276  568  427  272  112  423  270  419  420  108  266  417  106  263  261  412  552  260  410  548   94   95  406  806  255  252  544   91  399  245  395  540  244   80  241
 124  281  123  120  119  278  118  117  116  115  113  271  425  110  269  267  109  107  105  265  104  103  262  102   99  257   97  256  100  253  547   93   92  401  250   90  249   88   86   85   84   83
