# This puzzle is unsolvable
73
   2    1    3  292    6    7  294    8    9   10   11   12   13   14   15   16   17   18   19   20   21   22   23   24   25   26   27   28   29   30   31   32   33   34   35   36   37   38   39   40   41   42   43   44   45   46   47   48   49   50   51   52   53   54   55   56   57   58   59   60   61   62   63   64   65   66   67   68   69   70   71   72   73
 288  290  569  291  572    5  573  295  296  297  298  299  300  301  302  303  304  305  306  307  308  309  310  311  312  313  314  315  316  317  318  319  320  321  322  323  324  325  326  327  328  329  330  331  332  333  334  335  336  337  338  339  340  341  342  343  344  345  346  347  348  349  350  351  352  353  354  355  356  357  358  359   74
 287  289    4  842  293 1106  844  574  575  576  577  578  579  580  581  582  583  584  585  586  587  588  589  590  591  592  593  594  595  596  597  598  599  600  601  602  603  604  605  606  607  608  609  610  611  612  613  614  615  616  617  618  619  620  621  622  623  624  625  626  627  628  629  630  631  632  633  634  635  636  637  360   75
 286  568  570 1105  571 1363 1107  845  846  847  848  849  850  851  852  853  854  855  856  857  858  859  860  861  862  863  864  865  866  867  868  869  870  871  872  873  874  875  876  877  878  879  880  881  882  883  884  885  886  887  888  889  890  891  892  893  894  895  896  897  898  899  900  901  902  903  904  905  906  907  638  361   76
 285  566  841  843 1104 1364 1108 2080 1109 1110 1111 1112 1113 1114 1115 1116 1117 1118 1119 1120 1121 1122 1123 1124 1125 1126 1127 1128 1129 1130 1131 1132 1133 1134 1135 1136 1137 1138 1139 1140 1141 1142 1143 1144 1145 1146 1147 1148 1149 1150 1151 1152 1153 1154 1155 1156 1157 1158 1159 1160 1161 1162 1163 1164 1165 1166 1167 1168 1169  908  639  362   77
 284  565 1103  567 1102  840 1361 1611 1849 1366 1613 1367 1368 1369 1370 1618 1371 1372 1374 1375 1376 1377 1378 1379 1380 1381 1382 1383 1384 1385 1386 1387 1388 1389 1390 1391 1392 1393 1642 1394 1396 1397 1398 1399 1400 1401 1402 1403 1404 1405 1406 1407 1408 1409 1410 1411 1412 1413 1414 1415 1416 1417 1418 1419 1420 1421 1422 1423 1170  909  640  363   78
 283  837  839  838 1360 1608 1610 1848 1612 1365 1614 1615 1616 1617 1856 1858 1619 1373 2089 1622 1623 1624 1625 1626 1627 1628 1629 1630 1631 1632 1633 1634 1635 1636 1637 1638 1639 1640 1395 1643 1882 1644 1885 1645 1647 1648 1649 1650 1651 1652 1653 1654 1655 1656 1657 1658 1659 1660 1661 1662 1663 1664 1665 1666 1667 1668 1669 1424 1171  910  641  364   79
 282  564  836 1358 1609 1356 1847 1100 2081 1851 1852 1853 1854 2086 2087 1855 1859 2091 1621 1862 2093 1863 1864 1865 1866 1867 1868 1869 1870 1871 1872 1873 1874 1875 1876 1877 1878 1879 1641 2112 1881 1883 1884 1646 1886 1887 1888 1889 1890 1891 1892 1893 1894 1895 1896 1897 1898 1899 1900 1901 1902 1903 1904 1905 1906 1907 1670 1425 1172  911  642  365   80
 563  835  834 1101 1359 1099 1607 1850 1362 2082 2083 2084 2309 2308 2085 1857 2088 2313 1620 2092 1861 2094 2095 2096 2097 2098 2099 2100 2101 2102 2103 2104 2105 2107 2108 2546 2332 2109 2110 1880 2113 2114 2115 2116 2117 2118 2119 2120 2121 2122 2123 2124 2125 2126 2127 2128 2129 2130 2131 2132 2133 2134 2135 2136 2137 1908 1671 1426 1173  912  643  366   81
 281  561  562 1097 1606 1357 2077 1846 2079 2305 2306 2307 2310    0 2311 2526 2527 2090 1860 2314 2316 2317 2320 2534 2743 2321 2322 2323 2324 2325 2326 2327 2328 2106 2329 2545 2331 2549 2111 2335 2336 2552 2337 2338 2340 2341 2557 2342 2343 2344 2346 2347 2348 2349 2350 2351 2352 2353 2354 2355 2356 2357 2358 2359 2138 1909 1672 1427 1174  913  644  367   82
 280  279  832  560 1355 1604 1605 1845 2304 2520 2521 2522 2523 2524 2732 2525 2312 2529 2530 2315 2531 2940 2739 2532 2533 2537 2744 2538 2539 2747 2540 2749 2542 2544 2330 2753 2547 2334 2333 2550 2551 2758 2553 2339 2555 2556 2558 2559 2766 2345 2561 2562 2563 2564 2565 2566 2567 2568 2569 2570 2571 2572 2573 2360 2139 1910 1673 1428 1175  914  645  368   83
 559  833 1354 1096 1098 1603 2078 1844 2303 2519 2728 2729 2730 2731 2931 2733 2528 2735 2736 2737 2738 2740 2938 2318 2536 2942 2535 2944 2745 2746 2541 2947 2543 2750 2751 2953 2754 2548 2756 2757 2759 2760 2761 2554 2762 2763 2962 2765 2965 2560 2767 2769 2770 2771 2772 2773 2774 2775 2776 2777 2778 2779 2574 2361 2140 1911 1674 1429 1176  915  646  369   84
 278  277  558  831 1601 1842 1602 2301 2302 2518 2727 2928 2929 2930 3122 2933 2734 2934 3126 2935 2936 3129 2319 2742 2941 3132 3135 2943 2945 3138 2948 2748 2949 2950 2752 2955 3144 3143 2755 3147 2957 2958 2959 2960 2961 3153 2764 2964 2966 3157 2768 3158 2968 2970 2971 2972 2973 2974 2975 2976 2977 2780 2575 2362 2141 1912 1675 1430 1177  916  647  370   85
 276  557  830 1353 1352 1843 2075 2076 2300 2517 2726 2927 3120 3121 3123 2932 3124 3125 3309 3311 3127 3128 2939 3313 3131 2741 3134 3136 3319 2946 3137 3139 3140 3141 2951 2952 3500 3145 3331 2954 3330 3148 3150 3151 3152 3154 2963 3155 3156 3340 3159 2967 2969 3161 3162 3163 3164 3165 3166 3167 2978 2781 2576 2363 2142 1913 1676 1431 1178  917  648  371   86
 275  556 1092 1095 1094 1841 1840 2074 2299 2516 2725 2926 3119 3304 3305 3306 3307 3308 3484 2937 3486 3312 3130 3314 3316 3133 3317 3493 3318 3321 3497 3324 3499 3665 3325 3142 3502 3328 2956 3504 3332 3149 3508 3333 3336 3510 3337 3512 3338 3339 3341 3342 3160 3344 3345 3346 3347 3348 3349 3168 2979 2782 2577 2364 2143 1914 1677 1432 1179  918  649  372   87
 273  274 1093 1597  829 1351 1599 2514 2297 2515 2724 2925 3118 3303 3480 3481 3482 3483 3485 3310 3487 3654 3488 3489 3315 3657 3492 3494 3660 3496 3322 3498 3667 3666 3501 3326 3329 3146 3327 3672 3505 3506 3507 3334 3509 3335 3513 3514 3515 3516 3517 3518 3343 3519 3520 3521 3522 3523 3350 3169 2980 2783 2578 2365 2144 1915 1678 1433 1180  919  650  373   88
 554  828  555  827 1600 2072 2073 1598 1837 2070 2924 3115 3117 3302 3479 3648 3649 3650 3651 3652 3653 3813 3655 3656 3491 3490 3818 3661 3495 3320 3662 3664 3323 3825 3826 3668 3669 3503 3671 3673 3674 3834 3835 3675 3678 3511 3679 3680 3681 3682 3683 3684 3685 3686 3687 3688 3689 3524 3351 3170 2981 2784 2579 2366 2145 1916 1679 1434 1181  920  651  374   89
 553  552  826 1091 1350 1349 1838 2723 2298 2296 2722 2923 3116 3301 3478 3646 3647 3808 3810 3811 3812 3964 3814 3815 3816 3658 3817 3659 3820 3821 3663 3974 3822 3824 3977 3827 3829 3830 3980 3832 3833 3984 3985 3677 3676 3988 3838 3839 3840 3841 3842 3843 3844 3845 3846 3847 3690 3525 3352 3171 2982 2785 2580 2367 2146 1917 1680 1435 1182  921  652  375   90
 272  551  824 1090 1348 1347 1836 1839 2071 2295 2721 2921 2922 3300 3477 3645 3807 3960 3961 3962 4104 4241 4108 3966 3967 3968 4113 4112 3819 3971 3972 3973 3823 3975 3976 3979 3828 4123 3670 3981 3831 3982 4128 3986 3837 3989 4132 3990 3991 3992 3993 3994 3995 3996 3997 3848 3691 3526 3353 3172 2983 2786 2581 2368 2147 1918 1681 1436 1183  922  653  376   91
 271  269 1088  825 1089 1596 2069 1835 2511 2513 2720 2718 3114 3299 3476 3806 3959 3809 4103 4106 3965 4370 4107 4109 4110 4111 3969 3970 4248 4114 4252 4117 4253 4118 4254 4121 4256 4258 4124 4125 3983 4127 4263 4129 4130 3836 4133 4134 4269 4135 4136 4137 4138 4139 3998 3849 3528 3692 3354 3173 2984 2787 2582 2369 2148 1919 1682 1437 1184  923  654  377   92
 822  549  550  823 1345 1346 1593 2068 2294 2512 2717 2510 3112 3113 3298 3643 3644 3804 3958 4242 4368 4105 4244 4371 4245 4246 4247 4375 4377 4249 4250 4116 4380 4120 4119 4122 3978 4383 4259 4387 4126 4389 4262 4510 3987 4266 4131 4395 4268 4270 4271 4272 4273 4140 3999 3693 3851 3527 3355 3174 2985 2788 2583 2370 2149 1920 1683 1438 1185  924  655  378   93
 270  268  821 1343 1344 1834 1594 2293 2292 2509 2290 3111 2919 2918 3297 3474 3957 4102 4238 3963 3805 4489 4488 4369 4492 4493 4373 4374 4376 4115 4379 4378 4251 4499 4255 4384 4257 4385 4386 4261 4260 4507 4388 4264 4265 4394 4513 4267 4396 4397 4398 4399 4274 4141 4000 3850 3529 3531 3356 3175 2986 2789 2584 2371 2150 1921 1684 1439 1186  925  656  379   94
 267  548 1087 1592 2067 1595 1832 2066 2920 2065 2291 2719 3110 3296 3475 3642 3803 4239 4236 4101 4366 4600 4490 4243 4491 4372 4603 4495 4605 4497 4496 4381 4498 4611 4382 4502 4503 4504 4505 4617 4506 4391 4392 4390 4393 4511 4512 4514 4515 4516 4517 4400 4275 4142 4001 3852 3532 3695 3530 2791 3176 2790 2585 2372 2151 1922 1685 1440 1187  926  657  380   95
 266  547  820 1086 1342 1833 1341 2064 2288 2508 2507 2917 3109 3295 3473 3472 3641 3801 3956 4099 4100 4367 4599 4601 4602 4494 4604 4607 4709 4712 4609 4807 4501 4500 4612 4812 4717 4615 4616 4720 4618 4508 4509 4621 4622 4623 4624 4625 4626 4627 4518 4401 4276 4143 4003 4002 3696 3694 3177 3359 2987 2988 2586 2373 2152 1923 1686 1441 1188  927  658  381   96
 265  546  819 1084 1340 1591 1830 1831 2715 2506 2716 2714 3108 3294 3471 3802 3955 4098 3954 4486 4704 4240 4703 4705 4800 4706 4802 4707 4708 4804 4606 4711 4610 4613 4715 4614 4718 4813 4719 4721 4619 4620 4723 4724 4725 4726 4727 4728 4729 4628 4519 4402 4277 4004 3854 3855 3697 3357 3853 3358 2793 2792 2588 2374 2153 1924 1687 1442 1189  928  659  382   97
 264  545 1082  817 1085 1083 1588 1589 2063 2505 2915 2916 3107 3293 3636 3953 3638 3952 4365 4362 4484 4234 4485 4596 4702 4801 4889 4803 4608 4892 4806 4808 4713 4714 4896 4716 4811 4814 4902 4900 4816 4722 4818 4819 4820 4821 4822 4823 4730 4629 4520 4403 4278 4144 4005 4145 3534 3699 3360 3180 3178 2589 2990 2587 2154 1925 1688 1443 1190  929  660  383   98
 263  544  818  816 1590 1829 2287 2289 2286 2504 3106 3104 3292 3468 3470 3640 3467 3798 4097 4235 4364 4237 4487 4598 4799 4798 4888 4890 4891 4970 4893 5043 4894 4895 4809 4977 4810 4980 4899 4815 4903 4817 4905 4906 4907 4908 4909 4824 4731 4630 4521 4404 4279 4147 4146 3701 3535 3700 3179 3361 3181 2989 2376 2375 2155 1926 1689 1444 1191  930  661  384   99
 262  543  815 1081 1339 1338 2062 2061 2502 2712 2710 2713 2914 3291 3800 3639 3637 3951 4096 4233 4363 4483 4699 4887 4597 4886 4966 4968 5041 4710 4972 4973 4805 4975 4897 5167 5049 5169 4901 4981 4982 4904 4984 4985 4986 4987 4910 4825 4732 4631 4522 4405 4280 4148 3857 3698 3537 3533 3362 2991 2794 2992 2590 2377 2156 1928 1927 1445 1192  931  385  663  100
 261  542  814 1080 1337 1587 1828 2503 2059 1827 2285 2911 2913 3105 3469 3799 3289 3797 3950 4095 4361 4593 4482 4594 4595 4700 4967 4969 5040 4971 5044 5107 4974 5047 4898 4978 4979 5053 5050 5116 5051 4983 5054 5056 5057 4988 4911 4826 4733 4632 4523 4281 4007 4149 3859 4006 3856 3536 3363 3182 2993 2795 2796 2158 2378 1692 1690 1691 1193 1194  932  662  386
 260  541  813 1079 1586 1585 2284 1826 2060 2058 2711 3103 2912 3465 3290 3635 3795 3949 4094 4232 4231 4360 4797 4480 4795 4965 4884 5104 5105 5042 5106 5209 5045 4976 5164 5048 5112 5114 5113 5215 5115 5171 5055 5118 5058 5220 4912 4827 4734 4633 4524 4406 4283 4282 4150 3858 3703 3702 3364 3183 2994 2797 2591 2592 2157 1929 1447 1446  933  664  387  102  103
 259  540 1078 1335 1336 1584 1825 2057 2283 2501 2500 2910 3287 3102 3466 3634 3796 3948 4093 4230 4358 4359 4701 5039 4698 4885 5034 5038 5103 5160 5161 5108 5046 5162 5211 5253 5111 5166 5052 5216 5218 5117 5120 5119 4990 4989 4913 4828 4735 4634 4525 4408 4407 4151 4009 3861 4008 3538 3365 3184 2995 2594 2380 2379 2159 1930 1693 1448 1195  934  665  101  388
 258  539  812 1077 1334 1583 1823 1824 2282 2499 2709 3464 3288 2909 3463 3633 3794 3793 3947 4092 4229 4478 4481 4592 4697 4793 4963 5037 5102 5159 5208 5210 5250 5110 5109 5249 5214 5213 5257 5168 5175 5173 5222 5174 5059 5061 4991 4914 4829 4409 4526 4411 4285 4284 3860 4010 3704 3539 3366 3185 2799 2593 2798 2381 2160 1931 1694 1449 1196  935  666  389  104
 257  538  811 1076 1333 1582 2056 2055 2281 2498 3101 2907 2708 2908 3632 3792 3946 4091 4357 4228 4356 4227 4590 4479 4693 4696 4883 4962 4964 5158 5207 5163 5248 5281 5165 5306 5254 5286 5255 5256 5219 5217 5122 5062 5121 5060 4915 4830 4736 4635 4636 4528 4410 4152 4011 3706 3862 3540 3367 3186 2996 2801 2595 2382 2161 1932 1695 1450 1197  936  667  390  105
 256  537  810 1075 1332 1581 1822 2280 2279 2497 2706 3462 3285 3461 3631 3791 3630 4089 4088 4090 4695 4477 4881 4591 4796 4882 5035 5036 5101 5100 5206 5247 5280 5252 5305 5285 5282 5284 5309 5259 5172 5176 5221 5123 4992 5063 4916 4831 4737 4527 4529 4637 4286 4153 4012 3705 3541 3542 3187 2998 2800 2997 2596 2383 2162 1933 1696 1451 1198  937  668  391  106
 255  536  809 1074 1331 1580 2054 1820 2496 2495 2905 3286 3100 3460 3629 3099 3943 3789 3945 4226 4355 4476 4589 4792 4790 4880 5099 4961 5156 5157 5205 5246 5279 5212 5283 5320 5303 5307 5170 5289 5287 5258 5223 5177 5124 4994 4917 4832 4738 4739 4638 4287 4154 4013 4014 3863 3369 3370 3368 3188 2999 2802 2597 2384 2163 1934 1697 1452 1199  938  669  392  107
 254  535  808 1073 1330 1579 1821 2707 2278 2053 2906 2704 2494 3284 3283 3459 3944 3942 4087 4225 4354 4475 4694 4791 4878 4794 4960 5033 5098 5155 5154 5245 5278 5304 5251 5321 5322 5323 5308 5310 5288 5064 5224 4995 5066 5065 4834 4833 4639 4640 4530 4412 4288 4155 4015 3708 3864 3543 3371 3189 3000 2803 2598 2385 2164 1935 1698 1453 1200  939  670  393  108
 253  534  807 1072 1578 1328 2052 2275 2277 2491 2703 2705 3098 2904 3458 3628 3941 3790 4224 4223 4353 4474 4691 4692 4879 4959 4958 5032 5097 5203 5204 5244 5277 5302 5318 5319 5326 5328 5311 5292 5260 5290 5125 5178 4997 4918 4996 4741 4742 4531 4642 4413 4289 4156 3866 3865 3707 3709 3544 3190 3001 2804 2599 2386 2165 1936 1699 1454 1201  940  671  394  109
 252  533  806 1071 1329 1577 1819 2492 2276 2702 2903 2902 3097 3280 3281 3626 3788 3940 4086 4352 4473 4586 4587 4588 4789 4788 4877 5031 5096 5153 5202 5243 5275 5276 5301 5327 5325 5313 5312 5291 5261 4993 5225 5128 5179 4919 4835 4740 4641 4532 4415 4414 4290 4157 4016 3867 3710 3545 3372 3191 3002 2805 2600 2387 2166 1937 1700 1455 1202  941  672  395  110
 251  532  804 1070 1818 2051 2049 2493 1817 2700 2701 3282 3096 3787 3627 3456 3786 3939 4085 4222 4351 4472 4585 4690 4787 4876 4957 5030 5095 5201 5200 5242 5274 5300 5317 5316 5315 5324 5295 5263 5262 5180 5127 5226 5067 4998 4920 4837 4745 4743 4534 4292 4416 4017 4018 3868 3711 3546 3373 3192 3003 2806 2601 2388 2167 1938 1701 1456 1203  942  673  396  111
 250  531 1069  805 1327 1815 1576 1575 2273 2274 2490 3094 3095 3279 3455 3457 3625 4084 4083 4221 4350 4471 4584 4689 4786 4875 4956 5029 5094 5152 5150 5241 5299 5298 5297 5296 5234 5294 5314 5293 5264 5182 5181 5129 5126 4999 4921 4922 4836 4643 4417 4418 4291 4159 4158 3869 3712 3547 3374 3193 3004 2807 2602 2389 2168 1939 1702 1457 1204  943  674  397  112
 249  530  803 1067 1068 1325 1326 2050 1816 2489 2699 2901 3093 3278 3624 3622 3937 3785 4082 4220 4349 4470 4583 4688 4785 4874 4955 5028 5093 5151 5198 5199 5273 5272 5236 5270 5232 5268 5269 5266 5265 5227 5228 5069 5068 5000 4839 4744 4644 4535 4533 4419 4293 4160 4019 3870 3713 3548 3375 3194 3005 2808 2603 2390 2169 1940 1703 1458 1205  944  675  398  113
 248  529  802 1323 1324 1574 1814 2048 2272 2697 2488 3092 3454 3274 3277 3623 3784 3938 4081 4219 4348 4469 4582 4687 4784 4873 4954 5027 5092 5149 5197 5239 5240 5238 5235 5191 5140 5190 5231 5188 5230 5229 5130 5183 5001 5002 4924 4838 4747 4746 4537 4536 4294 4161 4020 3871 3714 3549 3376 3195 3006 2809 2604 2391 2170 1941 1704 1459 1206  945  676  399  114
 247  528  801 1065 1066 1572 2046 2047 2271 2698 2900 2899 3090 3091 3276 3783 3453 3621 3936 4218 4347 4468 4581 4686 4783 4872 4953 5026 5091 5148 5196 5195 5194 5271 5192 5237 5267 5189 5137 5078 5187 5185 5184 5131 5070 4923 4840 4749 4645 4646 4538 4420 4295 4162 4021 3872 3715 3550 3377 3196 3007 2810 2605 2392 2171 1942 1705 1460 1207  946  677  400  115
 246  527  800 1322 1321 1573 1812 2045 1813 2487 2696 2897 2898 3089 3782 3781 4079 3935 4217 4216 4346 4467 4580 4685 4782 4871 4952 5025 5090 5147 5146 5085 5144 5143 5193 5233 5141 5080 5139 5138 5135 5186 5133 5132 5071 4927 5072 5003 4748 4648 4539 4421 4296 4163 4022 3873 3716 3551 3378 3197 3008 2811 2606 2393 2172 1943 1706 1461 1208  947  678  401  116
 526  244  525  799 1570 1571 1811 2043 2270 2269 2694 2695 2896 3451 3452 3934 4080 4215 4078 4344 4465 4345 4579 4684 4781 4870 4951 5024 5089 5087 5020 5084 5145 5017 5142 5082 5081 5012 5013 5079 5136 5134 5008 5074 5004 5005 4925 4842 4926 4649 4423 4540 4297 4164 4023 3874 3717 3552 3379 3198 3009 2812 2607 2394 2173 1944 1707 1462 1209  948  679  402  117
 245  524 1063 1320 1064 1569 1810 2268 2044 2486 2693 2895 3088 3275 3273 3450 3620 3780 3933 4466 4214 4578 4464 4682 4683 4780 4950 5023 5022 5021 5088 4862 5018 4942 5083 5015 5014 5011 4935 5077 5009 5076 5007 5073 4931 5006 4928 4647 4750 4841 4751 4422 4298 4165 4024 3875 3718 3553 3380 3199 3010 2813 2608 2395 2174 1945 1708 1463 1210  949  680  403  118
 243  523  798  797 1062 1568 1807 2041 2042 2485 2484 2894 3086 3087 3272 3618 3779 3932 4077 4341 4577 4463 4681 4576 4779 4869 4949 4948 4947 4944 4863 5086 4943 4941 5016 4859 4939 4938 4937 4853 4936 4934 4933 5075 4932 4930 4929 4843 4844 4650 4651 4541 4424 4166 4025 3876 3719 3554 3381 3200 3011 2814 2609 2396 2175 1946 1709 1464 1211  950  681  404  119
 242  795  796 1061 1567 1808 1809 2266 2483 2692 2691 2893 3271 3448 3447 3449 3619 3617 4075 4076 4342 4343 4462 4680 4778 4868 4774 4866 4864 4946 4945 4769 4861 4860 4857 4940 4856 4855 4854 4852 5010 4851 4850 4849 4848 4847 4846 4845 4752 4542 4425 4300 4299 4167 4026 3877 3720 3555 3382 3201 3012 2815 2610 2397 2176 1947 1710 1465 1212  951  682  405  120
 241  794  793 1317 1319 1566 2039 2265 2267 2892 2690 3085 3084 3270 3616 3777 3776 3778 3930 4213 4212 4461 4575 4679 4777 4867 4776 4675 4865 4773 4771 5019 4770 4768 4858 4767 4765 4764 4763 4762 4761 4760 4759 4758 4757 4756 4755 4754 4753 4652 4543 4426 4301 4168 4027 3878 3721 3556 3383 3202 3013 2816 2611 2398 2177 1948 1711 1466 1213  952  683  406  121
 520  240  522 1060 1318 1565 1806 2038 2040 2482 2264 2891 3083 3269 3615 3614 3929 3931 4073 4340 4460 4336 4574 4677 4678 4569 4775 4567 4772 4672 4565 4670 4669 4447 4667 4766 4666 4665 4664 4663 4662 4661 4660 4659 4658 4657 4656 4655 4654 4653 4544 4427 4302 4169 4028 3879 3722 3557 3384 3203 3014 2817 2612 2399 2178 1949 1712 1467 1214  953  684  407  122
 521 1058 1059 1315 1316 1564 1805 2263 2037 2481 2688 2689 3082 3445 3446 3613 3775 3928 4072 4074 4211 4208 4572 4457 4571 4676 4674 4568 4673 4451 4564 4671 4562 4561 4668 4560 4559 4558 4557 4556 4555 4554 4553 4552 4551 4550 4549 4548 4547 4546 4545 4428 4303 4170 4029 3880 3723 3558 3385 3204 3015 2818 2613 2400 2179 1950 1713 1468 1215  954  685  408  123
 239  519  792 1057 1314 1563 1803 2036 2262 2480 2890 3080 2888 3268 3266 3774 3927 3926 4339 4210 4338 4337 4335 4459 4570 4456 4454 4452 4328 4450 4566 4563 4449 4448 4446 4445 4444 4443 4442 4441 4440 4439 4438 4437 4436 4435 4434 4433 4432 4431 4430 4429 4304 4171 4030 3881 3724 3559 3386 3205 3016 2819 2614 2401 2180 1951 1714 1469 1216  955  686  409  124
 238  791  516 1056 1313 1562 2478 1804 2035 2479 2687 3081 3267 3443 3444 3773 3772 4068 4070 4209 3925 4066 4203 4334 4458 4455 4453 4331 4330 4329 4327 4326 4325 4324 4323 4322 4321 4320 4319 4318 4317 4316 4315 4314 4313 4312 4311 4310 4309 4308 4307 4306 4305 4172 4031 3882 3725 3560 3387 3206 3017 2820 2615 2402 2181 1952 1715 1470 1217  956  687  410  125
 518  237  790 1055 1312 1561 1802 2261 2259 2260 2886 2889 3079 3442 3612 3610 4071 3771 4069 4573 4206 4204 4202 4333 4064 4201 4200 4199 4198 4197 4196 4195 4194 4193 4192 4191 4190 4189 4188 4187 4186 4185 4184 4183 4182 4181 4180 4179 4178 4177 4176 4175 4174 4173 4032 3883 3726 3561 3388 3207 3018 2821 2616 2403 2182 1953 1716 1471 1218  957  688  411  126
 236  235  517 1054 1311 1560 1801 2031 2477 2476 2885 2686 3264 3265 3441 3440 3609 3924 4207 4205 3921 4067 3919 4063 4332 4065 4061 4060 4059 4058 4057 4056 4055 4054 4053 4052 4051 4050 4049 4048 4047 4046 4045 4044 4043 4042 4041 4040 4039 4038 4037 4036 4035 4034 4033 3884 3727 3562 3389 3208 3019 2822 2617 2404 2183 1954 1717 1472 1219  958  689  412  127
 784  515  789 1310 1559 1800 2033 2258 2034 2474 2685 2475 2887 3262 3263 3608 3923 3611 3922 3766 3920 3918 3429 3917 3761 4062 3759 3913 3912 3911 3910 3909 3908 3907 3906 3905 3904 3903 3902 3901 3900 3899 3898 3897 3896 3895 3894 3893 3892 3891 3890 3889 3888 3887 3886 3885 3728 3563 3390 3209 3020 2823 2618 2405 2184 1955 1718 1473 1220  959  690  413  128
 234  514  788 1053 1309 1558 1799 1798 2032 2257 2684 2884 3078 3077 3261 3439 3770 3767 3765 3603 3764 3763 3600 3762 3915 3916 3426 3758 3757 3756 3755 3754 3752 3418 3751 3750 3749 3748 3747 3746 3745 3744 3743 3742 3741 3740 3739 3738 3737 3736 3735 3734 3733 3732 3731 3730 3729 3564 3391 3210 3021 2824 2619 2406 2185 1956 1719 1474 1221  960  691  414  129
 787  233  786 1052 1307 1051 1308 1797 2256 2473 2683 2682 3076 3260 3438 3607 3769 3768 3604 3605 3431 3601 3430 3599 3597 3914 3596 3594 3593 3592 3421 3591 3589 3753 3588 3587 3586 3585 3584 3583 3582 3581 3580 3579 3578 3577 3576 3575 3574 3573 3572 3571 3570 3569 3568 3567 3566 3565 3392 3211 3022 2825 2620 2407 2186 1957 1720 1475 1222  961  692  415  130
 232  231  785  513 1557 1556 2030 2029 2255 2472 2681 2883 2882 3075 3437 3436 3606 3434 3254 3602 3433 3251 3428 3427 3598 3760 3246 3595 3423 3243 3420 3590 3240 3417 3236 3238 3235 3413 3234 3412 3411 3410 3409 3408 3407 3406 3405 3404 3403 3402 3401 3400 3399 3398 3397 3396 3395 3394 3393 3212 3023 2826 2621 2408 2187 1958 1721 1476 1223  962  693  416  131
 230  512 1049 1050 1306 1555 1796 2028 2254 2471 2680 2881 3074 3259 3258 3257 3435 3256 3255 3432 3252 3250 3063 3062 3247 3425 3245 3424 3244 3242 3422 3419 3054 3239 3237 3416 3414 3048 3233 3046 3232 3231 3230 3229 3228 3227 3226 3225 3224 3223 3222 3221 3220 3219 3218 3217 3216 3215 3214 3213 3024 2827 2622 2409 2188 1959 1722 1477 1224  963  694  417  132
 229  510  511  783 1048 1554 1795 2027 2253 2470 2679 2880 3073 3072 3071 3070 3069 3068 3067 3253 3066 3065 2868 3249 3248 3060 3059 3058 3057 3056 3055 3241 3053 3052 2856 3051 3415 3049 3047 2851 3045 3044 3043 3042 3041 3040 3039 3038 3037 3036 3035 3034 3033 3032 3031 3030 3029 3028 3027 3026 3025 2828 2623 2410 2189 1960 1723 1478 1225  964  695  418  133
 228  509  782 1047 1305 1304 1794 2026 2252 2469 2678 2879 2878 2877 2876 2875 2874 2873 2872 2871 2870 3064 2665 3061 2866 2865 2864 2863 2862 2861 2657 2860 2443 2858 2857 2855 2854 2650 2853 2852 2850 2848 2645 2847 2846 2845 2844 2843 2842 2841 2840 2839 2838 2837 2836 2835 2834 2833 2832 2831 2830 2829 2624 2411 2190 1961 1724 1479 1226  965  696  419  134
 227  508  781 1046 1303 1553 1792 1793 2251 2468 2677 2676 2675 2674 2673 2672 2671 2670 2669 2668 2667 2869 2664 2867 2451 2450 2662 2660 2659 2447 2658 2859 2655 2654 3050 2653 2652 2651 2648 2647 2849 2646 2434 2644 2643 2642 2641 2640 2639 2638 2637 2636 2635 2634 2633 2632 2631 2630 2629 2628 2627 2626 2625 2412 2191 1962 1725 1480 1227  966  697  420  135
 226  507  780 1045 1302 1552 1551 2025 2250 2467 2466 2465 2464 2463 2462 2461 2460 2240 2459 2458 2456 2454 2666 2452 2661 2663 2449 2448 2228 2227 2446 2656 2445 2444 2442 2441 2440 2439 2649 2437 2436 2435 2215 2433 2432 2431 2430 2429 2428 2427 2426 2425 2424 2423 2422 2421 2420 2419 2418 2417 2416 2415 2414 2413 2192 1963 1726 1481 1228  967  698  421  136
 225  506  779 1044 1301 1550 1791 2024 2249 2248 2247 2246 2245 2244 2243 2242 2241 2239 2012 2457 2235 2455 1531 2236 2453 2232 2230 2002 2229 2226 1999 2000 2225 2224 2223 2222 2221 2220 2438 2218 1990 2217 2216 2214 2213 2212 2211 2210 2209 2208 2207 2206 2205 2204 2203 2202 2201 2200 2199 2198 2197 2196 2195 2194 2193 1964 1727 1482 1229  968  699  422  137
 224  505  778 1043 1300 1549 1790 2023 2022 2021 2020 2019 2018 2017 2016 2015 1779 2014 2013 2010 2238 2237 2008 1774 1771 2233 2006 2231 2004 2003 1273 1766 1998 1997 1996 1995 1758 1993 2219 1992 1991 1989 1988 1987 1986 1985 1984 1983 1982 1981 1980 1979 1978 1977 1976 1975 1974 1973 1972 1971 1970 1969 1968 1967 1966 1965 1728 1483 1230  969  700  423  138
 223  504  777 1042 1299 1548 1789 1788 1787 1786 1785 1784 1783 1782 1781 1780 1536 1778 1777 2011 2009 1773 1772 2007 1770  750 1271 1526 1767 1765 2005 1764 1763 1762 1761 1760 1994 1759 1757 1756 1755 1754 1753 1752 1751 1750 1749 1748 1747 1746 1745 1744 1743 1742 1741 1740 1739 1738 1737 1736 1735 1734 1733 1732 1731 1730 1729 1484 1231  970  701  424  139
 222  503  776 1041 1298 1547 1546 1545 1544 1543 1542 1541 1540 1539 1538 1286 1537 1535 1534 1023 1775 1280 1530 2234 1528 1527 1768 1769 1272 2001 1524 1521 1520 1519 1518 1517 1516 1515 1514 1513 1512 1511 1510 1509 1508 1507 1506 1505 1504 1503 1502 1501 1500 1499 1498 1497 1496 1495 1494 1493 1492 1491 1490 1489 1488 1487 1486 1485 1232  971  702  425  140
 221  502  775 1040 1297 1296 1295 1294 1293 1292 1291 1290 1289 1288 1287 1285 1284 1025 1533 1532 1776 1022 1019 1529 1277 1015 1522  189 1525  745 1523 1269 1009 1010 1268 1266 1265 1264 1263 1262 1261 1260 1259 1258 1257 1256 1255 1254 1253 1252 1251 1250 1249 1248 1247 1246 1245 1244 1243 1242 1241 1240 1239 1238 1237 1236 1235 1234 1233  972  703  426  141
 220  501  774 1039 1038 1037 1036 1035 1034 1033 1032 1031 1030 1029 1028 1027 1026 1024 1283 1281 1021 1282  478 1278  753 1017 1016 1274  747 1013 1012  743 1270 1008 1267  740 1006 1005 1004 1003 1002 1001 1000  999  998  997  996  995  994  993  992  991  990  989  988  987  986  985  984  983  982  981  980  979  978  977  976  975  974  973  704  427  142
 219  500  773  772  771  770  769  768  767  766  765  764  763  762  761  760  759  758  757  756  755  754  195 1279  752 1275 1276  474  748 1014  469  470 1011  742 1007  741  739  738  737  736  735  734  733  732  731  730  729  728  727  726  725  724  723  722  721  720  719  718  717  716  715  714  713  712  711  710  709  708  707  706  705  428  143
 218  499  498  497  496  495  494  493  492  491  490  489  488  487  486  485  484  483  482  481  480  479 1020 1018  477  193  473  749  746  471  472  744  468  467  466  465  464  463  462  461  460  459  458  457  456  455  454  453  452  451  450  449  448  447  446  445  444  443  442  441  440  439  438  437  436  435  434  433  432  431  430  429  144
 217  216  215  214  213  212  211  210  209  208  207  206  205  204  203  202  201  200  199  198  197  196  194  475  751  476  192  191  190  188  187  186  185  184  183  182  181  180  179  178  177  176  175  174  173  172  171  170  169  168  167  166  165  164  163  162  161  160  159  158  157  156  155  154  153  152  151  150  149  148  147  146  145
