# This puzzle is unsolvable
51
   3    1    2  201  205  578    6  208  207  211  584    7  210   11   14  214   16   18   19   20   21   22   23   24   25  226   26   27   28   29   31   32   33   34   35   36   37   38   40  240   41  242   42   44   46  245   48  247   49   50   51
 200    4  390  204    5  394  393  757    8    9  400  209   13 1380  213  588  216  217  218  219  220  221  223  413  224  417  416  418  228   30  230  231  232  233  234  235  237  427   39  238  243  433  244   43   45  246   47  437  248  439  249
 197  391  202  577  921  579  395  758  206  403  924   10  405   12   15  406   17  931  409  410  411  412  222  415  597  225  600  227  603  229  421  422  423  424  425  426  236  612  430  239  431  241  790  434  618  619  620  436  438  440   54
 575  198  396  203  753  580  754  923  581  925  401  760  212  761  404  215  407  590  766  593  594  595  596  414  598  599  419  420  601  777  604  605  606  607  608  609  611  613  428  614  787  615  792  432 1116  616  961  621  442   53   52
 920  392  576  752  397 1232  398 1081  402  582  926  585  763  586 1237 1384  592  408  935  768  769  770  937  772  773 1101  775  943  778  602  779  780  781  784  610  951  786  429 1115  788  789  791  955  435  793  958  623  794  251  250   55
 574  199  751  918  922 1079  755 1233 1080  399 1085  929  930  587  762  765 1238  764  934  591 1095  936  771  938  939 1100  774  776 1103  944  945  946 1105  782  947  950  953  952  960 1112  956  957  617 1268  795  622  443  252  624  441   56
 196  573  572  750  749  919 1377  756  583 1086  759  927 1089 1088 1242  589 1090 1241 1096 1526 1389 1246 1098  941 1251 1394  942 1102 1252 1104 1256 1106  949  948  783 1540 1258 1263 1270  785 1264 1118 1117  962  959  964  796  797  255  253   57
 389  388  569  747  916  748 1082 1235 1513 1084 1087 1240  928 1385  767 1091 1093  932  933 1388 1245 1247 1249 1527 1248 1097  940 1254 1255 1890 1257 1400 1401 1107 1109 1259 1262 1541  954 1111 1409 1412  963 1266 1119  966 1269  625  444  254   58
 193  194  195  386 1231 1230 1234 1077 1083 1515 1514 1236 1379 1382 1239 1094 1520 1243 1244 1523 1524 1390 1392 1099 1529 1250 1531 1658 1253 1779 1398 1536 1403 1261 1108 1110 1668 1406 1542 1114 1408 1113 1265 1121 1120  799  626   60  445  257  256
 192  191  384  917  570 1376 1078 1375 1640 1511 1378 1516 1643 1381 1518 1519 1522 1386 1387 1768 1525 1769 1391 1656 1655 1396 1775 1659 1661 1395 1533 1995 1663 1669 1538 1260 1405 1670 1672 1789 1411 1267 1410  798 1544 1123  447  801  627   61  258
 385  387  383  571  915 1076 1229 1374 1512 1639 1641 1642 1762 1517 1383 1765 1766 1649 1521 1652 1767 1883 2080 1393 1653 1776 1530 1778 1397 1532 1892 1662 1664 1895 1537 1404 1402 1667 1407 1543 1790 1545  965 1273  450 1122  800   64  446  448   59
 190  382  568  746  914 1075 1228 1373 1510 1760 1872 1761 1976 1763 1645 1646 1092 1879 1771 2163 1770 1772 1987 1651 1528 1657 1885 1777 1660 1889 1399 1781 1783 1784 1665 1539 1666 1786 1673 1900 1788 1546 1124 1413 1271 1414  967   63  628  632   62
 381  188  567  745  913 1074 1227 1372 1509 1638 1759 1873 1874 1871 1644 1978 1648 1878 1981 1650 1880 1983 2081 2083 1989 1774 2085 1888 1534 1535 1891 1893 1782 1894 1896 1785 1897 2095 1674 1549 1548 1793 1415 1274 1547 1272  802  970  968  631  261
 189  566  565  744  912 1073 1226 1371 1508 1637 1758 1973 1975 1764 2072 2244 1877 1980 2076 1654 1647 1773 1881 1986 1882 2172 1887 2089 1992 1780 2090 2177 1996 1998 1999 1787 2000 1898 1899 1551 1675 1416 1275 1276 1126  969 1125  262  629  451  260
 187  564  379  743  911 1072 1225 1370 1507 1636 1757 1869 1870 1977 1876 2070 2074 1979 2079 1984 2246 2168 1884 2170 1988 1990 1886 2253 2252 2175 2176 2088 1994 2093 2092 2094 2001 2002 1791 2003 1420 1277 1550 1417  630  807  803  449  806   68   66
 186  380  563  742  910 1071 1224 1369 1506 1635 1756 1971 1974 2241 1982 2073 1875 2162 2164 2075 2078 2243 2249 2167 1985 2082 2173 1991 2325 2174 2254 1993 2179 1997 2180 2181 2096 1902 1901 1792 1418 1676 1128 1127 1129  633  453  259   67  452   65
 185  378  740  741  909 1070 1223 1368 1505 1634 1755 1972 1868 2160 2158 2161 2239 2077 2165 2245 2379 2318 2166 2171 2169 2322 2251 2086 2388 2087 2255 2091 2330 2258 2178 2261 1903 2183 1795 1671 1794 1552 1677 1419  971  809  804  972  805  636   69
 184  377  562  739  908 1069 1222 1367 1504 1633 1867 1970 2069 2071 2240 2313 2242 2311 2314 2317 2316 2435 2319 2248 2320 2084 2250 2323 2327 2324 2488 2257 2328 2262 2184 2182 2259 2097 2005 1904 1678 1555 1553  973  808 1278  634  635  265  263  638
 183  376  561  738  907 1068 1221 1366 1503 1632 1754 2159 1866 2068 2157 2238 2312 2431 2380 2315 2382 2247 2381 2437 2384 2321 2486 2385 2390 2444 2387 2256 2489 2329 2260 2185 2006 2004 1905 1906 1680 1421 1423 1279 1131 1130  637  266   70  455  264
 182  375  560  737  906 1067 1220 1365 1502 1631 1753 1864 1865 2067 2155 2156 2237 2310 2375 2376 2433 2483 2436 2383 2438 2439 2441 2386 2491 2449 2326 2443 2393 2391 2263 2331 2099 1798 1797 1907 1422 1681 1554 1280  974  976  975  454  268  810   71
 181  374  559  736  905 1066 1364 1218 1501 1630 1752 1863 1862 1969 2066 2236 2309 2373 2430 2377 2434 2481 2482 2484 2485 2440 2526 2527 2492 2490 2389 2445 2392 2333 2394 2186 2098 1910 1679 1799 1556 1425 1283 1281 1132  977  639  457  459  267  269
 180  373  558  735  904 1217 1219 1500 1629 1628 1751 1968 2154 1966 2153 2235 2308 2432 2478 2378 2480 2521 2522 2523 2524 2525 2578 2487 2442 2559 2493 2448 2395 2332 2008 2100 2009 1796 2007 1801 1427 1282 1683 1134 1133  978  812  811  458  456   72
 179  372  557  734  903 1065 1064 1363 1499 1750 1627 1749 1967 2065 2152 2234 2374 2429 2479 2519 2520 2552 2553 2554 2555 2556 2557 2528 2529 2558 2494 2447 2396 2335 2334 2102 2101 1909 2264 2010 1558 1682 1426 1424 1557 1285  813  640  460  270   73
 178  371  556  733  902 1063 1216 1362 1361 1626 1498 1965 1861 2064 2233 2307 2372 2306 2428 2477 2518 2551 2576 2577 2593 2594 2560 2561 2532 2530 2451 2450 2266 2265 2187 2267 2103 2104 1908 1912 1802 1559 1560 1135 1137 1136  814  641  271  272   74
 370  369  555  732  901 1215 1360 1214 1497 1625 1747 1748 1860 2063 2062 2232 2370 2371 2427 2476 2517 2550 2575 2592 2596 2583 2579 2584 2582 2531 2446 2495 2397 2336 2268 2188 2190 2189 2012 2011 1684 1685 1428 1284 1286  979  980  642  462  461   75
 177  367  554  552  731  900 1062 1061 1359 1496 1746 1859 2061 2150 2151 2231 2305 2368 2426 2475 2516 2549 2574 2599 2600 2580 2586 2563 2581 2533 2496 2497 2398 2337 2191 2192 2014 2106 1800 2017 1911 1561 1429 1140 1138  981  815  273   76  463   77
 175  176  368  729  898 1212 1211 1358 1495 1624 1745 1963 1962 2060 1964 2149 2369 2304 2424 2425 2515 2548 2573 2589 2591 2595 2598 2597 2562 2534 2454 2452 2399 2338 2269 2272 2107 2015 1914 1803 1686 1689 1687 1563  982  816  817  643  644  275  274
1059  366  899  730 1058 1213  727 1357 1494 1623 1744 1858 1961 2059 2148 2303 2229 2302 2367 2423 2513 2514 2546 2547 2590 2588 2567 2566 2568 2535 2453 2499 2400 2339 2105 1808 2194 1804 2109 1562 1688 1287 1289 1139 1288  983  818  645  465  464   78
 553  174  365  551  897  728 1356 1355 1493 1622 1856 1857 1960 2058 2147 2230 2301 2366 2473 2474 2471 2572 2571 2543 2569 2570 2539 2585 2564 2565 2498 2401 2402 2340    0 2270 1913 2193 2108 1915 1806 1807 1430 1290 1141  984  819  646  466  276   79
 173  550  895 1057 1060 1209 1056 1492 1491 1621 1743 1855 1959 2057 2146 2228 2227 2300 2365 2512 2472 2545 2544 2542 2541 2540 2538 2587 2503 2536 2500 2455 2341 2342 2273 2110 2111 2013 1805 2016 1917 1565 1564 1291 1142  985  820  647  467  277   80
 172  171  549  894  725 1055 1210 1354 1620 1741 1742 1854 1958 2056 2145 2226 2364 2420 2422 2468 2470 2510 2509 2508 2507 2506 2505 2504 2460 2501 2537 2456 2403 2196 2195 2271 2019 1918 1690 2018 1566 1432 1431 1433 1292  986  821  648  468  278   81
 170  364  726  363  724  896 1208 1353 1490 1619 1740 1853 1957 2055 2225 2298 2299 2421 2469 2511 2417 2467 2466 2465 2464 2463 2462 2461 2459 2502 2458 2457 2404 2343 2274 2197 2112 2020 1809 1916 1691 1567 1434 1293 1143  988  987  822  649  279   82
 362  547  548  361  722 1054 1207 1352 1489 1618 1739 1852 2054 2143 2144 2224 2362 2363 2360 2419 2418 2416 2415 2414 2413 2412 2411 2410 2409 2408 2407 2406 2405 2344 2275 2198 2113 1919 1810 1811 1692 1569 1435 1294 1144 1145  823  650  469  280   83
 169  168  546  892  893  723 1053 1351 1488 1617 1738 1851 1956 2053 2142 2223 2297 2296 2293 2359 2291 2357 2356 2355 2354 2353 2352 2351 2350 2349 2348 2347 2346 2345 2276 2199 2114 2021 1920 1437 1568 1693 1295 1296 1146  989  824  651  470  281   84
 167  359  360  890  721 1205 1206 1350 1487 1616 1737 1850 1955 2052 2141 2222 2295 2361 2294 2358 2292 2290 2289 2288 2287 2286 2285 2284 2283 2282 2281 2280 2279 2278 2277 2200 1921 2022 1812 1694 1695 1571 1572 1436 1147  990  825  652  471  282   85
 165  545  166 1050  889 1052 1204 1349 1486 1615 1736 1849 1954 2051 2140 2221 2220 2219 2218 2217 2216 2215 2214 2213 2212 2211 2210 2209 2208 2207 2206 2205 2204 2203 2202 2201 2115 2023 1922 1813 1696 1570 1438 1297 1148  991  826  653  472  283   86
 544  543  720  891  888 1051 1203 1348 1485 1614 1735 1848 1953 2050 2139 2138 2137 2136 2135 2134 2133 2132 2131 2130 2129 2128 2127 2126 2125 2124 2123 2122 2121 2120 2119 2118 2116 2117 2024 1814 1697 1573 1439 1298 1149  992  827  654  473  284   87
 357  358  541  887  542 1049 1202 1347 1484 1613 1734 1847 1952 2049 2048 2047 2046 2045 2044 2043 2042 2041 2040 2039 2038 2037 2036 2035 2034 2033 2032 2031 2030 2029 2028 2027 2026 2025 1923 1924 1816 1698 1440 1299 1150  993  828  655  474  285   88
 164  355  356  540  719 1048 1201 1346 1483 1612 1733 1846 1951 1950 1949 1948 1947 1946 1945 1944 1943 1942 1941 1940 1939 1938 1937 1936 1935 1934 1933 1932 1931 1930 1929 1928 1927 1926 1925 1699 1815 1574 1441 1300 1151  994  829  656  475  286   89
 163  717  354  718  886 1047 1200 1345 1482 1611 1732 1845 1844 1843 1842 1841 1840 1839 1838 1837 1836 1835 1834 1833 1832 1831 1830 1829 1828 1827 1826 1825 1824 1823 1822 1821 1820 1819 1818 1817 1700 1575 1442 1301 1152  995  830  657  476  287   90
 162  161  353  716  539 1046 1199 1344 1481 1610 1731 1730 1729 1728 1727 1726 1725 1724 1723 1722 1721 1720 1719 1718 1717 1716 1715 1714 1713 1712 1711 1710 1709 1708 1707 1706 1705 1704 1703 1702 1701 1576 1443 1302 1153  996  831  658  477  288   91
 159  538  715  884  885 1045 1198 1343 1480 1609 1608 1607 1606 1605 1604 1603 1602 1601 1600 1599 1598 1597 1596 1595 1594 1593 1592 1591 1590 1589 1588 1587 1586 1585 1584 1583 1582 1581 1580 1579 1578 1577 1444 1303 1154  997  832  659  478  289   92
 158  160  352  537  882 1044 1197 1342 1479 1478 1477 1476 1475 1474 1473 1472 1471 1470 1469 1468 1467 1466 1465 1464 1463 1462 1461 1460 1459 1458 1457 1456 1455 1454 1453 1452 1451 1450 1449 1448 1447 1446 1445 1304 1155  998  833  660  479  290   93
 157  351  536  883  713 1043 1196 1341 1340 1339 1338 1337 1336 1335 1334 1333 1332 1331 1330 1329 1328 1327 1326 1325 1324 1323 1322 1321 1320 1319 1318 1317 1316 1315 1314 1313 1312 1311 1310 1309 1308 1307 1306 1305 1156  999  834  661  480  291   94
 350  349  714  712  881 1042 1195 1194 1193 1192 1191 1190 1189 1188 1187 1186 1185 1184 1183 1182 1181 1180 1179 1178 1177 1176 1175 1174 1173 1172 1171 1170 1169 1168 1167 1166 1165 1164 1163 1162 1161 1160 1159 1158 1157 1000  835  662  481  292   95
 156  534  535  711  880 1041 1040 1039 1038 1037 1036 1035 1034 1033 1032 1031 1030 1029 1028 1027 1026 1025 1024 1023 1022 1021 1020 1019 1018 1017 1016 1015 1014 1013 1012 1011 1010 1009 1008 1007 1006 1005 1004 1003 1002 1001  836  663  482  293   96
 155  348  533  710  879  878  877  876  875  874  873  872  871  870  869  868  867  866  865  864  863  862  861  860  859  858  857  856  855  854  853  852  851  850  849  848  847  846  845  844  843  842  841  840  839  838  837  664  483  294   97
 154  347  532  709  708  707  706  705  704  703  702  701  700  699  698  697  696  695  694  693  692  691  690  689  688  687  686  685  684  683  682  681  680  679  678  677  676  675  674  673  672  671  670  669  668  667  666  665  484  295   98
 153  346  531  530  529  528  527  526  525  524  523  522  521  520  519  518  517  516  515  514  513  512  511  510  509  508  507  506  505  504  503  502  501  500  499  498  497  496  495  494  493  492  491  490  489  488  487  486  485  296   99
 152  345  344  343  342  341  340  339  338  337  336  335  334  333  332  331  330  329  328  327  326  325  324  323  322  321  320  319  318  317  316  315  314  313  312  311  310  309  308  307  306  305  304  303  302  301  300  299  298  297  100
 151  150  149  148  147  146  145  144  143  142  141  140  139  138  137  136  135  134  133  132  131  130  129  128  127  126  125  124  123  122  121  120  119  118  117  116  115  114  113  112  111  110  109  108  107  106  105  104  103  102  101
