# This puzzle is unsolvable
20
 79 202 150 149  78  82  81  84 154 211  86 263 159 265  89 218  19  20  22  16
  6  73  77   3 204 209 146 148   7  83  10  88 153  14  15 269 155  93 158  18
  2 253  80   4 144 147 145 206  11 210 156 260 343 216  13 308  17  23  21  95
  1  76 143 203  75 208   9 301 337  87 262 213  12  85 344 217   8  96 311 219
141 257 205  71 254   5 261 340 152 212 339 215 270 313 345  97 163 160  25  94
255 138 256 298 151 382 334 214 304 336 369 267 309 307 157 268 222 162 165  98
199 139 300 335 251 383 259 207 264 346 395 302 100 266 221  92  91 161  24 274
 72 294  67 252  74 357 385 364 333 276 303 275 370 167 397  90 271  28  26 102
198  68 201 134 249 140 384 338 399 272 387   0 396 312 367 349 390 341 220 347
 69 135 200 295 393 297 332 368 365 381 377 398 389 374 166 366 342 310 101 314
 70 293 137 328 326 363 248 394 258 299 376 306 283 348 315 169 223 273  30 170
197 329 142 250 195 292 360 361 358 330 236 388 229 168 224 372  31 104  32  27
 66  65 245 331 379 241 289 386 362 305 373 371 322 355 375 318 228 225  99 105
130 133 136 246 359 194 380 317 323 288 321 353 350 278 285 171 316 172 108  29
132  64  63 247 129 296 291 244 240 181 352 378 287 230 282 109 164  33  34 106
196  62 193 127 185 122 327 186 284 392 356 234 391 231 232 351  37 177 226 279
190 191 131 187  60 239 325 119 120 237 117 176 113 320 114 178 277 103 319  35
 61 128 286  54 188 290 324 243 121  47 182 179 233  43  44  45 112 174  36 111
 59 126 192 242 125 124 183  53  51 184 115 235 180 281 107 110 280 227  41 175
 58  57  56  55 189  50 123 238  52  49 354  48  46  38 118 173 116  42  40  39
