# This puzzle is unsolvable
24
 95  94   5  91   6  99 100  97   8   9  13  10 105  15  14 106  16 190  18 112 332  21  23  24
  1   2  96   3   4  98   7 101 186 102 104  11 389 268 107 109 193  19 110 191  20  22 116  25
177 179 252 254  92 253 182 258 183 260 185 388 263 108 441 485 385 192 111 195 196 113 114  26
 93 175 178  88 251 321 381 256 180 329 103 187 387 189 265  17 269 199 194 271 270 118 115  27
173  90 322 181 318 257 255 481 325 323 475  12 259 264 486 483 267 393 333 272 274 197  29  28
174 176 250  85  87 433 249 326 383 327 382 514 437 331 392 442 188 338 445 336 198 339 202 117
 84 172 380 429 320 511 430 317 378 435 328 517 476 184 262 266 335 273 334 337 397 203 200  31
247 316  86 248 431 379 432 434 513 539 436 261 386 438 520 330 394 341 396 201 119 125 205 123
 89 314 319 315 171 375 510 324 540 512 544 390 439 482 391 444 443 340 275 487 276  30  34  32
246 245 170 377 311 374 470 572 537 473 477 480 515 523 521 446 550 522 395 399 518 204 122 120
168 424 165  82 376 474 478 471 479 542 541 560 440 545 450 401 524 519 398 565 447 277  35  33
 83 243 244 372 423 427 509 469 384 508 573 563 561 566 402 490 400 547 484 343 121 278 342 206
166 167 241  80 373 559 370 556 543 516 546 564 568   0 575 526 493 449 403 279 448 127  36 207
 81 164  79 313 426 428 506 504 538 421 567 569 502 549 562 529 451 488 548 404 453 208 282  37
 78  77 238 368 472 371 425 557 570 558 536 555 527 494 574 491 495 492 405 128 346 280 283  38
169 161 242 369 467 468 503 507 535 532 571 501 458 525 498 496 452 457 454 284  42 124  40  39
163 310 308 162 240 554 465 422 531 499 505 413 461 500 293 489 551 345 408 344 131 348 126  41
 76 309  75 364 235 312 367 366 533 463 294 224 462 530 459 460 456 552 347 129 353 281 286  44
239 307 157 365 299 534 464 418 415 414 360  57 497 361 291 411 219 292 409 349 406 213 130  43
159  74 160 151 306 302 363 416 362 300 357 297 358 412 553 528 354 211 288 209 210 214 216 133
 73 234 303 153 304  64 466 301 419 359 225 223  54 289 355 226 455 218 290 410 132 212 407 135
 71 237 232 155 305 152 231  61 150 148 298 295 144  56 140 356 350  53 285  46 142 217  45 215
 70  72 158 236  66  63  62  60 229 149 296 228 146 145 143  52 221 138 352  51 136 351  47 134
 69  68 233 156 420  67  65 154 227  59 230 417  58 222 147 220  55 139 141 287  50 137  49  48
