# This puzzle is unsolvable
45
 346  175  504  178  345  181  349    5  183    9  186  187   13   14   15   16   17   18   19   20   21   22   23   24   25   26   27   28   29   30   31   32   33   34   35   36   37   38   39   40   41   42   43   44   45
   1  177  176  179    3  182    7  350    8  351  184   12  189  515  191  358  360  192  362  194  196  197  198  199  200  201  202  203  204  205  206  207  208  209  210  211  212  213  214  215  216  217  218  219   46
 344  343  180    2    4    6  659  509   11  354  352   10  188  357  517  190  668  193  519  195  363  364  365  366  367  368  369  370  371  372  373  374  375  376  377  378  379  380  381  382  383  384  385  220   47
 341  342  505  656  348  507  347  508  510  807  185  516  355  511  665  518  670  520  359  521  522  523  524  525  526  527  528  529  530  531  532  533  534  535  536  537  538  539  540  541  542  543  386  221   48
 174  503  657  801  502  506  802  937  661  353  513  664  356 1071  666  667  669  671  361  672  673  674  675  676  677  678  679  680  681  682  683  684  685  686  687  688  689  690  691  692  693  544  387  222   49
 799  173  339  501  658  804  662  660  663  942  808  945  514  809  811  946  812  813  814  815  816  817  818  819  820  821  822  823  824  825  826  827  828  829  830  831  832  833  834  835  694  545  388  223   50
 340  337  172  800  655  935  803  805  941  943  512  806 1070  944  810  947 1074  948  949  950  951  952  953  954  955  956  957  958  959  960  961  962  963  964  965  966  967  968  969  836  695  546  389  224   51
 171  338  167  934  938 1183  936 1064 1296 1295  939 1298 1067 1190 1072 1192 1073 1075 1076 1077 1078 1079 1080 1081 1082 1083 1084 1085 1086 1087 1088 1089 1090 1091 1092 1093 1094 1095  970  837  696  547  390  225   52
 168  170  651  499  654 1063 1062 1066 1297 1065 1186 1068  940 1188 1191 1303 1193 1194 1195 1196 1197 1198 1199 1200 1201 1203 1204 1417 1205 1206 1207 1208 1209 1210 1211 1212 1213 1096  971  838  697  548  391  226   53
 336  797  653  500  798  932  933 1185 1299 1184 1189 1401 1069 1301 1499 1405 1304 1305 1306 1307 1308 1309 1310 1311 1314 1202 1512 1316 1513 1317 1319 1422 1320 1321 1322 1323 1214 1097  972  839  698  549  392  227   54
 334  335  652  649  496  795  796 1293 1180 1182 1187 1300 1498 1302 1404 1407 1502 1408 1409 1410 1411 1412 1413 1509 1312 1315 1313 1419 1418 1421 1318 1423 1518 1424 1425 1324 1215 1098  973  840  699  550  393  228   55
 169  498  647  497  495  794  931 1059 1181 1399 1294 1586 1497 1500 1501 1664 1667 1503 1504 1505 1506 1507 1414 1415 1510 1416 1511 1601 1514 1420 1516 1517 1519 1426 1325 1216 1100  975  842 1099  700  551  394  229   56
 166  165  648  650 1057  793 1061 1060 1292 1398 1400 1403 1587 1582 1665 1402 1589 1590 1591 1592 1593 1594 1508 1595 1596 1597 1598 1600 1680 1515 1603 1604 1605 1520 1427 1326  974 1101  976  841  701  552  395  230   57
 333  164  792  646  930  929 1179 1291 1495 1491 1396 1583 1666 1496 1585 1406 1739 1670 1804 1671 1672 1673 1674 1675 1676 1677 1599 1679 1681 1602 1751 1683 1606 1521 1428 1218 1217  977  843  702  553  554  396  231   58
 163  494  493  491  645  791 1178 1176 1058 1584 1397 1494 1735 1668 1802 1734 1588 1740 1669 1858 1806 1744 1745 1746 1747 1811 1678 1749 1750 1752 1682 1684 1523 1607 1522 1327 1219 1102 1103  703  978  397  232  233   59
 332  160  492  788  789  790  928 1288 1395 1394 1493 1856 1662 1738 1737 1736 1803 1905 1805 1861 1743 1807 1808 1809 1810 1812 1748 1813 1814 1816 1753 1754 1608 1429 1609 1430 1328 1330 1220  981  705  555  398  400   60
 161  331  490  330  927  926 1056 1175 1177 1289 1581 1393 1661 1663 1799 1857 1741 1859 1860 1742 1908 1862 1863 1864 1865 1866 1867 1868 1818 1870 1815 1685 1817 1610 1329 1332 1104 1221  845  844  979  556  235  234   61
 159  162  329  644  925 1054 1053 1287 1489 1290 1579 1492 1659 1733 1801 1800 1798 1855 1906 1907 1909 1910 1949 1912 1951 1913 1916 1915 1758 1869 1755 1687 1688 1524 1431 1432 1105  980  846  704  706  399  557   63  236
 328  489  643  642  787  923 1055 1174 1490 1392 1578 1580 1660 1732 1797 1854 1903 1904 1944 1946 1978 1947 1948 1950 1911 1914 1984 1872 1917 1871 1434 1756 1612 1686 1225 1525 1222 1224  848  847  707  558  402  401   62
 158  327  487  488  641  786 1052  924 1173 1286 1391 1577 1658 1731 1796 1902 1943 1941 1977 1942 1979 2002 1980 2004 1981 1952 1983 1953 1919 1918 1689 1757 1611 1433 1333 1331 1226 1223 1106  849  708  559  403  237  238
 157  326  640  639  785  922 1051 1172 1390 1487 1488 1576 1657 1730 1795 1853 1976 1940 1901 1945 2016 2001 2003 1982 2005 1985 1954 1955 1873 1761 1690 1691 1527 1526 1435 1614 1108 1335 1107  850  709  562  560   65   64
 156  325  486  638  783  921 1050 1171 1285 1389 1486 1575 1656 1729 1851 1852 1899 1900 1975 1998 1974 2017 2018 2019 2006 1986 1956 1920 1874 1760 1530 1618 1531 1613 1529 1334 1109  983  982  851  561  405  404  239   66
 155  324  484  784  485  920 1049 1170 1284 1283 1485 1574 1655 1728 1794 1793 1972 1999 1973 2000 2015 1997 2014 2007 2008 1957 1875 1823 1759 1819 1828 1821 1615 1337 1438 1436 1336  985  987  984  855  853  240  241   67
 154  323  483  637  782  919 1048 1282 1387 1388 1484 1573 1654 1727 1849 1850 1898 1897 1936 1996 2023 1993 2012 2021 2020 1987 1958 1876 1877 1763 1822 1616 1528 1820 1532 1228 1227  711 1110  988  710  712  563  406   68
 153  322  636  781  780 1047 1168 1169 1281 1386 1483 1572 1653 1726 1792 1791 1848 1971 1939 1969 2022 2024 2011 2009 1991 1988 1959 1921 1824 1692 1694 1762 1693 1617 1437 1440 1112  986 1111  852  713  564  407  242   69
 152  321  482  635  917  918 1046 1167 1280 1385 1482 1571 1652 1725 1789 1790 1937 1891 1970 2013 1965 1929 1964 1966 1960 1961 1989 1924 1923 1879 1439 1533 1695 1825 1764 1445 1441 1231  854  714  716  565  408  243   70
 151  320  481  634  779  916 1045 1166 1279 1384 1481 1570 1651 1723 1724 1845 1846 1938 1895 1968 1994 1992 1887 1886 1990 1928 1927 1878 1620 1697 1766 1765 1698 1229 1339 1113 1338  990  989  856  858  566  567  244   71
 150  319  480  633  778  914  915 1044 1165 1278 1480 1569 1650 1788 1787 1894 1847 1934 1967 1889 1931 1888 1995 1930 1774 1885 1926 1826 1922 1882 1619 1621 1534 1535 1444 1340 1230 1442  991  410  717  409  412  247  245
 149  318  479  632  777 1043 1042 1164 1277 1383 1479 1568 1649 1721 1722 1893 1896 1933 1839 1840 1711 1890 1932 1962 2010 1776 1883 1827 1925 1880 1767 1443 1696 1447 1345 1341 1342 1114  857  992  411  568  413  246   72
 148  317  478  631  776  913 1163 1162 1276 1382 1478 1567 1648 1786 1843 1844 1842 1892 1841 1779 1635 1778 1836 1835 1963 1884 1548 1705 1881 1830 1768 1699 1536 1622 1623 1232 1117  715 1235  719 1236  569   76  249   73
 147  316  477  630  775  912 1040 1041 1275 1381 1380 1566 1647 1718 1783 1716 1935 1785 1781 1838 1777 1837 1710 1632 1834 1633 1831 1832 1770 1829 1769 1538 1700 1446 1537 1233 1234 1119 1116  721  415  720  572   74   75
 146  315  476  629  774  911 1039 1161 1379 1476 1477 1565 1646 1720 1719 1643 1637 1782 1714 1713 1636 1638 1780 1772 1706 1833 1704 1546 1771 1628 1630 1703 1624 1701 1343 1344 1118  859 1115  995  718  570  573  414   77
 145  314  475  628  773  910 1038 1160 1274 1378 1474 1475 1645 1644 1717 1784 1642 1715 1557 1555 1639 1364 1365 1709 1551 1773 1458 1631 1547 1629 1544 1451 1539 1448 1120  997  860 1238  993  863  996  864  251   78   79
 144  474  473  627  772  908  909 1159 1273 1272 1377 1564 1563 1561 1641 1469 1559 1560 1466 1712 1556 1361 1460 1553 1707 1634 1708 1455 1354 1454 1626 1453 1625 1540 1541 1347 1346  994 1121  723  722  571  861  248  252
 142  313  311  626  771  907 1037 1158 1271 1376 1473 1373 1472 1372 1470 1471 1467 1370 1558 1640 1465 1554 1461 1549 1552 1359 1545 1457 1250 1355 1543 1702 1542 1350 1627 1449 1348 1123 1122  866  862  574  416  253  250
 312  143  471  472  625  770 1036 1157 1269 1374 1267 1562 1149 1263 1264 1260 1369 1468 1463 1464 1459 1462 1550 1362 1775 1252 1357 1456 1356 1353 1247 1452 1244 1352 1243 1003 1237 1126  998  725  724  418  417  254   80
 141  310  624  623  769  906 1035 1156 1153 1270 1152 1266 1265 1147 1371 1262 1367 1259 1366 1258 1257 1363 1256 1253 1360 1139 1251 1358 1249 1248 1130 1131 1450 1245 1246 1239 1351  865 1124  999  726  576  575  419   81
 140  309  470  622  905 1034 1155 1154 1268 1375 1029 1151 1150  894 1146 1024 1368 1145 1144 1143 1142 1141 1140 1255 1254 1137 1136 1135  883 1011 1007  878 1005 1128 1127  436  732 1241 1240 1001  577  255  420  256   82
 139  308  469  621  904  767 1033 1032 1031 1030  760 1028 1027 1025 1148 1023 1261  891  752 1021 1018 1017  886 1015 1014  743 1013 1012  880  879 1134 1008 1129  874 1349 1000  728 1125  867  871  730  868  578   83   84
 138  307  468  768  766  903  902  901  899  761  898  896  611  892 1026  451  755  890  753  889 1019  887  885 1016 1138  746  882 1010  592  741 1133 1132  738  733  875 1004  873 1242  870  727  259  729  581  423   86
 137  306  620  765  764  617  763  762  614  456  458  757  895  607  893  606  605 1022 1020  750  888  748  747  599  745  884  744  881  441  439 1009  735  736  591  433  588  872 1002  586  731  580  421  427  422  258
 136  305  618  619  464  616  300  459  297  900  457  610  897  609  756  450  754  751  603  749  602  601  600  444  598  597  596  440  877  739  876  594 1006  434  585  587  429  584  268  869  579  582  425  257   88
 135  304  467  466  462  461  613  615  460  294  293  612  292  758  119  454  453  604  286  448  447  446  282  445  281  443  277  593  740  595  590  437  273  589  100  269    0  734  265  583  263   92  424  262   87
 134  303  302  465  301  127  463  125  295  122  759  121  455  452  608  291  288  449  114  287  284  283  280  110  442  106  279  278  274  275  737  272  102  270   98  431   97  432  430   93  264   94  426  260  261
 133  132  131  130  129  128  296  299  298  126  124  290  123  120  118  289  117  116  115  285  113  112  111  108  109  105  107  742  276  438  104  103  101   99  435  271  267   96  266   95   90  428   91   89   85
