# This puzzle is unsolvable
39
 153    1  155  156    5  158    8  159    9   10   11   12   13   14   16  168  166   18   19  174   21   22   24   25  176   26  180   27   30   31  460   32  185   33   35  187   36   38   39
 152  297    2    4  298    7    6  302  304  439  161  163  164  165   15   17  311  169  170   20  172  317   23  175  177  319  179   29  178  324  326  183  462  588  186   34   37  188   40
 295    3  433  154  299  157  301  438  303  160  305  306  307  571  308  309  167  312  313  171  450  314  318  580  453  320  181   28  322  325  182  461  463  329  590  330  332  189  190
 151  150  430  296  561  434  563  436  440  162  568  442  570  444  445  310  446  804  447  576  315  579  173  451  581  582  456  458  323  585  589  184  708  327  328  464  191  331   41
 149  431  293  559  432  300  435  437  565  566  569  441  688  689  443  572  801  573  574  575  449  316  452  454  699  701  321  584  459  704  586  706  705  592  465  468  466   43   42
 146  148  294  429  560  680  562  564  796  795  900  567  684  799  904  690  908  448  694  577  578  808  698  811  810  812  455  703  457  816  707  587  709  710  467  193  334  333   44
 291  147  557  292  679  794  681  682  896  899  686  797  800  687  998  905  691  693  692  695  696  809  697  700  915  583  702  813  815  817  919  818  819  711  591  593  192  335  194
 145  290  428  558  678  792  791  683  994  897  798  685  902  903  802  803  907 1002  805  910  806  911 1007  913 1009  916 1098 1100  920 1013  917  921  821  820  594  469  336  195   47
 144  427  677  554  676  790  793  895  898  992 1083  993  901  999 1000  906 1088 1001 1003 1091  807 1004 1094 1095  912 1176 1010  918  814 1012 1016 1015  922  712  595  470  337   48   45
 143  289  556  425  555  789  894  991 1080 1160 1082  995 1084  996 1087 1085 1166  909 1090 1169 1092 1005 1008 1093  914 1096 1097 1011 1099 1014 1101  923  822  713  596  471  338   46  196
 142  288  426  553  675  788  893  990 1079 1081 1232 1161 1162 1165  997 1236 1301 1089 1167 1170 1171 1006 1172 1173 1174 1175 1177 1179 1180 1102 1017  924  823  714  597  472  339  197   49
 141  287  423  424  674  787  892  989 1078 1159 1158 1163 1164 1235 1086 1238 1168 1302 1359 1241 1242 1307 1309 1243 1310 1365 1178 1247 1249 1103 1018  925  824  715  598  473  340  198  199
 286  422  552  673  785  786  891  988 1077 1074 1230 1233 1297 1294 1237 1356 1357 1240 1304 1303 1305 1244 1245 1246 1364 1312 1311 1181 1248 1104 1019  926  825  716  599  341  200  202  342
 139  140  551  281  672  784  889  890  987  986 1231 1296 1295 1298 1234 1402 1404 1239 1355 1360 1361 1306 1479 1308 1317 1363 1250 1182 1183 1105 1020  927  826  717  600  474  201   51   50
 285  550  549  421  671  783  782  985 1076 1229 1157 1351 1350 1353 1300 1354 1403 1443 1475 1406 1498 1362 1367 1447 1410 1412 1254 1366 1251 1106 1021  928  718  475  601  344  203   53   52
 138  284  417  888  780  670 1075 1072 1156 1154 1155 1228 1400 1299 1397 1441 1444 1358 1405 1407 1477 1446 1408 1448 1409 1313 1316 1185 1107 1108 1023  929  602  719  477  480  476  478   54
 137  283  779  668  885  981  977  419 1073 1291 1226 1293 1399 1396 1352 1401 1471 1439 1513 1476 1445 1480 1449 1450 1411 1369 1253 1255 1184  930  829  828  827  603  722  479  343   56  204
 136  418  420  669  778  887  544  983 1153 1292 1225 1348 1227 1438 1440 1469 1472 1474 1481 1519 1414 1452 1478 1415 1413 1368 1315 1252 1022 1187  931  830  720  604  345  206  346   55   57
 135  280  282  547  416  414  546 1071 1152 1070 1224 1290 1349 1398 1436 1442 1473 1470 1497 1516 1517 1501 1482 1502 1451 1318 1257 1314 1111 1256 1024 1025  721  481  724  350  606  205   59
 134  279  548  667  982  984  883  886 1069 1150 1287 1288 1151 1347 1395 1468 1437 1520 1514 1511 1500 1503 1499 1453 1416 1372 1188 1109 1113 1186  832  831  932  605  726  723  207   58  349
 132  133  666  413  665  781  777  884 1149 1068 1346 1345 1435 1344 1394 1512 1428 1496 1460 1495 1505 1423 1515 1455 1454 1370 1371 1258 1026 1110  933 1189  833  482  725  208  348  210   60
 277  415  543  545  664  882  980  879 1067  775 1148 1223 1221 1466 1467 1492 1493 1462 1509 1510 1486 1483 1484 1458 1418 1319 1417 1259 1260 1191 1029 1190  836  934  935  347  608  209   64
 276  130  542  412  773  541  774 1066  979  881 1222 1286 1494 1389 1491 1464 1432 1488 1507 1426 1506 1518 1504 1487 1456 1375 1374 1373 1320 1027 1192 1112  936  834  607  483  351  484   61
 131  278  662  540  411  776  880 1063  978 1219 1283 1285 1338 1393 1392 1433 1390 1427 1490 1489 1508 1425 1420 1419 1377 1324 1321 1322 1261 1193 1031 1030  837  835  727  609  352   62  211
 274  663  273  275  410  659  976 1146  878 1284 1220 1341 1289 1342 1434 1336    0 1384 1332 1382 1424 1461 1485 1457 1323 1376 1378 1262 1263 1115 1114 1028  937  839  485  610  487   63  213
 129  128  538  409  661  660  877  875  975 1147 1145 1218 1343 1388 1210 1463 1275 1431 1334 1381 1128 1379 1459 1422 1421 1195 1326 1035 1194 1119 1117  938  730  728  613  612  354  353  214
 125  127  271  408  772  771  974 1142 1064 1144 1217 1340 1391 1337 1387 1429 1386 1385 1335 1207 1273 1272 1380 1328 1201 1268 1271 1034 1116 1264 1196 1032  729  939  611  212   65  217  215
 406  124  539  272  537  973  769  971 1060 1216 1138 1214 1279 1339 1213 1282 1277 1430 1206 1208 1383 1330 1331 1329 1267 1327 1204 1036 1266  942 1118  840  615  489  488  614  486  356   66
 270  407  658  123 1061  770  876 1065 1141 1062 1280 1212 1137 1211 1278 1135 1276 1209 1050 1130 1270 1274 1269 1124 1203 1125 1121 1197 1039 1120  838  940  943  732  841  490  491  355   67
 405  536  126  535  656  768  767  972  873  967 1281 1143 1053 1054 1465 1136 1133 1333 1131 1046 1045 1126 1205 1325 1198 1199 1202 1041 1123 1040 1033 1037  843  618  492  216  357  218   68
 267  268  122  657  655  970  874  968 1057 1139 1215 1140 1056  962 1134  960 1051  753 1132 1049 1048 1129 1043  954  851  952  950 1200 1265  947 1038  731  617  944  616  494  358  359   69
 121  533  653  404  269  534  763  870  762 1058  867  965  964  963  961 1052  959  958  956  858  857  855 1042 1044  854  953  852 1122  948  850  941  733  738  845  621  222  619  219   70
 120  266  531  652  403  402  969  765 1059 1055  966  761  865  863  756  861  860  859  957  955  749  856 1127  747  951  949  628  744  848  842  740  945  846  735  362  363  360  220   71
 119  264  258  532  528  872  871  649  524  764  866  760  644  757  755  862  639  752  636  514 1047  750  633  746  853  631  849  742  946  741  623  734  847  493  620  361  223  221   72
 400  263  529  650  654  527  648  869  647  868  646  758  645  759  864  640  516  754  751  635  515  511  632  748  745  629  743  627  504  626  625  622  736  739  496  844  364  495   76
 262  260  265  261  651  526  255  257  525  523  522  521  520  643  642  518  637  385  382  381  513  510  634  509  508  630  507  506  374  503  502  624  501  737  367  497   73  224   74
 118  259  401  530  398  766  397  107  253  393  390  251  388  248  519  100  384  517  638  244  512  380  379  378  377  376  235  373  505  372  371  370  500  498  369  366   75  365  226
 115  399  116  109  396  395  394  108  252  105  104  102  389  249  387  641  245  246  383  242   95  241  240  239  238  237  375  236  234  233   86   84  232  228  499   81  227   77  225
 117  114  112  111  113  254  110  256  106  391  392  250  103  101  247  386   99   97   98   96  243   94   93   92   91   90   89   88   87   85  231   83  368  230  229   82   80   79   78
