# This puzzle is unsolvable
16
 64   1 116   3 243 117  68  12 119 157  71  73  19  76 199 167
114 115 156  58  65 195  59 197   4  11   6 227 123 163  72 166
152  60 153 196  62  67   8 118 201 198  10 225  75 165 122  13
 61 109 193  63 161 159   5  56  84 246 124   9 121 125  14 226
  7 111 223 113   2  57  66 221 192  21 169 120  79  74  16  15
220  52  54 110 112 222 245 244 158 200 129  18 168  22 128 171
218  53 239 188 241 242 215 194 240 252 203 173 233 131  24  20
108 151 154 190 219 236 228  69 162 130 164 202 207  17  81 170
105 102 107 160 206 106 254 224  70 229 249 234 132 126 178  78
148  55 217 237  44 187  97 232 247  83 250  23 127  33  27  26
238 189 182 216 103 191  96  51 205  35 253 208 231   0 230 209
 99 155 183 185  98 149 255 212 179  94 251  82 140  80 204  89
146  45 172  49 141 104 184 138  31 235 137 135  28 139 133  77
143 147  50 145 180 213 214 181  93  92  36  88 210 174  90  29
 48  47 100 150 101 186  37 144  42 211  95  91 175  32 176  30
 41  46  43 248 142  38  39  86  40 177 136  25  87  85 134  34
