# This puzzle is unsolvable
16
 64 190 115   6   8  63   7 167  68  10 129 163 122  72  13  15
 60 112 111   1   4   3 247 152   9  71 118 125 199  12  16  74
113 155 117   2 114 120 157  67   5 160  11  69  14  73  17  18
 62  56 153  65  53 156 194  66 197 227 225  81  70  77 124 127
240  58 109 192 116 151 242 191 121 218 202 119 123  75  19 126
189  61 193 110 222 195 226  76 200 196 244 169 228 165  20  80
 59 221 237 219 159 224 158  51  22 252 198 164 255 203 166  21
108  57 182 243 220 250  54 162 161 204 254  79  82 130  78 170
107 148 251 185 149 210 236 238 241 201 229 168 171 128  26 208
184 154 217 105 209 235 174 248 230 233 246 140 133 206  35 131
 55 101 150 106 179 188 142 253 216  38 211  40 132 134  32  23
 43 104 223 186 234 232 138  99 245 141 205  83  88  87  24  31
 47  52 187 249 146 103 239 181  37 178 137   0  25 175  27  28
 46  97 100 147  50 102  36 213  86  91 136 212  90  85  34  84
 49  44  48 215  98  92  41  96 183  93 139  39 231  89  29  33
145  45  42 143  95 144 177 135 180 214 176  94 173 172 207  30
