# This puzzle is unsolvable
47
   2    1    3    4    5    6    7    8    9   10   11   12   13   14   15   16   17   18   19   20   21   22   23   24   26  209   27   28  211   29  213   32   31  216   33   34  221  393   41  566   42  226  404  401  403   47  228
 184  185  186  187  188  189  190  191  192  193  194  195  196  197  198  199  200  201  378  202  204  205  206  207  208   25  212  210  386  388   30   36  390   37  394  218  396   38  220  224   43   40  572   44  730   45  229
 183  360  361  362  363  364  365  366  367  368  369  370  538  371  373  375  376  543  377  203  547  379  380  381  552  551  554  709  385  555  214  215  217  392   35  395  564  223  398  225  397  724  571  227  727   46  232
 182  359  528  529  530  531  533  692  534  535  536  537  372  539  541  374  542  544  704  702  546  548  549  550  384  708  710  712  714  387  556  391  559 1013  558 1012  719  222   39  399  563  400   49  402   50   48  569
 181  358  527  688  689  690  532  842  693  845  694  697  698  849  540  700  701  853  545  706 1001  855  858 1002  382  553  711  862  713  389  717  557  718  868  560  562  873  723  726  565  874  568  722  876  728  230  405
 180  357  526  687  840  841  691  986  844  695  847  696  848  851  994  993 1131  854  998 1135  703  705  857  383 1003  707  860  863  865  716 1011 1147 1272  867  219  561 1150  720 1018  875 1020  725  407  406  231   51  234
 179  356  525  686  839  984  985  987  843  988  846  990  991 1128  699  850 1257  852 1000  997  856 1136  859 1137 1265 1005 1139 1007  864  715 1008 1010  870 1277  871  872 1279 1153  567  878  879  729  573   53  733  233  236
 178  355  524  685  838  983 1120 1121 1122 1123  989 1252 1253  992 1127 1130 1375 1132  996  995 1378 1260  999 1138 1004  861 1140 1142  866 1006 1009 1145 1148 1274  721 1014 1151 1396 1015 1019 1021  877  732   52  570  237  411
 177  354  523  684  837  982 1119 1248 1249 1250 1124 1251 1125 1126 1254 1129 1488 1258 1377 1380 1259 1262 1134 1264 1384 1267 1268 1388 1143 1141 1601 1144 1146  869 1276 1149 1016 1017 1278 1152  731  575  882   59   55  576   56
 176  353  522  683  836  981 1118 1247 1368 1369 1370 1371 1372 1373 1256 1374 1486 1489 1490 1381 1261 1263 1382 1383 1495 1266 1386 1387 1270 1501 1273 1391 1390 1392 1394 1398 1399 1395 1282 1281 1280  574  410    0  408  238   54
 175  352  521  682  835  980 1117 1246 1367 1480 1481 1482 1483 1484 1255 1485 1376 1591 1487 1491 1133 1492 1494 1496 1599 1385 1600 1497 1700 1269 1271 1500 1502 1504 1393 1275 1507 1508 1155 1156  881 1022 1023   60  409   57   58
 174  351  520  681  834  979 1116 1245 1366 1479 1584 1585 1586 1587 1588 1589 1685 1590 1592 1593 1379 1595 1596 1691 1692 1498 1598 1499 1602 1603 1389 1606 1505 1506 1608 1400 1509 1397 1157 1154 1025  880  412  577  413  415  235
 173  350  519  680  833  978 1115 1244 1365 1478 1583 1680 1681 1682 1683 1684 1772 1686 1687 1688 1594 1493 1778 1777 1690 1597 1694 1695 1699 1604 1697 1605 1701 1702 1703 1704 1024 1609 1611 1158  885  883  579   62  584  239  241
 172  349  518  679  832  977 1114 1243 1364 1477 1582 1679 1768 1769 1770 1771 1773 1852 1774 1776 1689 1856 1854 1859 1693 1781 1784 1696 1862 1863 1787 1503 1607 1707 1789 1610 1511 1285 1159 1283  884  736  734  735  582  578  243
 171  348  517  678  831  976 1113 1242 1363 1476 1581 1678 1767 1848 1849 1850 1923 2041 1853 1775 1855 1858 1779 1930 1993 1780 1783 1782 1934 1698 1867 1938 1791 1936 1705 1612 1403 1510 1284 1160 1026 1027  886  740  581  737  580
 170  347  516  677  830  975 1112 1241 1362 1475 1580 1677 1766 1847 1920 1921 1851 1924 1926 2043 1928 1927 1857 1861 1994 1931 1995 1932 1785 1786 2053 1866 1937 1788 1792 1614 1402 1286 1287 1031 1028  887  738  242  414  583  240
 169  346  515  676  829  974 1111 1240 1361 1579 1676 1675 1765 1846 1985 1983 1922 1987 2042 1988 1925 1991 2046 1929 1860 2049 1996 2000 1933 2099 1864 1869 1939 1868 1706 1514 1613 1404 1401 1163 1161 1162  420  739  418  417   61
 168  345  514  675  828  973 1110 1239 1473 1577 1578 1763 1674 1845 1919 1918 1986 2038 2039 1989 2045 1990 2047 1992 2136 2098 2097 1998 2055 2051 1790 1797 1940 1793 1512 1289 1615 1708 1290 1167 1288 1029  888  419  416   63   64
 167  344  513  674  827  972 1109 1238 1360 1474 1472 1764 1761 1915 1843 1844 2040 2044 2089 2088 2091 2092 2133 2094 2132 2093 2168 2100 1997 1999 1865 1871 1941 1616 1709 1513 1405 1515  587 1033  891  741  889  585  245   66  246
 166  343  512  673  826  971 1108 1237 1359 1471 1576 1673 1672 1762 1916 1917 1984 1981 1982 2090 2159 2130 2131 2134 2048 2096 2095 2052 1935 1942 2002 1872 1795 1711 1794 1617 1406 1407 1164 1030  892  742  890  422  244  247   65
 165  342  511  672  825  970 1107 1236 1358 1357 1573 1470 1575 1842 2037 1980 2128 2086 2160 2183 2129 2162 2185 2187 2135 2166 2139 2050 2056 2054 2003 2001 1870 1710 1873 1618 1516 1517 1166 1291 1165 1032  586  421  588  249   67
 164  341  510  671  824  969 1106 1235 1356 1468 1469 1574 1671 1841 1914 1978 2036 2087 2127 2158 2161 2163 2164 2188 2165 2189 2167 2137 2101 2057 1943 1945 1874 2004 1619 1621 1620 1518 1408 1293  894 1035  893  743  248  251   68
 163  340  509  670  823  968 1105 1234 1669 1572 1759 1839 1840 1760 1913 2035 1979 2085 2126 2156 2184 2200 2202 2208 2203 2141 2169 2102 2138 2103 2058 2006 1796 1944 1798 1712 1622 1409 1169 1411 1168 1034  744  250  745  423   70
 162  339  508  669  822  967 1233 1353 1355 1354 1670 1758 1757 1668 1911 1977 2034 2084 2082 2123 2124 2181 2201 2205 2206 2190 2191 2005 2142 2104 2059 1800 1875 1877 1713 1520 1519 1410 1294 1036  895  746 1037  590  589   69  424
 161  338  507  668  821  966 1104 1103 1467 1571 1465 1755 1756 1912 1976 1975 2033 2125 2083 2154 2186 2180 2207 2199 2204 2192 2171 2140 2105 2060 1876 2007 1878 1879 1521 1714 1292 1412 1295 1170 1038  896  748  747  425  252   71
 160  337  506  667  820  964  965 1232 1351 1352 1667 1837 1665 1838 1910 2032 2081 2121 2182 2155 2157 2197 2195 2198 2194 2172 2170 2106 2010 2107 2061 1802 1799 1715 1946 1623 1414 1522 1171 1297  897  749  591  426  427  253   72
 159  336  505  666  819 1231 1102 1101 1568 1230 1466 1464 1569 1836 1909 1974 2031 2118 2122 2153 2179 2149 2196 2177 2174 2193 2173 2143 2145 1947 2008 1948 2011 1716 1717 1624 1625 1413 1296 1173 1039 1172  592  750  593  254   73
 158  335  504  665  818  963 1100 1229 1228 1463 1570 1666 1664 1908 1973 2027 2079 2080 2120 2117 2178 2021 2151 2070 2113 2019 2146 2144 2108 2062 2065 2009 1801 1718 1803 1523 1416 1415 1299 1175 1040 1041  899  898  596  255  256
 157  334  503  664  817  962 1099 1350 1349 1566 1461 1567 1754 1835 1907 1972 1969 2029 2075 2152 2150 2115 2112 2020 2175 2068 2071 2111 2110 2012 2063 1880 1805 1804 1719 1626 1524 1300 1417 1174  754 1042  751  594  428  429   75
 156  333  502  663  816  961 1098 1227 1347 1348 1462 1663 1834 1753 1905 2078 1970 2028 2119 2024 1964 2074 2176 2148 2114 2147 1956 2066 2013 2015 1952 1950 1881 1949 1882 1720 1627 1525 1298 1176  900  902  901  430  257   76   74
 155  332  501  662  815  960 1097 1226 1460 1565 1662 1751 1752 1833 1831 1906 1904 2030 2077 1965 2022 2072 2073 1960 2017 2067 1959 1544 1954 2014 2109 1951 1883 1806 1721 1628 1526 1527 1301 1043 1044  595  903  752  597   77   78
 154  331  500  661  814  959 1096 1225 1346 1564 1563 1661 1749 1750 1832 1830 1971 2026 1967 1899 1963 2116 1821 1962 1819 2069 2018 1955 2064 1889 1887 1888 1884 1807 1630 1723 1629 1418 1528 1045  756 1178  432  757  258  433  259
 153  330  499  660  813  958 1095 1224 1345 1459 1457 1748 1659 1903 1827 1902 2025 1966 2076 1898 1897 1896 1820 2023 1895 1817 1958 1818 1890 1814 1812 1953 1886 1808 1725 1529 1530 1419 1302 1177 1303  905  753  434  598  431   79
 152  329  498  659  812  957 1094 1343 1223 1344 1458 1562 1660 1828 1826 1744 1901 1742 1825 1823 1824 1739 1894 1893 1645 1891 2016 1732 1957 1730 1811 1813 1810 1728 1631 1633 1722 1421 1420 1179 1046  755  599  435  261  260   80
 151  328  497  658  811  956 1093 1456 1342 1561 1560 1658 1829 1746 1654 1745 1968 1900 1650 1741 1738 1733 1736 1737 1547 1643 1816 1815 1731 1729 1638 1636 1885 1632 1727 1726 1531 1423 1304  906  600  904  758  601  436  262   82
 150  327  496  657  810  955 1092 1222 1341 1455 1559 1656 1555 1449 1653 1448 1743 1651 1740 1648 1649 1822 1546 1734 1961 1892 1640 1642 1735 1541 1639 1637 1724 1431 1809 1532 1533 1047 1180 1181  907  908  760  759  264   81   83
 149  326  495  656  809  954 1091 1221 1454 1453 1558 1657 1747 1333 1556 1655 1652 1554 1551 1550 1549 1647 1440 1646 1437 1323 1439 1641 1435 1540 1539 1538 1432 1537 1535 1634 1635 1534 1424 1305  910  761 1049  909  263  438   84
 148  325  494  655  808  953 1090 1220 1340 1219 1338 1451 1450 1332 1210 1078 1446 1552 1444 1327 1328 1442 1548 1545 1438 1644 1321 1543 1542 1434 1433 1316 1315 1536 1428 1422 1312 1182 1306 1048 1183  911 1051  603  440  437  265
 147  324  493  654  807  952 1089 1218 1216 1452 1557 1211 1335 1334 1079 1553 1447 1445 1074 1329 1204 1441 1326 1325 1324 1436 1199 1320 1319 1318 1317 1430 1429 1313 1190 1189 1426 1056 1307 1309 1308 1054 1050  602  604  266   85
 146  323  492  653  804  806 1088 1217 1214 1213  944 1336 1081 1212 1209 1080 1331 1077 1443  789 1205 1203 1202 1201 1200 1198 1322 1197 1196 1195 1194 1193 1314 1192 1191 1311 1425 1188 1053 1184 1185 1052  605  763  606  439   86
 145  322  491  652  949  951  950 1087 1339 1086 1337  795 1084 1207  941 1076 1208 1330  935 1206 1073 1072 1071 1070 1069 1068 1067 1066 1065 1064 1063 1062 1061 1059 1057 1310 1427 1187  917 1186  914  913  912  762  268  267   87
 144  321  490  651  803  805  948  947 1085  945 1215 1083  942  639  940  939  938  936  937 1075  934  933  932  931  930  929  928  927  926  925  924  923  922 1060  920 1058 1055  918  610  916  768  764  442  608  441  443   88
 143  320  489  650  648  802  800  799  798  946  796 1082  943  640  794  792  635  791  634  788  787  786  785  784  783  782  781  780  779  777  776  775  774  921  773  919  772  771  770  769  915  607  766  765  269  270   90
 142  319  488  649  647  646  801  645  644  643  797  642  477  476  793  636  638  790  299  470  469  631  630  629  628  627  626  625  624  778  622  621  620  619  618  617  616  615  614  450  613  767  444  271  609  445   89
 141  318  487  486  485  484  483  482  481  480  479  641  305  304  125  637  473  471  633  119  632  468  467  466  465  464  463  461  460  623  459  458  457  456  455  454  453  452  451  612  278  449  611  448  447  446   91
 140  317  316  315  314  313  312  311  310  309  308  128  478  127  306  302  303  123  472  301  120  297  296  295  294  293  291  462  290  289  288  287  286  285  284  283  282  281  280  279  277  276   97  275  274   92  272
 139  138  137  136  135  134  133  132  131  130  129  307  126  475  124  474  121  300  122  298  118  117  116  115  114  113  292  112  111  110  109  108  107  106  105  104  103  102  101  100   99   98   96   95   94  273   93
