# This puzzle is unsolvable
20
 77 204   1 203   2  73 202  89 149  83   7  10 156  13  90  92  91  16  18  93
140   3  78 206  79   5 146  84 208 213  81  85  12   9 154  87 158  17  94  19
143  76  74  72  11  80 147  75   8 367 210 153   6 308  15  14 162 159  20  21
256 152 144 301 298 150 338 151 148 306 211 266 155 157  96 268 217 101 220  97
300 138 255   4 260 363 258 261 207 209 264 382  86 216 267  22 219  23 160 271
201 336 205 145 299 337 365  82 263 262 340 343 214 346 309 218 269 273  99  24
253 136  70  69 302 259 257 364 304 265 310 225 369 215 164  28  26  95  30 270
139 141 254 251 249 362 307 342 385 212 397 370 388  88 221 311 344 223 100  25
 68 293  71 142 366 332 381 374 341 305 384 345 372 313 315 272 167  98 104 168
252 303  67 297 333  66 197 339 368 396 379 399 389 319 387 349 222 161 169  27
199 135 132 296 198 246 361 359 330 331 392 317 277 375  31 163 312 102 226 171
 65 200 241  64 394 295 380 386 133 393 348 352 351 378 371 274 227 321  29 110
192 137 335 195 248 357 377 355 383 398 347 373 390 181 350   0 105 174 165 106
134 196 250 334 247 326 123 329 376 287 285 239 229 107 166 316 282 224 103 108
129  62 291 286 358 294 292 324 395 323 284 322 353 172 228 275 233 230  34 276
 63 194  61 131 130 193 289 240 183 391 360 242 281 116 279 109 314 178 170 175
 58 125 190 244 243 122 120 327 238 325 185 283 180 236 318  38 320  32 111  33
328  60  55  53 126 290 184  52 354  46 117 356 115 179 231  42 278 232 112  41
128  59 189  54 127  57 124  49 182 186 118 237 173 235 234  37  35 113 176  43
 56 191  48 187 121 188 245 288  50 119  51  47  44  45 280 177  36 114  40  39
