# This puzzle is unsolvable
62
   2    1    3    4    5    6    7    8    9   10  254   11   12   13   14   16   18   19  262   20   21   22   23   24   25   26  271  270   28   29   33   32   34  277   35   36   37   38   39  283   40   42   43   45   46  289   47   48   49   50   51   52   53   54   55   56   57   58   59   60   61   62
 244  245  247  481  483  485  249  250  251  252  253  255  256  257  493   15  259   17  495  263  264  265  266  267  268  269  505  272  506  509   31  274  275  738  278  279  280  281  282  518  520   41  286   44  523  288  290  291  292  293  294  295  296  297  298  299  300  301  302  303  304   63
 242  243  480  246  248  482  486  713  934  487  490  935  491  492  717  258  261  496  724  497  499  500  501  502  503  504  273   27  734  508   30  512  511  276  513  958  741  515  746  519  284  285  522  287  524  751  525  526  527  528  529  530  531  532  533  534  535  536  537  538  305   64
 479  708  709  928  484  711  931  715 1144  489 1350  716  719 1150  720  494  260  723 1156  498  726  727  728  729  730  731  732  733  954 1165  510  956  737 1171  739  514 1174  744  517  516  966  965  521  749  750  970  752  753  754  755  756  757  758  759  760  761  762  763  764  539  306   65
 241  478  706  707  710 1142  932  712 1146  488 1147  718  938  939  722  940  941  942 1152  725 1155  946  947  948  949  950  952  507  953  736  955  735  957  740  742  743  962  745 1173  963  964  747  748  967  969 1181  971  972  973  974  975  976  977  978  979  980  981  982  765  540  307   66
 240  477  927  926 1140  929 1141 1143  714  933 1349  937 1148  936 1353  721 1153 1355 1154  943  944 1157 1158 1362 1160 1163 1364  951 1367 1563 1166 1167 1168 1169 1170 1756  961  959 1379 1175 1176 1177 1178  968 1180 1179 1385 1184 1185 1388 1186 1187 1188 1189 1190 1191 1192  983  766  541  308   67
 239  476  705 1139 1344  930 1345 1346 1347 1145 1348 1545 1351 1149 1352 1151 1354 1358 1552 1357 1359 1360 1361 1559 1161 1159 1366 1164 1162 1368 1369 1370 1565 1375 1372 1570  960 1377 1172 1378 1380 1381 1382 1383 1182 1579 1384 1582 1386 1387 1389 1390 1391 1392 1393 1394 1193  984  767  542  309   68
 238  475  704  925 1138 1343 1540 1541 1542 1543 1544 1546 1733 1547 1548 1549 1551  945 1738 1553 1554 1555 1556 1923 1557 1560 1561 1365 1748 1751 1752 1753 1754 1371 1567 1566 1376 1571 1572 1573 1574 1575 1576 1577 1578 1580 1767 1183 1769 1583 1584 1585 1586 1587 1588 1395 1194  985  768  543  310   69
 237  474  703  924 1137 1342 1539 1728 1729 1730 1731 1732 1912 1734 1735 2088 1550 1737 1356 1918 1741 1742 1743 1558 1363 1745 1747 1749 1562 1930 1564 2101 1932 1934 1568 1373 1569 1757 1759 1760 1761 1762 1763 1764 1765 1766 1768 1581 1770 1949 1771 1772 1773 1774 1589 1396 1195  986  769  544  311   70
 236  473  702  923 1136 1341 1538 1727 1908 1909 1910 2082 1911 1913 1914 1736 1916 2086 1740 1917 1919 1921 1922 1925 1744 1746 1926 2098 1927 1928 1750 2264 2103 1933 1935 1374 1937 1758 1938 1939 1940 1941 1942 1943 1944 1945 1946 1947 2119 1948 1950 1951 1952 1775 1590 1397 1196  987  770  545  312   71
 235  472  701  922 1135 1340 1537 1726 1907 2080 2081 2245 2083 2084 2085 2250 2251 2249 1739 1920 2092 2255 2257 2094 1924 2096 2097 2260 2100 2263 1929 1931 2104 1755 2105 2106 1936 2108 2109 2110 2111 2112 2113 2114 2115 2279 2116 2117 2118 2120 2121 2122 1953 1776 1591 1398 1197  988  771  546  313   72
 234  471  700  921 1134 1339 1536 1725 1906 2079 2244 2400 2246 2247 2248 1915 2405 2407 2087 2253 2091 2256 2411 2093 2258 2414 2259 2563 2262 2099 2265 2102 2266 2267 2268 2269 2107 2270 2272 2273 2274 2275 2276 2277 2278 2434 2280 2281 2282 2283 2284 2123 1954 1777 1592 1399 1198  989  772  547  314   73
 233  470  699  920 1133 1338 1535 1724 1905 2078 2243 2399 2401 2402 2403 2551 2553 2404 2089 2254 2090 2410 2697 2560 2095 2413 2261 2416 2417 2419 2566 2420 2421 2422 2423 2424 2425 2271 2427 2428 2429 2430 2431 2432 2433 2581 2435 2436 2437 2438 2285 2124 1955 1778 1593 1400 1199  990  773  548  315   74
 232  469  698  919 1132 1337 1534 1723 1904 2077 2242 2547 2398 2549 2691 2552 2406 2408 2252 2555 2409 2556 2558 2412 2559 2415 2561 2562 2565 2705 2703 2567 2568 2569 2570 2571 2572 2426 2574 2575 2576 2577 2578 2579 2719 2580 2582 2583 2584 2439 2286 2125 1956 1779 1594 1401 1200  991  774  549  316   75
 231  468  697  918 1131 1336 1533 1722 2240 2546 2075 2241 2548 2688 2550 2693 2822 2692 2554 2826 2695 2557 2827 2698 2699 2700 2701 2702 2564 2418 2706 2837 2707 2708 2709 2710 2712 2573 2713 2714 2715 2717 2849 2972 2718 2720 2721 2722 2585 2440 2287 2126 1957 1780 1595 1402 1201  992  775  550  317   76
 230  467  696  917 1130 1335 1532 1721 1903 2397 2076 2238 2689 2687 2943 2690 2945 2823 2824 2694 2949 2828 2696 2829 2830 2831 2832 2833 2835 2704 2836 2838 2961 2839 2840 2841 2711 2843 2844 2845 2847 2716 2971 2848 2851 2974 2852 2723 2586 2441 2288 2127 1958 1781 1596 1403 1202  993  776  551  318   77
 229  466  695  916 1129 1334 1531 1720 1902 2073 2074 2395 2239 2819 2821 2686 2946 2947 3063 2825 2948 3064 2951 2952 2953 2954 2955 2956 2834 3180 2959 2960 3076 2962 2963 2964 2842 2966 2967 2968 2846 3192 2970 2850 3087 2973 2853 2724 2587 2442 2289 2128 1959 1782 1597 1404 1203  994  777  552  319   78
 228  465  694  915 1128 1333 1530 1719 1901 2072 2396 2545 2684 2944 2942 2820 3060 3061 3062 3065 3171 2950 3066 3067 3175 3068 3071 2957 2958 3072 3074 3075 3183 3077 3078 3079 2965 3080 3081 3084 2969 3191 3085 3086 3088 2975 2854 2725 2588 2443 2290 2129 1960 1783 1598 1405 1204  995  778  553  320   79
 227  464  693  914 1127 1332 1529 1718 1900 2071 2237 2394 2685 2683 2818 2816 3059 3167 3168 3169 3270 3172 3173 3174 3274 3275 3070 3069 3179 3073 3181 3182 3282 3184 3185 3186 3187 3188 3082 3083 3289 3190 3195 3090 3193 2976 2855 2726 2589 2444 2291 2130 1961 1784 1599 1406 1205  996  779  554  321   80
 226  463  692  913 1126 1331 1528 1717 1899 1898 2236 2393 2544 2543 2817 2940 2941 3058 3268 3170 3269 3363 3272 3273 3176 3279 3276 3177 3278 3368 3280 3281 3373 3283 3284 3285 3286 3287 3379 3288 3291 3292 3382 3194 3089 2977 2856 2727 2590 2445 2292 2131 1962 1785 1600 1407 1206  997  780  555  322   81
 225  462  691  912 1125 1330 1527 1716 1897 2070 2235 2392 2542 2541 2682 3057 3056 3166 3267 3360 3361 3521 3271 3446 3365 3367 3277 3178 3453 3369 3372 3455 3456 3374 3375 3376 3377 3378 3380 3381 3290 3384 3293 3196 3091 2978 2857 2728 2591 2446 2293 2132 1963 1786 1601 1408 1207  998  781  556  323   82
 224  461  690  911 1124 1329 1526 1715 1896 2069 2234 2391 2540 2681 2815 2814 2939 3165 3266 3359 3444 3362 3364 3448 3449 3366 3450 3451 3452 3371 3454 3529 3530 3457 3458 3459 3460 3461 3537 3189 3464 3463 3465 3294 3092 2979 2858 2729 2592 2447 2294 2133 1964 1787 1602 1409 1208  999  782  557  324   83
 223  460  689  910 1123 1328 1525 1714 1895 2068 2233 2390 2539 2680 2813 2938 3055 3164 3265 3358 3520 3445 3522 3447 3590 3524 3525 3370 3526 3527 3528 3531 3598 3532 3533 3534 3535 3536 3538 3462 3466 3295 3383 3197 3093 2980 2859 2730 2593 2448 2295 2134 1965 1788 1603 1410 1209 1000  783  558  325   84
 222  459  688  909 1122 1327 1524 1713 1894 2067 2232 2389 2538 2679 2812 2937 3054 3163 3264 3442 3443 3519 3588 3523 3589 3591 3592 3593 3594 3595 3596 3597 3657 3599 3600 3601 3602 3603 3604 3540 3539 3385 3199 3198 3094 2981 2860 2731 2594 2449 2296 2135 1966 1789 1604 1411 1210 1001  784  559  326   85
 221  458  687  908 1121 1326 1523 1712 1893 2066 2231 2388 2537 2678 2811 2936 3053 3162 3263 3357 3441 3518 3587 3648 3649 3650 3651 3652 3653 3654 3655 3656 3658 3709 3659 3711 3660 3661 3662 3605 3467 3297 3296 3200 3095 2982 2861 2732 2595 2450 2297 2136 1967 1790 1605 1412 1211 1002  785  560  327   86
 220  457  686  907 1120 1325 1522 1711 1892 2065 2230 2387 2536 2677 2810 2935 3161 3050 3262 3356 3440 3517 3586 3585 3647 3700 3701 3702 3703 3704 3705 3706 3707 3708 3710 3754 3712 3663 3606 3541 3468 3386 3298 3201 3096 2983 2862 2733 2596 2451 2298 2137 1968 1791 1606 1413 1212 1003  786  561  328   87
 219  456  685  906 1119 1324 1521 1710 1891 2064 2229 2386 2535 2676 2809 2934 3052 3160 3261 3355 3354 3516 3584 3646 3699 3744 3742 3746 3747 3748 3749 3786 3751 3752 3753 3755 3713 3664 3607 3542 3469 3387 3388 3299 3097 2984 2864 2863 2734 2452 2299 2138 1969 1792 1607 1414 1213 1004  787  562  329   88
 218  455  684  905 1118 1323 1520 1709 1890 2063 2228 2385 2534 2675 2808 3049 3051 2932 3159 3353 3439 3515 3583 3644 3645 3698 3778 3745 3780 3782 3784 3750 3785 3787 3789 3788 3714 3665 3608 3543 3389 3300 3203 3202 3099 3098 2985 2735 2597 2598 2453 2139 1970 1793 1608 1415 1214 1005  788  563  330   89
 217  454  683  904 1117 1322 1519 1708 1889 2062 2227 2384 2533 2674 2807 2931 3260 2933 3258 3437 3438 3514 3582 3697 3696 3743 3825 3806 3781 3783 3811 3812 3813 3814 3790 3756 3715 3666 3609 3544 3470 3471 3390 3204 3100 2986 2865 2736 2599 2454 2300 2140 1971 1794 1609 1216 1417 1215  789  564  331   90
 216  453  682  903 1116 1321 1518 1707 1888 2061 2226 2383 2532 2673 2806 3048 3158 3157 3352 3259 3351 3512 3513 3643 3695 3779 3808 3810 3809 3829 3830 3832 3833 3815 3791 3757 3716 3667 3610 3545 3472 3391 3301 3302 3205 2866 2738 3102 2455 2457 2301 2142 2141 1795 1610 1418 1416 1006 1007  565  332   91
 215  452  681  902 1115 1320 1517 1706 1887 2060 2225 2382 2531 2672 2805 2930 3047 3156 3257 3434 3436 3435 3581 3740 3738 3739 3741 3776 3840 3839 3828 3834 3841 3816 3792 3758 3717 3668 3611 3546 3473 3392 3303 3101 2989 2987 2988 2600 2304 2601 2302 2456 1972 1973 1796 1611 1009 1217  790  791  333   92
 214  451  680  901 1114 1319 1516 1705 1886 2059 2224 2381 2530 2671 2804 2929 3046 3155 3256 3350 3349 3511 3580 3642 3777 3693 3641 3807 3826 3843 3842 3831 3793 3759 3818 3760 3718 3669 3612 3547 3474 3393 3304 3104 3206 2867 2737 2739 2868 2305 2458 2303 1977 1612 1419 1218 1420 1008  792  566   94  334
 213  450  679  900 1113 1318 1515 1704 1885 2058 2223 2380 2529 2670 2803 2928 3045 3154 3255 3348 3433 3510 3579 3640 3692 3694 3774 3804 3805 3824 3837 3836 3835 3817 3762 3719 3670 3613 3615 3548 3475 3394 3307 3211 3103 3208 2869 2740 2144 2741 2145 2602 2143 1797 1613 1798 1614  793  568  567  569   93
 212  449  678  899 1112 1317 1514 1703 1884 2057 2222 2379 2528 2669 2802 2927 3044 3153 3254 3347 3432 3509 3578 3639 3737 3736 3773 3803 3801 3827 3838 3822 3797 3820 3794 3819 3720 3614 3549 3395 3476 3306 3305 2871 3106 3207 2870 2604 2459 2603 2460 2306 1802 1974 1220 1422 1421 1012 1222  336  335   95
 211  448  677  898 1111 1316 1513 1702 1883 2056 2221 2378 2527 2668 2801 2926 3043 3152 3253 3346 3431 3508 3577 3638 3691 3735 3772 3775 3802 3800 3799 3821 3798 3796 3795 3761 3763 3671 3616 3550 3398 3309 3397 3308 3209 2742 2743 2990 2462 2605 2461 2307 1976 1975 1615 1219 1010  794 1011  337   96   97
 210  447  676  897 1110 1315 1512 1701 1882 2055 2220 2377 2526 2667 2800 2925 3042 3151 3252 3345 3430 3507 3575 3576 3637 3690 3771 3770 3823 3729 3769 3767 3766 3765 3764 3722 3672 3721 3673 3551 3477 2991 3478 3396 3210 3105 2994 2992 2606 2308 2146 1800 1799 2147 1978 1423 1013  796  570  795  572  338
 209  446  675  896 1109 1314 1511 1700 1881 2054 2219 2376 2525 2666 2799 2924 3041 3150 3251 3344 3429 3506 3574 3636 3689 3734 3733 3732 3731 3768 3682 3728 3727 3726 3725 3724 3723 3674 3617 3552 3479 3399 3213 3108 3212 2872 2607 2993 2148 2310 1979 1801 1619 1617 2151 1223 1221 1014  571  797  339   98
 208  445  674  895 1108 1313 1510 1699 1880 2053 2218 2375 2524 2665 2798 2923 3040 3149 3250 3343 3428 3505 3635 3634 3688 3687 3686 3684 3683 3730 3681 3626 3680 3679 3678 3677 3675 3620 3618 3555 3554 3400 3480 3310 3109 3107 2995 2873 2463 2465 2309 1803 2311 2149 1424 1616 1980 1015  798  573  340   99
 207  444  673  894 1107 1312 1509 1698 1879 2052 2217 2374 2523 2664 2797 2922 3039 3148 3249 3342 3427 3504 3573 3633 3632 3631 3630 3685 3629 3628 3627 3563 3625 3624 3623 3621 3558 3676 3553 3619 3481 3401 3311 3214 2997 2746 2609 2874 2876 2744 2150 1983 1982 1426 1805 1618 1224 1425  799  576  341  100
 206  443  672  893 1106 1311 1508 1697 1878 2051 2216 2373 2522 2663 2796 2921 3038 3147 3247 3248 3341 3503 3572 3571 3570 3569 3568 3567 3566 3565 3564 3562 3561 3560 3559 3622 3487 3557 3556 3483 3484 3313 3482 3312 3215 2998 2745 2747 2608 2467 2312 2464 1806 1428 1225 1227 1427  575 1016  106  342  101
 205  442  671  892 1105 1310 1507 1696 1877 2050 2215 2372 2521 2662 2795 2920 3037 3146 3246 3425 3340 3426 3501 3500 3499 3498 3497 3496 3416 3495 3494 3493 3491 3490 3489 3488 3408 3486 3405 3404 3319 3402 3216 3110 2996 2877 2610 2155 2611 2466 2315 2153 1804 1807 1620 1018  801 1017  345  574  102  580
 204  441  670  891 1104 1309 1506 1695 1876 2049 2214 2371 2520 2661 2794 2919 3036 3145 3245 3339 3140 3502 3422 3421 3420 3332 3419 3417 3328 3329 3327 3492 3413 3412 3410 3407 3320 3485 3224 3220 3218 3317 3314 3217 3111 2999 2875 2748 2612 2468 2613 2313 1621 1981 1986 1429 1226 1229  344 1021  103  804
 203  440  669  890 1103 1308 1505 1694 1875 2048 2212 2213 2519 2792 2793 3034 2917 2918 3338 3243 3424 3242 3336 3334 3333 3418 3236 3331 3330 3415 3326 3414 3229 3325 3411 3409 3323 3321 3226 3316 3406 3403 3117 3219 3112 2749 3001 2614 2751 2470 2152 1985 1808 1984 1809 1622 1430 1228  579 1019  800  803
 202  439  668  889 1102 1307 1504 1693 1874 2047 2370 2517 2518 2659 3033 2660 3142 3244 3144 3035 3241 3423 3335 3240 3238 3237 3133 3235 3234 3233 3232 3230 3231 3228 3324 3123 3322 3121 3223 3318 3315 3221 3222 3004 2881 3002 3000 2878 2879 2469 2317 2314 2154 1810 1625 1023 1434 1020  802  343  577  104
 201  438  667  888 1101 1306 1503 1692 1873 2046 2211 2369 2368 2791 2790 2916 3143 2787 2913 3141 3029 3139 3137 3239 3026 3135 3022 3132 3131 3130 3129 3017 3127 3128 3125 3014 3124 3122 3225 3119 3118 3115 3005 3113 3114 2752 2750 2754 2615 2471 2316 1987 1433 1988 2156 1231 1432  348  346 1431  347  105
 200  437  666  887 1100 1305 1502 1691 1872 2044 2045 2367 2516 2656 2658 2657 2914 3031 3030 3337 2910 3136 3138 3025 3023 3134 2903 3021 3020 3019 3018 3016 2897 3015 3126 2893 3227 3010 3011 3120 3008 3007 3006 3116 2757 2885 2880 3003 2617 2318 2158 2159 1624 1811 1233 1623 1230  578 1022  807  581  107
 199  436  665  886 1099 1304 1501 1690 1871 2043 2210 2209 2366 2515 3032 2915 2786 2911 2909 2908 3028 3027 2907 2906 3024 2777 2904 2902 2901 2900 2899 2771 2898 2769 3013 2896 2894 2765 3009 2889 2627 2888 2887 2758 2884 2753 2882 2616 2472 2319 1989 2157 1813 1812 1435 1627 1232 1024  805  806  582  349
 198  435  664  885 1098 1303 1500 1689 1869 1870 2208 2365 2514 2655 2789 2788 2785 2912 2784 2783 2782 2781 2779 2644 2905 2778 2776 2775 2774 2773 2635 2636 2770 2768 2767 2895 3012 2629 2892 2763 2890 2761 2760 2759 2886 2756 2623 2755 2618 2473 2320 1990 1991 1626 1628 1436 1234  809  808  350  109  108
 197  434  663  884 1097 1302 1499 1688 2042 2041 2207 2364 2513 2654 2653 2652 2507 2650 2651 2648 2647 2646 2645 2780 2643 2642 2641 2640 2638 2496 2772 2637 2491 2634 2632 2488 2766 2486 2891 2628 2764 2625 2481 2480 2624 2883 2621 2620 2474 2475 2322 2321 1630 1992 1815 1629 1235 1025 1026  583  584  110
 196  433  662  883 1096 1301 1498 1687 1868 2206 2363 2362 2512 2511 2510 2509 2357 2508 2649 2355 2504 2503 2502 2501 2500 2499 2498 2497 2639 2184 2495 2341 2493 2490 2633 2487 2631 2630 2335 2485 2483 2330 2626 2482 2479 2622 2327 2478 2619 2324 2323 2161 2160 1816 1814 1437 1236 1027  810  352  351  111
 195  432  661  882 1094 1095 1300 1686 2038 1867 2204 2205 2361 2360 2359 2358 2356 2506 2354 2505 2353 2352 2351 2350 2349 2348 2347 2186 2345 2344 2494 2343 2492 2340 2489 2338 2337 2336 2334 2332 2484 2762 2331 2171 2329 2328 2168 2326 2477 2166 1997 2162 1993 1631 1817 1632 1237 1028  811  585  586  112
 194  430  431  660 1093 1299 1497 1685 1866 2040 2039 2203 2202 2201 2200 2199 2198 2197 2196 2195 2194 2193 2192 2191 2190 2189 2188 2346 2185 2017 2018 2342 2183 2181 2339 2179 2178 2176 2175 2333 2174 2006 2172 2001 2003 2170 2169 1644 2000 1998 2165 2164 1819 1994 1633 1438 1238 1029  812  587  353  113
 193  192  429  881  880 1298 1496 1684 1865 1863 2037 2036 2035 2034 2033 2032 2031 2030 2029 2028 2027 2026 2025 2024 2023 1847 2021 2020 2187 1843 1842 2016 2182 2014 2180 2013 1837 2177 2009 1649 2173 2007 2005 2004 2002 1828 1825 2325 2476 1822 1639 1821 2163 1440 1239 1439 1240 1030  813  588  354  114
 191  659  879  878 1092 1297 1495 1494 1864 1680 1862 1861 1860 1859 1858 1857 1856 1855 1854 1853 1852 1851 1850 1849 1848 1663 1469 2022 2019 1661 1659 1841 2015 1839 1656 1838 2012 2010 2008 1832 1833 1831 1830 1829 2167 1826 1999 1640 1253 1638 1041 1248 1996 1995 1818 1442 1635  814 1032  356  355  115
 428    0  657  658 1091 1296 1292 1683 1681 1489 1679 1678 1677 1676 1675 1674 1673 1672 1671 1670 1669 1668 1476 1276 1666 1664 1474 1468 1660  848 1267 1466 1657 1840 1655 1654 2011 1836 1651 1460 1648 1457 1647 1646 1645 1453 1642 1827 1823 1449 1636 1634 1637 1446 1444 1441 1241 1031  358  589  590  117
 190  427  656  877 1295 1492 1682 1493 1491 1290 1488 1487 1486 1485 1484 1483 1482 1481 1480 1479 1478 1477 1475 1473 1667 1665 1272 1472 1844 1846 1271  622  846 1658 1653 1264 1835 1650 1261 1834 1459 1051 1456 1455 1257 1048 1824 1254 1641 1451 1820 1448 1247 1445 1245 1443 1242 1033  815  592  116  118
 189  426  655  876 1090 1089 1293 1490 1084 1291 1083 1288 1287 1286 1285 1284 1283 1282 1281 1280 1279 1278 1277 1275 1068 1274 1270 1845 1471 1470 1265  623 1464  392 1465 1463  841 1462 1652 1260 1458 1258 1050 1049 1643 1454 1452 1252 1450 1249 1043 1042 1447 1246  822 1244 1034  817  591  593  816  359
 188  425  654  875 1088 1294 1087 1086 1085  868 1082 1080  865 1079 1078 1077 1076 1075 1074 1073 1072 1071 1070 1069  853 1067 1273 1662 1063 1062 1061  149 1467 1060  845 1266 1058 1263 1262 1461 1259 1052 1256 1047  833  608  832 1251 1044 1250  827 1040  825  600 1037 1036 1243 1035  818  819  357  360
 187  424  653  874  873  872  648  870  645  415  867 1289  642  864  863  862  861  860  859  858  857  856  855  854  629  628 1066  851  394 1065 1269  624 1268 1059  386  839  618 1055 1053  385  837  614  835  611 1255  834 1046  830  376  606  605  601  373 1039 1038  369  821  820  595  120  594  119
 186  423  652  651  650  649  176  869  866  416  414 1081  643  641  640  639  638  637  636  635  634  633  632  631  399  630  850  852  849  625 1064  847  844 1056 1057  148  843  389  840 1054  838  615  612  380  139  610  377  375  609  372  132  604  826  603  823  370  130  597  596  364  361  121
 185  422  421  420  419  418  871  178  646  413  175  412  411  410  409  408  407  406  405  404  403  402  401  400  398  158  397  396  154  155  627  390  393  153  619  388  150  147  616  145  383  836  143  381  379  140  831  829  607  135  374  133  824  371  602  599  598  366  365  363  362  122
 184  183  182  181  180  179  177  417  647  174  644  173  172  171  170  169  168  167  166  165  164  163  162  161  160  159  157  156  395  626  152  151  391  842  620  621  387  617  384  146  144  613  382  142  141  137  138  378 1045  136  828  134  131  129  368  128  367  127  126  125  124  123
