# This puzzle is unsolvable
9
21  2 50 26 19 63 16 70  7
12 33 41  5 74 40 47 10 75
17 29 61 76 38 30 13 45 48
53 52 59 62 71 68 54 15 44
36 35 22 34 39  8 14 25  1
32  0 11 80 72 73 43 67 56
60 66 79 55 69  4 18 23 31
24 65 42 58  3 28 57 37  6
77  9 27 78 64 46 20 51 49
