# This puzzle is unsolvable
21
 81   1   4   2   6   5   7  10 281 331  87 367  94 228 329 169  98 225 100 285  99
 78  80  79 151 157  86 219  90 156  91  13   8  16 364 165 102  17  26 101  22  97
149   3 273 152  84  82   9 155  11  89 159 325 167  96  92 282  14 286  20  23  19
153 274 218  77 360 272  83 277 163 162 164 330  95 283 231  12  18 174 161 170 289
150 316 215 321  85 269 318 275 158 328 368 280 398 224 332  21 166  15 168  24  28
 76 217 147 319 358 392 220  88 396 160 278 399 363 371 234 279  93 175 230 172 233
148 211 216 270 317 221 327 433 362 418 324 432 326 290 287  25 284 107 173 232 105
 75  73  71 271 212 267 222 394 322 365 395 422 420 227 421 335 238 236 235  27 104
208 154 146 320 276 268 361 390 359 413 393 424 372 397 401 366 226  30 229  29 108
 74 145 214  72 323 416 314 391 357 434 223 369 423 338 333 334 171 103 373  31 106
264 213  70 315 388 389 354 312 408 387 419 435 403 378 178 292 288 177 237 109  32
210 266 207 142 261  69 355   0 356 379 426 436 431 400 402 295  35 336 176 110 293
206 144  68 203 265 350 353 382 440 410 437 438 337 370 380 404 430 243 239  33  34
143  67 263 141 383 351 412 411 409 417 439 179 375 405 427 294 113 180 340 241 181
262 202 352  66 313 386 209 415 414 374 381 425 428 345 339 407 342 112 377 111  36
139 140 311 310 205 308 384 259 307 194 344 250 343 376 300 406 242 240  45 183  42
137 204 257 131 256  57 201 429 305 306 128 299 291 191 248 125 297 298 184  39 119
 65  64 200 138  53 133 304 126 385  50 252 303 189 182 296  43 120 245 187 186 117
 63 134 260 199 309 196 255 258 197 349 348 192 347 341 249  48 185 116 121  37  38
 62 136  60 135  56 251 195  54 193 301 254 253 123 188  46  47 118 114 246  40  41
 61  59  58 198  55 346 132  52 130  51 127 302 129  49 190 122 124  44 247 244 115
