# This puzzle is unsolvable
52
 204  205    2    3  207  208    6  402  595  212   11   12   13   14   15   16   17   18   19   20   22  226   23  227   26   27   28  231   29   31   32   33   34  237   35   36   37   38   39   40   41   42   44   45  443   47   48  446  251  634  253   50
   1  590  401  589    4    7  772  210    8    9   10  776  216  217  218  219  221  222  224  225   21   24  608  421   25  229  230  232  233   30  234  235  236  433  238  240  435  241  242  243  245  246   43  247  630  248   46  250   49  449   51   52
 203  768  206  588  941  403  592  209  406  945  597  411  410  598  413  414  220  416  418  419  417  420  607  422  228  424  425  426  427  428  429  430  431  432  621  239  436  623  437  438  244  626  441  442  444  249  447  635  252  448  255  254
 202  399  200  770    5  398  407  594  771  774  773  409  599  412  600  601  415  603  783  223  606 1120  957  609  423  611  612  613  614  794  615  616  617  618  619  434  622  624  803  625  440  439  807  628  809  632  445  631  450   55   53  257
 201  199  587  593  769  938  942  211  596  775  213  214  215  778  779  780  602  782  604  605 1272  785  788  789  610  790  791  792  793  795  966  796  797  620  972  799  801  973  802  804  805  627 1141  978  629  810   57  982  258  451   54   56
 586  396  766  767  404 1407  591  408  946 1263 1411  948  777  947  950  951  954  953  784 1274  786  955  787 1276 1123 1277  961  962  963  964  965  967  968  798  969  800 1135  971  975 1136  976  806  808  979  980 1144  633  981  812  453  260  256
 400  195  940  395  583  585  943  944 1107 1108 1264 1110 1265  949 1112 1269  781 1116  952 1420 1119 1121  959 1122 1125  960 1126 1127 1128 1283 1129 1131 1286 1133  970 1290 1291 1438  974 1138 1139  977 1140 1142 1143  813  811  983  815  636  259   58
 197  765 1260  394  937  584 1261  405 1109 1262 1111 1266 1419 1415 1113 1270 1271 1115 1418 1422  956 1275 1273 1278 1124 1279 1280 1281 1282 1284 1285 1130 1287 1132 1288 1436 1134 1289 1292 1137 1294 1295 1296 1297 1298 1145  984  639  814  454  452   59
 392  198  393  763 1101 1106 1105 1408 1259 1409 1412 1551 1267 1114 1268 1809 1555 1416 1557 1421 1118 1423 1561  958 1426 1427 1428 1429 1698 1430 1431 1432 1433 1434 1574 1435 1437 1577 1441 1293 1442 1581 1443 1582 1299 1146  816  817  637  638  261   60
 939  397 1257  580  582 1104 1256 1103 1258 1410 1550 1682 1413 1414 1554 1556 1117 1686 1688 1692 1690 1815 1562 1425 1424 1696 1818 1566 1567 1701 1570 1572 1702 1704 1573 1575 1578 1439 1440 1579 1580 1583 1446 1444 1445  985  987  986  641  455  262   61
 581  762  196  764  935 1254 1406 1102 1547 1548 1680 1681 1552 1553 1807 1684 1417 1925 1926 1558 1813 1559 1693 1563 1565 1694 1697 1568 1569 1699 1824 1700 1571 1703 1705 1706 1576 1833 1832 1709 1710 1711 1584 1301 1302 1147 1148  640  818  456  263   62
 759  194  390  579 1097 1098 1100 1549 1546 1678 1804 1805 1683 1806 1685 1687 1812 2033 1689 1811 1814 1691 1816 1817 1933 1564 1695 1820 1822 1823 1940 1939 1826 1827 1943 1828 1708 1707 1947 1834 1712 1714 1713 1300 1447 1149  988  819  642  457  264   63
 576  388  936  391  934 1679 1402  932 1405 1544 1677 1920 1921 1922 1808 1923 1810 1560 1927 2036 1930 1928 2037 1932 1819 2231 1934 1821 1936 1938 2046 1825 1941 1942 1830 1829 1831 1944 2055 1948 1835 1715 1585 1303 1304  820  989  821  643  458  265   64
 387  578  760  930 1096  761 1255 1404 1403 1676 1802 1919 2026 2129 1924 2029 2031 2034 2225 1929 2035 2039 1931 2041 2138 2040 2042 1937 2043 2045 2145 2047 2048 2049 2050 2150 2053 1946 2152 2054 1949 1836 1449 1448 1153 1150 1151  990  822  459  266   65
 193  189  756  389 1095  933 1094 1545 1543 1675 1801 1917 1803 2028 2027 2032 2130 2132 2131 2307 2135 2227 2038 2228 2232 2141 2139 2142 2143 2044 2144 2146 2147 2148 2149 1945 2051 2153 2151 1950 1837 1716 1586 1587 1450  992 1154  991  644  460  267   66
 192  575 1251  758  931 1099 1401 1253 1542 1800 1918 2024 2025 2030 2220 2304 2127 2222 2223 2133 2226 2137 2136 2313 2230 2140 1935 2233 2234 2235 2236 2237 2238 2239 2240 2241 2052 2056 1952 1839 2057 1717 1590 1451 1306 1305  645  823  461  462  268   67
 191  757  190  929  755 1540 1252 1250 1399 1541 1799 2126 2303 2128 2216 2221 2305 2306 2134 2382 2308 2310 2311 2312 2229 2390 2389 2314 2317 2318 2319 2320 2321 2322 2323 2324 2242 2155 2154 1951 1838 1718 1588 1589 1452 1152 1155  993  647  463  269   68
 188  385  384  574  927 1400 1093 1398 1539 1674 1798 2125 1915 2124 2301 2219 2379 2380 2224 2381 2450 2384 2386 2388 2514 2513 2316 2457 2392 2393 2394 2395 2396 2397 2398 2325 2243 2244 2058 1953 1840 1719 1591 1453 1455 1307 1156  825  649  648  270   69
 185  186  386  754 1091  928 1249 1538 1672 1673 1796 1913 1916 2123 2218 2302 2217 2448 2449 2451 2309 2385 2452 2454 2456 2315 2458 2391 2459 2460 2461 2462 2463 2464 2399 2326 2245 2156 2059 1954 1841 1592 1454  996 1309  646  994  824  826  464  271   70
 382  571  187  753  577  926 1248 1537 1092 1797 2022 1914 2023 1912 2021 2215 2378 2447 2383 2508 2605 2510 2511 2387 2608 2455 2516 2568 2517 2570 2520 2521 2522 2465 2400 2327 2246 2157 2060 1955 1842 1720 1721 1310  995 1308  827  651  828  465  272   72
 184  572  752  925  573 1090 1396 1397 1670 1671 1794 1911 1795 2214 2299 2300 2377 2445 2446 2509 2564 2561 2453 2512 2607 2515 2612 2569 2519 2518 2571 2572 2523 2466 2401 2328 2247 2158 2061 1956 1843 1722 1593 1456  998 1157 1158  997  652  466   71  273
 183  570  381  751  924 1089 1247 1246 1394 1536 1668 1793 2122 2020 2121 2298 2376 2559 2505 2560 2563 2562 2606 2565 2643 2609 2566 2567 2611 2613 2614 2573 2524 2467 2402 2330 2329 2062 2063 1957 1844 1723 1594 1457 1311 1312  831  829  467  650  274   73
 569  383  182  750  923 1245 1087 1534 1395 1535 1666 2018 1910 2212 2119 2213 2375 2504 2442 2507 2506 2602 2668 2641 2642 2644 2610 2645 2646 2647 2616 2574 2525 2468 2403 2248 2161 2249 2159 1958 1845 1724 1596 1595 1160 1159  830  654  653  468  275   74
 181  748  380  922 1088  921 1244 1393 1667 1669 1533 1909 2019 2120 2211 2297 2295 2444 2603 2557 2558 2604 2639 2669 2670 2691 2673 2674 2649 2615 2648 2575 2526 2469 2404 2331 2160 2064 1959 1846 1725 1726 1460 1315 1314 1000  999  832  655  469  276   75
 179  379  568  749 1084  747 1085 1392 1241 1665 1791 1908 2017 2210 2296 2373 2374 2502 2372 2556 2601 2638 2671 2667 2689 2690 2672 2692 2675 2650 2617 2576 2527 2470 2405 2332 2250 2251 2162 1960 1848 1847 1459 1458 1597 1313 1161 1002  471  656  277   76
 378  376  565  377  566  919 1086 1391 1532 1792 1789 1790 2016 2118 2209 2294 2443 2600 2501 2503 2599 2640 2666 2688 2699 2700 2702 2693 2676 2651 2618 2577 2528 2471 2406 2333 2252 2163 2067 1961 1727 1599 1462 1461 1316 1317 1001 1003  833  470  278   77
 180  178  374  375  920  746 1242 1664 1388 1663 1907 1906 2015 2117 2116 2292 2440 2439 2441 2555 2665 2637 2635 2687 2701 2697 2694 2677 2678 2652 2619 2578 2529 2472 2407 2334 2164 2165 2065 1962 1849 1728 1598 1600 1164 1162  834 1163  473  658   78  281
 567  373  564  744  918 1083  916 1243 1529 1531 1788 1905 2014 2115 2293 2208 2371 2438 2500 2554 2598 2636 2664 2686 2698 2696 2703 2695 2653 2654 2620 2579 2530 2473 2408 2335 2253 2068 2066 1963 1850 1729 1601 1463 1318 1165 1004  657  835  472  280  279
 176  563  177  562  917  745 1389 1239 1662 1661 1904 2013 2012 2291 2369 2370 2206 2436 2499 2553 2597 2662 2684 2685 2683 2682 2681 2680 2679 2621 2622 2580 2531 2474 2409 2336 2254 2166 1964 2070 1851 1730 1602 1464 1319 1166 1005  836  659  474   80   79
 372 1081  371 1240 1387 1082 1390 1528 1527 1530 1787 1786 2114 1903 2113 2207 2367 2368 2437 2552 2596 2663 2634 2661 2660 2659 2658 2657 2656 2655 2623 2581 2532 2475 2410 2256 2255 2167 2069 1966 1965 1852 1731 1465 1320 1167 1006  837  660  475  282   81
 175  560 1080  914  743 1079 1238 1383 1386 1660 1784 1785 2011 2112 2205 2290 2497 2435 2551 2498 2550 2595 2632 2630 2629 2628 2627 2587 2626 2625 2537 2582 2533 2476 2411 2337 2257 2168 2071 1967 1853 1732 1603 1466 1321 1168 1007  838  661  476  283   82
 561  742  559  370  739  741 1234 1237 1384 1526 1782 1659 2010 2111 2204 2289 2366 2496 2549 2547 2490 2592 2633 2544 2591 2590 2589 2485 2539 2540 2624 2583 2534 2477 2412 2338 2339 2258 2072 1968 1854 1733 1604 1467 1322 1169 1008  839  662  477  284   83
 174  173  558  915  910 1078 1076 1077 1235 1900 1901 1902 2009 2110 2203 2288 2365 2434 2495 2548 2545 2631 2594 2546 2543 2542 2588 2585 2421 2586 2584 2482 2535 2478 2413 2340 2259 2169 2170 2073 1855 1734 1605 1468 1323 1170 1009  840  663  478  285   84
 556  172  913  912 1236 1385 1382 1523 1525 1783 1658 1899 2008 2109 2202 2287 2364 2433 2493 2430 2492 2593 2427 2489 2488 2487 2541 2422 2484 2538 2536 2483 2416 2417 2479 2341 2260 2171 2074 1969 1856 1735 1606 1469 1324 1171 1010  841  664  479  286   85
 368  171  738  740  557 1075 1232 1657 1524 1780 1656 2007 2108 2107 2285 2201 2432 2360 2494 2429 2428 2491 2356 2426 2425 2424 2351 2486 2352 2349 2481 2419 2346 2480 2414 2265 2261 2172 2075 1970 1857 1736 1607 1470 1325 1172 1011  842  665  480  287   86
 367  369  366  554  911 1231 1380 1233 1654 1522 1897 1898 2006 2200 2363 2284 2286 2362 2431 2359 2358 2357 2277 2355 2354 2353 2350 2269 2420 2348 2418 2347 2267 2345 2343 2342 2262 2173 1971 1972 1858 1737 1608 1471 1326 1173 1012  843  666  481  288   87
 170  737  553  555  908 1074 1230 1521 1520 1779 1781 1778 2105 2005 2199 2361 2195 2196 2282 2281 2280 2278 2094 2276 2188 2273 2187 2423 2182 2183 2270 2272 2268 2344 2415 2264 2263 2174 2076 1973 1859 1738 1609 1472 1327 1174 1013  844  667  482  289   88
 168  735  736  909 1381 1072 1073 1379 1653 1655 1777 1896 2004 2106 2198 2283 2100 2101 2194 2193 2097 2191 2190 2095 2093 2275 2091 2184 2185 2271 2180 2086 2179 2266 2178 2082 2176 2175 1974 2078 1739 1740 1610 1473 1328 1175 1014  845  668  483  290   89
 167  365  364  169  734  907 1229 1378 1519 1652 1776 1895 2003 2104 2103 2197 1995 2102 1996 2192 2279 2096 1992 1881 2189 2090 1988 2186 2089 2088 2181 2085 1982 2084 2177 2083 2081 1976 1975 2077 1860 1611 1612 1474 1329 1176 1015  846  669  484  291   90
 166  363  552  733  906 1071 1228 1377 1518 1651 1893 1894 2002 2001 2000 1998 1767 2098 2099 1885 1884 1994 1880 2274 1990 1989 2092 1987 1986 1984 2087 1983 1981 1870 1980 1977 1868 2079 2080 1741 1861 1744 1613 1475 1330 1177 1016  847  670  485  292   91
 165  164  362  732  905 1070 1227 1376 1517 1650 1775 1892 1891 1890 1889 1999 1769 1768 1997 1765 1993 1883 1991 1879 1878 1877 1758 1875 1874 1985 1755 1872 1871 1751 1869 1979 1748 1746 1866 1864 1482 1616 1614 1476 1331 1178 1017  848  671  486  293   92
 163  361  551  550  904 1069 1226 1375 1516 1649 1774 1773 1772 1508 1771 1888 1887 1640 1886 1766 1764 1634 1882 1762 1760 1759 1757 1876 1756 1628 1754 1626 1753 1752 1750 1749 1621 1747 1865 1862 1863 1745 1743 1477 1332 1179 1018  849  672  487  294   93
 360  549  730  731  903 1068 1225 1374 1515 1648 1647 1646 1644 1770 1509 1643 1507 1642 1639 1638 1637 1763 1636 1499 1633 1632 1631 1630 1629 1493 1873 1627 1625 1624 1623 1622 1485 1978 1867 1742 1483 1481 1615 1478 1333 1180 1019  850  673  488  295   94
 162  359  548  729  902 1067 1224 1373 1514 1513 1510 1368 1645 1366 1214 1055 1506 1641 1504 1501 1359 1358 1761 1357 1498 1497 1496 1495 1494 1350 1492 1491 1490 1489 1488 1487 1620 1342 1619 1618 1617 1480 1337 1479 1334 1181 1020  851  674  489  296   95
 161  358  547  728  901 1066 1223 1372 1371 1370 1512 1511 1367 1365 1364 1363 1213 1505 1361 1503 1502 1047 1635 1500 1355 1354 1353 1352 1351 1349 1198 1348 1347 1346 1344 1343 1033 1486 1484 1341 1188 1340 1186 1336 1335 1182 1021  852  675  490  297   96
 160  357  546  727  900 1065 1222 1221 1220 1219 1369 1218 1217  890 1215  888 1053 1362 1051 1360 1209 1207 1046 1356 1204 1203 1202 1201 1200 1199 1039 1197 1194 1035 1192 1193 1345 1191 1190 1339 1189 1338 1185 1026 1184 1183 1022  853  676  491  298   97
 159  356  545  726  899 1064 1063 1062 1061 1060 1059 1058 1216  887  889 1212 1211 1052 1050 1210 1206 1049 1208 1205 1045 1044 1043 1042 1041 1040  872 1037 1196 1195 1036  866 1032 1030  865  688 1028 1187 1027  859 1025 1024 1023  854  677  492  299   98
 158  355  544  725  898  897  896  895  894  893  892  891 1056  714 1057 1054  886  885  884  883  882 1048  880  879  878  877  876  875  873  698  697 1038  871  870  869  868  691 1031  864  863    0  687  684  501  858  857  856  855  678  493  300   99
 157  354  543  724  723  722  721  720  719  718  717  715  713  530  339  712  711  710  708  525  706  881  705  704  703  702  701  699  874  515  514  696  695  694  692 1034  867  318  504  313  862  689  861  685  683  682  681  680  679  494  301  100
 156  353  542  541  540  539  538  537  536  535  534  716  533  532  529  528  527  526  709  524  707  523  522  521  520  519  518  700  326  516  513  512  321  511  693  319  315  508  507  115 1029  686  860  310  111  499  498  497  496  495  302  101
 155  352  351  350  349  348  347  346  345  344  343  342  341  531  340  140  337  336  335  334  333  332  331  330  329  328  327  517  325  323  125  123  320  121  510  506  509  690  505  317  503  311  502  112  500  308  307  306  305  304  303  102
 154  153  152  151  150  149  148  147  146  145  144  143  142  141  139  338  138  137  136  135  134  133  132  131  130  129  128  127  126  324  124  122  322  120  119  118  117  316  116  114  314  312  113  110  309  109  108  107  106  105  104  103
