# This puzzle is unsolvable
52
 204  205    3  589  401    4  209  210    9   10   11   12   13   14   15   16   18   19   20   21  224  223  225  422   23   25  424   27   28  233   30   31  235   34   35   36   37   38   39   40   41   42   43   44   45   46   47   48   49   50   51   52
 199  203    2  206  591  402    6    7  211  212  214  215  216  217  599  218  222  416  417  418  419  421   24  788  609  230   26  231  614   29  234   33  236  237  238  239  240  241  242  243  244  245  246  247  248  249  250  251  252  253  254   53
   1  207  397  587  588    5  590  406  592  213  409  410  411  413  219   17  221  603  220   22  606  420  226  227  425  229  427  613  232  428  431   32  432  619  433  436  434  623  437  438  439  440  628  441  443  444  445  446  447  448  255   54
 399  201  396  398  768  208  403  407  405  594  408  777  597  412  414  602  415  782  604  605  785  607  608  959  228  611  962  612  616  794  429  796  618  798  620  800  435  802  624  625  626  627  442  629  630  631  632  633  634  449  256   55
 202  400  938  404 1105    8  942  769  944  596  595  946 1111  598  778  779  601  781  783  784  786  787  958 1121  423  789  792  615  965  964  793  617  797  799  621  801  622 1136  974  803  804  977  807  981  980  809  810  812  635  450  257   56
1104  586  939  200  767  772  771  593  773  775  945  947  948  949  600  950  951  953  954 1119 1120 1423  956 1277  610 1123  790  426  967 1129  430  966  969  971  972  970  973 1135  975 1138  976  806  805  808  979  811  982  813  452  453  258   57
 394  770  937 1103  198  583  941  943  774 1108 1109 1112 1113 1114  952  780 1270 1115 1116  955 1118 1275  957 1122  961 1125  791  963 1128 1285 1432 1131  795  968 1133 1134 1290 1437 1137 1139 1140 1141  978 1142 1143 1144  815  983  814  260  259   58
 585 1260  395  766  936 1409  940 1407 1259 1264 1412  776 1266 1267 1268 1269 1417 1271 1117 1273 1421 1274 1276 1278 1281 1279 1430 1282 1126 1431 1130 1132 1286 1288 1435 1289 1438 1439 1292 1293 1294 1295 1296 1297 1145  984  985  639  451  636  261   59
 197  765  763 1101  764 1102 1408 1406 1107 1262 1265 1110 1552 1413 1414 1416 1555 1418 1272 1419 1561 1422 1817 1692  960 1283 1428 1284 1568 1127 1569 1433 1434 1287 1828 1574 1575 1291 1709 1440 1441 1442 1443 1444 1298 1146  638  637  640  816  262   60
 582  393  391  935 1100 1261 1257 1405 1680 1263 1411 1551 1682 1415 1687 1922 1685 1557 1689 1420 1813 1562 1559 1563 1564 1425 1124 1280 1567 1938 1570 1700 1571 1827 1572 1576 1436 1706 1577 1579 1581 1712 1582 1583  986  987  988 1147  817  454  455   61
 584  392  196  933 1258 1547 1106 1256 1546 1548 1410 1681 1683 1553 1556 1925 1688 1558 1560 1691 1690 1815 1424 1932 1818 1696 1697 1426 1936 1699 1701 1429 1702 2050 1573 1829 1578 1831 1708 1711 1580 1713 1584 1445 1446 1299  819  820  457  263   62   63
 195  580  192  762  581 1099 1255 1403 1677 1805 1806 1549 1921 1804 1808 1554 1686 1811 1812 1930 1814 1931 2039 1820 1565 2041 1427 1566 1822 2044 1823 1940 1939 1703 1944 2051 2055 1948 1710 1949 1833 1834 1835 1447 1300 1301  818  642  456  641  264   64
 194  390  761  760  579  578 1550 1919 1678 1545 1679 2028 1923 1920 2030 1807 1809 1810 1927 2034 2036 1929 2230 1694 1933 1693 2139 2043 1698 1821 1824 1704 1705 1825 1941 2052 1707 1942 1947 1832 2054 1448 1585 1303 1302 1148 1149  643  989  458  265   65
 193  388  389  759 1254  934 1098 1543 1404 1803 2026 1801 2220 2130 2029 1924 2032 1926 1928 2135 2037 2136 1816 2227 2143 1937 1934 1935 2046 2145 2045 1826 2048 2049 2150 1830 1943 1945 2152 1837 1836 1586 1714 1449 1304 1305  821 1150 1151  822  266   66
 190  191  758 1097 1096 1402  932 1544 1400 2027 1917 2128 2024 2217 2127 2031 2033 2132 2449 2305 2309 2225 2140 1695 2038 2232 2042 1819 2234 2142 2144 2047 2146 2147 2148 2149 2151 2053 1950 1946 1951 1715 1587 1451 1152 1450  990  645  644  459  460  267
 189  387  577  576  930 1253 1252 1675 1676 1797 1802 1684 2125 1915 2124 2304 2303 2131 2222 2307 2035 2226 2228 2138 2229 2040 2315 2141 2235 2318 2236 2237 2238 2239 2240 2241 2242 2153 2056 1952 1716 1717 1588 1452 1306 1153  991  823  646  461  268   67
 188  386  757  756  929  931 1251 1800 1401 1250 1674 1673 1918 1913 2025 2221 2379 2134 2306 2451 2308 2384 2137 2313 2231 2314 2389 2233 2317 2393 2319 2320 2321 2322 2323 2324 2243 2154 2057 1839 1838 1718 1589 1307 1154  992  824  647  825  462  269   68
 385  574  575  755  928 1094 1095 1399 1542 1672 1798 1799 1916 2219 2129 2126 2223 2133 2224 2383 2387 2452 2310 2311 2385 2388 2391 2316 2390 2459 2392 2395 2396 2397 2398 2325 2244 2155 2058 1953 1840 1719 1590 1453 1308 1155  993  995  826  649  270   69
 187  384  573  754  927 1093 1092 1249 1538 1540 1914 1541 2023 2218 2380 2301 2448 2447 2382 2381 2450 2511 2386 2453 2312 2456 2457 2458 2518 2461 2460 2521 2463 2464 2399 2326 2245 2156 2059 1954 1841 1720 1591 1454 1310 1309 1156  994  463  648  271   70
 186  383  572  753  926 1091 1248 1398 1671 1796 1539 1912 2022 2123 2216 2302 2378 2508 2507 2509 2510 2512 2513 2514 2455 2515 2516 2517 2519 2520 2462 2394 2522 2465 2400 2327 2246 2157 2060 1955 1842 1721 1593 1592 1455 1157  996  827  650  464  272   71
 185  382  571  752  925 1090 1247 1397 1396 1670 1794 1795 2021 2121 2122 2300 2375 2377 2444 2560 2559 2561 2564 2454 2565 2566 2567 2568 2569 2570 2571 2572 2523 2466 2401 2328 2247 2158 2061 1956 1843 1722 1594 1456 1311 1158  997  828  651  465  274   72
 184  381  570  751  924 1089 1246 1536 1537 1535 1669 1910 2020 2215 2213 2214 2299 2445 2505 2506 2602 2640 2562 2607 2608 2609 2610 2611 2612 2613 2614 2573 2524 2467 2402 2329 2248 2159 2062 1957 1844 1723 1595 1457 1312 1159  998  829  652  466   73  273
 183  380  569  750  923 1088 1244 1395 1793 1245 1911 1909 2019 2119 2120 2298 2376 2446 2558 2603 2604 2638 2605 2563 2606 2701 2644 2645 2647 2648 2615 2574 2525 2468 2403 2330 2249 2160 2063 1958 1845 1724 1313 1458 1314 1160  999  653  654  467  275   74
 182  379  568  749  922 1087 1394 1393 1534 1668 1667 1792 2018 2118 2212 2295 2442 2443 2504 2557 2639 2668 2669 2643 2670 2646 2672 2674 2692 2649 2616 2575 2526 2469 2404 2332 2331 2161 2064 1959 1846 1725 1596 1459 1161 1000  831  830  469  468  276   75
 181  378  567  748  921 1086 1243 1392 1533 1666 1791 1908 2017 2210 2296 2373 2502 2503 2501 2555 2556 2666 2642 2641 2690 2671 2691 2673 2650 2617 2618 2576 2527 2528 2470 2405 2250 2162 2065 1960 1847 1726 1597 1460 1315 1162 1001  832  655  470  277   76
 180  377  566  747  920 1085 1242 1391 1532 1665 1790 1907 2016 2211 2294 2374 2441 2554 2371 2637 2598 2600 2667 2688 2665 2686 2702 2651 2675 2652 2620 2471 2472 2407 2473 2333 2163 2067 2164 1961 1848 1727 1598 1462 1461 1163 1002  833  656  471  278   77
 179  376  565  746  919 1084 1241 1390 1531 1664 1789 1906 2015 2117 2116 2370 2297 2209 2553 2601 2597 2685 2687 2664 2660 2697 2703 2676 2678 2655 2619 2578 2577 2406 2334 2252 2251 2066 1962 1963 1849 1728 1600 1599 1316 1164 1003  834  657  472  279   78
 178  375  564  745  918 1083 1240 1389 1530 1663 1788 1905 2014 2115 2208 2439 2440 2372 2500 2599 2634 2635 2636 2700 2689 2694 2699 2677 2680 2621 2530 2529 2531 2408 2335 2336 2253 2165 2068 1964 1850 1729 1601 1463 1317 1165 1004  836  835  474  280   79
 177  374  563  744  917 1082 1239 1388 1529 1662 1787 1904 2013 2114 2207 2293 2369 2438 2499 2552 2662 2663 2631 2684 2658 2683 2698 2696 2679 2653 2579 2581 2580 2474 2475 2337 2254 2166 2069 1851 1731 1852 1602 1464 1318 1319 1166 1005  473  658  281   80
 176  373  562  743  916 1081 1238 1387 1528 1661 1786 1903 2012 2113 2206 2292 2368 2437 2498 2551 2596 2633 2659 2661 2681 2657 2695 2626 2682 2693 2625 2622 2532 2411 2256 2476 2255 2167 2070 1965 1853 1730 1465 1466 1167 1008 1006  837  659  475  282   81
 175  372  561  742  915 1080 1237 1386 1527 1660 1785 1902 2011 2112 2205 2291 2290 2436 2497 2550 2595 2632 2630 2543 2590 2542 2628 2587 2627 2656 2624 2584 2623 2410 2412 2409 2257 2168 2071 1968 1966 1732 1604 1603 1320 1170 1168  838  661  660  283   82
 174  371  560  741  914 1079 1236 1385 1526 1659 1784 2010 2009 2111 2204 2289 2367 2366 2435 2549 2594 2547 2544 2546 2487 2589 2588 2654 2538 2586 2585 2582 2533 2477 2340 2338 2258 2171 2169 2073 1967 1733 1854 1169 1321 1009 1011 1007  477  476  284   83
 173  370  559  740  913 1078 1235 1384 1525 1658 1783 1901 2110 2203 2288 2287 2365 2434 2496 2548 2492 2592 2593 2629 2591 2541 2540 2539 2537 2483 2583 2535 2534 2478 2339 2414 2259 2072 2074 2170 1855 1734 1605 1467 1468 1322  664  839  663  662  285  286
 172  369  558  739  912 1077 1234 1383 1524 1657 1782 1900 2008 2109 2202 2286 2364 2433 2495 2494 2493 2491 2427 2545 2490 2488 2486 2485 2484 2536 2482 2481 2416 2480 2413 2342 2341 2172 1969 1970 1856 1735 1606 1469 1323 1324 1171  840  478  479   85   84
 171  368  557  738  911 1076 1233 1382 1523 1656 1781 1899 2007 2108 2201 2285 2363 2432 2431 2430 2429 2357 2356 2428 2425 2424 2352 2272 2423 2422 2348 2418 2417 2479 2415 2343 2260 2261 2075 1857 1858 1736 1607 1470 1325 1172 1010  844  288  841  287   86
 170  367  556  737  910 1075 1232 1381 1522 1655 1780 1898 2006 2107 2200 2362 2361 2360 2281 2359 2358 2355 2426 2489 2354 2274 2353 2351 2350 2420 2419 2346 2268 2345 2265 2344 2262 2173 2076 1971 1859 1738 1737 1471 1173 1012  842  665  480  843   88   87
 169  366  555  736  909 1074 1231 1380 1521 1654 1779 1897 1896 2106 2199 2284 2283 2282 2280 2192 2193 2278 2277 2276 2275 2091 2273 2270 2421 2349 2269 2181 2347 2266 2178 2264 2263 2174 2077 1861 1972 1611 1608 1472 1327 1326 1014 1175 1174  666  482  289
 168  365  554  735  908 1073 1230 1379 1520 1653 1778 1895 2005 2004 2198 2197 2196 2195 2194 2098 2279 2191 2190 2189 2188 2186 2185 2090 2271 2183 2182 2087 2267 2179 2082 2083 1978 2176 2078 1860 1740 1739 1609 1610 1473 1013 1015  668  669  481  291  483
 167  364  553  734  907 1072 1229 1378 1519 1652 1777 1894 2003 2105 2104 2103 2101 2100 2099 2097 1994 2095 1992 2093 1990 2187 2092 1987 2184 2088 1873 2180 1980 2084 1979 1981 1977 2175 2080 1865 2079 1862 1474 1328 1475 1016 1329  845  670  290  667  484
 166  363  552  733  906 1071 1228 1377 1518 1651 1776 1893 2002 2001 1999 2102 1998 1997 1996 1995 1993 2096 1881 2094 1879 1989 1877 1988 2089 1754 1874 2086 1984 2085 1869 1982 2081 2177 1975 1482 1863 1973 1741 1612 1176 1177  847  846  486  292   90   89
 165  362  551  732  905 1070 1227 1376 1517 1650 1775 1891 1890 1889 2000 1768 1888 1886 1885 1884 1883 1882 1762 1991 1878 1759 1758 1876 1985 1986 1872 1626 1983 1870 1750 1749 1867 1974 1866 1745 1864 1742 1613 1331 1330 1017  848  671  485   91  293   92
 164  361  550  731  904 1069 1226 1375 1516 1649 1774 1892 1772 1771 1770 1769 1887 1767 1766 1765 1764 1763 1761 1634 1497 1760 1631 1630 1757 1875 1756 1627 1871 1490 1868 1622 1748 1621 1617 1618 1614 1743 1615 1476 1179 1178 1018 1019  487  488  294   93
 163  360  549  730  903 1068 1225 1374 1515 1648 1647 1773 1646 1645 1508 1643 1641 1640 1639 1638 1637 1636 1880 1633 1498 1351 1353 1496 1755 1197 1752 1491 1751 1349 1488 1623 1033 1484 1619 1744 1616 1481 1478 1333 1477 1180  673  849  672  295  296   94
 161  162  359  728  729  901 1224 1373 1514 1513 1512 1511 1510 1644 1509 1642 1507 1506 1504 1503 1501 1360 1500 1357 1632 1635 1354 1494 1629 1348 1753 1345 1628 1624 1346 1342 1747 1487 1485 1343 1483 1479 1337 1334 1332 1181  850 1020  674  489  297   95
 160  358  548  547 1067  902 1223 1372 1371 1370 1369 1368 1367 1366 1365 1364 1363 1505 1362 1209 1050 1502 1358 1205 1356 1355 1352 1350 1202 1492 1625 1493 1489 1195 1344 1620 1193 1032 1976 1340 1339 1480 1336 1186 1184 1335 1021  851  852  491  490   96
 357  356  546  727  900 1066 1065 1221 1220 1219 1218 1217 1216 1215 1214 1213 1212 1211 1361 1210 1359 1207 1208 1206 1041 1499 1042 1200  876 1040 1199 1347 1036 1037 1194 1486 1192 1191 1341 1188 1746 1338 1027 1187 1024 1182 1183  853  675  676  298   97
 159  544  355  726  897 1063 1222 1062 1061 1060 1059 1058 1057 1056 1055 1054 1053 1052  884 1051  881 1046 1047 1204  703  875 1043  699 1201 1495 1198 1038 1196  695  868 1034  692  866 1190 1189  862 1029  860 1185  856 1026 1022  854  677  492  299   98
 158  354  724  545 1064  899  896  895  894  893  892  891  890  889  888  887  711  709  883  524  334  879  331  702  877  704 1044 1203  874  873 1039  870  697  869 1035  865  864 1031  690  863 1028  861  685  859 1025  857 1023  855  678  493  300   99
 157  542  540  353  898  722  721  720  719  718  717  716  715  714  713  712  528  886  885  525  708 1049  880  132  878  700  517  516  871  323  322  872  693  121  509  119  318  867  688 1030  687  686  311  684  858  683  681  680  679  495  100    0
 155  543  725  541  723  539  538  537  536  535  534  533  532  531  530  529  337  527  710  705  882 1048  707  520  519 1045  325  128  515  514  124  694  696  122  507  511  510  505  689  314  504  502  501  309  500  682  498  497  494  302  301  101
 352  156  351  350  150  349  348  347  346  144  143  342  142  341  339  338  335  336  526  333  134  522  523  521  330  329  328  518  327  324  513  698  512  319  317  508  691  117  115  313  312  503  310  111  110  499  307  306  496  305  303  102
 154  153  152  151  149  148  147  146  344  345  343  145  141  140  340  139  137  138  136  135  332  706  133  131  130  701  129  127  326  126  125  123  320  321  120  118  316  116  506  315  114  113  112  109  308  108  107  106  304  105  104  103
