# This puzzle is unsolvable
45
 177    1    2    4    8    6  351  183    9   10   11  188   12  190   15  191   17   19  193   20   21   22  197   25  526  201  200   28  205  204   31   34   32   35  535  209  212  211   39   40   41  219  217   43   46
 175  176  179    3    5    7  182  507  184  185  186  353  187  514  189  359  518   18  670  361  194  196  364   23  198  366  202   26   30  206  374  210  208  537  377   36   37  214  541  216  383   42   45  220   44
 343  174  178  346  347  180  348  510  508  512  663  511  356  358   14  192  519  669  813  523  195  363  674  367  199  368  527  678  203   27  683  373   33  380  966  688  379   38  381  540  384  542  386   48   49
 173  344  345  505  658  181  509  349  660  662  354  513  355  357  517  516   16  362  360  521  672  522  675  365  525  529  369  682  531  372  375  207  538  536 1092  832  378  689  692  215  382  544  385  221  218
 342  655  504  502  506  656  350  803  804  661  664  352   13  668  810  812  515  811  520  671  816  524  820  819  676  824  681  370 1086  532   29  534  376  687  686  968  969  691  213  834  388  223  693  543   47
 172  341  503  654  801  936  659  802  939  940  942  941  806  808  667  944  947  815  949  817  673  818   24 1082  528  677  371  821  680  962  533  684  829 1091  828  964  830 1094  833  835  694  389  222  387   51
 171  340  501  799  800  937  657  938 1067  805 1066 1189  809  666  665  945  948  814  950 1077  951  953 1079  954  958 1085  530 1087  822 1205  960  826  685 1090 1093 1211 1210  831  690  695  539  545  225   52   50
 170  339  499  653  798  935 1064 1065 1185 1188 1070  943 1190 1071 1072 1074 1193 1075 1076 1196 1078 1199  952 1200  956  679  955 1084 1089 1088 1207  827 1426 1209  965 1212 1213  967 1095  836  696  546  390  547   53
 169  652  651  500  797  934 1063 1184 1296 1187 1298  807 1068 1302 1192 1073  946 1194 1195 1198 1197 1080 1309 1414 1203 1083  957 1315  823 1206 1204  959 1420 1319 1321 1320 1214  971  698  837  839  548  549  227  224
 336  338  337  498  796  933 1062 1183 1295 1186 1401 1069 1404 1303 1405 1191 1305 1306 1411 1307 1308 1312 1506 1311 1202 1513 1314 1514 1317 1208  825  963 1519 1322 1323 1096  972  838  970  840  699  550  226  228   54
 168  167  649  650  795  932 1061 1182 1400 1297 1402 1299 1300 1586 1304 1408 1406 1407 1409 1410 1412 1413 1595 1415 1509 1081 1418 1316 1313 1679 1515  961 1517 1422 1424 1324 1215 1097  974  697  973  393  391  392  229
 166  334  333  335  793  931 1060 1181 1294 1399 1495 1496 1403 1500 1301 1502 1589 1503 1504 1505 1593 1508 1310 1416 1510 1511 1600 1601 1419 1516 1425 1602 1421 1325 1216 1217 1099 1098  841  842  700  551  394   56   55
 165  494  497  496  648  930 1059 1180 1293 1398 1497 1584 1585 1498 1587 1737 1501 1592 1669 1671 1594 1742 1744 1507 1201 1598 1512 1750 1423 1606 1318 1518 1605 1753 1520 1326 1218 1100  976  975  701  552  395  230   57
 164  332  794  495  792  929 1058 1292 1397 1179 1494 1583 1736 1665 1499 1666 1590 1857 1591 1745 1672 1675 1596 1746 1597 1677 1866 1417 1603 1752 1680 1604 1427 1522 1428 1328 1219 1327 1101  843  702  553  231   58   59
 163  493  646  647  791  928 1057 1176 1178 1291 1582 1663 1664 1588 1800 1667 1668 1670 1904 1804 1863 1807 1673 1674 1676 1678 1915 1815 1681 1684 1814 1682 1685 1521 1429 1329 1102 1221  704  977  844  554  396  232   60
 162  331  492  790  789  927 1288 1289 1395 1492 1493 1581 1662 1734 1735 1738 1805 1856 1803 1741 1808 1913 1809 1911 1811 1599 1749 1867 1751 1609 1683 1754 1523 1607 1430 1330 1220  979 1103  705  703  398  397   61  236
 161  330  644  645  924  926 1056 1055 1290 1396 1394 1491 1580 1661 1798 1859 1740 1739 1944 1907 1806 1861 1951 1747 1983 1748 1812 1813 1868 1758 1686 1756 1755 1608 1524 1331 1222  845 1104  978  556  399  235  234  233
 160  491  328  490  788  925 1054 1175 1177 1392 1658 1490 1660 1732 1797 1733 1858 1903 1802 1862 1908 1860 1912 1949 1950 1910 1817 1953 1954 1872 1688 1816 1610 1526 1525 1431 1432 1105  706  847  980  848  555   63  400
 159  329  786  158  642  787 1053 1174 1393 1287 1579 1659 1795 1577 1488 1854 1731 1905 1978 1801 1975 1909 1981 1864 1957 1810 1984 1874 1870 1818 1871 1757 1687 1433 1434 1332 1223 1106  981  846  559  558  557  402   62
 157  327  489  783  643  923 1173 1172 1391 1286 1390 1578 1489 1901 1850 1799 1852 1945 1946 1976 1979 1948 1987 1869 1947 1865 1914 1952 1916 1759 1819 1612 1611 1527 1435 1333 1224 1107  982  707  849  708  237  401   64
 324  485  488  487  640  785 1052 1050 1285 1486 1389 1576 1942 1796 1730 1855 1899 1853 1906 1941 2000 2001 2006 1743 2020 1982 2004 1985 1956 1689 1820 1690 1613 1528 1436 1334 1225 1108  983  850  709  560  403  238   65
 156  154  325  638  641  922 1049 1051 1284 1487 1485 1656 1657 1729 1727 1902 1940 1943 1977 2002 1973 2018 2019 1980 2024 1877 2007 1760 1955 1917 1875 1761 1614 1529 1336 1437 1226 1109  984  851  710  561  404  239   66
 155  486  326  919  639  784  921 1171 1283 1387 1388 1574 1573 1575 1655 1792 1900 1898 1972 1998 1997 2016 1921 2003 1919 2005 1918 1823 1920 1873 1822 1691 1692 1530 1335 1227 1110 1111  985  852  711  562  405  240   67
 153  323  484  637  920 1048 1169 1170 1282 1386 1484 1572 1654 1794 1728 1793 1896 1974 1999 1996 1938 2014 2022 1986 2008 2010 1959 1876 1764 1821 1763 1762 1615 1616 1617 1531 1228 1112  986  853  712  563  406  241   68
 321  482  322  781  782 1047  917 1168 1281 1483 1482 1653 1652 1726 1851 1791 1849 1848 1897 1971 2015 2012 2011 2017 2021 1885 1960 1878 1923 1824 1694 1693 1765 1532 1337 1339 1439 1113  987  854  713  564  407  242   69
 152  319  636  483  918  634  780 1167 1280 1385 1481 1651 1725 1723 1790 1847 1937 1939 1995 1967 1934 2023 1993 1991 1958 1962 1990 1989 1922 1825 1696 1618 1619 1438 1338 1440 1229 1230  988  855  714  565  408  243   70
 151  150  320  779  635  916 1046 1045 1279 1384 1571 1480 1570 1724 1789 1846 1845 1970 1895 1994 1966 2013 1965 1988 1964 1963 1925 1961 1879 1924 1826 1699 1533 1534 1441 1231 1114 1115  989  856  715  566  409  244   71
 481    0  479  632  778  915 1044 1166 1165 1478 1382 1383 1650 1787 1722 1788 1935 1936 1969 1890 1932 1931 1992 2009 1886 1927 1832 1831 1880 1882 1766 1695 1621 1535 1442 1698 1340 1233  990  857  716  567  410  245   72
 149  633  318  631  777  914 1043 1163 1278 1164 1567 1479 1569 1568 1844 1893 1892 1891 1968 1933 1841 1888 1930 1928 1929 1884 1772 1881 1768 1827 1769 1767 1620 1622 1342 1443 1341 1232  991  858  717  568  411  246   73
 148  480  317  478  776  913 1042 1276 1381 1277 1648 1649 1721 1785 1786 1784 1843 1781 1714 1842 1889 1837 1887 1835 1834 1883 1773 1828 1830 1829 1700 1697 1537 1447 1117 1234 1116 1118  992  859  718  569  412  247   74
 147  316  629  476  630  775  912 1162 1275 1380 1477 1566 1565 1720 1718 1783 1839 1715 1894 1840 1838 1779 1836 1776 1833 1926 1707 1705 1704 1771 1623 1702 1701 1536 1444 1445 1343 1235  993  860  719  570  413  248   75
 146  315  475  477  774  911 1041 1161 1274 1379 1476 1564 1647 1646 1562 1717 1641 1713 1368 1780 1712 1636 1777 1778 1774 1632 1631 1706 1628 1629 1770 1543 1539 1538 1446 1344 1239 1119  994  861  720  571  414  249   76
 145  314  628  313  773  910 1160 1157 1273 1378 1474 1643 1475 1560 1468 1642 1557 1716 1782 1638 1364 1637 1711 1709 1708 1775 1630 1547 1546 1703 1627 1626 1624 1540 1346 1236 1347 1237  995  862  721  572  415  250   77
 312  143  474  770  627  772 1040 1037 1271 1158 1376 1644 1472 1469 1558 1261 1466 1146 1639 1554 1555 1552 1710 1551 1633 1459 1548 1456 1455 1545 1544 1542 1625 1541 1448 1238 1345 1120  996  863  722  573  416  251   78
 144  626  311 1039  771  908 1038 1270 1159 1374 1473 1563 1272 1561 1370 1645 1719 1640 1556 1462 1362 1635 1360 1634 1359 1550 1458 1457 1355 1356 1453 1452 1451 1450 1449 1348 1240 1121  997  864  723  574  417  252   79
 141  625  473  470  907  909 1036 1156 1153 1268 1269 1372 1470 1559 1263 1367 1260 1464 1257 1366 1363 1365 1553 1361 1460 1549 1251 1358 1249 1454 1354 1353 1352 1351 1350 1349 1123 1122 1124  998  575  418  419  253   80
 142  471  472  769  623  906 1035 1154 1155 1377 1266 1267 1471 1264 1371 1369 1262 1259 1465 1258 1255 1463 1461 1254 1138 1252 1134 1357 1248 1133 1247 1246 1245 1244 1243 1242 1241 1125  999  724  865  725  576  254   81
 310  140  622  309  768 1034  901 1375 1151  897 1029 1373 1265  895 1148  892 1467 1147 1143 1142 1141 1256 1140 1253 1137 1014 1135 1250  880 1132 1009 1131 1130 1129 1128 1127 1126 1000  867  866  726  577  420  255   82
 138  308  621  766  624 1033  905 1030 1031 1152  762  896 1150 1149  894 1025 1023 1145 1144 1021 1019 1018 1017  885 1016  884 1013 1136 1012 1011 1010 1008 1007 1006 1005 1004 1003 1002 1001  868  727  578  421  256   83
 136  468  467  469  767  903  615 1032  902  898  611  759 1026  756 1028 1024  893  890 1020  889  749  888  887  886 1139  598  883  743  881  879  878  877  876  875  874  873  872  871  870  869  728  579  422  257   84
 305  139  620  764  904  461  619  900  761  760  758  612  757  609  754  753  752  891 1022  751  602  748  747  746  745 1015  742  882  741  740  739  738  737  736  735  734  733  732  731  730  729  580  423  258   85
 137  134  307  466  617  765  763  299  614  458  899 1027  455  454  755  607  606  605  604  750  603  601  600  599  744  597  596  595  594  593  592  591  590  589  588  587  586  585  584  583  582  581  424  259   86
 135  306  304  131  618  616  297  462  460  456  613  294  291  608  610  452  451  450  449  448  447  446  445  444  443  442  441  440  439  438  437  436  435  434  433  432  431  430  429  428  427  426  425  260   87
 302  303  463  465  128  301  300  126  125  123  457  120  292  119  122  118  288  287  286  285  284  283  282  281  280  279  278  277  276  275  274  273  272  271  270  269  268  267  266  265  264  263  262  261   88
 132  133  130  464  129  127  298  296  459  295  124  293  453  121  289  290  117  116  115  114  113  112  111  110  109  108  107  106  105  104  103  102  101  100   99   98   97   96   95   94   93   92   91   90   89
