# This puzzle is unsolvable
34
   1    3  132    5  135    6    9  138  141    7   14  381  147  267  146   17  148  269   22  150  152  276  498   23   24   25   26   27  160   28  162   29   32   34
 256    4  137  134  480  262  139  378   11  489   10   13   16  591  492  487  270  275   18  501  149   21  393  155  156  157  159  161   30   31  285  163   33   35
 255  133    2  259  131  373  261  376    8  265  144  266  268  491  764  143  589  273   20   19  153  500  391  278  279  158  396  398  282  284  165   36  164   37
 370  130  253  260  257  375  136  674  486  140   15  833   12  490  142  385  386  684  151  496  390  154  600  596  394  281  694  397  283  507  287  167   38   39
 369  372  371  479  580  258  482  583  485  675  263  484  383  145  494  593  272  387  274  497  392  770  277  598  499  280  505  604  504  399  401  286  166  289
 128  129  374  582  252  377  757  581  483  264  758  585  587  765  384  271  592  682  389  388  683  688  687  692  851  695  693  502  503  400  508  288  402  168
 477  126  254  672  481  677  756  673  678  832  763  380  681  679  588  493  841  767  844  495  595  689  601  849  602  599  775  395  605  506  403  290  169   40
 366  249  368  476  478  127  379  671  761  676  835  488  590  584  766  680  685  594  686  771  769  846  774  597  776  848  696  603  509  405  291  292  170   41
 125  578  367  667  577  579  475  755  899  759  586  760  838  964  909  907  839  842  768  845  773  971  691  911  915  690  608  778  606  697  607  404  171   42
 250  365  474  668  573  897  898  831  959  961  901  836  904  382  905  968  843  965 1021  970  914  972  847  975  779  850  852  777  510  610  406  293  172   43
 124  576  248  575  753  669  749  902  896  834  903  900  762 1057 1017  840  906 1064 1019 1022  910  913  974  916  772  780  917  698  512  511  407  294  173   44
 123  251  247  574  754  670  829  830  958  960 1014  962  837 1011 1015  908  967 1061  969 1062 1099 1066  912 1023  973  918  699  609  611  513  408  295  174   45
 122  363  473  246  121  364  472  752  957 1055 1012 1013  963 1016 1094 1020  966 1125 1097 1065 1100 1025  976  919  853  855  854  781  700  409  410  175  176   46
 119  361  120  469  664  471  826  751  748  895 1056 1054 1091 1060 1059 1122 1142 1095 1103 1124 1027  977 1024  920  978  921  782  701  783  514  297  298  296   47
 245  362  244  470  666  571  665  828  572  956  827 1090 1092 1093 1058 1018 1144 1096 1126 1101 1067 1128 1028 1026  923  787  857  614  612  613  515  299  177   48
 243  360  468  465  567  570  894  750  892 1009 1010 1007 1008 1121 1120 1118 1141 1063 1127 1068 1129 1098 1029  979  858  924  859  784  702  516  411  412  178   49
 118  242  467  568  825  663  569  662  746  955 1005 1053 1140 1052 1139 1152 1143 1123 1102 1069 1131 1073 1071 1104  980  922  856  704  517  518  615  519  179  180
 117  115  240  359  744  660  466  747  952  951 1051 1089 1117 1119 1137 1154 1148 1149 1155 1147 1072 1105 1070 1031 1030  860  703  785  415  416  413  414   51   50
 358  357  239  659  743  565  661  823  893  954 1004 1050 1088 1116 1136 1151 1146 1133 1138 1130 1145 1107 1032  981  982  927  705  618  617  616  302  300  301   52
 237  236  112  241  564  116  355  824  889  953 1006 1049 1087 1113 1150 1134 1135 1109 1153 1132 1106 1108  983 1074  925  926  788  786  520  706  521  182  181   53
 114  113  658  462  745  563  821  822 1003  890  950 1002 1086 1085 1115 1044 1112 1110 1078 1077 1075 1033  984  862  789  707  864  708  620  523  303  522   54   56
 234  110  566  820  464  562  819  948  949  888 1047 1084 1048 1043 1114 1082 1111  993 1039 1038 1034 1037  929  871  791  861  622  711  619  419  621  183  417  186
 356  352  108  235  463  738  818  560  891  883  943 1046 1045  942  997 1079 1081 1080  990 1040 1076  985  930  870  987  865  709  710  525  863  524  304   55  305
 238  461  353  657  739  656  742  887  816 1001 1000  999  998  806 1083 1041  995  996  994  874  934  869  873  928  931  712  986  792  790  306  420  418  185   57
 111  233  350  351  653  650  741  651  817  815  947  884  944  880  879  878 1042  992  939  722  991  936  798  933  868  797  866  794  187  526  421   58   59  188
 654  109  349  354  561  460  740  813  886  734  652  882  945  881  941  940  876  938  937  721  719  989  935  539  631  932  717  713  528  308  309  307   60  190
 655  232  559  459  456  732  946  647  645  730  735  810  811  808  727  877  638  875  725  802 1036  800 1035  720  793  534  867  623  530  624  424  310  422  184
 107  106  348  457  556  458  736  551  550  885  733  809  642  728  807  545  805  724  542  804  633  872  433  988  799  630  718  714  715  795  529  425  191   61
 104  231  105  455  555  558  737  554  646  449  812  335  547  729  641  544  640  639  438  635  723  540  801  434  537  796  626  628  429  627  532  527   62  313
 103  230  347  346  454  553  557  552  648  446  731  644  548  643  330  443  726  442  803  636  326  538  632  535  629  716  533  431  430  426  189  423  427  192
 102  229  226  345  453  452  450  451  338    0  447  334  549  444  546  441  212  440  543  327  634  436  435  323  321  432  316   73  625  317  312  314  311   65
 228  344  343  342  341  222  649  339  814  337  218  336  445  333  332  331  329  637  541  437  325  324   78  536  204  196   75  201  428   70  315  193  195   64
 100  227   98   96   95  221  340   91  448   92  217  216  215  214  213  210  211  209  439  208  207  206   79   76  205  202   71  198  531  199  318  194   68   66
  99  225  101  224  223   97   94  220   93  219   90   89   88   87   86   85   84   83   82  328   81   80  203   77   74  320  322   72  200  319   69  197   67   63
