# This puzzle is unsolvable
36
   2    1    3    4    5    6    7    8    9   11   10  152   15  150   12   13   17  285   18  290   21  161   22  165   23   24  296   25   28   30   29  169   33  172   36   37
 140  141  142  143  144  145  146  147  279  280  151  282  283  153   14   16  286  159  158   20  291  292  531  162  297  164  298  167  421   32  425  303  170   34  305   35
 139  272  273  274  275  276  277  278  404  148  149  407  520  284  155  156  287   19  288  160  414  293  294  417   26  299   27   31  422  300  171  424  302  174   39   38
 138  271  396  397  398  399  400  401  402  403  281  521  405  154  409  157  410  412  527  289  529  415  416  163  642  420  419  538  166  304  744  426  176  175  173   40
 137  270  395  512  513  514  622  515  516  625  518  519  627  522  408  524  526  411  528  734  532  637  640  533  418  168  536  643  537  539  423  301  540  427   41  177
 136  269  394  511  620  621  721  623  517  816  725  406  629  628  523  630  525  634  413  636  530  828  534  638  639  641  742  535  644  645  647  646  541  306  307  178
 135  268  393  510  619  811  720  813  724  815  726  727  817  820  728  631  731  632  635  633  825  735  295  737  739  740  741  743  834  542  429  431  309  428  182   43
 134  267  392  509  618  722  812  723  624  898  899  626  818  902  730  821  906  732  733  824  736 1052  738  910  829  831  914  832  746  916  745  648  180  179  183  311
 133  266  391  508  617  719  718  896  814  972  974  900  901  819  729  904  905  981  823  909  908 1051  911  827  987 1056  991  833  649  747  650  543  312  308  544   42
 132  265  390  507  616  717  810  895  897  973  975 1042  976  903  977  978  822 1108  907  983  826 1055  985  830  989  913  915  917  836  835  651  545  432   46  547   44
 131  264  389  506  615  716  809  894  971 1040 1041 1101 1044  979 1045 1105  980 1048  982  984 1049 1160 1054  988  912  990 1114  839  918  748  314  434  185  430   48   45
 130  263  388  505  614  715  808  893  970 1039 1100 1102 1043 1153 1046 1106 1047 1201 1107 1110 1050 1111  986 1053 1113 1165 1058 1057  837  838  655  548  546  550  433  313
 129  262  387  504  613  714  807  892  969 1038 1099 1152 1154 1155 1103 1104 1157 1158 1198 1109 1205 1161 1162 1163  992  919  996  921  653  553  435  922   47  310   49  186
 128  261  386  503  612  713  806  891  967  968 1037 1151 1196 1197 1233 1156 1200 1237 1159 1202 1203 1239 1112 1164 1115  995  840  920  654  549  652  657  181  315  436  187
 127  260  385  502  611  711  712  805  890 1036 1098 1097 1232 1230 1199 1234 1260 1235 1263 1238 1265 1204 1206 1118 1059  993  752  923 1116    0  750  749  753  551  184  438
 126  259  384  501  610  710  804  889  966 1035 1096 1150 1193 1258 1231 1259 1294 1236 1280 1264 1241 1208 1166 1207 1168  994 1117 1000  554 1060  656  658  844  317   52  189
 125  258  383  609  709  608  803  888  965 1034 1095 1195 1149 1194 1261 1279 1262 1292 1267 1286 1210 1240 1167 1169 1061 1064  926  997  751  841  843  556  318   51  321   50
 124  257  381  500  499  802  887  886  964 1033 1094 1148 1192 1229 1257 1278 1281 1282 1244 1285 1209 1284 1119 1211 1062  842  998 1002  319  437  440  192  439   54  316  558
 123  256  498  382  607  708  801  885  963 1030 1146 1147 1191 1256 1255 1291 1287 1283 1295 1268 1242 1247 1213 1121 1120 1063 1065  847  754  757  759  190  188  320  555  322
 122  255  380  497  606  707  800  799  962 1093 1032 1145 1190 1228 1277 1276 1293 1288 1270 1289 1212 1246 1171 1266 1170  999  756  928  845  925  846  559  441  193  661  660
 121  254  379  496  605  797  883  705  884  961 1031 1091 1189 1227 1254 1275 1251 1290 1269 1217 1252 1272 1248 1243 1214 1172 1122  927 1001  924  848   58  664  196  191   53
 120  253  378  495  604  704 1141  706  960 1089 1092 1142 1090 1188 1225 1253 1221 1273 1271 1249 1180 1173 1130 1067 1068 1124  929  930  849  662  557  194  561  442  444   57
 119  252  377  494  603  703  882  798 1028 1029 1144 1226 1186 1224 1223 1222 1250 1079 1182 1274 1216 1076 1245 1125 1071 1126 1123 1004 1066  552  758  755  659  445   60   56
 118  251  376  493  796  881  601  957 1140  958  959 1143 1084 1083 1184 1136 1134 1220 1219 1179 1176 1174 1215 1177 1128  933 1003 1069  931  850  853  663  323  324  443   55
 117  250  375  492  702  701  795  880  956 1085 1027 1087 1139 1187 1138 1135  945 1183 1181 1133 1178 1218 1175 1005 1127  936 1070  851  760  448  447  761  328  325   59  197
 116  249  372  491  602  793  794  879 1026 1088 1086 1022 1019 1185 1023 1081 1080 1017 1078 1016 1077 1013 1132 1072 1074 1009 1008  665  762  763  562  668  764  449  446   61
 113  115  374  373  600  599  700  878  955 1025 1024  950  949 1021 1137  947  946 1014 1015  944 1129 1075 1131 1010  934  857 1006  935  666  765  563   62  564  560  195   63
 111  248  246  490  489  792  790  877  954  953  952  951  948 1018  687  782  867 1082  777  943  861  940  939 1073  858 1007  854  673  932  852  450  671   65  565  326  327
 114  369  596  488  371  699  598  789  874  788  873  872 1020  870  868  780  869  942  778  941  863 1011  938 1012  859  460  937  674  769  768  766  667  452  329  330  198
 110  247  697  597  487  791  876  696  875  787  691  786  690  474  866  688  685  682  776  860  771  680  679  678  770  677  571  462  767  459  451  566   64  454  212  200
 244  245  364  486  112  485  595  481  479  693  689  785  871  781  784  864  779  584  865  683  774  775  575  773  856  855  461  341  672  567  210  669  331  199  201   66
 109  482  368  594  236  698  695  361  590  587  783  478  475  354  585  353  472  581  684  579  862  681  465  577  463  675  772  574   78  342  457  453  670  455  202   67
 242  367  366  370  483  238  593  589  359  692  231  356  588  229  352  226  582  470  471  469  578  467  466  464  576  214  344  573   77  568  569  334  332  203  211  207
 243  694  239  103  484  592  363  480  232  360   93  473  586  583  686  476   91  351  224  347  222   84   87   81  219  339  343   80  340  208   76  333   69  205   70  204
 241  108  107  237  102  101  591  100  234  358  230   95   98  228  227   92   90  580  350  348  468  220  221  345  346  676  572   79  213  570  209  335   68   73  337  206
 240  106  105  104   99  235  365  362  233   97  477  355   96  357   94  225   89  223   85   88   86  349  218   83  215  217  216   82  458  338   75  456   74   72  336   71
