# This puzzle is unsolvable
54
   2    1    3    4  216    7  422    8  617    9   12   11   14   15   16  227   17  228   18  231   19   22   23  438   25  238   27  241   30  242  640   34   32   33  451  450  833   36  247  254  457   42   44   45  256   47  259  460   48   50   51   52   53   54
 212  213  214  215    6    5  217  218  219  223  620   10   13  224  226  432  431  229  230   20   21  233  235  236   24   26  439  443   28  444  829   31  448  245  246  449  249   40   37   39  650  649   41  255  455   46  659  258   49  260  262  263  264   55
 415  211  417  419  614  420  616  421  221  222  619  427  425  225  624  429  627  433  816  629  234  436  633  437  440  237  441   29  637  446  445  243  447  452  644  252   35  834  835 1351  253  458  459   43  462  653  461  844  656  463  465  261  265   56
 416  418  612  800  613  615  618  804  424  220  808  986  426  622  428  430  625  626  434  628  232  997  818  631  634  635  239  639  240  442  828  244  830  831  643  250  646 1016  454 1187  651 1192 1022 1507  654  843  655 1023  464  658  660  466  266   57
 210  209  414  799  611  802 1155  982  985  805  621  809  987  623  990  812  814  813  995  630  632  435 1167  999  820 1003  824  821  823 1175  826  642 1343 1009  832  645  248 1014 1501  838  251  839  841  842 1355  840  257  845  661  657  662  467  468  267
 413  610 1152  977  801  981  983  803  807 1156  423  811  810 1323 1161  992  991  993  994  815 1166 1170  819  998 1000 1001 1172  636  827  825 1339 1176 1007 1008 1012 1010 1181 1013  837   38 1188  652  836 1017 1353 1510 1193 1021  847  848  470  269  469   59
 207  208 1151  411  608  979 1315 1153  984 1157  806 1159  989 1322 1160 1162 1163 1327 1164  996 1165  817 1169 1333 1171 1336 1173 1002  638 1338 1005 1006 1179 1180 1011    0 1182  647 1504 1015 1349 1352  648 1020  456 1191 1354 1024 1026  850  846   58  268   60
 206  798  607  609  980 1316 1154 1318 1473 1319 1320 1321 1477  988 1324 1325 1326 1328 1483 1485 1329 1330 1168 1332 1489 1335 1491  822 1004 1174 1342  641 1178 1497 1647 1499 1648 1186 1345 1346 1503 1018 1350 1019 1190 1189 1356 1025 1194  849  664  471  270   62
 205  412 1150  976  797 1313 1149 1472 1317 1474 1475 1158 1624 1478 1479 1480 1481 1482 1484 1630 1631 1487 1334 1488 1905 1490 1637 1337 1493 1494 1177 1340 1341 1500 1646 1347 1344 1184 1185 1348 1650 1505  453 1509 1655 1197 1511 1358 1196 1195  665  272  663   61
 410  204  796  974  605 1314 1471 1470 1620 1621 1623 1476 1625 1764 1626 1627 1629 1768 1767 1902 1770 1486 1331 1907 1775 1636 1639 1492 1640 1495 1496 1645 1642 1498 2039 1784 1649 1183 1787 1651 1652 1653 1506 1654 1508 1512 1357 1028 1027  851  666  472  474  473
 604  606  409  795  975 1148  978 1619 1760 1761 1622 1762 1763 1895 1765 1766 1628 1769 2025 1901 1772 2026 1632 1633 1774 1776 1909 1779 1780 1641 1913 1911 1643 1783 1644 1919 1502 1786 1789 1790 1791 1792 1793 1794 1656 1657 1359 1198 1029  852  667  273   63  271
 202  203  793  791  973  794 1147 1469 1617 1618 1892 1893 1894 1896 2134 2136 2019 1898 2021 1900 1771 1773 2029 1778 1634 1908 1638 2032 2147 1912 1781 1782 1914 1915 1785 1917 1918 1788 1920 1921 1922 1923 1924 1795 1658 1513 1360 1199 1030  853  668  475  274   64
 406  407  199  603  792 1311 1312 1467 1759 1891 2016 2014 2017 2133 2018 2020 1897 2022 1899 2023 2024 2140 1904 1635 2143 2030 1777 2150 1910 2034 2036 2037 2152 2038 2261 1916 2041 2042 2043 2044 2045 2046 1925 1796 1659 1514 1361 1200 1031  854  669  476  275   65
 198  408  600  200 1146 1145 1466 1616 1468 1310 1757 2015 2132 2135 2241 2243 2242 2137 2246 2138 2139 1903 2028 2144 2250 1906 2031 2146 2255 2033 2035 2151 2259 2153 2359 2040 2156 2157 2158 2159 2160 2047 1926 1797 1660 1515 1362 1201 1032  855  670  477  276   66
 201  402  405  972 1143  971 1309 1615 1756 1758 1890 1889 2131 2240 2340 2342 2244 2245 2434 2247 2248 2142 2249 2141 2439 2145 2252 2148 2254 2149 2256 2357 2258 2361 2154 2263 2362 2264 2265 2266 2161 2048 1927 1798 1661 1516 1363 1202 1033  856  671  478  277   67
 403  196  601  790 1144 1308 1305 1465 1614 1755 1888 2013 2239 2129 2341 2432 2344 2435 2518 2345 2348 2438 2027 2251 2349 2352 2441 2526 2354 2356 2257 2530 2358 2260 2262 2452 2155 2363 2364 2267 2162 2049 1928 1799 1662 1517 1364 1203 1034  857  672  479   69   68
 599  195  970  789  602 1140 1612 1887 1464 1753 2012 2126 2130 2127 2238 2433 2343 2436 2519 2662 2346 2347 2350 2522 2523 2443 2253 2353 2444 2355 2531 2529 2450 2533 2360 2535 2453 2454 2365 2268 2163 2050 1929 1800 1663 1518 1365 1204 1035  858  673  480  278   70
 197  404  788  969 1142 1141  786 1306 1611 2010 1754 1613 2128 2235 2339 2237 2431 2517 2593 2595 2520 2521 2440 2665 2525 2442 2351 2528 2445 2447 2604 2449 2448 2534 2451 2610 2536 2455 2366 2269 2164 2051 1930 1801 1664 1519 1366 1205  859  674  675  481  279   71
 401  598  787  968 1307  966  967 1463 1752 1884 1885 2011 2236 2429 2430 2515 2516 2514 2594 2721 2437 2596 2772 2597 2599 2667 2527 2669 2602 2603 2446 2605 2607 2532 2608 2609 2537 2456 2367 2270 2165 2052 1931 1802 1665 1520 1367 1037 1036  860  482  281  280   72
 194  597  784  400  596 1139 1304 1462 1610 1749 2009 1886 2335 2337 2428 2591 2592 2590 2660 2720 2722 2663 2726 2725 2524 2601 2668 2670 2729 2671 2672 2606 2673 2674 2676 2611 2538 2457 2368 2271 2166 2053 1932 1803 1666 1521 1368 1206 1207  861  676  483  282   73
 397  396  595  783 1138 1303 1461 1460 1609 1883 1750 2338 1882 2234 2124 2336 2513 2659 2719 2770 2661 2773 2598 2724 2818 2778 2780 2776 2728 2730 2731 2732 2733 2675 2677 2612 2539 2458 2369 2272 2167 2054 1933 1804 1667 1522 1369 1208 1038  862  677  484  283   74
 193  398  785  594  965 1137 1300 1302 1751 1748 2125 1607 2007 2233 2334 2427 2512 2589 2658 2716 2664 2816 2814 2727 2774 2666 2857 2779 2823 2781 2782 2783 2784 2734 2735 2613 2540 2459 2370 2273 2168 2055 1934 1805 1668 1523 1370 1209 1039  863  678  485  284   75
 399  192  782  781  964  963 1135 1459 1458 2008 2004 1879 2005 2333 2122 2426 2511 2588 2717 2815 2812 2718 2900 2817 2901 2910 2821 2820 2859 2856 2825 2785 2737 2736 2678 2614 2541 2460 2371 2274 2169 2056 1935 1806 1669 1524 1371 1210 1040  864  679  486  285   76
 191  190  592  593  779 1136 1133 1608 1606 1457 1747 1881 2006 2232 2332 2425 2587 2585 2657 2656 2852 2723 2879 2882 2775 2912 2854 2819 2905 2824 2886 2827 2826 2680 2679 2615 2542 2461 2372 2275 2170 2057 1936 1807 1670 1525 1372 1042 1041  865  680  487  286   77
 189  778  590  962 1132  591  780 1456 1605 1301 1880 2120 2121 2123 2231 2331 2509 2510 2584 2586 2771 2899 2883 2853 2866 2777 2858 2822 2885 2913 2860 2861 2786 2738 2681 2616 2543 2462 2373 2276 2171 2058 1937 1808 1671 1373 1212 1211 1043  866  681  488  287   78
 395  188  394  961  960 1134 1299 1455 1604 1746 2003 1743 2119 2230 2229 2424 2422 2654 2768 2769 2880 2851 2813 2878 2850 2903 2600 2914 2855 2862 2830 2788 2787 2739 2682 2617 2544 2463 2374 2277 2172 2059 1938 1672 1527 1526 1374 1213 1044  867  682  489  288   79
 392  777  393  959 1297 1298 1453 1296 1603 1877 1878 1745 2227 2228 2329 2330 2423 2583 2507 2653 2715 2655 2714 2898 2895 2911 2864 2884 2887 2902 2904 2828 2789 2740 2683 2618 2545 2464 2375 2278 2173 2060 1939 1809 1674 1528 1375 1214 1045  868  683  490  289   80
 187  186  391  589  588  776 1295 1454 1602 1875 1744 1876 2002 2327 2328 2421 2508 2506 2652 2651 2849 2810 2873 2881 2896 2877 2915 2888 2889 2907 2832 2829 2831 2741 2684 2619 2546 2465 2376 2174 2061 1940 1811 1673 1810 1529 1376 1215 1046  869  684  491  290   81
 185  390  775 1131  958 1130  957 1601 1742 2000 1874 2001 2118 2117 2326 2420 2505 2582 2712 2713 2767 2809 2811 2847 2894 2863 2876 2906 2892 2791 2865 2792 2790 2742 2685 2620 2547 2377 2280 2279 2175 2062 1941 1812 1675 1530 1377 1216 1047  870  685  492  291   82
 184  389  587  586  956 1128 1452 1294 1451 1600 2116 1998 2225 2325 2224 2419 2504 2581 2650 2711 2765 2764 2897 2848 2846 2872 2870 2909 2839 2836 2890 2891 2793 2743 2686 2621 2467 2466 2378 2281 2176 2063 1942 1813 1676 1531 1378 1217 1048  871  686  493  292   83
 183  388  585  774 1129  955 1293 1450 1599 1999 1741 1872 2223 2115 2226 2418 2503 2580 2649 2766 2710 2763 2808 2875 2841 2843 2801 2869 2871 2908 2834 2833 2794 2744 2687 2622 2548 2468 2379 2282 2177 2064 1943 1814 1677 1532 1379 1218 1049  872  687  494  293   84
 182  387  584  773  954 1126 1127 1449 1738 1740 1873 1995 1997 2113 2324 2578 2501 2579 2647 2708 2709 2807 2845 2804 2803 2893 2874 2840 2750 2868 2838 2835 2796 2745 2688 2623 2549 2469 2380 2283 2178 2065 1944 1815 1678 1533 1380 1219 1050  873  688  495  294   85
 181  386  583  772  953 1125 1292 1448 1739 1598 1871 1870 2114 2222 2323 2417 2415 2648 2502 2762 2759 2806 2844 2702 2842 2752 2867 2753 2799 2837 2797 2749 2746 2689 2624 2551 2550 2470 2381 2284 2179 2066 1945 1816 1679 1534 1381 1220 1051  874  689  496  295   86
 180  385  582  951  952 1289 1291 1290 1597 1737 1447 2112 2110 2221 2322 2416 2499 2500 2645 2707 2761 2760 2570 2757 2805 2802 2751 2697 2696 2798 2694 2695 2795 2747 2692 2625 2552 2471 2382 2285 2180 2067 1946 1817 1680 1535 1382 1221 1052  875  690  497  296   87
 179  384  581  771  950 1446 1445 1594 1595 1596 1869 1994 2219 1996 2218 2414 2577 2575 2646 2576 2642 2706 2758 2701 2639 2636 2755 2754 2800 2633 2693 2748 2629 2691 2690 2626 2553 2472 2383 2286 2181 2068 1947 1818 1681 1536 1383 1222 1053  876  691  498  297   88
 178  383  580  770 1124 1123 1122 1288 1735 1868 1993 1736 2109 2220 2111 2320 2413 2498 2643 2571 2704 2705 2641 2700 2640 2756 2698 2699 2635 2634 2632 2631 2630 2558 2628 2627 2554 2473 2384 2287 2182 2069 1948 1819 1682 1537 1384 1223 1054  877  692  499  298   89
 177  382  579  769  768  949 1287 1443 1444 1593 1734 1867 1992 2317 2321 2217 2497 2574 2572 2644 2489 2569 2567 2703 2638 2564 2637 2485 2484 2563 2557 2560 2481 2480 2478 2556 2555 2474 2386 2385 2288 2183 2070 1820 1683 1538 1385 1224 1055  878  693  500  299   90
 176  381  578  767  948 1121 1286 1442 1592 1733 1866 1991 2318 2496 2412 2319 2409 2495 2573 2493 2491 2488 2568 2400 2402 2401 2565 2487 2397 2482 2298 2562 2561 2559 2479 2390 2477 2476 2475 2289 2071 1950 1949 1821 1684 1539 1386 1225 1056  879  694  501  300   91
 175  380  577  766  946  947 1120 1285 1590 1732 1865 1990 2108 2216 2316 2410 2411 2313 2494 2406 2309 2492 2405 2490 2399 2566 2486 2398 2301 2299 2395 2483 2393 2194 2392 2391 2389 2388 2387 2290 2184 2072 1951 1822 1685 1540 1387 1226 1057  880  695  502  301   92
 174  379  576  945 1119 1284 1591 1441 1589 1731 1864 1989 2107 2215 2315 2212 2101 2314 2408 2312 2407 2404 2403 2310 2306 2305 2304 2302 2199 2396 2085 2300 2394 2083 2296 2295 2294 2293 2292 2186 2185 2073 1952 1823 1686 1541 1388 1227 1058  881  696  503  302   93
 173  378  575  765  764 1118 1283 1439 1730 1863 2105 2106 2213 1985 1983 2102 2211 2210 2209 2207 2206 2208 2308 2307 2205 2203 2202 2200 2090 2303 2088 1966 2297 2084 2193 2192 2191 2189 2188 2291 2187 2074 1953 1824 1687 1542 1389 1228 1059  882  697  504  303   94
 172  377  574  763  944 1117 1282 1588 1440 1729 1862 1988 2214 2104 1855 1721 2100 2099 2096 1977 2311 2095 2094 2204 2092 2091 2201 1970 2089 2198 2197 2195 2196 1965 2082 2081 1834 2190 2078 2077 2076 2075 1954 1825 1688 1543 1390 1229 1060  883  698  505  304   95
 171  376  573  762  943 1116 1281 1438 1587 1728 1861 1987 2103 1984 1720 1856 1854 1980 1979 2097 1978 1848 1975 2093 1973 1972 1971 1843 1969 1841 2086 1838 1964 1962 1963 1961 1833 2080 1959 1958 1957 1956 1955 1826 1689 1544 1391 1230 1061  884  699  506  305   96
 170  375  572  761  942 1115 1280 1437 1586 1727 1860 1858 1986 1857 1577 1426 1982 1981 2098 1852 1976 1851 1713 1974 1846 1845 1844 1842 1968 2087 1967 1840 1703 1837 1836 1835 1960 2079 1832 1831 1830 1829 1828 1827 1690 1545 1392 1231 1062  885  700  507  306   97
 169  374  571  760  941 1114 1279 1436 1585 1726 1725 1724 1859 1579 1722 1576 1718 1853 1717 1716 1850 1714 1849 1847 1711 1710 1709 1708 1707 1706 1705 1839 1559 1558 1560 1701 1699 1698 1697 1696 1695 1694 1693 1692 1691 1546 1393 1232 1063  886  701  508  307   98
 168  373  570  759  940 1113 1278 1435 1584 1583 1582 1581 1723 1580 1267 1578 1575 1574 1573 1572 1715 1571 1570 1712 1568 1567 1566 1565 1564 1563 1562 1704 1702 1408 1557 1700 1556 1555 1554 1553 1552 1551 1550 1549 1548 1547 1394 1233 1064  887  702  509  308   99
 167  372  569  758  939 1112 1277 1434 1433 1432 1431 1430 1429 1100 1427 1266 1424 1719 1422 1421 1420 1419 1418 1569 1417 1416 1415 1414 1413 1412 1252 1561 1410 1409 1407 1406 1405 1404 1403 1402 1401 1400 1399 1398 1397 1396 1395 1234 1065  888  703  510  309  100
 166  371  568  757  938 1111 1276 1275 1274 1273 1272 1270 1269 1428  744 1425 1099 1265 1423 1263 1262 1261 1260 1259 1258 1257 1256 1255 1254 1253 1085 1411 1251 1249 1248 1247 1246 1245 1244 1243 1242 1241 1240 1239 1238 1237 1236 1235 1066  889  704  511  310  101
 165  370  567  756  937 1110 1109 1108 1107 1106 1105 1271 1104  928 1268 1101 1098 1097 1264 1096 1095 1094 1093 1092 1091 1090 1089 1088 1087  910  911 1084 1250 1082 1081  905 1080 1078 1077 1076 1075 1074 1073 1072 1071 1070 1069 1068 1067  890  705  512  311  102
 164  369  566  755  936  935  934  933  932  931  930  929 1103  926 1102  925  924  923  922  921  920  919  918  917  916  915  914  730  913 1086  727  909 1083  908  907  721 1079  903  902  901  900  899  898  897  896  895  894  893  892  891  706  513  312  103
 163  368  565  754  753  752  751  750  749  748  747  746  554  745  927  742  741  740  739  738  737  736  735  734  733  732  731  539  729  537  728  726  725  724  906  722  904  720  719  718  717  716  715  714  713  712  711  710  709  708  707  514  313  104
 162  367  564  563  562  561  560  559  558  557  556  555  553  552  743  551  550  549  548  547  546  545  544  543  542  541  540  340  131  132  338  534  533  532  723  531  530  529  528  527  526  525  524  523  522  521  520  519  518  517  516  515  314  105
 161  366  365  364  363  362  361  360  359  358  357  356  355  354  353  352  351  350  349  348  347  346  345  344  343  342  341  538  130  129  912  536  335  128  333  332  331  330  329  328  327  326  325  324  323  322  321  320  319  318  317  316  315  106
 160  159  158  157  156  155  154  153  152  151  150  149  148  147  146  145  144  143  142  141  140  139  138  137  136  135  134  339  133  336  535  337  127  334  126  125  124  123  122  121  120  119  118  117  116  115  114  113  112  111  110  109  108  107
