# This puzzle is unsolvable
24
  1  92 178  97  95   5   6 184   8   9  10 187 105  12 106  16 270 116 195 267  27 117  24  26
 93 179  90   3 177 253  96   7  11 183 102 103 192 108 261  17  18  23 265 107 109 111 110  25
175   2  94 382 182 180  98 100 478  99 104 436 185 392 331 262  14 441 191  19  22 193  21 114
 91 252   4 321 320 324 255 101 256 181 437 259 263  13 266 188 115  20 334 112 268 197  29 200
 89 174 176 250 251 513 514 257 323 328 326 264  15 327 189 440 190 391 337 269 397 118 119  31
 88  87 173 378 379 385 254 258 384 386 387 329 330 333 194 444 389 113 443 394 338 196  30 121
172 249 318 432 431 322 476 479 381 325 442 260 390 519 332 486 393 335 336 395 447 202 199 120
 86 170 316 319 377 430 481 480 572 435 484 563 548 438 388 399 271  28 446 198 275 345 272 273
 85 317 248 429 383 376 541 186 428 510 575 439 482 546 520 524 488 445 518 274 277 122 124  32
169  83 245 433 314 313 560 474 562 473 475 516 545 552 549 485 400 398 521 396 123 203 340 201
 82 246  84 373 509 472 434 380 537 511 517 574 483 568 544 401 491 547 206 341 344  37 342 276
167 171 244 247 168 315 375 559 427 535 561 573 565 564 542 489 490 522 278  35 339 125 205 204
 81 166 165 312 372 425 311 477 540 539 543 426 571 487 566 523 450 493 451 448  38 126  34  33
241  79 374 242 512 424 467 507 470 570 538 569 525 458 528 554 456 550 449 129 279 127  40  36
 80 164 243 163 240 310 471 469 508 515 555 499 409 553 463 414 459 207 492 343 128 210  41 282
307 370 422  76 362 371 557 536 505 558 532 415 529 297 531 567 551 402 403 404 347 208 280  39
162 466  74  78 464 468 229 368 504 534 413 498 412 356 527 495 530 454 406 349 405 281 131 130
239 306 157 235 465 419 416 506 417 238 462 358 148 556 453 496 408 494 452 350 346 348 209 211
160 159 421 237 423 161 533 359 502 301 360 501 460 500 457 410 354 353 218 407 352  44 286  43
 77  69 308 156 420 299   0  66 363 298 497 503  61 357 293 526 355 351 287 283 288 284 213 132
152 309  75 236 302 233 369 364 366 227  62 147 145 295 143 411 455 289  55 216  42 212 134 133
 72  73 231  64 367 232 365 418 300  57 361  59 226 461 294 291 220 141 217  51 285 215 214  45
304 303 234 154 230 305 151 150 146 149  60 224 292 144  54 219 221  53 138 139 137 140 136  47
158  71  68  70 155 153 228  65  67 296  63 225 223  58 222  56 142 290  52  49 135  50  48  46
