# This puzzle is unsolvable
74
   2    1    3    4    5    6    7    8    9   10   11   12   13   14   15   16   17   18   19   20   21   22   23   24   25   26   27   28   29   30   31   32   33   34   35   36   37   38   39   40   41   42   43   44   45   46   47   48   49   50   51   52   53   54   55   56   57   58   59   60   61   62   63   64   65   66   67   68   69   70   71   72   73   74
 292  293  294  295  296  297  298  299  300  301  302  303  304  305  306  307  308  309  310  311  312  313  314  315  316  317  318  319  320  321  322  323  324  325  326  327  328  329  330  331  332  333  334  335  336  337  338  339  340  341  342  343  344  345  346  347  348  349  350  351  352  353  354  355  356  357  358  359  360  361  362  363  364   75
 291  576  577  578  579  580  581  582  583  584  585  586  587  588  589  590  591  592  593  594  595  596  597  598  599  600  601  602  603  604  605  606  607  608  609  610  611  612  613  614  615  616  617  618  619  620  621  622  623  624  625  626  627  628  629  630  631  632  633  634  635  636  637  638  639  640  641  642  643  644  645  646  365   76
 290  575  852  853  854  855  856  857  858  859  860  861  862  863  864  865  866  867  868  869  870  871  872  873  874  875  876  877  878  879  880  881  882  883  884  885  886  887  888  889  890  891  892  893  894  895  896  897  898  899  900  901  902  903  904  905  906  907  908  909  910  911  912  913  914  915  916  917  918  919  920  647  366   77
 289  574  851 1120 1121 1122 1123 1124 1125 1126 1127 1128 1129 1130 1131 1132 1133 1134 1135 1136 1137 1138 1139 1140 1141 1142 1143 1144 1145 1146 1147 1148 1149 1150 1151 1152 1153 1154 1155 1156 1157 1158 1159 1160 1161 1162 1163 1164 1165 1166 1167 1168 1169 1170 1171 1172 1173 1174 1175 1176 1177 1178 1179 1180 1181 1182 1183 1184 1185 1186  921  648  367   78
 288  573  850 1119 1380 1381 1382 1383 1384 1385 1386 1387 1388 1389 1390 1391 1392 1393 1394 1395 1396 1397 1398 1399 1400 1401 1402 1403 1404 1405 1406 1407 1408 1409 1410 1411 1412 1413 1414 1415 1416 1417 1418 1419 1420 1421 1422 1423 1424 1425 1426 1427 1428 1429 1430 1431 1432 1433 1434 1435 1436 1437 1438 1439 1440 1441 1442 1443 1444 1187  922  649  368   79
 287  572  849 1118 1379 1632 1633 1634 1635 1636 1637 1638 1639 1640 1641 1642 1643 1644 1645 1646 1647 1648 1649 1650 1651 1652 1653 1654 1655 1656 1657 1658 1659 1660 1661 1662 1663 1664 1665 1666 1667 1668 1669 1670 1671 1672 1673 1674 1675 1676 1677 1678 1679 1680 1681 1682 1683 1684 1685 1686 1687 1688 1689 1690 1691 1692 1693 1694 1445 1188  923  650  369   80
 286  571  848 1117 1378 1631 1876 1877 1878 1879 1880 1881 1882 1883 1884 1885 1886 1887 1888 1889 1890 1891 1892 1893 1894 1895 1896 1897 1898 1899 1900 1901 1902 1903 1904 1905 1906 1907 1908 1909 1910 1911 1912 1913 1914 1915 1916 1917 1918 1919 1920 1921 1922 1923 1924 1925 1926 1927 1928 1929 1930 1931 1932 1933 1934 1935 1936 1695 1446 1189  924  651  370   81
 285  570  847 1116 1377 1630 1875 2112 2113 2114 2115 2116 2117 2118 2119 2120 2121 2122 2123 2124 2125 2126 2127 2128 2129 2130 2131 2132 2133 2134 2135 2136 2137 2138 2139 2140 2141 2142 2143 2144 2145 2146 2147 2148 2149 2150 2151 2152 2153 2154 2155 2156 2157 2158 2159 2160 2161 2162 2163 2164 2165 2166 2167 2168 2396 2169 1937 1696 1447 1190  925  652  371   82
 284  569  846 1115 1376 1629 1874 2111 2340 2341 2342 2343 2344 2345 2346 2347 2348 2349 2350 2351 2352 2353 2354 2355 2356 2357 2358 2359 2360 2361 2362 2363 2364 2365 2366 2367 2368 2369 2370 2371 2372 2373 2374 2375 2376 2377 2378 2379 2380 2381 2382 2383 2384 2385 2386 2387 2388 2389 2390 2611 2391 2392 2393 2394 2395 2170 1938 1697 1448 1191  926  653  372   83
 283  568  845 1114 1375 1628 1873 2110 2339 2560 2561 2562 2563 2564 2565 2566 2567 2568 2569 2570 2571 2572 2573 2574 2575 2576 2577 2578 2579 2580 2581 2582 2583 2584 2585 2586 2587 2588 2589 2590 2591 2592 2593 2594 2595 2596 2597 2598 2599 2600 2601 2602 2603 2604 2605 2607 2818 2608 3022 2609 2823 2822 2613 2614 2397 2171 1699 1939 1449 1192  928  927  373   84
 282  567  844 1113 1374 1627 1872 2109 2338 2559 2772 2773 2774 2775 2776 2777 2778 2779 2780 2781 2782 2783 2784 2785 2786 2787 2788 2789 2790 2791 2792 2793 2794 2795 2796 2797 2798 2799 2800 2801 2802 2803 2804 2805 2806 2807 2808 2809 2810 2811 2813 2814 2815 2816 2817 2606 2819 3023 3024 2610 3025 2612 2615 3026 2616 2172 2399 1698 1450 1194 1193  654  374   85
 281  566  843 1112 1373 1626 1871 2108 2337 2558 2771 2976 2977 2978 2979 2980 2981 2982 2983 2984 2985 2986 2987 2988 2989 2990 2991 2992 2993 2994 2995 2996 2997 2998 2999 3000 3001 3002 3003 3004 3005 3006 3007 3008 3009 3010 3011 3012 3013 3014 2812 3016 3017 3018 3019 3021 3216 3218 2820 2821 3220 2824 2826 2400 2174 2398 1940 1700 1452 1451  929  655  375   86
 280  565  842 1111 1372 1625 1870 2107 2336 2557 2770 2975 3172 3173 3174 3175 3176 3177 3178 3179 3180 3181 3182 3183 3184 3185 3186 3187 3188 3189 3190 3191 3192 3193 3194 3195 3196 3197 3198 3199 3200 3201 3202 3203 3204 3205 3206 3207 3208 3209 3015 3211 3212 3213 3214 3020 3402 3403 3584 3028 2828 3221 2827 2617 2173 2825 1941 1701 1453 1195  930  656  657   87
 279  564  841 1110 1371 1624 1869 2106 2335 2556 2769 2974 3171 3360 3361 3362 3363 3364 3365 3366 3367 3368 3369 3370 3371 3372 3373 3374 3375 3376 3377 3378 3379 3380 3381 3382 3383 3384 3385 3386 3387 3388 3389 3390 3391 3392 3393 3394 3395 3397 3210 3398 3399 3400 3401 3215 3404 3583 3219 3585 3754 3407 3027 2619 2401 2175 1942 1702 1944 1196  931  658  376   88
 278  563  840 1109 1370 1623 1868 2105 2334 2555 2768 2973 3170 3359 3540 3541 3542 3543 3544 3545 3546 3547 3548 3549 3550 3551 3552 3553 3554 3555 3556 3557 3558 3559 3560 3561 3562 3563 3564 3565 3566 3567 3568 3569 3570 3571 3572 3573 3575 3396 3576 3577 3578 3579 3580 3581 3582 3217 3586 3405 2402 3032 2829 2618 2620 2177 1703 1943 1454 1197  932  659  377   89
 277  562  839 1108 1369 1622 1867 2104 2333 2554 2767 2972 3169 3358 3539 3712 3713 3714 3715 3716 3717 3718 3719 3720 3721 3722 3723 3724 3725 3726 3727 3728 3729 3730 3731 3732 3733 3734 3735 3736 3737 3738 3739 3740 3741 3742 3743 3745 3574 3746 3747 3748 3749 3750 3751 3752 3916 3753 3223 3406 3409 3408 3031 2179 2178 1945 2176 1704 1455 1198  933  660  378   90
 276  561  838 1107 1368 1621 1866 2103 2332 2553 2766 2971 3168 3357 3538 3711 3876 3877 3878 3879 3880 3881 3882 3883 3884 3885 3886 3887 3888 3889 3890 3891 3892 3893 3894 3895 3896 3897 3898 3899 3900 3901 3902 3903 3904 3905 3907 3744 3908 3909 3910 3911 3912 3913 3914 3915 3917 3755 3222 3410 3029 3224 3030 2622 2403 2404 1946 1705 1456 1199  934   92  379  380
 275  560  837 1106 1367 1620 1865 2102 2331 2552 2765 2970 3167 3356 3537 3710 3875 4032 4033 4034 4035 4036 4037 4038 4039 4040 4041 4042 4043 4044 4045 4046 4047 4048 4049 4050 4051 4199 4052 4054 4055 4057 4204 4059 4060 4061 3906 4062 4063 4064 4065 4066 4068 4214 4069 4070 3918 3756 3587 3225 3226 2831 2830 2405 2621 2180 1947 1706 1457 1200  935  661  662   91
 274  559  836 1105 1366 1619 1864 2101 2330 2551 2764 2969 3166 3355 3536 3709 3874 4031 4180 4181 4182 4183 4184 4185 4186 4187 4188 4189 4190 4191 4192 4193 4194 4195 4336 4197 4198 4338 4053 4201 4202 4056 4205 4058 4206 4207 4208 4209 4210 4211 4212 4352 4213 4067 4215 4071 3919 3757 3588 3411    0 3033 2832 2623 2406 2181 1948 1707 1201  936  663  382  381   93
 273  558  835 1104 1365 1618 1863 2100 2329 2550 2763 2968 3165 3354 3535 3708 3873 4030 4179 4320 4321 4322 4323 4324 4325 4326 4327 4328 4329 4330 4331 4332 4464 4333 4334 4196 4335 4337 4200 4340 4341 4203 4343 4344 4345 4346 4347 4348 4349 4350 4351 4483 4353 4217 4355 4216 4072 3758 3589 3412 3227 3034 2833 2624 2407 2182 1949 1708 1458 1202  937  664  383   94
 272  557  834 1103 1364 1617 1862 2099 2328 2549 2762 2967 3164 3353 3534 3707 3872 4029 4178 4319 4452 4453 4454 4455 4456 4457 4458 4459 4460 4584 4461 4462 4463 4465 4466 4467 4468 4469 4339 4471 4473 4342 4474 4475 4598 4596 4478 4479 4480 4481 4482 4484 4354 4357 4356 4073 3920 3761 3759 3413 3228 3035 2834 2625 2183 2184 1709 1460 1459 1203  938  665  384   95
 271  556  833 1102 1363 1616 1861 2098 2327 2548 2761 2966 3163 3352 3533 3706 3871 4028 4177 4318 4451 4576 4577 4578 4579 4580 4581 4582 4583 4699 4585 4586 4587 4588 4589 4590 4591 4592 4470 4709 4472 4597 4712 4595 4476 4477 4601 4716 4718 4602 4719 4606 4721 4358 4485 3921 3760 3590 3414 3415 3229 3036 2835 2626 2408 2185 1950 1710 1461 1204  939  666  385   96
 270  555  832 1101 1362 1615 1860 2097 2326 2547 2760 2965 3162 3351 3532 3705 3870 4027 4176 4317 4450 4575 4692 4693 4694 4695 4696 4697 4698 4700 4807 4701 4702 4703 4704 4707 4814 4706 4708 4594 4593 4710 4711 4820 4713 4599 4715 4603 4605 4604 4607 4925 4486 4076 4218 4219 3924 3925 3592 3230 3231 3037 2836 2410 2409 1952 1951 1711 1462 1205  940  667  386   97
 269  554  831 1100 1361 1614 1859 2096 2325 2546 2759 2964 3161 3350 3531 3704 3869 4026 4175 4316 4449 4574 4691 4800 4801 4802 4803 4804 4905 4805 4906 4808 4809 4810 4811 4705 4812 4913 4815 4816 4917 5008 4818 4819 4600 4921 4822 4717 4823 4724 4826 4720 4722 3922 4074 4220 3762 3593 3594 3591 3038 3039 2837 2627 2628 2186 1953 1712 1463 1206  941  668  387   98
 268  553  830 1099 1360 1613 1858 2095 2324 2545 2758 2963 3160 3349 3530 3703 3868 4025 4174 4315 4448 4573 4690 4799 4899 4900 4901 4994 4806 4995 4996 4907 4908 4909 4910 4911 4813 4914 4915 4916 4817 4918 4714 4919 4821 5096 5013 4922 4824 4825 4827 4488 4608 4222 4221 4075 3923 4077 3418 3416 3232 2838 2839 2629 2411 2187 1954 1713 1464 1207  942  669  388   99
 267  552  829 1098 1359 1612 1857 2094 2323 2544 2757 2962 3159 3348 3529 3702 3867 4024 4173 4314 4447 4572 4689 4798 4898 4992 4902 4993 4903 5079 5080 4998 4999 5000 5001 5002 4912 5004 5005 5006 5007 5092 5010 5094 5011 5012 5015 5095 4924 4926 4610 4609 4487 4359 4223 4078 3765 3763 3417 3595 3233 3040 2630 2631 2412 2188 1955 1714 1465 1208  943  670  389  100
 266  551  828 1097 1358 1611 1856 2093 2322 2543 2756 2961 3158 3347 3528 3701 3866 4023 4172 4313 4446 4571 4688 4797 4991 5076 5075 5077 4904 5220 5081 5155 5082 5083 5084 5085 5003 5087 5088 5089 5090 5009 5093 4920 5168 4923 5017 5016 5014 4829 4723 4489 4491 4360 4224 4079 3764 3926 3596 3419 3234 3041 2841 2414 2413 2189 1715 1957 1466 1209  944  671  390  101
 265  550  827 1096 1357 1610 1855 2092 2321 2542 2755 2960 3157 3346 3527 3700 3865 4022 4171 4312 4445 4570 4687 4796 4897 4990 5152 5153 5221 5078 5222 4997 5156 5158 5159 5228 5086 5160 5162 5164 5165 5167 5091 5234 5235 5169 4928 4927 4830 4828 4612 4490 4363 4362 4225 4080 3927 3766 3597 3420 3235 3043 3042 2840 2415 2190 1956 1468 1716 1210  945  672  391  102
 264  549  826 1095 1356 1609 1854 2091 2320 2541 2754 2959 3156 3345 3526 3699 3864 4021 4170 4311 4444 4569 4686 4795 4896 4989 5074 5151 5219 5154 5223 5283 5157 5225 5226 5161 5288 5229 5163 5290 5166 5292 5236 5293 5171 5170 5098 4831 5097 4611 4725 4613 4492 4361 4226 4081 3928 3767 3598 3421 3236 2842 2633 2632 2416 2191 1717 1959 1467 1211  946  673  392  103
 263  548  825 1094 1355 1608 1853 2090 2319 2540 2753 2958 3155 3344 3525 3698 3863 4020 4169 4310 4443 4568 4685 4794 4895 4988 5073 5150 5280 5281 5331 5224 5335 5285 5287 5227 5230 5382 5339 5291 5233 5232 5343 5294 5238 5237 5018 5019 4930 5173 5020 4728 4727 4493 4364 4082 3929 3768 3599 3422 3237 3044 2843 2634 2417 2192 1960 1958 1718 1212  947  674  393  104
 262  547  824 1093 1354 1607 1852 2089 2318 2539 2752 2957 3154 3343 3524 3697 3862 4019 4168 4309 4442 4567 4684 4793 4894 4987 5072 5149 5218 5279 5332 5284 5282 5334 5441 5286 5417 5337 5231 5341 5387 5340 5344 5295 5239 4929 4932 5099 4495 4726 4832 4616 4617 4614 4086 4083 4365 3769 3600 3423 3045 3046 2844 2635 2419 2193 1962 1470 1469 1471  948  675  394  105
 261  546  823 1092 1353 1606 1851 2088 2317 2538 2751 2956 3153 3342 3523 3696 3861 4018 4167 4308 4441 4566 4683 4792 4893 4986 5071 5148 5217 5277 5278 5376 5378 5414 5379 5383 5416 5381 5289 5421 5446 5297 5175 5345 5100 5172 4833 4933 4730 4729 4618 4228 4229 4615 3933 4230 3930 4227 3602 3601 3424 3238 2845 2637 2420 1961 2418 1719 1213 1720 1215  676  395  106
 260  545  822 1091 1352 1605 1850 2087 2316 2537 2750 2955 3152 3341 3522 3695 3860 4017 4166 4306 4307 4440 4682 4791 4892 5070 5147 5146 5216 5330 5329 5375 5377 5333 5463 5338 5380 5336 5385 5419 5468 5296 5342 5346 5241 5177 5240 4931 5174 5102 4367 4494 4369 4499 4496 3931 3772 3770 3427 3240 3239 3047 2846 2638 2196 2194 1722 2636 1472  949 1214  677  396  107
 259  544  821 1090 1351 1604 1849 2086 2315 2536 2749 2954 3151 3340 3521 3694 3859 4016 4165 4439 4438 4565 4564 4790 4891 4985 5069 5214 5215 5411 5439 5372 5410 5462 5442 5415 5413 5445 5474 5443 5422 5420 5300 5447 5101 5243 4837 5105 4836 4834 4731 4619 4497 4366 4233 4085 3771 3426 3773 3425 3241 3048 2847 2639 2195 2197 1964 1963 1723 1217  950  678  397  108
 258  543  820 1089 1350 1603 1848 2085 2314 2535 2748 2953 3150 3339 3520 3693 3858 4015 4164 4305 4563 4681 4680 4789 4983 4984 5068 5145 5274 5276 5374 5438 5440 5458 5459 5461 5475 5418 5386 5388 5423 5176 5389 5347 5298 5104 4935 4839 5023 4835 4732 4498 4231 4087 4089 4084 4088 3932 3936 3603 3243 3049 2848 2849 2421 2198 1724 1721 1473  951 1216  679  398  109
 257  542  819 1088 1349 1602 1847 2084 2313 2534 2747 2952 3149 3338 3519 3692 4014 4162 4012 4304 4437 4678 4679 4889 4890 4982 5067 5066 5144 5275 5412 5460 5472 5409 5437 5471 5448 5384 5464 5450 5444 5392 5350 5348 5106 5107 5244 5022 5021 5024 4934 4734 4735 4368 4621 3934 3776 3939 3604 3242 3429 3050 2640 2422 2423 1965 1474 1725 1475 1218  952  680  399  110
 256  541  818 1087 1348 1601 1846 2083 2312 2533 2746 2951 3148 3337 3518 3691 3857 3856 4303 4163 4436 4562 4561 4788 4787 4888 5139 5143 5213 5328 5327 5408 5407 5432 5436 5457 5473 5467 5424 5453 5349 5452 5242 5302 5299 5103 5179 4936 4838 4733 4620 4370 4500 4371 4232 3774 3775 3777 3605 3428 3245 3244 2850 2641 2424 2199 1966 1726 1476 1219  953  681  400  111
 255  540  817 1086 1347 1600 1845 2082 2311 2532 2745 2950 3147 3336 3517 3690 3855 4011 4013 4302 4435 4560 4677 4786 4887 4980 4981 5065 5272 5371 5326 5324 5470 5455 5373 5433 5466 5465 5449 5390 5426 5425 5351 5303 5301 5178 5180 5181 4938 4937 4622 4840 4373 4374 4234 3431 4236 4091 3606 3607 2852 3051 3053 2851 2642 2425 2200 1477 1478  955  954  682  401  112
 254  539  816 1085 1346 1599 1844 2081 2310 2531 2744 2949 3146 3335 3516 3689 3854 4010 4161 4158 4434 4559 4676 4785 4886 4979 5064 5270 5142 5212 5273 5271 5435 5370 5434 5454 5431 5430 5428 5391 5394 5427 5352 5246 5245 5026 5108 5025 5027 4841 4736 4501 4372 4239 4090 3935 4092 3938 3608 3054 3937 3246 3435 2645 2426 2201 1967 1969 1727 1223 1221  684  402  113
 253  538  815 1084 1345 1598 1843 2080 2309 2530 2743 2948 3145 3334 3515 3688 3853 4009 4301 4160 4433 4558 4675 4784 4885 5063 5209 5141 5210 5211 5325 5323 5369 5469 5405 5456 5400 5399 5451 5429 5357 5393 5353 5304 5247 5182 5109 5028 4939 4842 4737 4623 4502 4375 4625 4235 4093 3610 3434 3249 3779 2644 2854 2643 2428 2202 1968 1728 1220 1479  683  956  403  114
 252  537  814 1083 1344 1597 1842 2079 2308 2529 2742 2947 3144 3333 3514 3687 3852 4159 4300 4299 4432 4674 4556 4783 4884 4978 5061 5062 5140 5268 5321 5269 5406 5404 5402 5363 5401 5360 5398 5397 5396 5356 5355 5354 5183 5248 5110 5029 4843 4844 4738 4626 4503 4240 4624 3609 3247 2853 3052 3432 3056 3248 3055 2427 2203 1970 1729 1480  957 1224 1222  685  404  115
 251  536  813 1082 1343 1596 1841 2078 2307 2528 2741 2946 3143 3332 3513 3686 3851 4008 4157 4297 4298 4431 4557 4673 4782 4977 5060 5138 5208 5266 5366 5367 5364 5368 5403 5316 5313 5361 5359 5358 5310 5395 5309 5306 5305 5249 5184 5030 4941 4739 4740 4627 4237 4504 4376 4238 3940 3433 3782 3611 3430 2855 2646 2856 2429 2204 1971 1730 1481 1483  958  959  405  116
 250  535  812 1081 1342 1595 1840 2077 2306 2527 2740 2945 3142 3331 3512 3685 3850 4007 4156 4296 4430 4672 4781 4883 4882 4976 4975 5207 5206 5320 5365 5322 5267 5318 5317 5362 5260 5258 5312 5311 5255 5254 5307 5251 5250 4942 5111 5031 4845 4940 4741 4507 4505 4242 4378 4094 3778 4241 3612 3780 3057 3058 2647 2648 2430 2205 1972 1731 1226 1482 1225  686  687  117
 249  534  811 1080 1341 1594 1839 2076 2305 2526 2739 2944 3141 3330 3511 3684 3849 4006 4155 4295 4429 4555 4554 4779 4780 4974 4881 5137 5136 5205 5265 5319 5199 5264 5200 5259 5314 5195 5257 5256 5191 5190 5308 5186 5185 5112 5114 5113 4943 4848 4847 4628 4506 4377 4095 3781 3941 3942 3613 3437 3436 3250 2857 2649 2432 2431 1973 1732 1484  962  689  960  961  406
 248  533  810 1079 1340 1593 1838 2075 2304 2525 2738 2943 3140 3329 3510 3683 3848 4005 4154 4428 4553 4670 4671 4880 4973 5058 5059 5135 5204 5203 5202 5201 5263 5262 5261 5315 5126 5196 5194 5193 5192 5189 5253 5252 5188 5187 5032 5033 4846 4633 4631 4743 4629 4508 4243 3943 4096 3945 3783 3252 3059 3251 2858 2433 2650 2206 1975 1974 1227  688  963  407  409  118
 247  532  809 1078 1339 1592 1837 2074 2303 2524 2737 2942 3139 3328 3509 3682 3847 4004 4153 4294 4427 4552 4669 4778 4972 4971 5057 5134 5133 5132 5131 5130 5128 5048 5197 5198 5125 5124 5123 5122 5121 5120 5119 5118 5117 5116 5115 5034 4944 4946 4745 4742 4509 4379 4380 4097 4098 3944 3784 3438 3255 3060 2859 2434 2651 2209 2207 1733 1734 1228  690  691  119  408
 246  531  808 1077 1338 1591 1836 2073 2302 2523 2736 2941 3138 3327 3508 3681 3846 4003 4152 4293 4426 4551 4668 4777 4879 4970 5055 5054 4967 5053 5052 5051 5129 5127 5049 5047 5046 5045 5044 5043 5042 5041 5040 5039 5038 5037 5036 5035 4945 4849 4632 4630 4510 4381 4244 4099 3616 3617 3614 3615 3062 3061 2653 2860 2208 2435 1976 1486 1485  964  966  965  410  120
 245  530  807 1076 1337 1590 1835 2072 2301 2522 2735 2940 3137 3326 3507 3680 3845 4002 4151 4292 4425 4550 4666 4667 4878 4969 5056 4968 4966 4965 4870 4963 5050 4962 4961 4960 4959 4958 4957 4956 4955 4954 4953 4952 4951 4950 4949 4948 4947 4746 4851 4744 4511 4245 4384 3948 3946 3254 3253 3441 2862 3440 2861 2652 2210 2438 1736 1735 1229 1488 1230  692  411  121
 244  529  806 1075 1336 1589 1834 2071 2300 2521 2734 2939 3136 3325 3506 3679 3844 4001 4150 4423 4290 4424 4776 4876 4877 4875 4874 4873 4872 4871 4869 4964 4868 4867 4866 4865 4864 4863 4862 4861 4860 4859 4858 4857 4856 4855 4854 4853 4852 4850 4513 4634 4246 4512 4382 4101 3439 3618 3785 3258 3257 3444 2863 3064 2436 1978 1977 1737 1490 1487  967  693  123  122
 243  528  805 1074 1335 1588 1833 2070 2299 2520 2733 2938 3135 3324 3505 3678 3843 4000 4149 4548 4289 4664 4549 4775 4773 4772 4771 4770 4769 4768 4767 4766 4765 4764 4763 4762 4761 4760 4759 4758 4757 4756 4755 4754 4753 4641 4752 4751 4749 4748 4383 4385 4636 3947 3787 4100 3791 4102 3788 3259 3442 3786 3063 2654 2437 2211 1738 1489 1231 1232  694  412  125  413
 242  527  804 1073 1334 1587 1832 2069 2298 2519 2732 2937 3134 3323 3504 3677 3842 3999 4148 4291 4546 4421 4547 4774 4663 4661 4660 4659 4658 4657 4656 4655 4654 4653 4652 4651 4650 4649 4648 4646 4645 4399 4644 4643 4642 4522 4640 4750 4639 4637 4517 4747 4635 4106 3949 4103 3954 3950 3790 3256 3066 2656 2864 2657 2655 1979 2212 1980 1739 1234 1233  968  414  124
 241  526  803 1072 1333 1586 1831 2068 2297 2518 2731 2936 3133 3322 3503 3676 3841 3998 4147 4288 4422 4545 4665 4418 4662 4542 4541 4540 4539 4538 4537 4536 4535 4534 4533 4532 4531 4530 4529 4401 4647 4528 4400 4397 4524 4396 4520 4390 4519 4515 4391 4255 4514 4247 4386 3620 4105 4104 3260 2866 3065 3619 3443 2440 2214 2213 1981 1740 1492 1491  969  416  695  415
 240  525  802 1071 1332 1585 1830 2067 2296 2517 2730 2935 3132 3321 3502 3675 3840 3997 4146 4287 4420 4419 4544 4543 4416 4415 4414 4413 4412 4411 4410 4409 4408 4407 4406 4405 4404 4403 4402 4527 4265 4526 4121 4398 4261 4395 4521 4638 4392 4112 4389 3959 4388 4248 4387 3622 4252 4251 3621 3446 3789 3068 2865 2658 2439 2215 1982 1741 1235  970  971  696  417  126
 239  524  801 1070 1331 1584 1829 2066 2295 2516 2729 2934 3131 3320 3501 3674 3839 3996 4145 4286 4285 4284 4282 4417 4281 4280 4279 4278 4277 4276 4275 4274 4273 4272 4271 4270 4269 4268 4267 4266 4264 4525 4263 4118 4262 4523 4116 4259 4113 4518 4111 3960 4516 4253 4249 4250 3953 3792 3067 3445 3069 3070 3261 2867 2441 2216 1983 1742 1493 1236  972  697  128  127
 238  523  800 1069 1330 1583 1828 2065 2294 2515 2728 2933 3130 3319 3500 3673 3838 3995 4144 4143 4142 4141 4283 4140 4139 4138 4137 4135 4134 4133 4132 4131 4130 4129 4128 4127 4126 4125 4124 4123 3971 4122 4120 4119 4117 4260 4394 4114 4257 4256 4110 3961 4109 4108 3957 3794 3623 3624 3951 3262 3071 3625 2868 2659 2442 2217 1984 1743 1494 1237  973  698  419  129
 237  522  799 1068 1329 1582 1827 2064 2293 2514 2727 2932 3129 3318 3499 3672 3837 3994 3993 3992 3991 3990 3989 3988 3987 3827 4136 3984 3983 3982 3822 3981 3980 3978 3977 3976 3975 3974 3812 3813 3972 3970 3969 3968 3967 4115 4258 3966 3963 4393 3801 3800 4254 3798 3955 3793 4107 3626 3952 3263 3627 2871 2869 2660 2443 2218 1985 1744 1495 1238  701  418  699  130
 236  521  798 1067 1328 1581 1826 2063 2292 2513 2726 2931 3128 3317 3498 3671 3836 3835 3834 3833 3832 3831 3830 3829 3828 3985 3986 3826 3825 3824 3823 3821 3979 3820 3818 3817 3816 3815 3973 3647 3811 3644 3810 3809 3964 3807 3965 3805 3804 3962 3634 3277 3799 3956 3958 3797 3448 3629 3449 3450 3264 3073 3072 2870 2661 2219 1986 1745 1496 1239  974  700  420  131
 235  520  797 1066 1327 1580 1825 2062 2291 2512 2725 2930 3127 3316 3497 3670 3669 3668 3667 3666 3665 3664 3663 3662 3661 3660 3659 3658 3657 3656 3655 3654 3653 3819 3652 3475 3649 3648 3814 3472 3645 3469 3643 3642 3808 3641 3640 3806 3638 3636 3803 3802 3635 3458 3633 3630 3796 3795 3628 3447 3452 3265 2662 2445 2444 2220 1988 1987 1497 1241 1240  702  421  132
 234  519  796 1065 1326 1579 1824 2061 2290 2511 2724 2929 3126 3315 3496 3495 3494 3493 3492 3491 3490 3489 3488 3487 3486 3485 3484 3483 3482 3481 3480 3479 3478 3477 3650 3293 3474 3290 3473 3646 3471 3470 3468 3467 3466 3465 3639 3464 3637 3462 3279 3460 3459 3275 3631 3457 3456 3271 3453 3270 3267 3266 2872 2663 2446 2221 1989 1746 1747 1498  975  976  422  133
 233  518  795 1064 1325 1578 1823 2060 2289 2510 2723 2928 3125 3314 3313 3312 3311 3310 3309 3308 3307 3306 3305 3304 3303 3302 3301 3300 3299 3298 3297 3296 3295 3476 3651 3292 3100 3291 3289 3098 3287 3286 3285 3284 3283 3282 3281 3463 3461 3280 3278 3276 3084 3632 3273 3272 3079 3455 3454 3451 3268 2877 3076 2664 2447 2222 1748 1749 1499 1242  977  703  423  134
 232  517  794 1063 1324 1577 1822 2059 2288 2509 2722 2927 3124 3123 3122 3121 3120 3119 3118 3117 3116 3115 3114 3113 3112 3111 3110 3109 3108 3107 3106 3105 3103 3294 3102 3101 2901 3099 3097 3288 3096 3095 3094 3093 3092 3091 3090 3089 3088 3087 3086 3085 3082 3274 2883 3081 3080 2880 3269 3077 3074 3075 2873 2874 2448 2223 1990 1750 1500 1243  978  704  424  135
 231  516  793 1062 1323 1576 1821 2058 2287 2508 2721 2926 2925 2924 2923 2922 2921 2920 2919 2918 2917 2916 2915 2914 2913 2912 2911 2910 2909 2908 2907 2905 3104 2904 2696 2903 2902 2900 2899 2898 2897 2896 2895 2894 2893 2892 2891 2890 2889 2888 2887 2885 3083 2884 2676 2882 2881 3078 2672 2879 2671 2876 2875 2665 2450 2449 2224 1991 1501 1244  979  705  425  136
 230  515  792 1061 1322 1575 1820 2057 2286 2507 2720 2719 2718 2717 2716 2715 2714 2713 2712 2711 2710 2709 2708 2707 2706 2705 2704 2703 2702 2701 2700 2906 2699 2698 2697 2695 2694 2693 2692 2691 2690 2689 2688 2687 2686 2685 2684 2683 2682 2681 2679 2886 2678 2677 2460 2675 2674 2457 2458 2670 2878 2669 2668 2666 2452 2451 1752 1993 1502 1245  980  706  426  137
 229  514  791 1060 1321 1574 1819 2056 2285 2506 2505 2504 2503 2502 2501 2500 2499 2498 2497 2496 2495 2494 2493 2492 2491 2490 2489 2488 2487 2486 2485 2484 2483 2482 2481 2480 2479 2478 2477 2476 2475 2474 2473 2472 2471 2470 2469 2468 2467 2466 2680 2465 2464 2463 2462 2239 2234 2236 2235 2456 2455 2231 2454 2226 2667 1992 2225 1751 1503 1246  981  707  427  138
 228  513  790 1059 1320 1573 1818 2055 2284 2283 2282 2281 2280 2279 2278 2277 2276 2275 2274 2273 2272 2271 2270 2269 2268 2267 2266 2265 2264 2263 2262 2261 2260 2259 2258 2257 2256 2255 2254 2253 2252 2251 2250 2018 2249 2246 2248 1776 2245 2243 2242 2009 2010 2008 2461 2238 2237 2459 2673 2233 2232 2230 2229 2453 2228 2227 1994 1753 1504 1247  982  708  428  139
 227  512  789 1058 1319 1572 1817 2054 2053 2052 2051 2050 2049 2048 2047 2046 2045 2044 2043 2042 2041 2040 2039 2038 2037 2036 2035 2034 2033 2032 2031 2030 2029 2028 2027 2026 2025 2024 2023 2022 2021 2020 2019 1779 2017 2247 2015 2244 2014 2012 2013 2011 1771 1523 1768 2007 2005 2004 2003 2002 2001 2000 1999 1998 1997 1996 1995 1505 1248 1249  983  709  429  140
 226  511  788 1057 1318 1571 1816 1815 1814 1813 1812 1811 1810 1809 1808 1807 1806 1805 1804 1803 1802 1801 1800 1799 1798 1797 1796 1795 1794 1793 1792 1791 1790 1789 1788 1787 1786 1785 1784 1783 1535 1782 1781 1780 1778 1013 1775 1527  737 1774 1773 1524 2241 1522 1769 2240 1767 1765 1764 1763 1762 1761 1760 1759 1758 1757 1756 1754 1755  984  711  710  430  141
 225  510  787 1056 1317 1570 1569 1568 1567 1566 1565 1564 1563 1562 1561 1560 1559 1558 1557 1556 1555 1554 1553 1552 1551 1550 1549 1548 1547 1546 1545 1544 1543 1542 1541 1540 1539 1538 1537 1536 1534 1532 1278 1533 1530 1777 2016 1528 1526 1271 1006 1772 1269 1520 1521 1265 1766 1518 1517 1516 1515 1514 1513 1512 1511 1510 1509 1508 1506 1507  985  712  431  142
 224  509  786 1055 1316 1315 1314 1313 1312 1311 1310 1309 1308 1307 1306 1305 1304 1303 1302 1301 1300 1299 1298 1297 1296 1295 1294 1293 1292 1291 1290 1289 1288 1287 1286 1285 1284 1283 1282 1281  747 1280 1015 1277 1012 1531 1011 1529 1008 1525 1270 1005 1266 1770 2006 1004 1519 1263 1262 1261 1260 1259 1258 1257 1256 1255 1254 1252 1251 1250  986  713  432  143
 223  508  785 1054 1053 1052 1051 1050 1049 1048 1047 1046 1045 1044 1043 1042 1041 1040 1039 1038 1037 1036 1035 1034 1033 1032 1031 1030 1029 1028 1027 1026 1025 1024 1023 1022 1021 1020 1019 1017  746 1279  743 1276 1275  741 1273 1274 1007 1272 1010  735 1268 1267 1003 1264  450 1000  727  999  998  996  995  994  993  992  991 1253  989  988  987  714  433  144
 222  507  784  783  782  781  780  779  778  777  776  775  774  773  772  771  770  769  768  767  766  765  764  763  762  761  760  759  758  757  756  755  754  753  752  751  750  749  748 1018  744 1016  466 1014  464  742  461  740 1009  736  457  734  455  733 1001 1002  730  728  449  726  997  725  724  723  722  720  440  990  719  717  716  715  434  145
 221  506  505  504  503  502  501  500  499  498  497  496  495  494  493  492  491  490  489  488  487  486  485  484  483  482  481  480  479  478  477  476  475  474  473  472  471  470  469  468  467  179  745  465  463  460  459  738  739  458  170  168  456  452  731  732  451  163  448  447  446  445  444  443  156  721  441  718  439  438  437  436  435  146
 220  219  218  217  216  215  214  213  212  211  210  209  208  207  206  205  204  203  202  201  200  199  198  197  196  195  194  193  192  191  190  189  188  187  186  185  184  183  182  181  180  178  177  176  175  462  174  173  172  171  169  167  453  454  166  165  729  164  162  161  160  159  158  157  155  442  154  153  152  151  150  149  148  147
