# This puzzle is unsolvable
53
   2    1    3    4    5    6    7    8    9   10   11   12   13   14   15   16   17   18   19   20   21   22   23  431  624   27  233   29  236   28  985   30  441  440   35   38   36  244   39   40  249  448   43   41   46  451   47   48   49   50  258   51   52
 208  209  210  211  212  213  214  215  216  217  218  219  220  221  222  422  223  225  226  227  228  231  429   25   26  434  234   24  237  238  811  239  438  243  240  632   37  446  245  248   42  447   44   45  252  253  254  256  455  260  259   54   53
 207  408  409  410  411  412  413  414  415  416  417  418  419  420  421  614  224  424  425  426  427  229  230  430  621  980  232  435  810  627  436  437   31   32  815   34  634  636  247  246  638  250  251  450  642  452  645  255  456  257  458   55   56
 206  407  600  601  602  603  604  605  606  607  608  609  610  611  613  795  423  615  617  800  618  428  620  622  235  623  984  432  626  628  814  630   33  631  816  242  442  443  635  445  639  996  449  641  643  644  454  453  647  646  648  457  261
 205  406  599  784  785  786  787  788  789  790  791  792  793  794  612  796  797  798  616  801  802  619  803  804  805  978 1151  807  809  433 1313  629  439  989  813  818  819  821  637  444  997 1323  640  824  825  826 1002  828  829  459  649   59  262
 204  405  598  783  960  961  962  963  964  965  966  967  968  969  970  972  973  974  799  975  976  977 1145  981  982 1306  806  625 1309 1152  987  241  990  812  991  633  992  817  993 1162  822 1164  823  998 1000 1001 1003  827  830  463  831  461   57
 203  404  597  782  959 1128 1129 1130 1131 1132 1133 1134 1137 1135 1296  971 1138 1139 1140 1141 1143 1144 1147 1146 1148  979 1311  983 1310 1463 1154  988  986 1156 1157 1158 1161  994  995 1163  820 1474 1165  999 1168 1169 1005 1006  650  462  651  263  460
 202  403  596  781  958 1127 1288 1289 1290 1291 1292 1293 1136 1446 1295 1297 1298 1299 1300 1142 1302 1303 1304 1456 1305 1307 1459 1153 1312  808 1314 1155 1608 1315 1316 1159 1160 1319 1318 1321 1322 1473 1325 1166 1167 1326 1327 1171  832  265 1004   60   58
 201  402  595  780  956  957 1287 1440 1441 1442 1443 1444 1294 1447 1590 1448 1449 1450 1451 1301 1453 1454 1455 1735 1457 1458 1150 1460 1149 1464 1867 1610 1742 1743 1466 1469 1612 1317 1471 1615 1472 1878 1324 1476 1477 1328 1170  833  653  464  266  264   61
 200  401  594  779  955 1126 1285 1286 1583 1584 1586 1445 1588 1589 1852 1591 1592 1594 1595 1452 1596 1597 1598 1600 1734 1308 1601 1739 1462 1461 1603 1465 1467 1741 1989 1468 1873 1320 1470 1617 1614 1751 1475 1619 1478 1329 1172 1007  834  654  267  652   62
 199  400  593  778 1125 1124 1439 1438 1582 1721 1585 1723 1587 1724 1726 1725 1727 1593 1729 1730 1731 1732 1733 1599 1736 1863 1602 1740 1738 1985 1606 1866 1605 1745 1746 1611 1747 1613 1609 1874 1616 1753 1618 1620 1479 1330 1173 1008  655  466  465  268   63
 198  399  592  777  954 1123 1437 1283 1718 1720 1849 1722 1850 1851 1971 1973 1853 1728 1856 1857 1858 1859 1860 1981 1862 1737 2199 1607 1869 1870 2100 1868 2102 1871 1992 1875 1748    0 1749 1750 1754 1752 1755 1480 1331 1174 1010  836  835  656  467  269   64
 197  398  591  776  953 1122 1284 1436 1719 1581 1848 1967 1968 1969 1972 1855 1854 1975 1976 2192 2089 2090 1861 2093 1983 1864 2096 1986 2094 1604 2099 2202 2205 2206 1991 1872 1995 1994 1876 1997 1880 1879 1622 1621 1481 1175 1009 1011  837  657  468  270   65
 196  397  590  775  952 1121 1282 1435 1580 1717 1847 1846 2080 1970 2081 2082 2083 1974 2084 1978 2087 2088 2091 2193 2092 2292 2200 1984 2095 2298 1988 2098 2299 1744 2297 2104 2207 2208 2106 1877 1998 1881 1756 1623 1482 1332 1176  839  840  838  469   66   67
 195  396  589  774  951 1120 1281 1434 1579 1716 1845 1966 2079 2184 2185 2186 2085 2189 2086 2191 1977 2194 1979 2375 2196 1980 2198 1865 2379 2201 1987 2296 2097 2101 2386 2301 2302 2304 1996 2107 1999 1882 1626 1484 1334 1335 1333 1013 1012  658  272  271   68
 194  395  588  773  950 1119 1280 1433 1578 1715 1844 1965 2078 2183 2280 2282 2187 2188 2284 2286 2190 2374 2288 2287 2195 1982 2529 2380 2291 2384 2382 2383 1990 2103 2204 1993 2466 2110 2209 2105 2002 1758 1625 1483 1624 1486 1177 1178 1014  659  470  274  273
 193  394  772  947  586 1118 1279 1577 1714 1843 1842 1964 2077 2182 2279 2281 2370 2371 2521 2452 2524 2285 2373 2289 2455 2526 2290 2197 2294 2531 2461 2295 2203 2464 2303 2390 2387 2211 2389 2210 2000 1760 1885 1757 1759 1485 1016 1337  841  842  471  275   69
 192  393  587  949  771 1117 1278 1432 1576 1713 2179 1963 2181 2075 2369 2368 2448 2585 2283 2584 2453 2454 2588 2376 2458 2378 2457 2293 2459 2381 2462 2460 2534 2535 2465 2388 2306 2212 2001 2213 2109 2108 1884 1883 1627 1341 1336 1018  660  472 1015  276   70
 191  392  585  948 1274 1277 1430 1431 1575 1712 1841 1962 2076 2277 2278 2367 2520 2449 2450 2519 2372 2525 2643 2377 2646 2456 2528 2596 2648 2532 2530 2599 2385 2300 2595 2536 2469 2391 2305 2111 2005 1631 1886 1887 1338 1340 1180 1181 1017  662  473   71   72
 190  391  584  770  946 1116 1115 1428 1574 1840 1710 1961 1960 2180 2276 2447 2446 2365 2639 2640 2642 2523 2587 2591 2527 2692 2647 2733 2533 2593 2597 2699 2602 2463 2467 2468 2392 2113 2004 2112 2007 2003 1487 1761 1179 1762  843 1183  661  663  474  277   73
 189  768  390  769  944 1276 1273 1427 1429 1838 1711 2073 2074 2178 2275 2366 2583 2518 2586 2451 2522 2689 2691 2645 2644 2690 2594 2592 2695 2651 2698 2600 2700 2537 2598 2394 2538 2307 2114 2006 1889 1763 1489 1492 1488 1182 1019 1628  844  664  475  278   74
 187  766  767 1113 1275 1272 1426  945 1708 1573 1839 1957 1959 2072 2364 2517 2363 2582 2445 2581 2589 2687 2728 2730 2590 2731 2735 2734 2696 2649 2652 2697 2653 2601 2539 2470 2393 2215 2214 2115 1888 1629 1764 1184 1343 1342 1339 1185  845 1186  477   76  279
 583  188  580  943  578 1112 1114 1571 1572 1835 1709 1836 2071 2177 2274 2362 2273 2515 2516 2638 2688 2727 2732 2761 2762 2694 2693 2787 2766 2736 2738 2737 2655 2654 2472 2471 2310 2216 2116 2217 2218 1890 1767 1490 1765 1491 1632  847  846  280  665  476   77
 185  386  186  388  942  764 1111 1425 1570 1707 1837 1958 2176 2174 2175 2361 2444 2580 2684 2635 2641 2685 2729 2759 2800 2765 2790 2788 2768 2789 2656 2739 2657 2541 2540 2395 2397 2308 2311 2009 2309 2008 1493 1630 1634 1633 1021  848  667  666  478  479   75
 582  387  389  941  765  385 1271 1568 1567 1569 1706 2070 1956 2069 2270 2271 2442 2441 2360 2637 2686 2636 2760 2758 2784 2764 2801 2767 2650 2769 2740 2702 2604 2603 2542 2474 2473 2312 2219 2118 2117 1892 1494 1766 1344 1345 1022 1020  849  668  281  480  282
 183  581  939  760 1108  940 1424 1270 1421 1705 1834 1955 2068 2272 2358 2173 2443 2440 2514 2513 2578 2726 2725 2783 2763 2785 2786 2803 2770 2791 2703 2701 2606 2658 2543 2475 2396 2398 2119 2011 1891 1893 2010 1768 1346 1188 1187 1023  850  669  481  283   78
 184  384  763  579 1109 1110 1269 1423 1566 1704 1833 1954 2067 2172 2439 2512 2359 2577 2576 2579 2634 2724 2757 2782 2799 2808 2802 2804 2741 2742 2704 2659 2660 2544 2545 2399 2314 2313 2220 2120 1894 1895 1769 1635 1637 1347 1189 1024  851  670  482  284   79
 383  577  762  575  761 1106 1267 1107 1422 1703 1832 1953 2066 2171 2269 2268 2357 2575 2633 2682 2683 2723 2756 2781 2798 2807 2806 2805 2792 2772 2771 2661 2706 2605 2546 2476 2401 2400 2221 2222 2012 1896 1770 1773 1636 1348 1190 1025  852  672  671  285   80
 182  576  181  180  938 1105 1420 1565 1268 1702 1831 1952 2065 2267 2356 2437 2510 2438 2511 2632 2681 2722 2755 2780 2778 2797 2796 2795 2774 2793 2743 2705 2666 2607 2608 2477 2478 2316 2315 2121 2122 2013 1771 1496 1495 1350 1191 1027  674 1026  483  286   81
 381  574  382  936  937 1104 1266 1419 1564 1701 1830 1951 2064 2170 2266 2355 2436 2509 2574 2631 2680 2721 2754 2779 2777 2776 2750 2794 2773 2744 2745 2707 2610 2662 2481 2547 2403 2224 2124 2223 1897 1641 1774 1498 1497 1349 1192  853  855  854  484  287   82
 380  573 1103  759  572  934 1265 1418 1563 1700 1829 1950 2063 2169 2168 2354 2435 2508 2573 2630 2679 2720 2753 2752 2751 2775 2749 2713 2746 2710 2663 2664 2480 2709 2406 2609 2479 2317 2402 2123 2125 2014 2015 1639 1638 1640 1193 1028  673  675  485  288   83
 179  378  379  758  757  935 1264 1417 1562 1699 1828 1949 2062 2167 2265 2264 2353 2434 2571 2507 2678 2719 2718 2717 2716 2715 2714 2670 2708 2748 2550 2611 2482 2404 2548 2549 2407 2225 2227 2226 1900 1772 1898 1500 1499 1351 1194 1029  856  486  487  289   84
 177  571  178  756  933 1102 1263 1416 1561 1698 1827 1948 2061 2166 2262 2433 2263 2572 2628 2629 2677 2676 2675 2674 2673 2672 2671 2619 2747 2711 2669 2668 2612 2552 2665 2320 2483 2322 2318 2126 2018 1899 1775 1642 1501 1352 1196 1195 1030  857  290  291   85
 176  377  570  755  932 1101 1262 1415 1560 1697 1826 1947 2060 2165 2352 2432 2506 2505 2570 2627 2626 2625 2624 2623 2622 2621 2620 2712 2618 2558 2615 2617 2616 2405 2613 2486 2319 2551 2127 2228 2017 1902 1901 1643 1502 1353 1197 1031  858  676  677   86   87
 175  376  569  754  931 1100 1261 1414 1559 1696 1825 1946 2059 2164 2350 2351 2431 2504 2569 2568 2567 2566 2565 2497 2564 2495 2561 2560 2492 2557 2487 2555 2667 2556 2485 2411 2321 2484 2229 2019 2016 2128 1776 1777 1644 1354 1032 1033  679  488  292   88  293
 174  375  568  753  930 1099 1260 1413 1558 1695 1824 1945 2058 2163 2261 2349 2430 2503 2502 2501 2500 2499 2498 2422 2562 2563 2494 2493 2491 2559 2332 2488 2614 2328 2554 2553 2408 2230 2231 2129 2020 1903 1778 1645 1503 1355 1198  859  860  678  489  490   89
 173  374  567  752  929 1098 1259 1412 1557 1694 1823 1944 2057 2259 2260 2348 2429 2428 2427 2426 2425 2424 2340 2423 2496 2420 2419 2335 2416 2489 2333 2415 2329 2238 2412 2409 2323 2324 2232 2130 2021 1904 1779 1646 1504 1505 1356 1035  861  680  491   90  295
 172  373  566  751  928 1097 1258 1411 1556 1693 1822 1943 2056 2162 2161 2258 2347 2345 2344 2343 2342 2341 2249 2339 2421 2338 2337 2336 2418 2417 2490 2414 2413 2239 2330 2410 2327 2325 2131 2132 2022 1905 1781 1780 1507 1200 1034 1199  862  681  296  493  294
 171  372  565  750  927 1096 1257 1410 1555 1692 1821 1942 2055 2160 2257 2256 2346 2255 2254 2253 2252 2251 2250 2248 2247 2246 2245 2244 2334 2242 2241 2141 2033 2331 2139 2237 2235 2234 2233 2133 2023 1647 1648 1359 1357 1506 1201 1036  863  682  494   91   92
 170  371  564  749  926 1095 1256 1409 1554 1691 1820 1941 2054 2159 2158 2157 2156 2155 2154 2153 2152 2151 2150 2149 2148 2147 2146 2145 2243 2144 2143 2142 1919 2240 2138 2236 2326 2135 2134 2024 1784 1906 1907 1782 1511 1203 1037  864  683  684  297  492   93
 169  370  563  748  925 1094 1255 1408 1553 1690 1819 1940 2053 2052 2051 2050 2049 2048 2047 2046 2045 2044 2043 2042 2041 2040 2039 2038 2037 2036 2035 2140 1918 2032 2031 2030 2136 2137 2028 2027 1910 1783 1649 1358 1650 1508 1202 1038  865  686  298  299   94
 168  369  562  747  924 1093 1254 1407 1552 1689 1818 1939 1938 1937 1936 1935 1934 1933 1932 1931 1930 1929 1928 1927 1926 1925 1924 1923 1922 1921 1797 2034 1795 1916 1793 1915 2029 1913 1911 1788 2025 1908 1509 1786 1510 1360 1039  687  685  495  496  867   95
 167  368  561  746  923 1092 1253 1406 1551 1688 1817 1816 1815 1814 1813 1812 1811 1810 1809 1808 1807 1806 1805 1804 1803 1802 1801 1800 1799 1798 1796 1920 1794 1917 1792 1791 1789 1790 1912 1787 2026 1655 1909 1652 1514 1361 1364 1362 1651  869  497   96   97
 166  367  560  745  922 1091 1252 1405 1550 1687 1686 1685 1684 1683 1682 1681 1680 1679 1678 1677 1676 1675 1674 1673 1672 1671 1670 1669 1668 1667 1666 1665 1664 1663 1662 1661 1914 1660 1659 1658 1657 1656 1654 1512 1515 1785 1363 1206 1040  868  302  301   98
 165  366  559  744  921 1090 1251 1404 1549 1548 1547 1546 1545 1544 1543 1542 1541 1540 1539 1538 1537 1536 1535 1534 1533 1532 1531 1530 1529 1528 1527 1526 1525 1524 1523 1522 1521 1520 1519 1518 1517 1516 1368 1513 1653 1205  866  689 1042  498  303  300  304
 164  365  558  743  920 1089 1250 1403 1402 1401 1400 1399 1398 1397 1396 1395 1394 1393 1392 1391 1390 1389 1388 1387 1386 1385 1384 1383 1382 1381 1380 1379 1378 1377 1376 1375 1374 1373 1372 1370 1369 1367 1212 1051 1211 1047 1365 1204 1041 1207  499  305  500
 163  364  557  742  919 1088 1249 1248 1247 1246 1245 1244 1243 1242 1241 1240 1239 1238 1237 1236 1235 1234 1233 1232 1231 1230 1229 1228 1227 1226 1225 1224 1223 1222 1221 1220 1219 1218 1217 1371 1215 1214 1050 1048 1366  875 1043 1208  870 1044  501  503   99
 162  363  556  741  918 1087 1086 1085 1084 1083 1082 1081 1080 1079 1078 1077 1076 1075 1074 1073 1072 1071 1070 1069 1068 1067 1066 1065 1064 1063 1062 1061 1060 1059  887 1058 1057 1054 1053 1216  881 1052 1049 1210 1213 1046 1045 1209  695  506  688  690  100
 161  362  555  740  917  916  915  914  913  912  911  910  909  908  907  906  905  904  903  902  901  900  899  898  897  896  895  894  893  892  891  890  889  888  708  886 1056 1055  884  703  883  880  879  878  511  697  872  871  691  694  502  692  102
 160  361  554  739  738  737  736  735  734  733  732  731  730  729  728  727  726  725  724  723  722  721  720  719  718  717  716  715  714  713  712  710  524  709  521  707  706  885  705  516  882  702  700  699  876  698  874  873  109  108  504  306  103
 159  360  553  552  551  550  549  548  547  546  545  544  543  542  541  540  539  538  537  536  535  534  533  532  531  530  529  528  527  525  331  711  523  327  522  121  518  517  322  515  514  318  320  510  512  317  313  877  315  696  310  101  308
 158  359  358  357  356  355  354  353  352  351  350  349  348  347  346  345  344  343  342  341  340  339  338  337  336  335  334  333  332  526  330  328  126  520  326  324  519  323  704  319  701  321  118  508  513  693  111  509  507  311  505  307  104
 157  156  155  154  153  152  151  150  149  148  147  146  145  144  143  142  141  140  139  138  137  136  135  134  133  132  131  130  129  128  127  329  125  124  123  325  122  120  119  114  117  116  113  115  316  110  112  314  312  107  106  309  105
