# This puzzle is unsolvable
32
 125    4  127  129  242  246  130    7   10  133  250   11   12   14   15   16   17   18   19   21  143   22   24  148   25   26   27  150  156  151   30   31
   1  124    2  128    6  131  132    9  248    8  135  134   13  137  252  138  139  140  142   20  144  146   23  370  264  149  266   29   28  375   32   33
 123    3  238  126  448  243  349  244  354  453  247  457  357  549  253  458  255  141  256  257  259  145  147  368  265  267  373  372  153  154   34   35
 239  240    5  350  348  351  625  451  353  355  547  356  136  359  460  254  363  364  365  366  465  260  261  467  262  469  152  561  374  155  268   36
 121  120  446  347  449  626  543  245  544  249  456  360  459  358  362  361  461  462  464  258  466  367  468  263  470  642  371  471  472  158  161  270
 346  122  241  345  447  539  700  352  455  545  629  550  251  707  553  636  554  711  463  555  638  556  559  369  643  560  562  563  377  271  157   37
 234  119  237  236  540  701  452  628  627  454  546  630  548  552  836  777  634  710  637  712  557  890  641  640  718  474  476  269  379  473  159  160
 118  343  535  445  542  450  624  541  768  769  703  631  705  708  633  635  837  709  776  715  714  781  716  558  717  376  564  646  273  378  162  272
 235  444  344  443  538  536  623  699  829  702  770  706  704  885  774  833  551  780  639  932  892  782  784  785  645  644  475  568   38  275  274    0
 117  115  342  341  442  622  537  767  827  832  771  881  773  772  834  775  778  835  713  839  968  783  720  647  719  648  566  565  164   42   39  163
 231  116  340  232  441  621  698  697  830  828  882  927  884  632  883  887  779  967  969  889  891  840  842  844  567  649  726  380  381  276   41   43
 233  230  440  532  534  696  765  766  826  879  960  880  831  963 1008  965  888  993  930  893  934  896  933  651  477  722  650  478  382   45   44  165
 114  112  338  337  618  620  764  694  825  878  924  926  990  928  991  886  964  994  935  931  894  895  786  721  569  652  481  479  483  166  384   40
 229  439  111  616  617  619  695  760  876  919  923  925  988  961  962  992  936  929  970  838  971  996  787  729  897  570  723  482  571  480  277  278
 339  225  228  438  533  693  762  691  763  877  922  959  761  985  989 1020 1011 1012  997  841  848  846  847  788  792  789  725  572  385  279  383  168
 113  334  335  336  530  615  692  759  824  823  822  874  958  987 1010 1021 1013 1001  995  966  653  972  937  658  724  790  484  791  281  282  167   46
 227  226  437  435  529  613  531  690  820  917  918 1006  984  986 1007 1019 1000 1022  938  845  973  899  793  849  654  655  794  283  280  386  388  169
 109  110  333  527  436  612  757  821  614  920  983 1017 1005  978 1016  945 1002 1015  940  898  727  728  843  795  575  730  853  573  389   49   47   48
 108  107  332  433  434  689  758  873  819  875  957  921  953  950 1009 1003  977  974  906 1014  941  943  850  900  657  656  387  659  485  284  170   51
 224  105  223  432  525  687  818  688  870  871  869  956  916  951 1004 1018  976  861  907  939  975  901  942  851  731  486  488  574  577   52   50  171
 104  222  220  331  426  611  686  915  756 1023  868  979  872  980  864  982  954  807  999  740  905  946  732  576  578  660  390  287  487  172  285  174
 219  106  329  528  429  330  609  817  816  955  867  952  914  911  912  860  909  947  858  802  664  998  944  796  661  734  902  797  173  288   53  391
 221  103  523  526  431  524  521  755  608  814  866  910  675  981  949  672  908  741  904  665  948  854  739  666  579  855  491  489  286  392  175   54
 430  101  327  522  684  685  610  752  815  750  513  745  813  865  808  863  805  859  803  852  670  598  800  736  733  580  799  490  393  289  176   55
  99  100  428  606  520  607  681  753  746  811  676  810  678  595  674  591  806  743  857  589  856  667  801  499  585  583  492  735  395  178  291   57
 216  102  324  217  215  602  603  812  754  418  599  748  596  747  742  862  913  592  673  502  798  671  501  737  300  497  662  496  394  396   56  177
  98  326  325  427  320  517  683  751  679  417  601  511  312  508  413  507  744  199  590  669  406  588  302  586  903  498  581  584  493  290  292   58
 214  328  425  218  516   89  605  515  514  749  512  314  414  510  809  506  411  804  668  407  738  408  405  299  187  400  663  494  180  179  294   59
  97  323  210  682  423  421  604  680  420  600  677  313  597  198   80  509  412  410  194   75  409  404  301  401  582  500  397  402  293  495   60  295
  96  322  209  518  422  207  424  205   90  317  316   85   84  201  415  593  195   74  503  306  304  305   73  587  191  399   65  185   67  181  398   61
  95  213  321  211  519  208  318   87  419  315  202  200   81  309  307  416   82  193  196   77  192  303   72  190   70  189  403  297  186  182  296  183
  94  212   93   92   91  206  319   88   86  203  204   83  308   78  310  594  311  504  505   79  197   76   69   71   68  188   66  298  184   64   63   62
