# This puzzle is unsolvable
40
   2    1  304  158    5    6    7    8    9   10   11   13   14  168   17   18  171  170   16   20  175  465  177   24   26  182   27   28   29   30   31  188   34   35  190   36   37   38   39   40
   3  155  157    4  161  447  308  163  164  166   12  453  167  586  169  174   15  321  320  173  323   23   22  178  179   25  329  183  184  185  186   33  336  335  189  191  192  193  194   41
 303  305  701  307  159  577  162  309  311  580  313  585  314  318  456  319  712  172   19  176   21  324  464  325  180  181  721  330  331  332  333  187   32  337  476  338  339  342  340   42
 153  154  445  576  160  306  448  581  312  310  706  584  316  315  455  713  458  591  322  593  594  466  462  467  720  326  327  469  470  471  472  334  474  606  475  477  343  479  195  196
 302  156  444  442  700  925  446  583  165  822  452  450  454  317  708  589  457  714  460  461  459  463  597  835  328 1044  468  600  601  726  602  473  605  728  607  730  478  197  480   43
 152  300  443  441  579  578  451  816 1026  821  705  582  709  824  588  711  590  710  592  717  831  718  940  596  598  599  722  945  724  838  725  604 1048  727  729  608  609  341   47   46
 151  439  440  301  575  819  927  704  818  449  707  929  587  823 1032  932  826  827  828  829  715  595  937  719  834  837  944  723  836 1138  603  949  842  843  731  610  198   44  199   45
 149  150  697  299  572  814  817 1024 1023  926 1028 1117 1027  825 1029  931  933 1127 1035  830  936  938 1289  716  833 1042 1045  946  840  943  839  951 1137  844  846  611  481  344   49  346
 148  438  297  698  699  815  702  703 1200  928  820  930 1031 1121 1123 1122 1033 1125 1209 1037 1039  832 1040 1130  941 1134 1217 1136 1047  953 1049  841  845  612  735  733  483  200   48  202
 147  296  298  436  574  811  810  923 1022 1116 1276 1119 1030 1120 1124 1282 1034  934 1212 1036 1038 1286  939 1288 1043 1291 1041 1220 1290 1293 1221  948  952  950  487  732  345  349  347  204
 146  571  693  924  573  812  696  813  922 1025 1118 1201 1278 1204 1205  935 1207 1208 1128 1211 1210 1353 1287  942 1133 1135 1219  947 1418 1363 1050 1140  954  850  847  484  485  486  206  482
 295  437  694  568  695  809  920  919 1021 1115 1277 1203 1279 1346 1280 1206 1281 1283 1284 1129 1126 1285 1132 1213 1416 1131 1215 1222 1294 1142 1141  849  853  956  615  614  734   50   56  350
 145  569  570  567  918  692 1112 1198  921 1113 1274 1202 1275 1345 1347 1348 1349 1351 1352 1355 1413 1412 1214 1216 1357 1469 1358 1295 1218 1046 1139 1420 1052  737  958  736  203  351  352  201
 144  292  294  566  691  808  917 1114 1111 1020 1199 1404 1344 1405 1406 1408 1409 1350 1410 1411 1354 1414 1356 1415 1465 1292 1362 1361 1360 1296  848  957  960  852  613  488   51  354   52  348
 293  291  435  433  688  916 1018 1271 1110 1273 1343 1400 1403 1402 1407 1458 1459 1460 1461 1462 1463 1464 1466 1509 1467 1359 1468 1417 1298  955 1055 1143  959  618  739  616  617  353  205   55
 143  142  434  431  563  690 1196  915 1019 1197 1195 1339 1342 1341 1457 1456 1501 1503 1504 1506 1507 1508 1542 1511 1544 1470 1471 1058 1226 1223 1053  855 1051  619  208   53  489  210   54  491
 141  290  565  564  432 1017  807  806 1107 1272 1193 1340 1401 1455 1535 1537 1502 1539 1540 1505 1541 1569 1571 1543 1510 1512 1297 1419 1299 1054 1224 1300 1144 1057  738  211  620  621  209   57
 140  289  430  914  805  689 1013 1109 1016 1270 1194 1453 1399 1454 1500 1564 1565 1584 1586 1567 1568 1570 1572 1545 1513 1473 1421 1364 1365 1145 1225  858 1147  492 1056  740  207   58  490  356
 139  288  429  562  687  804  912 1269 1106 1015 1192 1338 1452 1498 1536 1497 1534 1566 1538 1585 1587 1598 1588 1546 1423 1422 1366 1228 1148 1227  742  741  746  622  851  493  961   60  355  212
 138  287  428  561  802  803 1014 1012  913 1190 1268 1337 1398 1496 1533 1499 1563 1562 1583 1596 1597 1547 1514 1425 1515 1302 1368 1301 1229 1367 1059  860  963  854  856  625  494  495  359  213
 137  286  427  560  686  685 1108 1191  911 1189 1267 1336 1397 1451 1450 1495 1561 1582 1595 1599 1590 1589 1573 1548 1472 1474 1369 1424 1230 1150 1146  962 1151  744  623  743  497  861  496  358
 136  285  426  559  684  910 1010 1104 1105 1266 1265 1335 1396 1449 1494 1532 1531 1560 1594 1577 1592 1591 1574 1549 1516 1475 1426 1304 1303 1149 1060 1232  745  857  859  357  360  361   62   59
 135  284  425  558  683  801 1011  909 1187 1103 1264 1334 1395 1493 1491 1530 1559 1581 1580 1523 1578 1554 1576 1575 1550 1476 1373 1305 1429 1152 1061 1063  965  967  626  624  628  215  498  214
 134  283  424  557  682  800  799  908  907 1008 1188 1333 1394 1448 1529 1558 1557 1556 1579 1593 1555 1553 1551 1518 1517 1477 1427 1371 1306 1370  966 1231  964  862  747  499  500  362  216   61
 133  282  423  556  681  906 1102 1007 1100 1009 1186 1332 1392 1492 1447 1528 1527 1526 1524 1485 1522 1483 1552 1520 1519 1428 1478 1372 1430  969 1153 1062  970 1065  749  501  748   64   63  217
 132  281  422  555  680  798  797 1006 1099 1101 1263 1444 1261 1393 1446 1489 1488 1487 1525 1438 1484 1482 1380 1433 1480 1431 1376 1234 1307 1235 1154 1233 1066 1064  751  629  219  366  364   65
 131  280  421  554  796  794  905 1185 1098 1097 1331 1260 1262 1329 1445 1490 1441 1440 1486 1321 1437 1436 1521 1381 1481 1314 1310 1374 1308 1309 1156  968  866  627  863  631  630  502  363  218
 130  279  420  553  679  795  904 1004 1005 1096 1183 1328 1390 1326 1443 1442 1323 1386 1439 1384 1382 1435 1246 1379 1479 1377 1244 1313 1236 1375 1067  864 1237  750  753  752  503  365  220   66
 129  278  419  552  678  677  903 1002 1181 1259 1257 1391 1184 1389 1388 1387 1324 1385 1322 1383 1248 1319 1247 1434 1165 1432 1317 1311 1240 1155 1158  974 1157  971  754  632  221  367   68   67
 128  277  418  551  676  793  902 1182 1093 1258 1256 1327 1330 1255 1325 1253 1252 1172 1251 1320 1169 1318 1316 1075 1315 1242 1243  981 1163 1312 1068  979  867  972 1069  633  504  222  223   69
 127  276  417  550  675  792 1001 1180 1003  999 1179 1091 1178 1177 1254 1175 1174 1083 1171 1249 1250 1082 1080 1168 1167 1245 1378 1241 1073 1239 1161 1070  865  976  868  634  505  368  224   70
 126  275  416  549  674  791  901 1000 1094 1095 1092  995 1176 1089 1088 1087 1084 1173  989 1170 1085  986 1081 1166 1164 1162 1077  764 1074 1238  873 1071  871  635  756  755  508  506  369   71
 125  274  415  548  673  899  900  998  896  895  997 1090  996  892  993 1086  991  990  886  988  987  883  985 1079  983  877  876  874 1076  763  978 1159  973  869  975  509  636  370  225  226
 124  273  414  547  789  790  898  897  539  785  784  893  781  890  994  992    0  887  775  885  884  882 1078  984  982  878  767  765  762 1160  643  870  516  872  507  757  638  371   72   74
 123  272  545  671  672  413  788  787  786  666  894  664  782  891  780  888  777  776  658  656  772  390  771  880  881  879  649  384  386  980  514  875  645  977  637  511  372  227   73   75
 122  412  670  544  546  669  668  540  667  665  783  663  661  535  659  778  889  528  655  654  773  527  391  769  768  523  646  648  766  761  515 1072  642  641  758  759  373  229  374  228
 270  271  411  543  542  407  406  541  404  538  537  401  662  399  532  396  657  531  530  529  653  524  389  652  770  522  521  383  242  520  644  760  517  377  379  510  512  639  375   76
 121  269  410  409  265  408  263  405  261  403  400  256  255  534  779  660  398  252  394  249  392  525  526  650  651   92  518  647   88  385  519  382  238  640  235  513  376  232  230   77
 120  268  267  266  110  113  111  109  260  258  536  259  257  105  104  533  103  251  395  393  774   97  248  388  245  243   94   93  387  240   89   87  236  380   84  378  234  233  231   78
 119  118  117  116  115  114  264  112  262  108  107  402  106  254  102  397  253  101  100   99  250   98  247   96  246   95  244   91  241   90  239   86  381  237   85   83   82   81   80   79
