# This puzzle is unsolvable
71
   2    1    3    4    5    6    7    8    9   10   11   12   13   14   15   16   17   18   19   20   21   22   23   24   25   26   27   28   29   30   31   32   33   34   35   36   37   38   39   40   41   42   43   44   45   46   47   48   49   50   51   52   53   54   55   56  336   58  338   59   61   62   64  343   65   66   67   68   69   70   71
 280  281  282  283  284  285  286  287  288  289  290  291  292  293  294  295  296  297  298  299  300  301  302  303  304  305  306  307  308  309  310  311  312  313  314  315  316  317  318  319  320  321  322  323  324  325  326  327  328  329  330  331  332  333  334  335  337   57   60  339  340  341   63  344  345  616  346  347  348  349   72
 279  552  553  554  555  556  557  558  559  560  561  562  563  564  565  566  567  568  569  570  571  572  573  574  575  576  577  578  579  580  581  582  583  584  585  586  587  588  589  590  591  592  593  594  595  596  597  598  599  600  601  602  603  604  605  869  607  609  872  610  611  613  342  614  615  617  880  618  619  350   73
 278  551  816  817  818  819  820  821  822  823  824  825  826  827  828  829  830  831  832  833  834  835  836  837  838  839  840  841  842  843  844  845  846  847  848  849  850  851  852  853  854  855  856  857  858  859  860  861  862  863  864  865  866  867  868  608  606  870  871  873  874  612  875  876  878 1133  879  881  620  351   74
 277  550  815 1072 1073 1074 1075 1076 1077 1078 1079 1080 1081 1082 1083 1084 1085 1086 1087 1088 1089 1090 1091 1092 1093 1094 1095 1096 1097 1098 1099 1100 1101 1102 1103 1104 1105 1106 1107 1108 1109 1110 1111 1112 1113 1114 1115 1116 1117 1118 1119 1120 1121 1122 1123 1124 1125 1126 1127 1128 1129 1130 1131  877 1380 1134 1135  882  621  352   75
 276  549  814 1071 1320 1321 1322 1323 1324 1325 1326 1327 1328 1329 1330 1331 1332 1333 1334 1335 1336 1337 1338 1339 1340 1341 1342 1343 1344 1345 1346 1347 1348 1349 1350 1351 1352 1353 1354 1355 1356 1357 1358 1359 1360 1361 1362 1363 1364 1365 1366 1367 1368 1369 1370 1371 1372 1373 1374 1375 1376 1377 1378 1618 1132 1381 1136  883  622  353   76
 275  548  813 1070 1319 1560 1561 1562 1563 1564 1565 1566 1567 1568 1569 1570 1571 1572 1573 1574 1575 1576 1577 1578 1579 1580 1581 1582 1583 1584 1585 1586 1587 1588 1589 1590 1591 1592 1593 1594 1595 1596 1597 1598 1599 1600 1601 1602 1603 1604 1605 1606 1607 1608 1609 1610 1611 1612 1613 1614 1615 1616 1617 1849 1379 1619 1137  884  623  354   77
 274  547  812 1069 1318 1559 1792 1793 1794 1795 1796 1797 1798 1799 1800 1801 1802 1803 1804 1805 1806 1807 1808 1809 1810 1811 1812 1813 1814 1815 1816 1817 1818 1819 1820 1821 1822 1823 1824 1825 1826 1827 1828 1829 1830 1831 1832 1833 1834 1835 1836 1837 1838 1839 1840 1841 1842 1843 1844 1845 1846 2070 1847 1848 1620 1382 1138  885  355  625   78
 273  546  811 1068 1317 1558 1791 2016 2017 2018 2019 2020 2021 2022 2023 2024 2025 2026 2027 2028 2029 2030 2031 2032 2033 2034 2035 2036 2037 2038 2039 2040 2041 2042 2043 2044 2045 2046 2047 2048 2049 2050 2051 2052 2053 2054 2055 2056 2057 2058 2059 2060 2061 2062 2063 2064 2065 2066 2282 2067 2284 2069 2071 1850 1621 1383 1139  886  624  356   79
 272  545  810 1067 1316 1557 1790 2015 2232 2233 2234 2235 2236 2237 2238 2239 2240 2241 2242 2243 2244 2245 2246 2247 2248 2249 2250 2251 2252 2253 2254 2255 2256 2257 2258 2259 2260 2261 2262 2263 2264 2265 2266 2267 2268 2269 2270 2271 2272 2273 2274 2275 2276 2277 2278 2279 2280 2281 2489 2068 2283 2285 2072 1852 1622 1384 1385  887  357  627   80
 271  544  809 1066 1315 1556 1789 2014 2231 2440 2441 2442 2443 2444 2445 2446 2447 2448 2449 2450 2451 2452 2453 2454 2455 2456 2457 2458 2459 2460 2461 2462 2463 2464 2465 2466 2467 2468 2469 2470 2471 2472 2473 2474 2475 2476 2477 2478 2479 2480 2481 2482 2483 2484 2485 2486 2487 2488 2688 2490 2491 2286 2073 1623 1851 1386 1140 1141  628  626   81
 270  543  808 1065 1314 1555 1788 2013 2230 2439 2640 2641 2642 2643 2644 2645 2646 2647 2648 2649 2650 2651 2652 2653 2654 2655 2656 2657 2658 2659 2660 2661 2662 2663 2664 2665 2666 2667 2668 2669 2670 2671 2672 2673 2674 2675 2676 2677 2678 2679 2680 2681 2682 2683 2684 2876 2685 2687 2879 2689 2492 2287 2074 1853 1624 1387 1142  888  889  358   82
 269  542  807 1064 1313 1554 1787 2012 2229 2438 2639 2832 2833 2834 2835 2836 2837 2838 2839 2840 2841 2842 2843 2844 2845 2846 2847 2848 2849 2850 2851 2852 2853 2854 2855 2856 2857 2858 2859 2860 2861 2862 2863 2864 2865 2866 2867 2868 2869 2870 2871 2872 2873 2874 3058 2875 2686 2877 2878 2690 2493 2288 1854 1625 1388 1143  891  890  629  359   83
 268  541  806 1063 1312 1553 1786 2011 2228 2437 2638 2831 3016 3017 3018 3019 3020 3021 3022 3023 3024 3025 3026 3027 3028 3029 3030 3031 3032 3033 3034 3035 3036 3037 3038 3039 3040 3041 3042 3043 3044 3045 3046 3047 3048 3049 3050 3051 3052 3053 3054 3055 3056 3057 3233 3059 3060 3061 2880 2691 2494 2289 2075 1855 1627 1389 1145  892  361  360   84
 267  540  805 1062 1311 1552 1785 2010 2227 2436 2637 2830 3015 3192 3193 3194 3195 3196 3197 3198 3199 3200 3201 3202 3203 3204 3205 3206 3207 3208 3209 3210 3211 3212 3213 3214 3215 3216 3217 3218 3219 3220 3221 3222 3223 3224 3225 3226 3227 3228 3229 3230 3231 3232 3400 3234 3235 3062 2881 2692 2291 2290 2076 1626 2077 1144 1146 1391  630  362   85
 266  539  804 1061 1310 1551 1784 2009 2226 2435 2636 2829 3014 3191 3360 3361 3362 3363 3364 3365 3366 3367 3368 3369 3370 3371 3372 3373 3374 3375 3376 3377 3378 3379 3380 3381 3382 3383 3384 3385 3386 3387 3388 3389 3390 3391 3392 3393 3394 3395 3396 3397 3398 3399 3559 3401 3236 3063 2882 2693 2495 2496 2078 1856 1628 1390  631  633  893  363   86
 265  538  803 1060 1309 1550 1783 2008 2225 2434 2635 2828 3013 3190 3359 3520 3521 3522 3523 3524 3525 3526 3527 3528 3529 3530 3531 3532 3533 3534 3535 3536 3537 3538 3539 3540 3541 3542 3543 3544 3545 3546 3547 3548 3549 3550 3551 3552 3553 3554 3555 3556 3708 3557 3558 3402 3237 3064 2883 2497 2292 2080 2079 1857 1629 1392 1147  894  632  364   87
 264  537  802 1059 1308 1549 1782 2007 2224 2433 2634 2827 3012 3189 3358 3519 3672 3673 3674 3675 3676 3677 3678 3679 3680 3681 3682 3683 3684 3685 3686 3687 3688 3689 3690 3691 3692 3693 3694 3695 3696 3697 3698 3699 3700 3701 3702 3703 3704 3705 3706 3707 3851 3709 3560 3403 3238 2884 2695 2694 2498 2294 1859 1858 1630 1394 1393 1148  895  365   88
 263  536  801 1058 1307 1548 1781 2006 2223 2432 2633 2826 3011 3188 3357 3518 3671 3816 3817 3818 3819 3820 3821 3822 3823 3824 3825 3826 3827 3828 3829 3830 3831 3832 3833 3834 3835 3836 3837 3838 3839 3840 3841 3842 3843 3844 3845 3981 3846 3848 3984 3849 3850 3710 3561 3404 3239 3065 3066 2696 2499 2293 2081 1860 1861 1631 1149  896  634  635   89
 262  535  800 1057 1306 1547 1780 2005 2222 2431 2632 2825 3010 3187 3356 3517 3670 3815 3952 3953 3954 3955 3956 3957 3958 3959 3960 3961 3962 3963 3964 3965 3966 3967 3968 3969 3970 3971 3972 3973 3974 3975 3976 3977 3978 3979 3980 3847 4228 3982 3983 3985 3712 3852 3562 3405 3240 3067 2885 2886 2500 2295 2082 1397 1863 2083 1396 1395  636  366   90
 261  534  799 1056 1305 1546 1779 2004 2221 2430 2631 2824 3009 3186 3355 3516 3669 3814 3951 4080 4081 4082 4083 4084 4085 4086 4087 4088 4089 4090 4091 4092 4093 4094 4095 4096 4097 4098 4099 4100 4101 4102 4103 4104 4105 4106 4107 4108 4109 4111 3987 3853 3711 3563 3564 3406 3241 3068 2887 2697 2698 2501 2296 1862 1156 1632 1150  897  367  898   91
 260  533  798 1055 1304 1545 1778 2003 2220 2429 2630 2823 3008 3185 3354 3515 3668 3813 3950 4079 4200 4201 4202 4203 4204 4205 4206 4207 4208 4209 4210 4211 4212 4214 4325 4215 4216 4217 4218 4219 4220 4221 4222 4223 4224 4225 4226 4339 4229 4114 4110 3988 3854 3713 3565 3407 3242 3069 2888 2699 2085 2298 2297 2502 2084 1634  899  900  369  368   92
 259  532  797 1054 1303 1544 1777 2002 2219 2428 2629 2822 3007 3184 3353 3514 3667 3812 3949 4078 4199 4312 4313 4314 4315 4316 4317 4318 4319 4320 4321 4322 4426 4323 4213 4326 4327 4328 4329 4330 4331 4332 4333 4334 4335 4336 4337 4227 3986 4231 4112 4113 3855 3714 3409 3408 3243 3070 2889 2700 2503 2300 2086 1864 1633 1153  370  638   94   96   93
 258  531  796 1053 1302 1543 1776 2001 2218 2427 2628 2821 3006 3183 3352 3513 3666 3811 3948 4077 4198 4311 4416 4417 4418 4419 4420 4421 4422 4423 4424 4425 4521 4324 4427 4525 4429 4431 4432 4433 4434 4435 4436 4437 4438 4439 4441 4338 4230 4340 4115 3989 3856 3715 3566 3410 3244 3071 2890 2702 2701 2703 1400 1398  901  643 1152 1151  639  374   95
 257  530  795 1052 1301 1542 1775 2000 2217 2426 2627 2820 3005 3182 3351 3512 3665 3810 3947 4076 4197 4310 4415 4512 4513 4514 4515 4516 4517 4518 4519 4520 4522 4609 4428 4523 4430 4526 4527 4528 4529 4530 4531 4532 4533 4534 4440 4535 4442 4232 3990 3857 3716 3860 3411 3567 3245 3072 2506 2896 2301 2505 1635 1636 2299 1866  640 1399  371  903  637
 256  529  794 1051 1300 1541 1774 1999 2216 2425 2626 2819 3004 3181 3350 3511 3664 3809 3946 4075 4196 4309 4414 4511 4600 4601 4602 4603 4604 4605 4606 4607 4608 4610 4524 4612 4691 4613 4614 4615 4616 4617 4618 4619 4620 4621 4536 4443 4341 4233 3859 3858 3991 3568 3246 3073 2891 2504 2892 2704 2507 2302 2088 1865 2087 1157  641  902  645   97  373
 255  528  793 1050 1299 1540 1773 1998 2215 2424 2625 2818 3003 3180 3349 3510 3663 3808 3945 4074 4195 4308 4413 4510 4599 4680 4681 4682 4683 4684 4685 4686 4687 4688 4761 4689 4611 4692 4693 4695 4766 4696 4697 4698 4699 4622 4537 4444 4342 4117 4116 3993 3718 3414 3569 3412 2893 3074 2508 2897 2705 1638 2092 1637 1155 1868 1639 1154  906  644  372
 254  527  792 1049 1298 1539 1772 1997 2214 2423 2624 2817 3002 3179 3348 3509 3662 3807 3944 4073 4194 4307 4412 4509 4598 4679 4752 4753 4754 4755 4756 4757 4758 4822 4759 4690 4762 4763 4827 4694 4828 4767 4768 4769 4700 4623 4538 4445 4343 4234 4118 3995 3992 3717 3248 3413 3571 3076 2895 2306 2304 2303 2089 1872 1401 1403 1159  905  642  375   98
 253  526  791 1048 1297 1538 1771 1996 2213 2422 2623 2816 3001 3178 3347 3508 3661 3806 3943 4072 4193 4306 4411 4508 4597 4678 4751 4816 4817 4818 4819 4820 4821 4877 4760 4824 4826 4881 4765 4764 4829 4830 4831 4770 4701 4624 4539 4345 4344 4346 4119 4120 3994 3721 3722 3570 3075 2894 3247 3249 2707 2090 2091 1871 1867 1406 1158  904  908 1161   99
 252  525  790 1047 1296 1537 1770 1995 2212 2421 2622 2815 3000 3177 3346 3507 3660 3805 3942 4071 4192 4305 4410 4507 4596 4677 4750 4815 4872 4873 4874 4876 4923 4823 4825 4880 4927 4928 4968 4882 4884 4832 4833 4771 4702 4625 4540 4448 4237 4235 3996 4236 3863 3719 3720 3417 3077 3415 2706 3078 2510 2093 1873 1643 1402 1869 1160 1640 1405  376  380
 251  524  789 1046 1295 1536 1769 1994 2211 2420 2621 2814 2999 3176 3345 3506 3659 3804 3941 4070 4191 4304 4409 4506 4595 4676 4749 4814 4871 4920 4921 4875 4924 4925 4879 4878 4965 4967 4930 4883 4886 4834 4885 4772 4703 4626 4541 4446 4348 4447 4239 3997 4121 3862 3724 3416 3250 2511 3251 3253 2708 2509 2307 1407 1874 1404  648 1641  907  100  377
 250  523  788 1045 1294 1535 1768 1993 2210 2419 2620 2813 2998 3175 3344 3505 3658 3803 3940 4069 4190 4303 4408 4505 4594 4675 4748 4813 4870 4919 4960 4922 4961 4963 4994 4995 4926 4964 4929 4932 4887 4931 4837 4773 4704 4627 4543 4542 4449 4347 3998 3861 3864 3723 3572 3573 3420 3254 2900 3079 2095 1870 1647 1642 1875  909  647  379  651  102  101
 249  522  787 1044 1293 1534 1767 1992 2209 2418 2619 2812 2997 3174 3343 3504 3657 3802 3939 4068 4189 4302 4407 4504 4593 4674 4747 4812 4869 4918 4959 4992 4962 5017 4993 4996 4966 4970 4969 4934 4933 4889 4888 4835 4774 4628 4450 4349 4350 4240 4241 4122 3999 3865 3419 3252 3418 2898 2709 3080 2308 2710 2096 1408  912 1162 1163  650  910  378  103
 248  521  786 1043 1292 1533 1766 1991 2208 2417 2618 2811 2996 3173 3342 3503 3656 3801 3938 4067 4188 4301 4406 4503 4592 4673 4746 4811 4868 4917 4958 4991 5016 5018 5033 5020 4997 4999 4998 5021 4935 4836 4838 4775 4705 4706 4544 4451 4352 4124 4000 3575 3725 4123 3574 3577 3255 3081 2512 2514 2513 2310 2305 2309 2094 1876 1409 1164  381  382  104
 247  520  785 1042 1291 1532 1765 1990 2207 2416 2617 2810 2995 3172 3341 3502 3655 3800 3937 4066 4187 4300 4405 4502 4591 4672 4745 4810 4867 4916 4957 4990 5032 5014 5040 5019 5035 5022 5000 5001 4971 4890 4776 4708 4707 4629 4545 4452 4453 4126 4238 4351    0 3868 3867 3576 3726 2901 3082 2899 2515 1645 1644 1646 1878 2097 1648  649  646  105  106
 246  519  784 1041 1290 1531 1764 1989 2206 2415 2616 2809 2994 3171 3340 3501 3654 3799 3936 4065 4186 4299 4404 4501 4590 4671 4744 4809 4866 4915 4956 5013 5015 5031 5034 5036 5037 5023 5002 4972 4973 4891 4893 4839 4777 4709 4546 4454 4243 4355 4242 4001 3727 3866 3578 3421 3256 2902 2713 2711 2516 2712 2311 2099 1877 1412 1166  911  913  652  108
 245  518  783 1040 1289 1530 1763 1988 2205 2414 2615 2808 2993 3170 3339 3500 3653 3798 3935 4064 4185 4298 4403 4500 4589 4670 4743 4808 4865 4914 4955 4989 5030 5010 5028 5039 5038 5024 5004 4975 4936 5003 4974 4779 4710 4634 4631 4630 4244 4127 4125 4002 3869 3728 3579 3422 3257 3083 2715 2903 2517 2312 1880 2098 2100 1165 1413 1410  914  384  107
 244  517  782 1039 1288 1529 1762 1987 2204 2413 2614 2807 2992 3169 3338 3499 3652 3797 3934 4063 4184 4297 4402 4499 4588 4669 4742 4807 4864 4913 4954 4988 5012 4987 5009 5027 5007 5026 4978 5005 4938 4892 4840 4937 4548 4636 4547 4455 4247 4129 4128 4003 3870 3729 3580 3424 3258 3084 2716 2714 2518 2314 2313 1650 1649 1167 1411  654  383  385  109
 243  516  781 1038 1287 1528 1761 1986 2203 2412 2613 2806 2991 3168 3337 3498 3651 3796 3933 4062 4183 4296 4401 4498 4587 4668 4741 4806 4863 4912 4953 4986 5029 5008 4980 4903 4945 5025 4976 4977 4939 4841 4632 4780 4711 4778 4633 4550 4353 4245 4131 4005 4004 3730 3871 3086 3423 2904 2905 2717 2519 1879 2101 1651 1415 1169 1168 1170  386  653  655
 242  515  780 1037 1286 1527 1760 1985 2202 2411 2612 2805 2990 3167 3336 3497 3650 3795 3932 4061 4182 4295 4400 4497 4586 4667 4740 4805 4862 4911 4952 4985 5011 4981 4906 4946 4944 5006 4979 4940 4895 4894 4843 4712 4635 4360 4354 4457 4456 4246 4130 3873 3872 3583 3581 3425 3085 3087 2906 2718 2520 2315 2102 1881 1414 1652  916  656  915  387  388
 241  514  779 1036 1285 1526 1759 1984 2201 2410 2611 2804 2989 3166 3335 3496 3649 3794 3931 4060 4181 4294 4399 4496 4585 4666 4739 4804 4861 4910 4951 4950 4984 4983 4948 4904 4900 4902 4943 4942 4941 4896 4842 4781 4551 4458 4549 4553 4356 4357 4248 3731 3874 3584 3585 3426 3259 3260 3088 2907 2521 2316 2103 1882 1653 1416 1171  917  658  111  110
 240  513  778 1035 1284 1525 1758 1983 2200 2409 2610 2803 2988 3165 3334 3495 3648 3793 3930 4059 4180 4293 4398 4495 4584 4665 4738 4803 4860 4909 4908 4907 4905 4949 4947 4982 4850 4848 4901 4898 4846 4782 4844 4713 4637 4714 4638 4459 4358 4249 4006 3875 3732 3733 3582 3262 3261 2908 2719 2522 2523 2317 2104 1883 1417 1418 1172  918  919  657  112
 239  512  777 1034 1283 1524 1757 1982 2199 2408 2609 2802 2987 3164 3333 3494 3647 3792 3929 4058 4179 4292 4397 4494 4583 4664 4737 4802 4859 4858 4857 4856 4855 4854 4852 4793 4849 4853 4791 4899 4897 4847 4784 4783 4715 4555 4552 4251 4359 4007 4133 4008 3876 3586 3734 3264 3090 3089 2909 2318 2721 2319 2105 1654 1884 1174 1173 1655  659  389  390
 238  511  776 1033 1282 1523 1756 1981 2198 2407 2608 2801 2986 3163 3332 3493 3646 3791 3928 4057 4178 4291 4396 4493 4582 4663 4736 4801 4800 4799 4798 4797 4796 4795 4794 4792 4851 4724 4790 4788 4646 4787 4716 4786 4461 4640 4558 4361 4134 4252 4132 4009 3877 3587 3735 3427 3263 3266 2910 2720 2525 2524 2106 1885 1656 1177 1419  920  660  391  113
 237  510  775 1032 1281 1522 1755 1980 2197 2406 2607 2800 2985 3162 3331 3492 3645 3790 3927 4056 4177 4290 4395 4492 4581 4662 4735 4734 4733 4732 4731 4729 4728 4653 4727 4726 4725 4722 4647 4723 4720 4564 4845 4785 4642 4639 4554 4462 4460 4463 4010 4011 3736 3431 3428 3429 3092 3091 2911 2722 2320 2107 1887 2108 1657  921  923 1175  661  115  114
 236  509  774 1031 1280 1521 1754 1979 2196 2405 2606 2799 2984 3161 3330 3491 3644 3789 3926 4055 4176 4289 4394 4491 4580 4661 4660 4659 4658 4657 4656 4730 4654 4652 4569 4651 4649 4721 4645 4562 4789 4719 4643 4644 4556 4717 4641 4464 4364 4250 4253 4135 3878 3737 3430 3265 3588 3093 2912 2723 2526 2321 2110 1886 1421 1420  922  662  393  392  394
 235  508  773 1030 1279 1520 1753 1978 2195 2404 2605 2798 2983 3160 3329 3490 3643 3788 3925 4054 4175 4288 4393 4490 4579 4578 4577 4485 4576 4575 4573 4655 4571 4380 4570 4479 4566 4565 4650 4373 4563 4561 4560 4718 4559 4467 4363 4365 4254 4362 4136 4012 3879 3738 3589 3432 3267 3094 2913 2724 2527 2322 1888 1659 1658 1661 1179  924  663  396  116
 234  507  772 1029 1278 1519 1752 1977 2194 2403 2604 2797 2982 3159 3328 3489 3642 3787 3924 4053 4174 4287 4392 4489 4488 4487 4486 4484 4277 4574 4481 4572 4480 4273 4271 4567 4476 4474 4473 4648 4374 4472 4371 4470 4468 4465 4557 4366 4143 4258 4137 4013 3880 3739 3590 3433 3268 3095 2914 2725 2528 2323 2111 2109 1422  925 1176  926  395  118  117
 233  506  771 1028 1277 1518 1751 1976 2193 2402 2603 2796 2981 3158 3327 3488 3641 3786 3923 4052 4173 4286 4391 4390 4389 4388 4387 4386 4384 4381 4483 4383 4276 4477 4378 4268 4568 4376 4475 4375 4266 4370 4469 4263 4369 4368 4466 4259 4256 4257 4255 4139 3740 3593 3435 3434 3269 3096 2915 2726 2529 2324 1660 1891 1424 1178 1662 1423  664  120  121
 232  505  770 1027 1276 1517 1750 1975 2192 2401 2602 2795 2980 3157 3326 3487 3640 3785 3922 4051 4172 4285 4284 4283 4282 4281 4280 4279 4385 4161 4278 4482 4382 4275 4157 4478 4377 4270 4150 4269 4151 4265 4471 4372 4262 4261 4367 4145 4141 4016 4138 3881 3591 3594 3883 3270 3097 3098 2916 2727 2530 2325 1890 1426 1181 1180 1428  665  666  119  399
 231  504  769 1026 1275 1516 1749 1974 2191 2400 2601 2794 2979 3156 3325 3486 3639 3784 3921 4050 4171 4170 4169 4168 4167 4165 4164 4162 4163 4039 4160 4274 4037 3903 4034 4379 4153 4154 4030 4267 4028 3896 4149 4148 4024 4147 3890 4260 4023 4020 4014 4015 3882 4019 3592 3436 3271 3099 2917 2728 2531 2326 2112 1889 2113 1425 1182  928  927  397  122
 230  503  768 1025 1274 1515 1748 1973 2190 2399 2600 2793 2978 3155 3324 3485 3638 3783 3920 4049 4048 4047 4046 4045 4043 4166 4042 3772 4040 3908 4038 4159 4158 4272 4035 4155 4156 4031 3899 4027 4029 3895 4264 4025 3892 4146 3889 4022 4144 4142 4018 3884 3742 3741 3743 3438 3437 3272 2918 2729 2532 2327 2114 1664 1183 1184  667  669  398  400  668
 229  502  767 1024 1273 1514 1747 1972 2189 2398 2599 2792 2977 3154 3323 3484 3637 3782 3919 3918 3917 3916 3915 3775 4044 3913 3910 3909 4041 3907 3767 3906 4036 3905 3762 4033 4032 3901 3898 3759 4152 4026 3894 3893 3753 3606 3605 3750 3891 3888 4140 3885 3746 3744 3595 3439 3273 3100 2919 2730 2533 2328 1894 1663 2116 1892 1665 1429  930  929  401
 228  501  766 1023 1272 1513 1746 1971 2188 2397 2598 2791 2976 3153 3322 3483 3636 3781 3780 3779 3778 3629 3630 3774 3914 3627 3626 3911 3467 3621 3620 3768 3619 3904 3616 3902 3763 3900 3761 3758 3611 3897 3757 3755 3604 3288 3607 3603 4021 3602 3887 4017 3600 3745 3597 3596 3274 3101 2920 2731 2534 2329 2115 1896 1668 1893 1666  670  671  124  123
 227  500  765 1022 1271 1512 1745 1970 2187 2396 2597 2790 2975 3152 3321 3482 3635 3634 3633 3632 3631 3777 3474 3776 3625 3912 3773 3771 3623 3769 3770 3465 3618 3766 3764 3461 3615 3614 3760 3612 3610 3609 3452 3756 3120 3754 3752 3748 3749 3447 3747 3599 3444 3442 3443 3276 3440 3275 3102 2732 2535 2331 2330 1667 1430 1427  932  933  931  402  125
 226  499  764 1021 1270 1511 1744 1969 2186 2395 2596 2789 2974 3151 3320 3481 3480 3479 3478 3477 3476 3475 3473 3628 3472 3471 3470 3624 3622 3304 3302 3464 3765 3300 3463 3617 3462 3459 3613 3458 3456 3455 3290 3454 3291 3453 3450 3115 3286 3284 3601 3886 3281 3279 3280 3441 3277 2926 3103 2921 2733 2332 1895 2117 1897 2118 1431 1185  672  403  126
 225  498  763 1020 1269 1510 1743 1968 2185 2394 2595 2788 2973 3150 3319 3318 3317 3316 3315 3314 3313 3312 3311 3310 3309 3308 3307 3468 2769 3466 3306 3131 3301 2950 3299 3298 3460 3297 3295 3457 3123 3121 3119 3118 3608 3751 3116 3451 3449 3283 3446 3445 3110 3598 3278 3106 3107 3105 2922 2539 3104 2734 2119 1898 1669 1187 1186  934  673  404  127
 224  497  762 1019 1268 1509 1742 1967 2184 2393 2594 2787 2972 3149 3148 3147 3146 3145 3144 3143 3142 3141 3140 3139 3138 3136 3305 3469 2956 3303 3132 3133 2953 2949 3130 3128 3127 3296 3125 3294 3293 2941 2942 2939 3287 3289 2937 3114 2935 3285 3448 3282 2932 3109 2928 2740 2927 2924 2735 2538 2536 2537 2123 2120 1670 1432 1188  935  674  405  128
 223  496  761 1018 1267 1508 1741 1966 2183 2392 2593 2786 2971 2970 2969 2968 2967 2966 2965 2964 2963 2962 2961 2960 2955 3137 2958 3135 3134 2575 2952 2767 2951 2763 2948 2947 3126 2946 3124 2944 3122 3292 2755 2754 2940 2556 2750 2936 2747 3111 3112 2933 2931 2930 3108 2739 2929 2925 2128 2736 2923 2333 1901 1671 1434 1433 1189  936  675  406  129
 222  495  760 1017 1266 1507 1740 1965 2182 2391 2592 2785 2784 2783 2782 2781 2780 2779 2778 2777 2776 2775 2774 2578 2959 2772 2957 2573 2370 2954 2157 2572 2367 2569 3129 2761 2760 2759 2945 2758 2562 2943 2356 2358 3117 2752 2352 2751 2553 2934 3113 2746 2548 2745 2744 2743 2742 2131 2737 2540 2122 2121 1900 1904 1899 1436 1190  937  676  130  131
 221  494  759 1016 1265 1506 1739 1964 2181 2390 2591 2590 2589 2588 2587 2586 2585 2584 2583 2582 2581 2580 2579 2375 2773 2372 2574 2771 2765 2766 1938 2570 2568 2364 2762 2566 2565 2564 2563 2756 2757 2560 2753 2558 2559 2557 2142 2748 2555 2552 2551 2550 2347 2133 2547 2342 2741 2738 2543 2542 2337 1902 2334 2125 1435 1674 1194 1191  938  408  407
 220  493  758 1015 1264 1505 1738 1963 2180 2389 2388 2387 2386 2385 2384 2383 2382 2381 2380 2379 2378 2377 2376 2576 2577 2373 2161 2770 2371 2158 2156 2764 2365 2154 2567 2363 2362 2361 2148 2359 2147 2561 2145 2355 2354 2353 2938 2350 2749 2349 2137 1690 2344 2549 2348 2546 2544 2130 2338 2336 2124 2335 1672 2541 1437 1673 1192  939  677  678  132
 219  492  757 1014 1263 1504 1737 1962 2179 2178 2177 2176 2175 2174 2173 2172 2171 2170 2169 2168 2167 2165 2164 2163 2162 2374 2369 1941 2368 2160 1940 1939 2155 2153 1934 2152 2151 2150 2360 2149 1927 2357 2146 2144 2143 2140 2351 2554 1920 2138 2346 1457 2135 2345 2343 2545 2341 2132 1910 1911 1906 1903 1905 1439 1193 1438  940  679  681  409  410
 218  491  756 1013 1262 1503 1736 1961 1960 1959 1958 1957 1956 1955 1954 1953 1952 1951 1950 1722 1949 2166 1946 1945 1944 1943 1716 1714 1715 2159 1937 2366 1936 1935 1472 1707 1932 1931 1930 1702 1929 1928 1926 1925 1924 1921 2139 1922 1692 1919 2136 1916 1689 2134 1915 1687 1912 1683 2339 2340 1907 1680 2126 1675 1677 1676  941  680  411  134  133
 217  490  755 1012 1261 1502 1735 1734 1733 1732 1731 1730 1729 1728 1727 1726 1725 1724 1723 1948 1486 1947 1720 1483 1718 1942 1481 1712 2768 1477 1711 1710 2571 1709 1471 1933 1706 1704 1468 1703 1701 1699 1464 1698 1696 2141 1923 1459 1694 1455 1693 1918 1917 1688 1914 1452 1685 1913 1206 2127 1909 1908 1679 1678 1440 1195 1196  942  682  138  414
 216  489  754 1011 1260 1501 1500 1499 1498 1497 1496 1495 1494 1493 1492 1491 1490 1489 1488 1487 1485 1721 1719 1717 1238 1482 1480 1479 1713 1476  982 1474 1233 1708 1227 1228 1705 1469 1467 1224 1466 1700 1463 1462 1697 1461 1695 1458 1691 1215  702  703 1454  958 1210 1686 1451 1684 1446 2129 1681 1445 1202 1199 1200 1442 1197  944  943  137  139
 215  488  753 1010 1259 1258 1257 1256 1255 1254 1253 1252 1251 1250 1249 1248 1247 1246 1245 1244 1243 1242 1241 1484 1240  987 1237 1236 1478 1235 1230 1475 1232 1473 1229 1226 1470  976 1225 1223  972 1465 1222 1220 1219 1218 1460  965 1216 1214 1456 1212 1211 1453  699 1209 1448 1449 1447 1682  954 1444  952 1443 1198  948 1441  683  684  412  135
 214  487  752 1009 1008 1007 1006 1005 1004 1003 1002 1001 1000  999  998  997  996  995  994  993  992  991  990  989 1239  728  986  985  984 1234  983  981  720  980  979  978  975  977  974  973  971  970 1221  969  968  967 1217  966  964 1213  961  962  960  959  957 1207 1450  956 1203 1204  953  951  693  950 1201  688  687  945  946  415  413
 213  486  751  750  749  748  747  746  745  744  743  742  741  740  739  738  737  736  735  734  733  732  731  730  988  461  727  726  725  724  723  722 1231  721  453  718  717  716  715  714  713  712  711  710  709  708  707  706  704  963  437  701  700  698 1208  431  694  150  696 1205  154  695  691  424  690  689  947  148  136  416  140
 212  485  484  483  482  481  480  479  478  477  476  475  474  473  472  471  470  469  468  467  466  465  464  463  729  187  460  459  458  457  456  455  454  452  719  451  450  449  448  447  446  445  444  443  442  441  164  439  436  705  438  435  434  157  432  430  697  955  429  428  151  692  149  422  145  146  685  949  418  419  417
 211  210  209  208  207  206  205  204  203  202  201  200  199  198  197  196  195  194  193  192  191  190  189  188  186  462  185  184  183  182  181  180  179  178  177  176  175  174  173  172  171  170  169  168  167  166  440  165  163  162  161  160  159  433  158  156  155  427  153  426  152  425  421  423  147  420  686  143  144  142  141
