# This puzzle is unsolvable
61
   2    1    3    4    5    6    7    8    9   10   11   12   13   14   15   16   17   18   19   20   21   22   23   24   25   27  265   28   30  270  269  501  273  272   34   35   36   38   39   40   41   42   43   44   45   46   47   48   49   50   51   52   53   54   55   56   57   58   59   60   61
 240  241  242  243  244  245  246  247  248  249  250  251  252  253  254  255  256  257  258  259  260  261  262  263  264   26  267  268   29  725  723  502  271  503  274  275   37  277  278  279  280  281  282  283  284  285  286  287  288  289  290  291  292  293  294  295  296  297  298  299   62
 239  472  473  474  475  476  477  478  479  480  481  482  483  484  485  486  487  488  489  490  491  492  493  494  495  719  266  496  499   31  938   32  504   33  505  506  276  730  509  510  511  512  513  514  515  516  517  518  519  520  521  522  523  524  525  526  750  527  529  300   63
 238  471  696  697  698  699  700  701  702  703  704  705  706  707  708  709  710  711  712  713  714  715  716  717  718  497  720  498  721  939  500  724  726  727  728  729  508  507  731  733  734  735  736  737  738  739  740  741  742  743  744  745  746  747  748  749  528  751  530  301   64
 237  470  695  912  913  914  915  916  917  918  919  920  921  922  923  924  925  926  927  928  929  930  931  932  933  934  935  722  936 1145 1146  940  941  943  944  945  946 1153  732  948  949  950  951  952  953  954  955  956  957  958  959  960  961  962  963 1171  964  531  532  302   65
 236  469  694  911 1120 1121 1122 1123 1124 1125 1126 1127 1128 1129 1130 1131 1132 1133 1134 1135 1136 1137 1138 1139 1140 1141 1142  937 1144 1343 1345 1147 1148  942 1149 1150 1151 1154  947 1155 1156 1157 1158 1159 1160 1161 1162 1163 1164 1165 1166 1167 1168 1169 1170  965  753  967  752  303   66
 235  468  693  910 1119 1320 1321 1322 1323 1324 1325 1326 1327 1328 1329 1330 1331 1332 1333 1334 1335 1336 1337 1338 1339 1340 1341 1143 1534 1342 1344 1346 1347 1348 1349 1351 1152 1352 1353 1354 1355 1356 1357 1358 1359 1360 1361 1362 1363 1364 1365 1366 1367 1368 1369 1172  968  966  533  304   67
 234  467  692  909 1118 1319 1512 1513 1514 1515 1516 1517 1518 1519 1520 1521 1522 1523 1524 1525 1526 1527 1528 1529 1530 1531 1532 1716 1533 1535 1536 1537 1538 1539 1540 1350 1541 1543 1544 1545 1546 1547 1548 1549 1550 1551 1552 1553 1554 1555 1556 1557 1558 1559 1370 1173  754  534  536  305   68
 233  466  691  908 1117 1318 1511 1696 1697 1698 1699 1700 1701 1702 1703 1704 1705 1706 1707 1708 1709 1710 1711 1712 1713 1714 1715 1891 1717 1718 1719 1720 1721 1722 1723 1724 1542 1726 1727 1728 1729 1730 1731 1732 1733 1734 1735 1736 1737 1738 1739 1740 1741 1560 1371 1174  969  755  756  306   69
 232  465  690  907 1116 1317 1510 1695 1872 1873 1874 1875 1876 1877 1878 1879 1880 1881 1882 1883 1884 1885 1886 1887 1888 1889 1890    0 1892 1893 1894 2063 2062 1896 1898 1899 1725 1901 1902 1903 1904 1905 1906 1907 1908 1909 1910 1911 1912 1913 1914 1915 1742 1561 1372  970  971  535  537  307   70
 231  464  689  906 1115 1316 1509 1694 1871 2040 2041 2042 2043 2044 2045 2046 2047 2048 2049 2050 2051 2052 2053 2054 2055 2056 2057 2058 2059 2060 2061 1895 2223 2065 2374 2066 1900 2068 2069 2070 2071 2072 2073 2074 2075 2076 2077 2078 2079 2080 2081 1916 1743 1562 1373 1175  757  538  308  309   71
 230  463  688  905 1114 1315 1508 1693 1870 2039 2200 2201 2202 2203 2204 2205 2206 2207 2208 2209 2210 2211 2212 2213 2214 2216 2367 2217 2218 2219 2220 2221 2064 1897 2225 2226 2067 2227 2228 2229 2230 2231 2232 2233 2234 2235 2236 2237 2238 2239 2082 1917 1744 1563 1177 1176  760  972  539   72   73
 229  462  687  904 1113 1314 1507 1692 1869 2038 2199 2352 2353 2354 2355 2356 2357 2358 2359 2360 2361 2362 2363 2364 2365 2215 2510 2509 2368 2370 2371 2372 2222 2516 2224 2376 2377 2378 2379 2380 2381 2382 2383 2384 2385 2386 2387 2388 2389 2240 2083 1918 1745 1565 1374 1375  973  758  761   75  540
 228  461  686  903 1112 1313 1506 1691 1868 2037 2198 2351 2496 2497 2498 2499 2500 2501 2502 2503 2504 2505 2506 2507 2508 2645 2644 2511 2369 2513 2514 2650 2373 2517 2375 2519 2520 2521 2522 2523 2524 2525 2526 2527 2528 2529 2530 2531 2390 2241 2084 1919 1746 1376 1564 1178  974  759  541   74  310
 227  460  685  902 1111 1312 1505 1690 1867 2036 2197 2350 2495 2632 2633 2634 2635 2636 2637 2638 2639 2640 2641 2642 2643 2772 2647 2512 2648 2776 2649 2651 2515 2652 2518 2654 2655 2656 2657 2658 2659 2660 2661 2662 2663 2664 2665 2532 2391 2242 2085 1920 1747 1566 1379 1377 1179  762  312  311   76
 226  459  684  901 1110 1311 1504 1689 1866 2035 2196 2349 2494 2631 2760 2761 2762 2763 2764 2765 2766 2767 2768 2769 2770 2366 2771 2646 2774 2775 2894 2777 2778 2779 2653 2782 3013 2783 2784 2785 2786 2787 2788 2789 2790 2791 2666 2533 2392 2243 2086 1921 1748 1567 1181 1378 1180  975  763  542   77
 225  458  683  900 1109 1310 1503 1688 1865 2034 2195 2348 2493 2759 2758 2880 2881 2882 2883 2884 2885 2886 2887 2888 2889 2890 2891 2773 2893 2895 3005 2896 3009 3010 2780 2899 2781 2901 2903 2904 2905 2906 2907 2908 2909 2792 2667 2534 2393 2088 2087 1922 1749 1568 1183  765  977  543  544  313  314
 224  457  682  899 1108 1309 1502 1687 1864 2033 2194 2347 2492 2630 2491 2879 2992 2993 2994 2995 2996 2997 2998 2999 3000 3001 3002 2892 3003 3004 3109 3006 2897 2898 3008 2900 3012 2902 3014 3015 3016 3017 3018 3019 2910 2793 2668 2535 2394 2244 2245 1923 1570 1750 1380 1182  976 1184  545  315   78
 223  456  681  898 1107 1308 1501 1686 1863 2032 2193 2346 2628 2490 2629 2878 2991 3096 3097 3098 3099 3100 3101 3102 3103 3104 3105 3106 3107 3108 3292 3007 3110 3112 3206 3011 3115 3116 3117 3118 3119 3120 3121 3020 2911 2794 2669 2536 2246 2396 1925 1751 1752 1569 1381  979  978  764  317  316   79
 222  455  680  897 1106 1307 1500 1685 1862 2031 2192 2345 2627 2757 2486 2756 2990 3095 3192 3193 3194 3196 3283 3197 3199 3285 3200 3201 3202 3203 3205 3294 3207 3113 3111 3209 3210 3211 3212 3214 3301 3215 3122 3021 2912 2795 2670 2537 2395 2248 2090 2089 1926 1571 1382 1185  980  766  768  318   80
 221  454  679  896 1105 1306 1499 1684 1861 2030 2344 2489 2626 2874 2754 2989 2876 3094 3191 3281 3195 3362 3284 3363 3198 3286 3288 3367 3290 3440 3371 3204 3295 3208 3296 3114 3297 3298 3299 3213 3379 3216 3123 3022 2913 2796 2671 2538 2397 2091 2247 1927 1572 1754 1383 1186  981  767  547  546   81
 220  453  678  895 1104 1497 1304 1498 1859 1860 2191 2190 2624 2755 2752 2877 3093 3190 3189 3280 3282 3360 3432 3364 3365 3366 3287 3438 3289 3293 3369 3372 3443 3373 3374 3375 3376 3377 3378 3300 3302 3217 3124 3023 2914 2798 2797 2672 2539 2092 1924 1753 1755 1573 1187  982  769  548  319  320   82
 219  452  677  894 1103 1305 1683 1681 1682 2028 2029 2189 2488 2625 2875 2987 2988 3091 3092 3278 3279 3361 3433 3434 3497 3436 3501 3500 3368 3441 3291 3370 3442 3444 3445 3446 3447 3448 3449 3380 3303 3219 3218 3024 2915 2799 2673 2540 2398 2249 1929 1928 2093 1574 1385 1386  984  983  770  549   83
 218  451  676  893 1102 1303 1495 1858 2027 2188 2342 2340 2487 2341 2753 2751 2986 3090 3188 3277 3359 3431 3496 3498 3435 3499 3437 3502 3439 3503 3504 3505 3506 3507 3508 3509 3510 3511 3450 3381 3305 3304 3125 3126 3025 2916 2674 2400 2250 2399 2251 1576 1756 1188 1190 1384 1189  551  322  550   84
 217  450  675  892 1101 1302 1680 1496 1857 2026 2187 2186 2343 2623 2873 2750 2872 3187 3276 3357 3358 3430 3495 3552 3553 3554 3555 3556 3557 3558 3559 3560 3561 3562 3563 3564 3565 3512 3451 3382 3306 3220 3127 3026 2917 2801 2800 2541 2401 2252 2094 2095 1930 1575 1387  985  986  771  552   85  321
 216  449  674  891 1100 1301 1494 1678 1679 2023 2025 2484 2485 2622 2621 2984 2985 3089 3186 3275 3356 3429 3494 3551 3600 3601 3602 3603 3604 3605 3606 3607 3608 3609 3610 3611 3566 3513 3452 3383 3307 3221 3128 3028 3027 2675 2676 2402 2253 2542 2096 1931 1757 1577 1388 1191  987  773  772  323   86
 215  448  673  890 1099 1300 1493 1676 1856 1855 2024 2339 2483 2620 2870 2871 2983 3088 3185 3274 3355 3428 3493 3550 3599 3640 3641 3642 3643 3644 3645 3646 3647 3648 3649 3612 3567 3514 3453 3384 3308 3222 3129 2920 2918 2677 2544 2543 2403 2254 2097 1932 1758 1389 1192  988  989  774  553  324   87
 214  447  672  889 1098 1299 1492 1853 1854 2185 2184 2183 2338 2337 2749 2869 2982 3087 3184 3273 3354 3427 3492 3549 3598 3639 3672 3697 3673 3674 3676 3677 3678 3679 3614 3650 3613 3515 3454 3385 3223 3224 3130 2919 3029 2678 2803 2545 2404 2255 2098 1933 1578 1760 1579 1193 1194  775  554  325   88
 445  213  671  888 1097 1298 1491 1675 1677 2021 2022 2482 2748 2747 2619 2868 2981 3086 3183 3272 3353 3426 3491 3548 3597 3638 3671 3698 3675 3720 3699 3700 3681 3702 3701 3680 3568 3516 3455 3309 3386 3225 3131 3030 2802 2921 2679 2546 2405 2256 2099 1934 1759 1580 1390 1391  776  777  555  326   89
 446  670  887 1096 1297 1296 1490 1674 1852 2182 2334 2336 2618 2481 2745 2867 2746 2980 3182 3271 3352 3425 3490 3547 3596 3637 3670 3696 3712 3711 3713 3682 3715 3652 3651 3618 3569 3615 3517 3456 3310 3132 3031 2922 2804 2680 2681 2547 2548 2257 2100 1935 1761 1762 1392 1196 1195  990  556  327   90
 212  444  669  886 1095 1294 1489 1851 1850 2020 2181 2478 2617 2480 2866 2977 3084 3085 3181 3270 3351 3424 3489 3546 3595 3636 3669 3695 3710 3714 3707 3718 3703 3684 3653 3571 3616 3617 3387 3311 3226 3312 3227 3032 2923 2805 2407 2549 2406 2258 2101 1936 1763 1581 1582 1197  991  778  557  328   91
 211  210  443  885 1094 1092 1293 1673 2019 2179 2180 2479 2616 2614 2744 2865 2979 3083 3180 3269 3350 3423 3488 3545 3594 3635 3668 3694 3719 3709 3716 3705 3708 3717 3683 3654 3572 3570 3518 3388 3389 3034 2924 3033 2807 2808 2806 2408 2409 2259 2102 1937 1764 1584 1393 1394  992  779  558  329   92
 209  442  668  667  884 1295 1488 1487 1849 2018 2332 2333 2615 2335 2743 2864 2978 3082 3179 3268 3349 3422 3487 3544 3593 3634 3667 3692 3693 3688 3661 3655 3704 3623 3656 3619 3520 3519 3457 3458 3459 3313 3134 3136 2809 2925 2682 2683 2550 2260 2103 1938 1765 1395 1583 1198  993  780  559  330   93
 208  441  666  883 1093 1671 1848 1847 1846 2017 2178 2331 2477 2612 2742 2863 2976 3081 3178 3267 3348 3421 3486 3543 3592 3633 3666 3691 3689 3663 3625 3687 3706 3685 3620 3657 3574 3573 3392 3393 3229 3133 3228 3035 2926 3135 2684 2410 2411 2261 2104 1939 1766 1585 1396 1199  994  781  560  331   94
 207  440  665  882 1091 1292 1486 1672 2015 2177 2330 2329 2613 2476 2741 2862 2975 3080 3177 3266 3347 3420 3485 3542 3591 3632 3665 3664 3628 3690 3662 3660 3582 3659 3622 3576 3523 3521 3461 3391 3231 3230 3316 3036 2927 2685 2687 2552 2551 2263 2262 1940 1767 1586 1397 1200  995  782  561  332   95
 206  439  664  881 1090 1291 1670 1485 2016 1669 2176 2328 2475 2611 2740 2861 2974 3079 3176 3265 3346 3419 3484 3541 3590 3631 3630 3629 3627 3584 3531 3626 3686 3621 3575 3390 3526 3525 3658 3394 3314 3315 3137 3037 2928 2810 2812 2412 2414 2105 2106 1941 1768 1587 1398 1201  996  783  562  333   96
 205  438  663  880 1089 1290 1484 1483 1845 2014 2175 2473 2474 2610 2739 2860 2973 3078 3175 3264 3345 3418 3483 3540 3589 3588 3587 3586 3585 3533 3583 3404 3579 3580 3529 3522 3578 3463 3460 3462 3317 3232 3138 3139 2931 2813 2553 2686 2413 2265 2264 1942 1769 1588 1399 1202  997  784  563  334   97
 204  437  662  879 1088 1289 1667 1668 1844 2013 2174 2472 2471 2609 2738 2859 2972 3077 3174 3263 3344 3417 3482 3539 3538 3537 3536 3535 3534 3532 3473 3471 3581 3624 3470 3577 3527 3524 3464 3395 3318 3233 3041 3038 3039 2930 2929 2811 2554 2415 2107 2108 1770 1589 1400 1203  998  785  564  335   98
 203  436  661  878 1087 1481 1482 1666 2012 1842 2173 2327 2737 2608 2736 2858 2971 3076 3173 3262 3343 3416 3481 3480 3479 3478 3477 3476 3475 3474 3406 3530 3469 3528 3402 3468 3467 3466 3465 3397 3396 3234 3140 3141 3040 2814 2688 2555 2690 2266 2267 1943 1772 1771 1401 1204  999  786  565  336   99
 202  435  660  877 1086 1288 1480 1843 1665 1840 2322 2326 2469 2735 2470 2857 2970 3075 3172 3261 3342 3415 3414 3413 3412 3411 3410 3409 3332 3249 3407 3472 3405 3403 3401 3326 3325 3400 3399 3398 3319 3235 3042 3236 2932 2815 2557 2556 2416 2268 2109 1944 1945 1590 1402 1205 1000  787  566  337  100
 201  434  659  876 1085 1287 1286 1479 2011 1841 2325 2167 2172 2468 2734 2856 2969 3074 3171 3260 3341 3340 3339 3338 3337 3336 3335 3334 3408 3250 3331 3330 3329 3328 3327 3242 3324 3239 3148 3149 3320 3043 3142 3143 2816 2691 2689 2417 2558 2111 2110 1946 1773 1591 1403 1206 1001  788  567  338  101
 200  433  658  875 1084 1285 1478 1664 1663 2010 2323 2009 2171 2607 2733 2855 2968 3072 3073 3259 3258 3256 3166 3255 3254 3252 3251 3159 3060 3333 3248 3246 3156 3245 3054 3244 3240 3241 3150 3321 3238 3323 3144 3145 2933 2817 2692 2559 2418 2112 1947 1774 1593 1592 1404 1207 1002  789  568  339  102
 199  432  657  874 1083 1284 1477 1661 1662 2169 2170 2008 2606 2605 2603 2853 2854 3168 3170 3169 3167 3067 3257 3165 3163 3162 3253 3161 3160 3158 3157 3247 3155 3154 3153 3243 3151 3051 3322 3147 3146 3237 3044 2934 2935 2818 2693 2560 2419 2269 2113 1948 1775 1594 1405 1208 1003  790  569  340  103
 198  431  656  873 1082 1283 1476 1660 1839 2318 2324 2319 2168 2321 2467 2852 2966 2848 3070 3069 2961 3068 2955 3065 2957 2841 3064 2839 3061 3059 3058 3057 3056 3052 2947 3152 2944 2942 2827 3048 2940 3046 3045 2938 2936 2694 2695 2561 2420 2270 2114 1949 1776 1595 1406 1209 1004  791  570  341  104
 197  430  655  872 1081 1282 1475 1659 1838 2007 2465 2850 2466 2464 3071 2728 2732 2731 2964 2962 2963 2846 2960 2589 2958 2842 3063 3062 2954 2952 2950 2949 2948 3055 2945 2946 2943 3050 2706 3047 2825 2941 2939 2823 2937 2819 2696 2562 2421 2271 2115 1950 1777 1596 1407 1210 1005  792  571  342  105
 196  429  654  871 1080 1281 1474 1658 2006 1837 1836 2320 2730 2604 2602 2851 2729 2597 2725 2849 2722 3066 3164 2956 2719 2840 2586 2953 2837 2835 2714 2951 2834 2833 2832 3053 2831 2705 2572 3049 2704 2826 2700 2822 2821 2820 2563 2697 2273 2272 2116 1951 1778 1597 1408 1211 1006  793  572  343  106
 195  428  653  870 1079 1280 1473 1835 1833 1834 2005 2601 2165 2967 2463 2600 2596 2965 2724 2453 2847 2845 2844 2590 2720 2715 2717 2444 2836 2583 2713 2582 2712 2710 2709 2708 2829 2830 2828 2574 2703 2702 2824 2569 2699 2698 2567 2423 2422 2274 2117 1952 1779 1598 1409 1212 1007  794  573  344  107
 194  427  652  869 1078 1279 1655 1656 2317 1470 2164 2003 2163 2166 2462 2599 2458 2457 2591 2723 2593 2592 2843 2959 2448 2718 2300 2585 2445 2838 2297 2294 2711 2579 2439 2577 2576 2707 2575 2433 2573 2571 2701 2430 2568 2428 2564 2565 2424 2275 2118 1953 1780 1599 1410 1213 1008  795  574  345  108
 193  426  651  868 1077 1278 1657 1832 1471 2001 2162 2315 2159 2460 2598 2726 2310 2727 2455 2456 2307 2149 2721 1988 2588 2449 2587 2451 2447 2299 2442 2581 2295 2293 2440 2438 2578 2436 2434 2435 2285 2431 2570 2283 2282 2429 2566 2426 2425 2276 2119 1954 1781 1600 1411 1214 1009  796  575  346  109
 192  425  650  867 1075 1076 1277 2004 1831 2002 1998 2158 2461 2313 2459 2311 2309 2454 2595 1455 1987 2594 2303 2450 2147 2301 2716 2298 1633 2446 2443 2584 1977 2140 2292 2291 2437 2289 2288 2286 2131 2432 2129 2130 2128 2126 2427 2280 2278 2277 2120 1955 1782 1601 1412 1215 1010  797  576  347  110
 191  424  649  866 1274 1469 1472 1654 1829 2316 1653 2161 2314 2312 1996 2155 1257 2153 2304 2308 1641 2452 2305 2302 1815 2148 2146 1982 1981 1978 1979 2296 2139 2441 2137 2136 2290 2135 2134 1968 2132 1967 1795 1964 1963 2127 2125 2124 2123 2121 1958 1956 1783 1602 1413 1216 1011  798  577  348  111
 190  423  648 1074 1276 1275 1468 1830 1827 1649 1997 1999 1825 1824 1991 1993 1642 1639 1818 2151 2150 1986 1637 1051 1985 2145 1812 2143 2144 2142 1976 1806 1627 2580 2138 1973 1972 1971 2133 2287 1966 2284 1616 1965 1792 2279 2281 1961 1960 2122 1787 1957 1784 1603 1414 1217 1012  799  578  349  112
 189  422  647  865 1072 1467 1652 1828 2000 2160 1648 1995 1461 1826 2157 2156 1820 1059 2154 1817 1990 1989 1635 1449 1983 1813 1810 1630 1629 1808 2141  612 1975 1804 1974 1623 1803 1800 1970 1969 1799 1797 1615 1617 1793 1962 1791 1790 1959 1789 1608 1786 1785 1604 1415 1218 1013  800  579  350  113
 188  421  646  862  864  863 1466 1463 1465 1462 1647 1460 1458 1822 1994 1644 1821 1452 1451  622 1638 1636 1634 1814 1445 1448 1984 1249 1811 1628 1805 1440 1439 1624 1437 1802 1801 1621 1433 1798 1619 1794 1796 1618 1614 1613 1425 1612 1611 1788 1421 1607 1606 1605 1416 1219 1014  801  580  351  114
 187  420  645  861 1272 1073 1067 1269 1267 1268 1264 1646 1459 1823 1454 1643 1456  852 1453 2306 1046 1255 1631 1049 1252 1446 1045 1809 1980 1442 1626 1807 1625 1243 1040 1240 1622 1435 1238 1432 1431 1430 1429 1428 1427 1426 1230 1424 1610 1609 1227 1420 1419 1418 1417 1220 1015  802  581  352  115
 186  419  860  859 1070 1071 1271 1464 1270 1266 1650 1265 1645 1055 1992  628  624 2152  627 1260 1258 1256 1816 1253 1050  619  833  615 1443  831 1441 1246  829 1438 1242 1241 1037 1620 1035 1237 1236 1235 1234 1233 1232 1231 1229 1423 1228 1226 1422 1225 1224 1223 1222 1221 1016  803  582  353  116
 185  418  643  644 1069 1273  857 1066 1651 1064 1063 1062  851 1263  847 1058 1819 1262 1261 1259 1640 1053  842 1250 1048 1447 1044 1444 1632 1042  387 1245  830 1244 1039 1038 1239 1434 1036 1034 1033 1032 1031 1030 1029 1028 1027 1026 1025 1024 1023 1022 1021 1020 1019 1018 1017  804  583  354  117
 184  417  640  641 1068  858  856  410 1065  850  634  849 1061  631 1457 1057  845  165  400 1054  397 1450  840  392 1251  835 1047 1043 1248  838  156  613  614 1041  828  827 1436  826  825  823  822  821  820  819  818  817  816  815  814  813  812  811  810  809  808  807  806  805  584  355  118
 183  416  639  638  642  637  855  175  854  853  406  172  632  405  401  398  168  626  163  844 1254  623  839  841  620  158  836  155  616 1247  611  150  384  610  609  608  607  605  824  604  603  602  601  600  599  598  597  596  595  594  593  592  591  590  589  588  587  586  585  356  119
 181  414  180  413  178  176  174  408  636  171  409  169  848  170  166  629  167  843  162  625  846  621  394  837  618  390  832  617  152  154  386  385  149  382  147  381  379  606  378  377  376  375  374  373  372  371  370  369  368  367  366  365  364  363  362  361  360  359  358  357  120
 415  182  179  177  411  412  635  407  402  173  633  630  403  404  399 1060  164 1056  161 1052  396  160  395  157  159  393  391  389  388  153  834  151  148  383  146  145  380  144  143  142  141  140  139  138  137  136  135  134  133  132  131  130  129  128  127  126  125  124  123  122  121
