# This puzzle is unsolvable
23
 88 172 239   3 243 242  89 175  92  97  99 100  13  15  16 104 185 321 105 187  21  26  23
  1   5 167  90   4   6  93 176   9  94  98 174  12 102 183  17  19 107 108 318 110  28 109
 87 166   0 241  95   7 173   8 309  11 178 177  14 180 254  18 316  20 106 193 186 114 111
 86  85   2 170 169  91 244 171  96  10 246 312 251 101 182 317 418 103 255 259 260  24 257
 83 236 165 168 304 360 240 245 248 247 308 412 250 525 367 249 252 184 422 121 253  22 189
 84  82 237 361 362 306 307 365 310 517 311 314 179 315 372 112 371 417 487 375  25 419 194
238  79 303 305 408 448 411 402 481 364 313 483 509 370 320 456 374 323 263 188 256 258 116
163 302 447 407 358 406 410 363 409 505 366 413 486 489 506 485 369 261 196 115 190 264  27
 81 162 234 359 404 449 450 504 414 415 453 455 508 421 420 118 373 416 460 192 379 191 322
233 299 353 298 403 356 295 480 446 527 452 515 458 368 522 424 457 461 325 195 319  29 324
 78 301 155 300 354 296 355 479 482 526 478 484 511 510 423 488 378 181 454 113  34 266 262
159  80 443 444 164 351 161 498 466 477 523 451 445 467 490 425 327 376 269 265  37 267  33
229 230 158 235 357 297 405 440 474 500 475 459 528 507 512 491 496 426 326 199 120 119 377
160 232 228  76 437 231 400 473 521 524 442 469 381 492 495 329 430 117  35 462  36  30  31
 77  75 293 294 441 347 401 395 471 352 514 516 520 497 464 494 513 380 268 198 123  32  38
157  72 225 292 350 348 397 438 502 501 476 470 339 493 465 328 197 463 382 383 122 124 330
 74 156 227 346 149 399 283 342 343 279 519 435 433 388 429 385 427 386 331 200 270  39 126
154 151 153 344 284 499 398 394 431 472 518 341 468 432 428 336 208 384 333 203 201 202  40
 73 224 289 396 290 285 349 147 436 282 392 434 389 138 387 337 276 332 209 271 273 125 334
 67  71 220  69 219 226 439 143  59 503 391 340 338 281 212 211 275 335 272 204 127  41  42
152  70  62 291 222 393 345  60 286 215 144 214 213 210 135 136 278  50 207 274 206 128  44
223  68  64 150 218 221 217  63 141 216  57 137 140 280 139  52 277 132 131 130 205  43 129
 66  65 148 145 288 146 287  61  58 142 390  56  55  54  53  51 133 134  49  48  47  46  45
