# This puzzle is unsolvable
20
 77 145   2  79  78 206   7  83  10 151  85  89 156  87  92  16 160  17  93  20
207 147  76   1   8   4  80 257   5  13   9 157  15  90 267  14  18  94  95 163
143 205  74   3  81 387  12 262  88 155 210  84  86 341 217  91 221  97  22  19
303 204  73   6 254 148 337 263  11 211 209 264 214 215 159 218 220  23  21  29
200 302 144 258  72  82 150 146 352 366 393 306 212  26 216 161 158  27  24 162
140  75 136 253 301 261 149 346 385 342 152 269 399 309 310  98 369 266  96  99
202  71 142 256 260 203 362 382 304 340 208 154 388 332 308 307 265 222 164  28
138 201 139 197 141 299 298 395 361 213 365 367 338 268 153 312 270 219 165  30
 70  69 137 296 255 300 345 252 259 339 396   0 311 389 313 344  33 271 168 167
 67 297 251 198 328 336 364 363 377 383 368 381 225 275 172 276 273 100  25 315
 68 199 335 134 249 124 326 305 378 272 373 392 343 350 169 101 274 371 224 102
196  65 359 295 372 294 293 384 357 334 370 320 397 351 386 348 166 109  31 107
 66  64 135 194 289 248 285 360 331 324 376 379 226 398 227 314 170 223  32 103
132  62 193 246 250 247 288 284 333 322 391  44 347 374 390 233 230 104 228 105
 63 195 192 292 131 327 380 286 236 240 349 321 281 316 318 173 277 178 280  34
133  60 130 358 330 287 356 183 329 319 113 234 282 354  42 231 171  38 279 108
291  57  61 290 126 325 243 394 323 184 283 241 375  43 232 174 114  40 229  36
 56  55  58 127 125 189  53 186  50 123 238 239 355 278 180 110 115  46 111  41
129 245 244  59 190 120  49  51 122  48 121 182 177 176 353 175  39  45  37 112
128 187 188  52 191  54 185 118 242 117 181 179 235  47 116 237 119 106 317  35
