# This puzzle is unsolvable
9
76 10 34 54 58 29 38 18 42
33 41  9 12 39  0 17 65 74
 4 27 60  3 55 24 66 63 67
22 32 51 69 78 11 53 75 28
31 23  8 49 71 62 16 14 68
36 57 25  6 15 50  5 64 59
 2 21 70 56 43 35 26 20 37
72 61 80 44  1 79 30 47 19
77 40  7 45 46 52 73 13 48
