# This puzzle is unsolvable
19
130 138   3   2 335 312 139  10  77 201  79 142  82 202  15  19 149 252  16
141  73 194   5 243 196  76  71 245 144  12  86  13  14 206  90  85  21  88
133   6 336 136   4  75 281 317   8  80   7  83 199  92   0  87 204  18  24
189  72 140  74 137 283  78 198 244  84  81 246 148 248 254  22  89  20  93
 69 191 190   1  11 241 145 313 286 337 253 197 247 205 150 209 255  17 151
134 135  63  70 314 192 242 143 200 289 338 342 291 251 153 288 152  23  91
193  66 132 195 188 237 284 308 279 287 290 340 292 322  94 154  26 157 295
239 234 238 347 339 307 352 311 282 341 257 146 351 249 211  95 159  96  25
186  67 187  68 278   9 273 343 315 344 353 147 155 320 318 250  29 208 207
 65 303 236 280 240 309 333 359 346 354 263 316 345 319 203 213 158  28 214
178 129 127  61 276 124 355 275 349 356 293 328 298 285 215 261 264 156 259
 64 131 235 274 331 305 306 334 310 325 304 360 212 357 216 294 100 160  98
 59 184 185 233 126 183 350 223 163 113 299 161 324 103 112 358 101 165 256
177 230 119 181 125 232 174  49  45 329 277 327 162 321 102  99  27  30 210
123 180  62 128 229 172 226 268  47 300 265 348 296 260 258  41  97  31 323
 57  60 182 117 272 332 228 115 326 222 267 110 171 169 266  34  33  32 217
179  58 121 118  52 271 227 221 301 176 302 224  42  36 168 108 167  44  38
 56 120 231 122  51 269  43 116 170 330 262 219 111 297 218 109 105  39  35
 54  55 225  53 173 175 270  50 114  48  46 164 220  40 106  37 166 104 107
