# This puzzle is unsolvable
35
 139  135  265  266    3  269  787  389  501   10  146   11   15  151    9   16  153  155   18   20  156   21   23   24   25   26   27   28   29   30   31   32   33   34   35
   1    2  141    0  383  500  267  144    7  270   12  395  394  599   14  150  279   17  152  281   19   22  158  159  160  161  162  163  164  165  166  167  168  169   36
 136  264  134  143  387    5  271  268    8  273  275  495  147  277  149  278  398  154  399  282  283  157  285  286  287  288  289  290  291  292  293  294  295  170   37
 138    4    6  385  137  697  388  142  865  274   13  145  608  148  505  400  509  510  280  401  513  284  404  405  406  407  408  409  410  411  412  413  296  171   38
 263  261  381  140  696  602  498  384  503  705  272  391  604  506  396  397  507  611  511  512  403  402  515  516  517  518  519  520  521  522  523  414  297  172   39
 262  133  494  496  497  493  601  939  606  698  504  392  790  792  791  610  612  613  614  615  616  514  617  619  620  621  622  623  624  625  524  415  298  173   40
 260  598  382  380  257  862  782  699  694  784  502  276  871  508  607  706  707  708  709  710  711  712  618  714  715  716  717  718  719  626  525  416  299  174   41
 258  132  129  499  130  390  605  702  393  936  701  700  703  609 1005  793  794  795  796  797  798  799  713  801  802  803  804  805  720  627  526  417  300  175   42
 378  131  386  259  489  786  863  866  934  781  785  867  789  870  704  872  873  874  875  876  877  879  800  880  881  882  883  806  721  628  527  418  301  176   43
 379  128  377  783  693  603  695  692  868  937  869  935  788  940  942 1006  944  945 1010  947  948  878  949  950  952  953  884  807  722  629  528  419  302  177   44
 593  254  255  376  691  596  861  256  932  933  999 1001 1004  938 1060 1007  943 1008  946 1065 1116 1066 1013  951 1014  954  885  808  723  630  529  420  303  178   45
 127  492  488  595  690  600  594  864  998  780 1000 1003  941 1002 1061 1108 1062 1063 1009 1064 1111 1012 1068 1016 1015  955  886  809  724  631  530  421  304  179   46
 126  121  485  375  491  597  776  689  778 1054  859 1055 1058 1059 1106 1107 1109 1110 1150 1113 1011 1067 1114 1018 1017  956  887  810  725  632  531  422  305  180   47
 371  487  373  372  777  592  997  996 1056 1053 1144 1057 1104 1145 1146 1147 1148 1180 1112 1183 1153 1115 1069 1022  957  958  888  811  726  633  532  423  306  181   48
 123  253  125  374  486  779  856  860  858 1102 1103 1143 1105 1176 1177 1178 1179 1149 1152 1154 1118 1019 1071 1074 1070  959  889  812  727  634  533  424  307  182   49
 251  124  252  484  490  931  688  929  993  928 1052 1101 1142 1175 1200 1201 1202 1181 1203 1182 1157 1186 1020 1117 1072  890  960  813  728  635  534  425  308  183   50
 118  122  483  370  588  687  775  855  994  992 1051 1100 1174 1199 1198 1216 1217 1219 1204 1151 1184 1119 1155 1075  963 1023  892  891  814  636  535  426  309  184   51
 120  589  683  591  586  590  685  857  995  927 1099 1140 1141 1173 1215 1223 1214 1218 1206 1185 1205 1123 1021 1076  961 1122  815  817  731  729  536  427  310  185   52
 481  247  366  587  250  367  773  772  682 1049 1050 1097 1098 1139 1172 1213 1196 1224 1220 1207 1187 1156 1158 1160 1120 1073  893  895  637  638  537  311  312  186   53
 686  119  117  249  246  680  853  854  930  991 1048 1096 1138 1171 1197 1194 1211 1222 1191 1208 1159 1189 1124 1077  894  730  964  734  732  538  429  428  187  188   54
 368  116  681  482  850  684  852  769  925  926  990 1047 1137 1170 1195 1167 1212 1221 1210 1190 1192 1188 1125 1121 1026 1079  962  819  639  641  818  430  314  313   55
 248  245  243  774  244  585  923  584  770  989 1046 1095 1134 1136 1169 1166 1193 1129 1034 1087 1162 1161  967 1082 1081  897  733  969  539  640  540   57  431   56   58
 114  115  771  369  480  768  583  851  924  988 1044 1093 1094 1133 1168 1088 1164 1024 1131 1128 1126 1027 1083 1030 1080  735  816 1028  966  823  543  432  315  190  191
 364  365  477  478  475  476  479  363  985 1045  987 1042 1092 1089 1090 1132  978  911 1163 1035 1209 1085 1031  965  820 1025  736  821  896  737  542  541  644   59  189
 242  241  113  581  474  677  921  679  922  984 1043  982 1135 1040 1091  913  977 1036 1165 1086  974  973 1033 1078  898  968  902 1029  738  642  643  436  433  434   62
 112  240  360  580  678  676  847  849  848  986  917  916 1041  981  980 1038 1039 1037  909 1084 1130  908 1032  829  900  971  899  651  545  645  544  547  194  316   63
 362  110  578  675  361  766  582  767  920  670  842  758  983  915  914  979  837  912 1127  835  749  907  970  828  972  744  901  824  739  822  437  435   60  192  319
 111  239  473  579  764  765  674  846  759  918  760  668  840  839  838  754  910  975  976  751  832  747  831  746  903  654  439  647  653  546  195  193  646  196  320
 109  359  472  576  577  574  353  844  843  761  841  757  756  755  753  836  752  833  834  560  657  904  906  554  827  742  826  740  197  648  650  438  318   65   61
 107  238  355  106  471  468  349  762  845  919  667  569  665  664  663  662  660  561  659  559  750  557  555  905  745  553  743  825  741  652  548  201  550  200  321
 108  354  575  357  672  763  673  467  463  571  572  567  666  566  565  564  563  661  453  215  748  830  449  558  655  331  552  551  443   77  323  324  549  317  325
 358  235  234  469  230  470  671  669  351  570  461  568  347  460  458  457  456  562  339  455  454  658  448  212  334  446  556  328  329  204  442  649  199   66   64
 104  356  236  100  573  352  229  466  464  465  348  346  343  459  220  342  341  340  217  214  337  450  335  338   79   80  208  211  444  445  441  205  327  202  322
 237  105  233  231   98   96   94  228  226  462  344  223  345  222  221  219  218   86  216  452   83  336  656  451  210  447  330   76  332   71   73  440   72   68  198
 232  102  103  101   99   97  227  350  225   95  224   93   92   91   90   89   88   87   85   84  213   82  209   81   78  333  207   75  206   74   70   69   67  326  203
