# This puzzle is unsolvable
9
61 62 14 25  3 68  4 75 38
42 27 29 37 53 64  5 17 18
69 50 73 72 36 15 60 77 46
55 58 11 19  1 79 23 78  7
28 45 30 32 33 41 67 34 31
26 24 54 59 43 35 76 39 65
51 49 10  2 20 57 71 66 16
63 22 12 48 80  6 47 74 56
44  9 52 70 13 21 40  8  0
