# This puzzle is unsolvable
48
   2    1    3    4    5    6    7    8    9   10   11   12   13   14   16  203   17   18   19  386   20  208  211  209   23   25   27   28   29   30   31   32   33   34   36   37   38  223   39   40   41   42   44   43  580   45   47   48
 188  189  190  191  192  193  194  195  196  197  198  199  200  201   15  381  204  205  206  207   22  559   21   24  213   26  214  215  216  217  218  219  220  221  222   35  403  228  404  408  230  583  409  411  231   49  233   50
 187  368  369  370  371  372  373  374  375  376  377  378  379  380  202  553  382  385  557  210  387  389  723  212  562  392  393  394  395  396  397  398  399  571  738  227  225  224  577  740  576  229  581  582   51   46  412  235
 186  367  540  541  542  543  544  545  546  547  548  549  550  551  552  554  717  383  556  558  388  724  560  722  390  563  564  728  565  566  569  570  734  401  402  735  573  406  739  741  407  578  579 1182  410  241  240  414
 185  366  539  704  705  706  707  708  709  710  711  712  713  714  715  716  555  384  719  720  721  561  391 1025  725  726  882  727  567  730  568  732  733  889  400  572  226  892  575 1041  742 1043  232  896  413  237   54  234
 184  365  538  703  860  861  862  863  864  865  866  867  868  869  870  871  872  718  874  876 1023  878  879 1164 1027  880  881  883  729  731  885  887 1034 1036  890  737 1038  897 1178  405  746 1183  585  899  743   52  236   53
 183  364  537  702  859 1008 1009 1010 1011 1012 1013 1014 1015 1016 1017 1018 1019  873 1021  875  877 1162 1163 1026 1028 1029 1168 1031  884 1033 1032 1173  888 1175  736  891 1040  574 1435  894 1180 1042  747  416  898  417  586  584
 182  363  536  701  858 1007 1148 1149 1150 1151 1152 1153 1154 1155 1156 1157 1159 1020 1160 1022 1161 1416 1024 1420 1166 1167 1169 1030 1171 1302 1172 1426 1303 1306 1037 1039 1179 1309  893 1311 1181 1312 1047   59  415  588  745  239
 181  362  535  700  857 1006 1147 1280 1281 1282 1283 1284 1285 1286 1287 1288 1158 1290 1291 1292 1293 1165 1295 1296 1297 1298 1299 1301 1170 1174 1035 1425 1543 1304 1307 1546 1176 1310 1308 1314  895  744  900 1046  750  245   56  901
 180  361  534  699  856 1005 1146 1279 1404 1405 1406 1407 1408 1409 1410 1411 1289 1412 1413 1414 1417 1532 1533 1418 1419 1537 1422 1300 1423 1428 1644 1544  886 1547 1652 1177 1548 1430 1313 1434 1045 1185  902 1044  748  749  590  238
 179  360  533  698  855 1004 1145 1278 1403 1520 1521 1522 1523 1524 1525 1526 1527 1528 1530 1531 1415 1534 1294 1535 1421 1743 1538 1536 1645 1539 1540 1541 1427 1649 1653 1545 1432 1433 1315 1188 1184 1048 1049  903   55  587   60   57
 178  359  532  697  854 1003 1144 1277 1402 1519 1628 1629 1630 1631 1632 1633 1634 1635 1529 1637 1638 1639 1640 1641 1740 1643 1834 1646 1647 1746 1648 1542 1749 1305 1841 1651 1550 1753 1436 1187 1186  905  751  752  591  419   58  246
 177  358  531  696  853 1002 1143 1276 1401 1518 1627 1728 1729 1730 1732 1905 1733 1734 1636 1736 1737 1738 1739 1642 1741 1742 1917 1744 1424 1747 1838 1748 1650 1429 1842 1752 1657 1438 1549 1437 1316  589  904  242  243  418  423  244
 176  357  530  695  852 1142 1141 1275 1517 1626 1727 1819 1820 1821 1731 1906 1822 1824 1735 1826 1828 1829 1830 1831 1832 1833 1836 1745 1835 1837 1922 1999 1840 1839 1551 1431 1654 1655 1317 1051 1053  908  753  421  592  422   61  420
 175  356  529  694  851 1001 1139 1274 1400 1516 1625 1726 1818 1902 1904 1982 1823 1825 1909 1827 1911 1912 1913 1914 1915 1916 1992 1918 1920 1996 1921 1923 2001 1750 1656 1751 1440 1658 1190 1052 1055  754  756  906  424  593  248   62
 174  355  528  693  850 1000  998 1140 1399 1515 1624 1725 1903 1980 1979 1907 2050 1984 1985 1910 1986 1987 1988 1989 1990 2059 2058 2061 1993 2063 1995 1998 1844 1843 1660 1754 1552 1439 1554 1056 1318 1189 1050  909  596  247   64   63
 173  354  527  692  997 1138  848 1398 1272 1397 1623 1724 1815 1817 2048 1981 2108 1908 1983 2051 2052 2054 2055 2056 2057 1991 2060 1994 2062 1919 2122 1997 1846 1924 1925 1760 1845 1319 1320 1194 1321  907  755  757  911  595  425  250
 172  353  526  691  849  996  999 1273 1396 1514 1621 1513 1622 1901 1978 2047 2046 2109 2111 2112 2053 2164 2113 2115 2116 2117 2118 2119 2120 2121 2123 2064 1926 1847 1755 1557 1555 1659 1323  910 1195 1054 1191  758  426  594  597  249
 171  352  525  690  846  847 1137 1271 1395 1512 1723 1722 1814 1816 1900 1976 2045 2049 2107 2203 2240 2163 2114 2166 2167 2168 2169 2170 2214 2171 2172 2066 2000 1927 1662 1930 1757 1756 1553 1192 1193  912  759  600  429  427  253   65
 170  351  524  689 1135  995 1136 1267 1270 1393 1510 1619 1721 1898 1975 2159 2160 2110 2162 2161 2206 2207 2165 2208 2210 2211 2212 2213 2173 2174 2067 2065 2002 1758 1929 1761 1661 1663 1556 1443 1196 1197 1058  428  254  251   68   66
 169  350  523  688  845 1134 1269 1511 1392 1268 1394 1620 1813 1618 1899 1973 1897 2104 2205 2204 2241 2242 2243 2209 2244 2245 2247 2248 2175 2124 2126 2125 2068 2004 2003 1447 1848 1442 1441 1324  913 1057 1059  762  760  598  252   67
 168  349  522  687  844  994  992  993 1266 1509 1720 1719 1811 1977 1974 2105 2155 2158 2201 2202 2268 2239 2270 2271 2272 2246 2273 2249 2215 2216 2176 2127 2069 1928 1664 1759 1445 1559 1558 1444 1325 1322  599  761  601  431  430   69
 167  348  521  686  843 1133 1132 1391 1390 1508 1617 1718 1896 1812 2042 2041 2157 2044 2238 2106 2288 2267 2289 2290 2291 2292 2274 2251 2250 2217 2005 1849 1933 1851 1931 1850 1765 1562 1448 1561 1446 1060  914  915  602  432  255   70
 166  347  520  685  842 1265  990 1264 1506 1387 1616 1717 1810 1971 2156 2103 2043 2154 2200 2237 2266 2269 2300 2301 2302 2276 2275 2252 2177 2218 2071 2070 1934 1932 1764 1762 1666 1665 1449 1326 1327 1061  916  763  603  433  256   71
 165  346  519  684  841  991 1131 1389 1386 1507 1615 1716 1895 2040 1972 2199 2153 2198 2234 2265 2286 2287 2299 2296 2297 2293 2303 2219 2220 2128 2129 2006 2072 1935 1852 1853 1763 1450 1328 1199 1198 1062  917  764  604  434  257   72
 164  345  518  683  840  989 1130 1263 1388 1614 1808 1809 1893 1970 1894 1969 2152 2148 2235 2264 2283 2284 2298 2259 2295 2294 2253 2277 2180 2178 2179 2073 2007 1855 1936 1766 1854 1451 1563 1329 1200 1063  918  765  435  436  258   73
 163  344  517  682  839  988 1129 1262 1505 1712 1613 1715 1807 2038 1891 2102 2150 2039 2233 2236 2231 2285 2282 2260 2281 2280 2254 2257 2279 2131 2130 2010 2008 2009 1668 1856 1667 1669 1560 1330 1201 1064  919  766  605  437  259   74
 162  343  516  681  838  987 1128 1261 1503 1612 1713 1714 1806 1892 1890 2101 2100 2099 2151 2263 2261 2191 2229 2228 2258 2278 2256 2222 2255 2132 2133 2074 2075 1768 1938 1767 1564 1452 1566 1331 1202 1065  920  767  606  438  260   75
 161  342  515  680  837  986 1127 1260 1385 1502 1504 1968 1805 2036 2098 2097 2035 2149 2196 2262 2232 2197 2230 2189 2226 2187 2185 2225 2181 2182 2076 1939 1937 1857 1858 1769 1670 1565 1671 1453 1332 1066  921  768  608  607  261   76
 160  341  514  679  836  985 1126 1259 1384 1500 1611 1711 1710 1804 1889 2095 2195 2037 2193 2194 2192 2190 2144 2143 2227 2140 2224 2138 2221 2223 2134 2011 2013 2077 1771 1568    0 1770 1455 1454 1203 1068  922  769  609  439   78  262
 159  340  513  678  835  984 1125 1258 1383 1610 1501 1609 1803 2033 1967 1966 2094 2096 2146 2092 2090 2089 2145 2142 2139 2186 2137 2183 2184 2136 2135 2078 1940 2080 2014 1567 1672 1673 1676 1067 1333 1334  923  770  440  263   77   79
 158  339  512  677  834  983 1124 1257 1382 1499 1709 1802 1965 1886 1888 1964 2030 2031 2093 2147 2091 2088 2087 2141 2188 2085 2084 2083 2082 2081 2012 2017 2015 1941 1860 1569 1861 1335 1456 1205 1069 1204  924  771  610  442  441  264
 157  338  511  676  833  982 1123 1256 1381 1498 1608 1708 1887 1801 1963 1960 2034 1959 2029 2028 2027 2026 2024 1952 2086 1953 2021 2019 2018 1946 2016 2079 1944 1773 1863 1862 1457 1674 1570 1206 1207 1070  925  772  611  265  266   80
 156  337  510  675  832  981 1255 1380 1379 1497 1607 1606 1800 1885 1962 2032 1961 1880 1958 1957 1956 1955 2025 1954 2022 2023 1871 1949 1950 2020 1867 1866 1945 1942 1859 1573 1772 1571 1458 1336 1208 1071  926  773  612  443  267   81
 155  336  509  674  980 1121 1120 1122 1254 1496 1605 1707 1706 1799 1883 1882 1881 1793 1879 1878 1877 1876 1875 1874 1873 1951 1588 1948 1869 1947 1686 1865 1943 1864 1774 1675 1574 1459 1460 1337 1209 1072  928  927  774  444  268   82
 154  335  508  673  829  831 1119 1253 1378 1495 1604 1705 1798 1884 1796 1795 1794 1698 1792 1791 1790 1789 1788 1787 1785 1690 1784 1870 1687 1868 1781 1779 1778 1777 1776 1572 1679 1680 1461 1340 1210 1338 1211  775  269  614  613   83
 153  334  507  672  830  979 1252 1251 1377 1602 1376 1603 1702 1797 1701 1700 1596 1699 1696 1695 1694 1591 1693 1692 1783 1872 1782 1688 1354 1685 1780 1684 1683 1682 1681 1677 1775 1576 1575 1464 1212  930 1073  615  777  445  446   85
 152  333  506  828  977  978 1118 1250 1494 1492 1491 1600 1703 1599 1598 1597 1595 1484 1594 1593 1592 1590 1479 1691 1478 1476 1689 1358 1585 1584 1582 1583 1581 1580 1578 1466 1577 1342 1216 1214 1076 1074 1339  776  931   84  270  447
 151  332  505  671  827  976 1117 1375 1493 1490 1601 1704 1488 1369 1487 1486 1485 1697 1482 1364 1480 1362 1587 1477 1786 1586 1475 1473 1471 1226 1224 1472 1470 1579 1467 1347 1678 1462 1341  939  929 1346  932  778  617  616  271   86
 150  504  669  670  826  975 1116 1249 1374 1373 1372 1489 1370 1242 1368 1367 1366 1365 1483 1363 1235 1481 1361 1359 1357 1589 1230 1353 1229 1474 1351 1222 1469 1349 1468 1221 1218 1465 1344 1217 1078 1077 1075  784  618  448  272   87
 149  331  503  668  825  974 1115 1248 1247 1246 1245 1371 1244 1107 1241 1240 1239 1238 1237 1101 1236 1233 1360 1232 1096 1231 1356 1355 1227 1352 1225  947 1090 1350 1220 1345 1348 1463  287  937 1084  786  779  619 1215   89  273  274
 148  330  502  667  824  973 1114 1113 1112 1111 1110 1109 1243 1108 1106 1105 1104 1103 1102 1100 1234 1098  806  955 1095  950  802  799 1228 1091  946 1092 1089  945  794  944 1219  790  942 1081  935 1079 1213 1080  451  450   88  449
 147  329  501  666  823  972  971  970  969  968  967  966  965  964  963  962  961  960  959 1099  956  646 1097  803  951 1094  641  801 1093  949  795  793  635  467 1088  791 1223 1083 1343  625  628  934  620  933  621  452  275   90
 146  328  500  665  822  821  820  819  818  817  816  815  814  813  812  811  810  809  649  808  958  957  805  953  954  952  800  640  948  797  469  796 1086 1087 1085  941  789  626  940  938  624  936  781  780  623  453  454   91
 145  327  326  664  663  662  494  661  659  658  657  656  655  654  653  485  652  651  650  807  647  804  645  644  643  476  642  639  798  638  470  637  634  465  943  107  629  788  459  286  787 1082  622  276   99  783  277  278
 144  325  499  497  496  495  660  493  492  491  490  489  488  487  486  484  309  483  482  648  481  479  478  477  475  474  299  472  297  296  471  636  293  468  462  633  632  631  627  460  785  100  458  455  456   92  280   93
 143  324  498  323  322  320  319  135  318  317  315  314  313  312  311  310  126  308  307  306  480  305  304  302  118  116  301  473  113  114  295  294  109  292  464  461  290  289  105  103  282  101  283  102  782  279   96   94
 142  141  140  139  321  138  137  136  134  316  133  132  131  130  129  128  127  125  124  123  122  121  303  120  119  117  300  115  298  112  111  108  110  466  291  104  288  284  630  792  106  463  285  457  281   98   97   95
