# This puzzle is unsolvable
59
   2    1    3    4    5    6    7    8    9   10   11   12   13   14   15   16   17   18   19   20   21   23  253   26   25   28  258   29   30  260   31   34  264  265   35   36   37   38  271   39  496   42   43  712  275   47   49  279  278   50   51  284   52 1128  507   55   57  287  289
 232  233  234  235  236  237  238  239  240  241  242  243  244  245  246  247  248  249  250  251  252  691  477   24   27  254  482  259  483  484  485   32  266  489  491  488  268  269   40  493   41  274  498   46   45  501  715 1124   48  280  504  506  720  933  508  290   59   60  511
 231  456  457  458  459  460  461  462  463  464  465  466  467  468  469  470  471  472  473  474  475  478   22  693  255  256  480  904  481  261   33  263  702  704  490  267  706  270  273  272 1116  276  500  922  716  923  277  718  282  926  925  930   53  285   54  286   62   58  292
 230  455  672  673  674  675  676  677  678  679  680  681  682  683  684  685  686  687  688  689  690  692  476  479  695  257  696  698  697  907  262  700  701  703  487 1111  705  492  912  495  918  711  713   44  497  499  502  503  719 1123  281  929  505  931  283  517   56   61  288
 229  454  671  880  881  882  883  884  885  886  887  888  889  890  891  892  893  894  895  896  897  898  899  900 1101  901  903 1104  906  699 1297  486  908  909  911 1482 1113 1112  494  709  919  710  714  921 1119 1121 1122 1318  924 1316 1127  723  928  512  725  293  510 1131   64
 228  453  670  879 1080 1081 1082 1083 1084 1085 1086 1087 1088 1089 1090 1091 1092 1093 1094 1095 1096 1097 1098 1099  694 1100  902 1102 1105 1106 1108 1107 1109 1110  910 1303  914  708  707  915  920  917 1118  717 1312 1496 1500 1315 1675 1498 1130 1125 1317  513  515  722  514   66  727
 227  452  669  878 1079 1272 1273 1274 1275 1276 1277 1278 1279 1280 1281 1282 1283 1284 1285 1286 1287 1288 1289 1290 1291 1292 1293  905 1103 1296 1480 1300 1299 1658 1485 1305 1302  913  916 1114 1308 1490 1492 1120 1311 1314 1673 1494 1670 1322 1129 1319  721  932  291  296  935  516   63
 226  451  668  877 1078 1271 1456 1457 1458 1459 1460 1461 1462 1463 1464 1465 1466 1467 1468 1469 1470 1471 1472 1473 1474 1475 1652 1294 1295 1478 1298 1481 1483 1657 1301 1484 1827 1487 1489 1306 1307 1115 1117 1665 1491 1671 1495 1313 1672 1503 1676 1133 1126  509  728  730  934  297   65
 225  450  667  876 1077 1270 1455 1632 1633 1634 1635 1636 1637 1638 1639 1640 1641 1642 1643 1644 1645 1646 1647 1648 1649 1650 1476 1651 1477 1653 1655 1654 1823 1659 1825 1828 1486 1304 1661 1488 1664 1833 1668 1993 1310 1493 1669  927 1842 1505 1678 1134 1501 1320  939  519   70  294  729
 224  449  666  875 1076 1269 1454 1631 1800 1801 1802 1803 1804 1805 1806 1807 1808 1809 1810 1811 1812 1813 1814 1815 1816 1817 1818 1819 1820 1479 1822 1656 1982 1824 1662 1985 1660 1829 1663 1991 1990 1667 1309 1995 2144 1836 1996 1837 1839 1499 1840 1502  724 1135  520  726 1504   68  734
 223  448  665  874 1075 1268 1453 1630 1799 1960 1961 1962 1963 1964 1965 1966 1967 1968 1969 1970 1971 1972 1973 1974 1975 1976 1977 1978 1979 1821 1980 2133 1983 2135 1984 2136 1826 1987 1989 1831 2142 1666 2143 1835 2150 2146 2291 1841 1497 1674  937 1323 1132  936 1321  295  938  299  300
 222  447  664  873 1074 1267 1452 1629 1798 1959 2112 2113 2114 2115 2116 2117 2118 2119 2120 2121 2122 2123 2124 2125 2126 2127 2128 2129 2274 2131 1981 2132 2134 2278 2138 2280 1830 1988 2140 2141 1832 1992 1994 1834 2550 2148 1998 1838 1999 2002 1843 1677  942 1845 1324  298   69 1136   67
 221  446  663  872 1073 1266 1451 1628 1797 1958 2111 2256 2257 2258 2259 2260 2261 2262 2263 2264 2265 2266 2267 2268 2269 2270 2271 2272 2130 2273 2275 2276 2277 2279 2137 2281 1986 2139 2282 2284 2420 2421 2285 2145 2423 2288 1997 2151 1325 1508 1847 2000  733  941  521  731   72  518  522
 220  445  662  871 1072 1265 1450 1627 1796 1957 2110 2255 2392 2393 2394 2395 2396 2397 2398 2399 2400 2401 2402 2403 2404 2405 2406 2407 2408 2409 2410 2411 2412 2413 2414 2415 2416 2418 2419 2666 2545 2779 2422 2286 2287 2292 2001 2149 2551 1682 1506 1139 1328 1327 1138  732  735  940  523
 219  444  661  870 1071 1264 1449 1626 1795 1956 2109 2254 2391 2520 2521 2522 2523 2524 2525 2526 2527 2528 2529 2530 2531 2532 2533 2534 2535 2536 2537 2538 2539 2540 2541 2542 2543 2417 2544 2283 2548 2879 2549 2669 2147 2289 2424 1844 1509 2003 1329 1510 1680 1326 1137  525   73   71   75
 218  443  660  869 1070 1263 1448 1625 1794 1955 2108 2253 2390 2519 2640 2641 2642 2643 2644 2645 2646 2647 2648 2649 2650 2651 2652 2653 2654 2655 2656 2657 2658 2660 2661 2772 2662 2664 2665 2547 2546 2552 2554 2671 2881 2290 2153 1848 1846 1679 1507 2006  737  943  945 1140  736  303  301
 217  442  659  868 1069 1262 1447 1624 1793 1954 2107 2252 2389 2518 2639 2752 2753 2754 2755 2756 2757 2758 2759 2760 2761 2762 2763 2764 2765 2766 2767 2768 2769 2659 2771 2773 2774 2663 2880 2776 2777 2778 2667 2553 2668 2426 2293 2004 2152 1511 2154 1141 1686  738  740  302  739   74   76
 216  441  658  867 1068 1261 1446 1623 1792 1953 2106 2251 2388 2517 2638 2751 2856 2857 2858 2859 2860 2861 2862 2863 2864 2865 2866 2867 2868 2869 2870 2871 2872 2770 2874 2875 2971 2876 2775 2973 2878 2429 2782 2431 2670 2005 2294 1688 2428 2158 1681 2007 1330  741 1143  304  944  528  305
 215  440  657  866 1067 1260 1445 1622 1791 1952 2105 2250 2387 2516 2637 2750 2855 2952 2953 2954 2955 2956 2957 2958 2959 2960 2962 2963 2964 2965 3052 2966 2968 2873 2969 2970 3057 3139 2877 2974 2882 2673 2427 2672 2781 2295 2425 1849 1683 1685 1513 1512 1690  946  526  524  307  529   77
 214  439  656  865 1066 1259 1444 1621 1790 1951 2104 2249 2386 2515 2636 2749 2854 2951 3040 3041 3042 3043 3044 3045 3046 3047 2961 3049 3050 3051 3131 3053 2967 3055 3056 3058 3059 3062 3060 3140 3061 2975 2555 2780 2296 2300 1850 2556 1335 1853 1514 2155 1332 1142  743  947 1144  306   78
 213  438  655  864 1065 1258 1443 1620 1789 1950 2103 2248 2385 2514 2635 2748 2853 2950 3039 3120 3121 3122 3123 3124 3125 3127 3048 3128 3129 3130 3132 3322 3054 3134 3268 3206 3135 3209 3137 2972 2976 2883 2784 2430 2886 2156 2011 2009 1851 1684 1517 2012 1145 1333 1516  527  742   79   80
 212  437  654  863 1064 1257 1442 1619 1788 1949 2102 2247 2384 2513 2634 2747 2852 2949 3038 3119 3192 3193 3194 3195 3196 3126 3197 3198 3200 3201 3202 3203 3133 3323 3269 3136 3207 3210 3138 2884 2977 2783 2557 2297 2008 2436 2304 2162 2298 2299 1334 1336 1852  949 1149  530  309  308   81
 211  436  653  862 1063 1256 1441 1618 1787 1948 2101 2246 2383 2512 2633 2746 2851 2948 3037 3118 3191 3256 3257 3258 3259 3260 3261 3199 3366 3263 3264 3266 3267 3205 3270 3325 3208 3141 3142 2979 2978 3063 2785 2786 2674 2560 2433 2301 2160 1331 1515 1687 1146  948  532  745  531   82  312
 210  435  652  861 1062 1255 1440 1617 1786 1947 2100 2245 2382 2511 2632 2745 2850 2947 3036 3117 3190 3255 3312 3313 3314 3315 3316 3262 3317 3319 3265 3406 3204 3369 3324 3273 3271 3211 3064 3065 2980 2885 2677 2787 2676 2163 2558 1857 2305 1854 2157 1858 1337 1856  746  951  744  310   84
 209  434  651  860 1061 1254 1439 1616 1785 1946 2099 2244 2381 2510 2631 2744 2849 2946 3035 3116 3189 3254 3311 3360 3361 3362 3363 3364 3367 3436 3321 3407 3368 3409 3370 3272 3371 3212 3143 2981 2888 2887 2678 2675 2435 2302 2559 2161 1855 2014 2159 2010 1339 1147 1338 1518  535  533  313
 208  433  650  859 1060 1253 1438 1615 1784 1945 2098 2243 2380 2509 2630 2743 2848 2945 3034 3115 3188 3253 3310 3359 3400 3401 3402 3403 3318 3320 3365 3461 3439 3408 3327 3274 3326 3213 3144 3066 2982 2889 2789 2788 2679 2561 2164 2437 1859 2013 2303  950 1151  953  749  315  311  747   83
 207  432  649  858 1059 1252 1437 1614 1783 1944 2097 2242 2379 2508 2629 2742 2847 2944 3033 3114 3187 3252 3309 3358 3399 3432 3433 3434 3405 3404 3473 3474 3440 3412 3372 3373 3328 3214 3145 3067 3068 2890 2681 2680 2563 2562 2015 2306 2434 2432 1693 1689 1152 1340  955  537  314  534   85
 206  431  648  857 1058 1251 1436 1613 1782 1943 2096 2241 2378 2507 2628 2741 2846 2943 3032 3113 3186 3251 3308 3357 3398 3431 3456 3458 3435 3437 3462 3410 3411 3460 3329 3276 3275 3215 3146 3070 3069 2983 2984 2564 2438 2439 2565 2166 2016 1519 1691 1692 1520 1521  952  748  316   86   87
 205  430  647  856 1057 1250 1435 1612 1781 1942 2095 2240 2377 2506 2627 2740 2845 2942 3031 3112 3185 3250 3307 3356 3397 3430 3455 3457 3472 3478 3459 3438 3413 3441 3374 3330 3277 3216 3147 3071 2985 2891 2790 2682 2566 2440 2165 2167 1861 1524 1341 1696 1522  954 1148  536  750  317  538
 204  429  646  855 1056 1249 1434 1611 1780 1941 2094 2239 2376 2505 2626 2739 2844 2941 3030 3111 3184 3249 3306 3355 3396 3429 3454 3471 3480 3477 3475 3463 3442 3376 3375 3331 3278 3217 3149 3148 2986 2892 2791 2683 2567 2309 2307 2308 2017 1862 2018 1695 1150 1153  752  751  539  318   88
 203  428  645  854 1055 1248 1433 1610 1779 1940 2093 2238 2375 2504 2625 2738 2843 2940 3029 3110 3183 3248 3305 3354 3395 3428 3453 3470 3479 3476 3466 3443 3415 3444 3377 3332 3219 3280 3218 3072 2987 2893 2792 2684 2685 2441 2442 2169 2019 1699 1694 1860 1523 1343  956  957  540  319   89
 202  427  644  853 1054 1247 1432 1609 1778 1939 2092 2237 2374 2503 2624 2737 2842 2939 3028 3109 3182 3247 3304 3353 3394 3427 3452 3469 3468 3448 3465 3464 3418 3416 3379 3378 3333 3279 3150 3073 2988 2895 2894 2569 2310 2444 2168 2022 2021 1700 1698 1697 1342 1344 1155  958  541  753   91
 201  426  643  852 1053 1246 1431 1608 1777 1938 2091 2236 2373 2502 2623 2736 2841 2938 3027 3108 3181 3246 3303 3352 3393 3426 3451 3450 3449 3421 3467 3446 3445 3414 3381 3334 3281 3220 3151 3074 2989 2896 2793 2794 2445 2795 2311 2312 2170 1525 1701 1863 1156 1154  959  754  542   90  320
 200  425  642  851 1052 1245 1430 1607 1776 1937 2090 2235 2372 2501 2622 2735 2840 2937 3026 3107 3180 3245 3302 3351 3392 3425 3424 3423 3422 3420 3447 3419 3417 3380 3336 3335 3282 3221 3152 3075 2990 2796 2570 2568 2686 1864 2443 2797 2171 2020 1345 1865 1526 1346  960  755  543  321   92
 199  424  641  850 1051 1244 1429 1606 1775 1936 2089 2234 2371 2500 2621 2734 2839 2936 3025 3106 3179 3244 3301 3350 3391 3390 3389 3388 3387 3386 3385 3384 3383 3382 3338 3283 3284 3222 3153 3076 2991 2899 2687 2898 2571 2314 2024 2313 2172 1528 2023 1527 1157 1158  961  756  322   93   94
 198  423  640  849 1050 1243 1428 1605 1774 1935 2088 2233 2370 2499 2620 2733 2838 2935 3024 3105 3178 3243 3300 3349 3348 3347 3346 3345 3344 3343 3342 3341 3340 3339 3286 3227 3337 3224 3154 3077 2992 2897 2798 2799 2688 2448 2173 2174 1868 1866 1702 1529 1347 1348 1159  962  544  323   95
 197  422  639  848 1049 1242 1427 1604 1773 1934 2087 2232 2369 2498 2619 2732 2837 2934 3023 3104 3177 3242 3299 3298 3297 3296 3295 3294 3293 3292 3291 3290 3289 3288 3287 3228 3223 3285 3155 3078 2993 2900 2689 2573 2447 2446 2449 2315 1867 2025 1703 1530 1350 1349  963  757  758  324   96
 196  421  638  847 1048 1241 1426 1603 1772 1933 2086 2231 2368 2497 2618 2731 2836 2933 3022 3103 3176 3241 3240 3239 3238 3237 3236 3235 3234 3233 3232 3231 3088 3163 3230 3229 3226 3225 3156 3079 2994 2901 2800 2690 2572 2575 2574 2175 1869 1704 1705 1531 1351 1160  964  759  545  546  325
 195  420  637  846 1047 1240 1425 1602 1771 1932 2085 2230 2367 2496 2617 2730 2835 2932 3021 3102 3175 3174 3173 3172 3171 3170 3169 3168 3167 3166 3165 3164 3005 3162 3161 3160 3159 3158 3157 3080 2995 2902 2801 2691 2576 2450 2316 2317 2177 2176 1870 1532 1161 1162  965  760  547  326   98
 194  419  636  845 1046 1239 1424 1601 1770 1931 2084 2229 2366 2495 2616 2729 2834 2931 3020 3101 3100 3099 3098 3097 3096 3095 3094 3093 3092 3091 3090 2915 3089 3087 3086 3085 3084 3000 3082 3081 2802 2693 2692 2577 2452 2318 2319 2179 1873 2026 1707 1163 1533 1165  966  761  548   97  327
 193  418  635  844 1045 1238 1423 1600 1769 1930 2083 2228 2365 2494 2615 2728 2833 2930 3019 3018 3017 3016 3015 3014 3013 3012 3011 3010 3009 3008 3007 2914 3006 3004 3003 3002 3001 2907 2998 2996 2903 2997 2803 2694 2578 2451 2320 2027 1872 1871 1706 1534 1352 1164  967  762  549  328   99
 192  417  634  843 1044 1237 1422 1599 1768 1929 2082 2227 2364 2493 2614 2727 2832 2929 2928 2927 2926 2925 2924 2923 2922 2921 2920 2919 2918 2917 2916 2816 2913 2912 2911 2910 3083 2999 2908 2906 2905 2904 2804 2695 2453 2030 2180 2029 2032 2031 1708 1536 1354 1353  968  763  550  329  100
 191  416  633  842 1043 1236 1421 1598 1767 1928 2081 2226 2363 2492 2613 2726 2831 2830 2829 2828 2827 2826 2825 2824 2823 2822 2821 2820 2819 2818 2817 2813 2814 2708 2707 2706 2811 2812 2810 2808 2807 2806 2805 2696 2579 2454 2178 2321 2028 1709 1710 1535 1355 1166  969  764  551  330  101
 190  415  632  841 1042 1235 1420 1597 1766 1927 2080 2225 2362 2491 2612 2725 2724 2723 2722 2721 2720 2719 2718 2717 2716 2715 2714 2713 2712 2711 2710 2709 2815 2705 2590 2589 2703 2909 2809 2701 2700 2699 2698 2697 2580 2455 2322 2181 1876 1874 1711 1357 1537 1167  970  765  552  331  102
 189  414  631  840 1041 1234 1419 1596 1765 1926 2079 2224 2361 2490 2611 2610 2609 2608 2607 2606 2605 2604 2603 2602 2601 2600 2599 2598 2597 2596 2595 2594 2593 2592 2591 2588 2704 2465 2702 2586 2585 2584 2583 2582 2581 2456 2323 2184 2183 1875 1877 1538 1356 1168  971  766  553  332  103
 188  413  630  839 1040 1233 1418 1595 1764 1925 2078 2223 2360 2489 2488 2487 2486 2485 2484 2483 2482 2481 2480 2479 2478 2477 2476 2475 2474 2473 2472 2471 2470 2469 2468 2467 2335 2333 2587 2334 2462 2461 2460 2459 2458 2325 2324 2326 2033 2034 1712 1539 1358 1169  972  767  554  333  104
 187  412  629  838 1039 1232 1417 1594 1763 1924 2077 2222 2359 2358 2357 2356 2355 2354 2353 2352 2351 2350 2349 2348 2347 2346 2345 2344 2343 2342 2341 2340 2339 2338 2337 2336 2464 2466 2332 2463 2331 2330 2329 2328 2327 2457 2186 2185 1878 1879 1713 1540 1359 1170  973  768  555  334  105
 186  411  628  837 1038 1231 1416 1593 1762 1923 2076 2221 2220 2219 2218 2217 2216 2215 2214 2213 2212 2211 2210 2209 2208 2207 2206 2205 2204 2203 2202 2201 2200 2199 2198 2197 2196 2195 2194 2046 2192 2191 2190 2189 2188 2187 2035 2182 2037 1714 1715 1541 1360 1171  974  769  556  335  106
 185  410  627  836 1037 1230 1415 1592 1761 1922 2075 2074 2073 2072 2071 2070 2069 2068 2067 2066 2065 2064 2063 2062 2061 2060 2059 2058 2057 2056 2055 2054 2053 2052 2051 2050 2049 2048 2193 2047 2045 2044 2043 2042 2041 2040 2039 2038 1881 2036 1880 1542 1361 1172  975  770  557  336  107
 184  409  626  835 1036 1229 1414 1591 1760 1921 1920 1919 1918 1917 1916 1915 1914 1913 1912 1911 1910 1909 1908 1907 1906 1905 1904 1903 1902 1901 1900 1899 1898 1897 1896 1895 1894 1893 1892 1891 1890 1889 1888 1887 1886 1885 1884 1883 1882 1717 1718 1543 1362 1173  976  559  771  337  108
 183  408  625  834 1035 1228 1413 1590 1759 1758 1757 1756 1755 1754 1753 1752 1751 1750 1749 1748 1747 1746 1745 1744 1743 1742 1741 1740 1739 1738 1737 1736 1735 1734 1733 1732 1731 1730 1729 1728 1727 1726 1725 1724 1723 1722 1721 1720 1719 1716 1546 1544 1363 1174  977  558  560  338  109
 182  407  624  833 1034 1227 1412 1589 1588 1587 1586 1585 1584 1583 1582 1581 1580 1579 1578 1577 1576 1575 1574 1573 1572 1571 1570 1569 1568 1567 1566 1565 1564 1563 1562 1561 1560 1559 1558 1557 1556 1555 1554 1553 1552 1551 1550 1549 1548 1547 1367 1364 1365 1175  773  772  561  110  111
 181  406  623  832 1033 1226 1411 1410 1409 1408 1407 1406 1405 1404 1403 1402 1401 1400 1399 1398 1397 1396 1395 1394 1393 1392 1391 1390 1389 1388 1387 1386 1385 1384 1383 1382 1381 1380 1379 1378 1377 1376 1375 1374 1373 1372 1371 1370  987 1369 1368 1545 1178 1176  978  774  562  339  112
 180  405  622  831 1032 1225 1224 1223 1222 1221 1220 1219 1218 1217 1216 1215 1214 1213 1212 1211 1210 1209 1208 1207 1206 1205 1204 1203 1202 1201 1200 1199 1198 1197 1196 1195 1194 1193 1192 1191 1190 1189 1188 1187 1186 1184  988 1183  986 1181  985 1366 1177  981  979  980  341  340  343
 179  404  621  830 1031 1030 1029 1028 1027 1026 1025 1024 1023 1022 1021 1020 1019 1018 1017 1016 1015 1014 1013 1012 1011 1010 1009 1008 1007 1006 1005 1004 1003 1002 1001 1000  999  998  997  996  995  994  993  992  990 1185  786  785 1182  572  782 1179  780  778  982  776  563  113  114
 178  403  620  829  828  827  826  825  824  823  822  821  820  819  818  817  816  815  814  813  812  811  810  809  808  807  806  805  804  803  802  801  800  799  798  797  796  795  794  793  792  791  790  789  991  576  787 1180  989  783  983  984  781  568  779  775  777  564  342
 177  402  619  618  617  616  615  614  613  612  611  610  609  608  607  606  605  604  603  602  601  600  599  598  597  596  595  594  593  592  591  590  589  588  587  586  585  584  583  582  362  581  579  359  788  577  575  355  784  574  571  570  350  569  567  347  565  344  115
 176  401  400  399  398  397  396  395  394  393  392  391  390  389  388  387  386  385  384  383  382  381  380  379  378  377  376  375  374  373  372  371  370  369  368  367  366  365  364  363  580  360  132  358  578  357  129  354  353  573  352  351  122    0  349  348  566  345  116
 175  174  173  172  171  170  169  168  167  166  165  164  163  162  161  160  159  158  157  156  155  154  153  152  151  150  149  148  147  146  145  144  143  142  141  140  139  138  137  136  135  361  134  133  131  130  128  356  127  126  125  124  123  121  120  119  346  118  117
