# This puzzle is unsolvable
56
   2    1    3    4    5    6    7    8    9   10   11   12   13  233   16   18  236   19  451  238   20  242  240   22  455  244   25   27   29  250   30  251   34   33  253  255   37   38   39   40   41   42   43   44   45  267   47   50   49  269   52   51   53  273   56   57
 220  221  222  223  224  225  226  227  228  229  230  231  232   15   14  235   17  652  651  237  654   23   24  454  456  243   26   28  247  249  459  859   32  464   36   35  256  257  258  259  260  261  262  263  265   46  478  268   48  480  479   54  483  271  272  275
 219  432  433  434  435  436  437  438  439  440  441  442  443  444  234  445  447  653  845  453  851   21  241  658  657  246  457  458  248  460   31 1046  252  667  254  466  467  469  671  471  472  473  676  474  476  266  477  681  682  680  481  270  685  881   55  274
 218  431  636  637  638  639  640  641  642  643  644  645  646  648  446 1032  846  449  239 1214  448  452  656  852  853  245  660  661  662  664  665  461  462  666  465  668  670  468  673  470  674  675  678  871  264  475 1063  679  876  684  879  482  484  686   60   58
 217  430  635  832  833  834  835  836  837  838  839  840  841  647  842  649  844 1212 1034  650  655 1386 1220 1037 1038  854  855  856  857  663 1224 1047  463 1048 1230  669  865  866  867  672 1056  869  870  872 1060  874  873  877  878  683 1066  687  880  485  277  276
 216  429  634  831 1020 1021 1022 1023 1024 1025 1026 1027 1029 1030  843 1031  847  848 1383  450  849 1035  850 1216 1389  659 1041 1044 1223 1042  858 1228  862 1051 1231  861 1232 1233 1234 1053  868 1235  677 1058 1059 1240  875 1061 1064 1065 1067  688  278   59  279  486
 215  428  633  830 1019 1200 1201 1202 1203 1204 1205 1207 1028 1208 1209 1210 1033 1701 1384 1385 1036 1387 1217 1704 1392 1219 1218 1390 1045 1394 1711  860 1400 1397 1049  864 1052 1402 1403 1236 1055 1057 1237 1238 1239 1241 1412 1062 1243 1244  882  689  489  488  491   61
 214  427  632  829 1018 1199 1372 1373 1374 1538 1375 1206 1541 1378 1380 1544 1381 1211 1382 1213 1549 1548 1039 1222 1040 1552 1557 1558 1225 1714 1043 1227 1399 1564 1565  863 1865 1401 1054 1569 1406 1407 1408 1409 1410 1411 1575 1242 1414 1245 1069  690  487   62   63  281
 213  426  631  828 1017 1198 1371 1536 1537 1693 1376 1377 1540 1379 1542 1543 1545 1700 1848 1547 1550 1215 1708 1388 1706 1554 1221 1393 1226 1559 1396 1398 1560 1050 1864 1229 1722 1720 1405 1721 1567 1570 1571 1572 1573 1574 1413 1415 1246  884 1068  883  691   64  280   65
 212  425  630  827 1016 1197 1370 1535 1692 1840 1694 1539 1696 1697 1698 1699 1986 1847 1703 1989 1702 1553 1854 1551 1391 1709 1556 1395 1712 1859 1713 1717 1561 1719 1718 1563 1566 1869 1404 1568 1724 1725 1726 1727 1728 1729 1577 1576 1416 1247 1070  885  284  490  282   66
 211  424  629  826 1015 1369 1534 1533 1839 1691 1843 1695 1982 1844 1845 1846 1705 1546 1987 1852 1992 1707 1710 1993 1997 1555 1857 2252 2128 1861 1715 1862 1716 1562 2004 1866 1867 1868 1870 1723 1871 1872 1873 1874 1875 1731 1730 1579 1578 1071 1072  886  692  492  693  283
 210  423  628  825 1014 1196 1368 1690 1689 1980 1841 1981 1842 1983 1984 1985 2118 1988 1849 1850 1991 1990 2124 1855 1994 1995 1856 1996 1858 1998 1860 2002 1863 2134 2135 2005 2006 2007 2008 2009 2011 2012 2143 2013 2014 1732 1733 1581 1248 1417 1249  887  695  694   68  285
 209  626  422  627 1013 1195 1366 1367 1838 1688 1979 2113 2236 2114 2238 2115 2116 2117 2121 2120 1853 2245 2122 2125 2127 2251 2364 2130 1999 2000 2001 2132 2003 2258 2257 2136 2137 2138 2139 2140 2141 2010 2267 2142 1876 1879 1580 1582 1418 1250 1073  889  888  493  494   67
 208  421  207  824  624 1194 1193 1532 1837 1836 2111 2112 2235 2352 2239 2240 2241 2242 2119 2243 1851 2123 2361 2246 2126 2250 2572 2365 2249 2254 2131 2370 2256 2133 2259 2374 2260 2261 2262 2263 2264 2266 2016 1880 2147 1877 1735 1734 1419 1252 1251  890  696  698  286  495
 419  206  823 1010 1011 1012 1365 1531 1687 1977 1978 2110 2234 2353 2237 2354 2459 2359 2358 2464 2244 2360 2362 2363 2248 2247 2473 2253 2129 2476 2255 2369 2371 2372 2373 2481 2375 2376 2484 2377 2378 2265 2145 2015 1878 2144 1584 1585 1420 1421 1074 1075  497  700   70   69
 420  625  820  822 1191 1192 1529 1530 1834 1835 1976 2109 2351 2460 2560 2355 2561 2356 2564 2465 2466 2467 2468 2469 2470 2471 2472 2366 2367 2475 2577 2575 2477 2479 2480 2580 2482 2483 2584 2485 2381 2380 2146 2148 2017 1881 1737 1736 1422 1253 1076  891  697  496  287   71
 203  205  816  821 1009 1363 1364 1528 1686 1833 1975 2108 2233 2232 2462 2461 2562 2357 2563 2738 2565 2658 2657 2567 2568 2570 2745 2573 2571 2368 2667 2669 2478 2578 2579 2753 2581 2673 2582 2487 2486 2379 2269 2019 2018 1882 1587 1423 1583 1254 1078 1077  699  498  288   72
 418  204  623  819 1008 1190 1362 1527 1685 1684 1974 2107 2349 2350 2457 2458 2652 2463 2653 2654 2655 2566 2659 2569 2660 2820 2663 2746 2474 2574 2749 2576 2827 2828 2752 2670 2672 2583 2674 2490 2585 2382 2271 2268 2149 2021 1739 1884 1424 1255  894  892  893  289  290   73
 817  622  417  818 1188 1189 1361 1526 1683 1832 1973 2106 2231 2348 2456 2559 2649 2557 2737 2739 2740 2656 2741 2742 2743 2662 2888 2666 2747 2947 2665 2751 2893 2671 2896 2754 2755 2756 2586 2384 2488 2270 2383 2150 2151 2020 1740 1738 1586 1425 1079  701  500  499  291   74
 416  202  621  620 1007 1187 1360 1525 1682 1831 1972 2105 2230 2347 2651 2650 2558 2735 2812 2813 2814 2882 2816 2817 2818 2661 2821 2822 2664 2748 2824 2750 2825 2668 2826 2831 2829 2757 2675 2489 2491 2587 2022 1885 2273 1886 1742 1883 1426 1256  702  896  703  501  292   75
 201  415  414 1005 1006 1004 1359 1524 1681 1830 1971 2104 2229 2346 2455 2556 2734 2736 2811 2880 2881 2883 2815 2884 2819 2885 2887 2999 2889 2823 2891 2892 2952 2894 2895 2830 2758 2677 2676 2589 2588 2386 2272 2153 2023 2152 1741 1588 1258 1257 1082  897  895  900   77   76
 200  413  618  815 1185 1186 1358 1523 1680 1829 1970 2103 2228 2345 2454 2555 2648 2733 2810 2879 2940 2941 2992 2993 2942 2744 2946 2945 2948 2949 2890 3003 3002 3004 2953 2897 2832 2759 2679 2492 2387 2385 2274 2024 1887 1888 1743 1428 1427 1259 1260  898 1081  293  503   78
 199  412  617  619 1003 1184 1357 1522 1679 1828 1969 2102 2227 2344 2453 2554 2647 2732 2809 2878 2939 2991 2943 3038 2944 2998 2886 3041 3000 3044 2950 3043 3046 2951 2955 2898 2833 2761 2760 2678 2493 2388 2275 2154 2025 1889 1590 1589 1429 1262 1080  899  502  704  705  504
 198  411  616  814  813 1002 1356 1521 1678 1968 1826 2100 2101 2341 2226 2553 2646 2731 2808 2877 2938 3036 2994 3072 2995 2996 3040 3042 3104 3078 3001 3045 3047 2954 3005 2899 2680 2681 2591 2494 2592 2389 2276 2155 2026 1744    0 1592 1591 1263 1083  296  295  294   79   80
 197  410  615  812 1001 1183 1355 1519 1520 1677 1827 2343 2225 2450 2452 2451 2552 2645 2807 2876 2937 2990 3071 3073 2997 3039 3076 3102 3103 3077 3079 3048 3006 3007 2956 2900 2762 2682 2496 2590 2390 2277 2278 2156 1890 1891 1745 1430 1086 1593 1261 1084  506  706  297   81
 196  409  614  811 1181 1182 1354 1517 1676 1825 1967 1966 2223 2224 2342 2551 2644 2730 2806 2935 2934 2936 3035 3034 3037 3100 3074 3075 3123 3106 3081 3080 3083 3008 2957 2958 2834 2836 2593 2594 2497 2391 2157 2028 2027 1746 1747 1433 1434 1431 1085  901  505  709  299   82
 195  408  810 1180 1000  998 1674 1673 1824 1675 2099 1965 2098 2340 2449 2550 2643 2729 2805 2875 2872 2989 3070 3099 3120 3101 3121 3122 3134 3124 3125 3082 3107 2902 2837 2903 2835 2838 2683 2685 2495 2392 2279 2158 2029 1892 1594 1432 1595 1264  708  707  902  509  298   83
 194  407  613  999  809 1353 1352 1515 1518 1823 1964 2097 2222 2339 2448 2549 2642 2728 2874 2873 2802 3067 3033 3096 3098 3119 3132 3131 3133 3108 3105 3084 2960 3050 2959 2904 2901 2763 2765 2596 2597 2498 2280 2159 2030 1893 1749 1748 1090 1087 1266  507  510  710  302  508
 193  611  612  808  997 1179 1351 1514 1822 1672 1963 2096 2221 2338 2447 2548 2641 2545 2803 2988 3069 2986 3031 3068 3066 3118 3117 3129 3126 3127 3110 3052 3049 3009 2961 2839 2764 2766 2684 2394 2595 2393 2395 2160 2031 1894 1596 1435 1436 1267 1265 1088  904 1089  903   84
 192  406  610  807  996 1178 1350 1821 1516 1820 1962 2095 2220 2337 2446 2547 2639 2804 2640 2727 2871 2987 2933 2985 3095 3097 3115 3128 3135 3111 3085 3051 3109 3010 3011 2962 2840 2767 2686 2500 2499 2282 2281 2161 2032 1895 1750 1597 1437 1091 1092  905  711  301  300  303
 190  405  609  805  806  995 1175 1176 1670 1819 1961 2094 2219 2335 2336 2638 2724 2726 2801 2725 2870 3028 2983 3030 3029 3116 3114 3130 3113 3112 3086 3087 3053 3012 2906 2905 2841 2768 2687 2598 2501 2396 2283 2162 2033 1896 1751 1598 1268 1269 1093  305  512  712  511  513
 404  191  400  804  993 1349 1177 1348 1671 1513 1960 2093 2218 2334 2444 2445 2637 2800 2869 2930 2931 2929 3027 3032 3094 3062 3093 3091 3090 3088 3058 3056 3054 3013 2963 2907 2842 2769 2688 2599 2502 2397 2284 2163 2034 1898 1897 1752 1599 1438  906  713 1094  514   87   85
 189  608  403  607  992  994 1347 1669 1666 1959 1958 2092 2217 2441 2443 2723 2722 2546 2868 2799 2982 2932 2984 3065 3025 3064 3023 3060 3059 3019 3089 3018 3055 2965 2964 2908 2843 2770 2689 2600 2503 2398 2285 2164 2035 1753 1600 1601 1439 1270 1271  715   88  714  304   86
 188  401  402  803 1346 1174 1511 1668 1512 1817 2091 2216 2332 2333 2442 2721 2544 2797 2866 2798 2867 2981 3026 3024 2976 3063 3092 3021 3020 2972 3017 3057 3016 3014 3015 2966 2844 2771 2690 2601 2504 2399 2286 2165 2036 1899 1754 1440 1273 1272  911  308  907  716  306   89
 187  399  606  605  991 1173 1344 1510 1345 1957 1818 2090 2214 2215 2543 2542 2636 2635 2720 2927 2928 2980 2979 2978 2977 2920 3061 2975 2973 2917 2971 2914 2970 2968 2967 2909 2845 2772 2691 2602 2505 2400 2287 2166 2037 1900 1756 1602 1096 1603  908 1095  909  717   90   91
 186  397  604  990  801 1172 1343 1507 1509 1667 1815 1956 2089 2331 2440 2541 2634 2719 2796 2865 2926 2925 2924 2923 2922 2921 3022 2974 2918 2916 2915 2852 2969 2913 2911 2910 2846 2773 2692 2603 2506 2401 2288 2167 2038 1901 1755 1757 1441 1442  718  518  516  910  521   92
 185  398  988  989  802 1171 1170 1665 1814 1816 1955 2088 2213 2330 2439 2540 2633 2718 2795 2864 2863 2862 2861 2789 2858 2788 2857 2785 2856 2854 2853 2782 2781 2849 2912 2779 2847 2774 2693 2604 2507 2402 2289 2168 2039 1902 1604 1443 1444 1274 1097  913  912  517  307  719
 184  603  602  987  800 1169 1508 1342 1664 1813 1954 2087 2212 2329 2438 2539 2632 2717 2794 2793 2792 2791 2790 2859 2860 2787 2919 2707 2705 2784 2703 2851 2700 2613 2698 2778 2848 2775 2694 2605 2508 2403 2290 2169 2040 1903 1606 1758 1445 1275 1098 1100  914  520  515   95
 183  395  601  797  799 1168 1341 1506 1663 1812 1953 2086 2211 2328 2437 2538 2631 2716 2715 2714 2713 2712 2624 2527 2709 2708 2855 2786 2617 2618 2783 2704 2702 2850 2780 2777 2776 2696 2695 2606 2509 2404 2291 2170 2042 2041 1605 1760 1446 1099 1101  723  519   93  310  312
 182  600  798  396 1167 1166 1340 1505 1662 1811 1952 2085 2210 2327 2436 2537 2630 2629 2628 2627 2626 2625 2529 2711 2710 2621 2622 2620 2619 2522 2616 2615 2701 2699 2612 2611 2697 2609 2608 2607 2510 2405 2292 2171 2043 1759 1904 1607 1277 1276  916 1102  720  721  309  722
 181  394  796  985  599  986 1339 1504 1661 1810 1951 2084 2209 2326 2435 2536 2535 2534 2533 2532 2531 2530 2315 2426 2528 2526 2525 2706 2524 2419 2418 2521 2614 2518 2517 2516 2610 2515 2513 2512 2511 2406 2293 2172 1906 1907 1905 1761 1448 1609 1279  915  311   94  313  314
 180  393  598  795  984 1165 1338 1503 1660 1809 1950 2083 2208 2325 2434 2433 2432 2431 2430 2429 2428 2427 2623 2424 2313 2423 2422 2420 2309 2523 2306 2519 2417 2415 2413 2412 2411 2514 2410 2409 2408 2407 2294 2173 2044 1908 1762 1447 1449  917 1278  724  522  523   96   97
 179  392  597  794  983 1164 1337 1502 1659 1808 1949 2082 2207 2324 2323 2322 2321 2320 2319 2318 2317 2316 2314 2425 2312 2311 2192 2310 2421 2308 2307 2305 2416 2520 2304 2302 2301 2300 2299 2298 2297 2296 2295 2174 2045 1763 1611 1608 1281  918 1103  920  919   99  316   98
 178  391  596  793  982 1163 1336 1501 1658 1807 1948 2081 2206 2205 2204 2203 2202 2201 2200 2199 2198 2197 2196 2195 2194 2066 2193 2191 2190 2189 2188 2187 2186 2185 2414 2303 2057 2181 2180 2179 2178 2177 2176 2047 2048 2046 1909 1610 1451 1280 1104  921  725  524  525  315
 177  390  595  792  981 1162 1335 1500 1657 1806 1947 2080 2079 2078 2077 2076 2075 2074 2073 2072 2070 1936 2069 1933 2068 2067 2065 2064 2063 2062 2061 2060 2059 2058 1921 2184 1778 2055 2053 2052 2051 2050 2049 2175 1912 1910 1764 1450 1612 1452 1282  922  726  526  317  100
 176  389  594  791  980 1161 1334 1499 1656 1805 1946 1945 1944 1943 1942 1941 1940 1939 1938 1793 1643 2071 1934 1639 1931 1787 1932 1635 1928 1927 1926 1925 1924 1923 2056 2183 2182 2054 1919 1918 1917 1915 1914 1913 1769 1911 1765 1766 1613 1614 1105 1283  727  729  318  101
 175  388  593  790  979 1160 1333 1498 1655 1804 1803 1802 1801 1800 1799 1798 1797 1796 1795 1483 1937 1935 1640 1791 1790 1788 1929 1930 1785 1784 1783 1782 1781 1780 1922 1776 1920 1775 1774 1773 1916 1772 1771 1770 1618 1768 1454 1616 1285 1284 1106  923  527  728  320  102
 174  387  592  789  978 1159 1332 1497 1654 1653 1652 1651 1650 1649 1648 1647 1646 1645 1644 1316 1484 1482 1792 1313 1480 1636 1786 1477 1633 1632 1473 1631 1630 1629 1628 1777 1626 1466 1625 1624 1623 1622 1621 1619 1617 1458 1767 1453 1289 1107  730  731  528  319  321  103
 173  386  591  788  977 1158 1331 1496 1495 1494 1493 1492 1491 1490 1489 1488 1487 1486 1485 1794 1641 1481 1642 1637 1789 1478 1310 1476 1475 1474 1131 1471 1303 1470 1779 1627 1300 1467 1465 1464 1463 1462 1620 1461 1460 1459 1456 1615 1287 1108 1286  924  530  531  529  104
 172  385  590  787  976 1157 1330 1329 1328 1327 1326 1325 1324 1323 1322 1321 1320 1319 1318 1317 1141 1314  955 1138 1638 1312 1634 1133 1134 1307 1304 1306 1128 1302 1469 1301 1468 1298 1123 1297 1296 1295 1294 1293 1292 1291 1457 1114 1455 1288 1109 1110  925  732  322  105
 171  384  589  786  975 1156 1155 1154 1153 1152 1151 1150 1149 1148 1147 1146 1145 1144 1143 1142  767  958 1315 1479 1137  953  954 1309  948 1130 1472 1305 1129  945 1127  943 1125 1299 1122 1121  938 1120 1119 1118 1117 1116 1290 1113 1112  738  929 1111  926  323  107  106
 170  383  588  785  974  973  972  971  970  969  968  967  966  965  964  963  962  961  960  959  766  957  763  765  762  764 1136  951  757 1308  949  947  946  554  942 1126  751 1124  940  939  937  546  935  934  743 1115  740  739  931  930  928  733  325  536  534  108
 169  382  587  784  783  782  781  780  779  778  777  776  775  774  773  772  771  770  769  768 1139  956 1140  565  562  761 1311  759 1135  758  558  755  556  944  754  752  750  941  550  749  748  936  747  745  543  545  121  542  541  539  736  734  735  532  535  324
 168  381  586  585  584  583  582  581  580  579  578  577  576  575  574  573  572  571  362  147  568  567  566  564  952  563  354  139  560  559  950  350  756  753  553  345  346  552  344  549  548  746  744  547  544  933  335  742  333  538  741  737  927  113  110  327
 167  380  379  378  377  376  375  374  373  372  371  370  369  368  367  366  149  364  570  148  569  360  145  358  357  141  760  353  137 1132  352  557  349  132  555  347  130  129  551  342  341  340  339  338  932  337  334  119  118  540  331  114  533  329  109  326
 166  165  164  163  162  161  160  159  158  157  156  155  154  153  152  151  365  150  363  146  361  144  359  143  142  355  356  561  140  138  136  351  135  134  348  133  131  128  343  127  126  125  124  123  122  120  336  117  332  116  537  330  115  111  112  328
