# This puzzle is unsolvable
16
191   2 154 155 112 217   5 168 166 117 123  72  78 167  12 125
195 113  60  68  69 157  71  66 222 194   6  67  14 197  13 122
 63   3  56 193 158 119 114 120 126  74  15 198  70  19 253  16
151 116 110   1  65  64 228  11 163 225   9  17   8 132 165  18
159 109  59  57 196  62 162 252 130 189  24 229 127  26  77  73
108 185 118 105 161  61 239  10 190   4   7  76 124 199 115 200
107 153 156 237 221 224 240 249 204 245  82 164 170  75  25  79
220 152 238 148 223 188 106 247 160 121 206 212 243 171  80  84
192  51  54 150 149 242 186 255 226 241 201   0  20  23 136 169
 55 103 216 233 138 218 235 214 202 251 232 203  21  81 205 129
102 219 145  49 215  58 213 244 227 246 179 131 176 208  89 128
 50 187  52 183 111 234 143 248  92 231 209 177  22  27  83 172
236  97 104  47 182  93 178 142  94 134  87 254 175 230  31 135
 98  46  44  53 100 144 211 141 207 137  86 210  88 173  28  29
101 184 146  48  41  40  39 181 140 180 174  36  30  33  90  32
 45  99 250 147  43  42  95  38  96  37  35  91  34 139  85 133
