# This puzzle is unsolvable
32
   2    1    3  127    4  129    9  133   11  248  355   12  251  255  360   16  361   19  365   21   20  368  366   23   22  262  266   26  154  151   28   30
 124  125  126    5  128    7    6  131   10  352  452  137  253   13  139   15   18  362  258  143  261  370  141  467  149  264  372   27   33   32   29   31
 123  240  241  242  243  244  246  247  451    8  135  249  136   14  138   17  142  257  364  463  147  557  714  369  146  470  471  265  148  269  152   34
 122  239  348  349  350  542  351  455  538  627  546  357  254  630  459  460  363  140  144  641  260   24  556  263  150   25  558  267  374  268  155  156
 121  347  448  449  447  130  354  358  547  456  132  134  359  634  550  457  461  256  259  638  465  462  468  560  145  371  373  375  376   35  153   36
 119  120  346  539  540  541  543  700  698  703  544  458  776  250  707  710  554  551  706  839  713  464  367  782  561  469  644  474  272  377   37  157
 238  237  345  702  245  625  626  450  453  699  769  883  772  252  548  549  636  637  552  711  715  639  559  718  643  466  563  475  472  159  158   38
 343  118  344  446  535  445  545  623  353  356  833  926  834  629  774  635  632  836  640  780  784  783  555  642  645  562  473  271  379  378  270  273
 236  444  235  342  624  621  768  701  880  830  454  775  773  633  931  631  887  838  553  778  781  719  785  717  716  646  564  476  274   40  161  160
 116  232  233  537  618  443  828  697  826  881  884  930  885  777  835  712  779  991  966  890  892  841  891  720  647  565  566  381  380   43  275   39
 115  341  231  534  536  827  766  620  770  960  832  628  771  767  886  888 1010  933  934  889  709  842  787  721  722  648  478  477  277  162   41   42
 114  234  441  338  117  695  619  876  622  922  705  829  928  924  962  990  708  837  840  965  893  894  786  843  568  649  567  479  383  276  164   44
 340  229  440  442  339  533  615  531  824  921  958  923  987  988  704  831 1022  968  932  895  937  845  723  724  725  574  569  382  385  480  163  165
 336  113  437  696  228  693  439  529  879  765  763  875  825  925 1020  929 1006  964 1012  846  896  935  789  650  726  651  652  481  384  278  166   45
 230  528  617  222  616  821  438  882  823  694  764  957  927  961 1001  963 1005  967  936  938  898  847  844  788  572  570  482  280  169  279  168   46
 108  110  227  692  333  111  878  762  761  917  822  877  819  980  993  989  996 1014  969  971  994  897  848  849  791  571  386  281  388   47  483  167
 532  334  223  612  530  610  614  613  873  874  959  992  919  986  951 1021  995 1011 1013  970  940  939  900  728  653  790  484  486  575  170  283   48
 689  225  109  432  112  331  435  760  872  690  955  920 1008 1009  911  983  984 1007  998  972  941  850  794  792  654  727  573  389  655  387   49   50
 107  337  335  691  611  820  759  871  758  870  914 1002  956  978  976 1023 1015 1017 1016  945  975  974  899  793  729  657  658  656  485  282  284  171
 226  436  526  224  524  685  527  754  688  981  813  918  985  952 1003 1004  950  910  999  973  997  901  851  852  795  730  576  390  286  391  172   51
 106  332  433  434  525  608  750  683  684  982  757  953  954  949  947 1018 1000  946  944  943  942  902  853  796  731  577  488  487  392  285  173   52
 104  105  221  430  687  609  815  606  686  979  818  916  747  865  816 1019  908  948  907  858  905  903  854  797  732  659  578  489  393  287  174   53
 103  219  330  220  431  523  817  603  869  811  812  912  913  810  863  909  861  977  860  859  904  856  855  798  733  579  580  490  288  175  176   54
 101  327  328  521  522  753  814  755  808  679  746  749  866  867  744  807  806  805  906  803  857  802  801  799  734  660  491  394    0  289  177   55
 102  324  217  329  422  604  428  752  756  677  915  680  864  674  862  673  743  742  804  739  668  738  800  736  735  661  582  581  395  178  291   56
 326  426   99  427  605  215  213  423  748  681  314  599  597  595  745  593  505  671  741  740  667  666  737  665  664  662  663  492  396  290  179   57
 519  218  520   98  607  429  682  602  512  868  678  809  676  675  594  672  411  591  670  669  589  588  587  586  585  584  583  493  494  397  292   58
 100  518  216  207  319  420  317  516  601  751  598  509  510  596  413  506  592  504  409  590  502  501  500  499  498  497  496  495  398  293  180   59
 325  321  323  320  209  419  424  421  418  600  511  514  416  508  312  412  308  410  306  503  407  406  405  404  403  402  401  400  399  294  181   60
 214   94  425  208  211  517  318  205  513  313  417  415  414  311  310  507  309  307   75  408  305  303  302  301  300  299  298  297  296  295  182   61
  96  212   97  322  316   89   90  515   86  202  203  201   82  200  199   80  197  196  194  193  304  192  191  190  189  188  187  186  185  184  183   62
  93   95   92   91  210   88  206   87  204   85   84  315   83   81   79  198   78   77  195   76   74   73   72   71   70   69   68   67   66   65   64   63
