# This puzzle is unsolvable
52
 402  206  207    5  210    7  208    8  213    9   10   12  217   13   15   20   18  222  418  604   19   22  420   24   27  230   28  426  428   30   31  234   33   34   35   36   37   38   39   40  437   41   43  247   46  248   47   48   49   50   51   52
 205    4  589  766  767  403  770  211  214   11  408  215  216   14  220   16   17   21  223  225   23  786  417  227   26   25  425   29  232  231  235   32  236  237  238  239  240  241  242  243   42  441  246  442   45  445  249  250  251  253  254   53
 204    1    3  940  591  209  769  406  212  409  594  599  411  412  218  413  221  416  784  419  224  605  610  607  228  423  229  422  427  233  429  430  431  432  433  434  435  624  436  626  439  440  244  629   44  444  446  447  252  448  255   54
   2  203  401  587  404  590    6  771  407  774  595  597  410  598  600  415  219  602  603  955  782  608  424  226  421  611  612  613  615  793  616  796  617  620  621  800  623  438  625  805  627  628  245  807  443  630  632  633  634  449  256   55
 400  398  768  588 1104  939 1106  405  593  592  596  947  776  778  779  601 1114 1271  781 1117  606  785  787  788  609  789  791  963  794  792  795  798  619  618  969  799  622  973  802  804  806  977  978  809 1143  631  982  810  635  450  257   56
 202  399  199  198  938 1105  941 1108  773  944  775  946  777  949  950 1269  951  414  780 1116 1118 1275  958  959  961  790  962  614  964  966  965  967 1132  968 1291  972  801  974  803  975 1139  976  980  979  808 1144  811  812  636  451  258   57
 397  585  764  765 1259 1260  943  942  772  945 1109 1264  948 1111 1113 1416  952 1115  783 1419  954 1120 1274 1121 1279  960 1124 1125 1127 1128 1131 1130 1286 1133 1135 1289 1290 1137 1439 1293 1138 1140 1141 1298  813 1142  815  981  637  452  259   58
 394  393  396  200  936  937 1102 1261 1107 1265 1411 1551 1268 1112 1414  953 1415 1556 1270 1272  957  956 1423 1422 1123 1278 1280 1126 1129 1281 1282 1573 1433 1574  797 1136 1292 1576 1437 1294 1295 1442 1296 1297 1299 1145  814  816  638  453  260   59
 582  201  586  583  763 1103 1407 1262 1409 1408 1263 1110 1550 1684 1553 1554 1558 1417 1418 1421 1276 1119 1425 1277 1695 1426 1568 1428 1569 1432 1284 1570 1287  971  970 1438 1436 1708 1440 1579 1441 1582 1444 1445  983 1147 1146  818  985  454  261   60
 195  197  392  395 1101 1100 1258 1548 1549 1681 1266 1267 1552 1413 1555 1687 1688 1559 1420 1273 1562 1561 1122 1424 1818 1565 1427 1699 1430 1283 1431 1571 1434 1285 1288 1134 1577 1575 1578 1833 1580 1584 1713 1583 1148 1581  817  984  639  455  262   61
 391  194  196  584  762  935 1257 1406 1405 1410 1680 1804 1682 1412 1807 1686 1809 1927 1557 1812 1560 1691 1692 1563 1564 1696 1698 1566 1822 1429 1702 1701 1572 1826 1435 1705 1828 1707 1709 1710 1832 1443 1450 1446 1585  986  641  819  640  456  263   62
 390  193  580  761  934 1099 1256 1547 1546 1679 1803 1805 1922 1923 1683 1811 2034 1926 1689 1814 1815 1930 1931 1694 1816 1819 1697 1567 1823 1700 1824 1703 1827 1704 1829 1946 1706 1830 1831 1835 1711 1716 1834 1301 1300  987 1447  988  642  457  264   63
 192  579  581  760  933 1098 1255 1404 1545 1678 1920 1918 1806 2030 1685 2031 1810 2033 1690 1928 1929 2039 1693 1817 1933 1934 1820 1821 1937 1938 1939 1825 1941 1942 2050 2051 1943 1945 1949 1712 1948 1303 1714 1448 1149 1302  820  821  643  458  265   64
 389  388  759  758  932 1097 1254 1403 1544 1677 1802 1808 1921 2028 2029 1924 2032 2133 2134 2132 2038 1813 1932 2137 2040 2041 2042 1936 1935 2044 2046 1940 2048 2049 2149 2242 1944 1947 2052 2054 1836 1715 1586 1449 1304  989  822  991  644  459  266   65
 190  191  577  931 1096 1095 1253 1402 1543 1676 1801 2027 1919 2128 2130 2131 2224 1925 2308 2135 2036 2228 2138 2229 2139 2140 2141 2043 2143 2045 2144 2145 2146 2148 2147 2240 2150 2154 1951 1950 2055 1837 1717 1587 1153 1150 1151  990  645  460  267   66
 387  576  757  578  930 1094 1252 1541 1401 1675 1800 1917 2026 2127 2129 2304 2380 2225 2221 2306 2310 2226 2385 2227 2231 2230 2232 2233 2142 2234 2235 2047 2321 2238 2239 2241 2324 2243 2056 2153 1838 1590 1451 1306 1152 1305  992  823  646  461  268   67
 189  386  575  756  929 1251 1250 1400 1542 1674 1799 1916 2025 2126 2219 2307 2035 2448 2309 2381 2452 2136 2037 2313 2454 2389 2315 2316 2392 2317 2236 2237 2395 2397 2322 2325 2323 2151 2057 1954 1588 1952 1839 1591 1308 1154  993  824  647  462  269   68
 188  385  574  755  928 1093 1249 1399 1540 1673 1798 1915 2024 2125 2218 2305 2447 2222 2220 2383 2384 2386 2311 2453 2312 2456 2391 2568 2318 2394 2319 2320 2464 2396 2398 2245 2152 2155 2244 2058 1720 1718 1589 1307 1309 1155  994  825  648  463  270   69
 187  384  573  753  754  927 1091 1398 1539 1672 1797 1914 2023 2124 2217 2302 2303 2508 2379 2449 2382 2510 2512 2388 2387 2314 2517 2458 2459 2462 2461 2520 2522 2326 2327 2400 2053 2156 2059 1840 1953 1719 1841 1453 1452 1156  995  826  649  464  271   70
 186  382  383  752  926 1248 1092 1397 1538 1671 1796 1913 2022 2123 2216 2301 2378 2509 2560 2223 2450 2451 2562 2513 2455 2688 2569 2460 2516 2572 2465 2393 2521 2402 2399 2466 2246 2157 2060 1955 1721 1592 1455 1454 1310 1157  996  827  650  465  272   71
 185  381  572  571 1090 1247 1396 1395 1537 1670 1795 1912 2021 2122 2215 2300 2377 2446 2507 2559 2561 2511 2563 2564 2566 2515 2611 2518 2519 2571 2614 2574 2523 2463 2401 2328 2329 2158 2061 1956 1842 1722 1593 1456 1311 1158  997  828  651  466  273   72
 183  184  570  751  925 1089 1246 1536 1669 1535 1794 2020 2019 2121 2214 2299 2376 2445 2558 2506 2604 2605 2607 2565 2514 2673 2457 2390 2570 2613 2573 2615 2524 2467 2403 2159 2247 2160 2062 1957 1843 1844 1723 1594 1312 1159  998  829  652  467  274   73
 182  380  569  750  924 1088 1245 1534 1394 1668 1910 1911 2018 2120 2213 2298 2375 2505 2556 2557 2641 2668 2606 2608 2700 2689 2567 2675 2646 2612 2647 2575 2525 2468 2330 2331 2248 2250 2063 1958 1845 1724 1595 1457 1313 1160  999  830  653  468  275   74
 181  377  379  749  923 1086 1087 1667 1392 1666 1792 1793 1909 2119 2212 2297 2374 2444 2503 2640 2639 2642 2702 2643 2687 2609 2670 2701 2692 2649 2648 2616 2526 2469 2404 2332 2249 2064 2067 1846 1961 1598 1459 1458 1314 1161 1000  831  654  469  276   75
 180  378  568  921  922  920 1244 1243 1393 1665 1791 1908 2017 2118 2211 2296 2373 2443 2603 2504 2602 2610 2666 2669 2644 2667 2645 2676 2691 2674 2617 2576 2527 2406 2405 2333 2251 2065 2165 1726 1597 1596 1725 1316 1460 1162 1001  832  655  470  277   76
 178  566  567  747  748 1085 1242 1533 1531 1664 1790 1907 2016 2117 2210 2295 2372 2442 2502 2555 2600 2601 2665 2686 2699 2672 2671 2693 2703 2650 2618 2577 2528 2470 2471 2252 2161 2066 1960 1959 1848 1847 1727 1315 1317 1163 1002  833  656  471  278   77
 565  376  179  746  919 1084 1390 1530 1391 1789 1788 1906 2015 2116 2209 2294 2371 2441 2440 2554 2634 2599 2636 2638 2637 2690 2695 2694 2651 2677 2652 2578 2529 2472 2407 2334 2163 2162 2164 1962 1728 1599 1463 1461 1164 1165 1003  834  657  472  279   78
 563  375  564  745  744 1083 1082 1241 1239 1532 1663 1905 2014 2207 2293 2292 2370 2500 2552 2553 2597 2598 2684 2664 2658 2697 2680 2696 2678 2653 2619 2620 2530 2473 2408 2335 2253 2068 1963 1850 1964 1849 1462 1600 1319 1318 1004  835  658  473  280   79
 175  176  562  918  917 1081 1389 1240 1388 1529 1787 2114 1903 2208 2291 2115 2439 2436 2501 2498 2551 2633 2635 2632 2698 2659 2685 2657 2679 2621 2580 2579 2581 2474 2409 2336 2255 2254 2166 2070 1965 1730 1729 1464 1166 1167 1005  836  659  474  281   80
 373  743  177  561  372  916 1238 1387 1528 1786 1785 1904 2012 2206 2010 2368 2438 2367 2497 2437 2499 2593 2630 2631 2663 2683 2682 2681 2655 2654 2533 2532 2623 2534 2337 2338 2256 2167 2069 1851 1853 1852 1601 1465 1320 1168 1006  837  660  475  282   81
 374  371  915  560 1080  913 1237 1662 1783 1661 1902 2011 2013 2112 2110 2204 2369 2205 2496 2550 2596 2546 2662 2544 2661 2660 2656 2625 2587 2588 2622 2582 2531 2410 2475 2411 2257 2168 2071 1966 1732 1602 1731 1604 1321 1169 1007  838  661  476  283   82
 370  173  741  914  742 1079 1236 1525 1660 1527 1386 1659 1901 2009 2113 2289 2111 2435 2495 2491 2549 2492 2590 2591 2595 2628 2626 2540 2585 2624 2584 2536 2583 2476 2478 2339 2258 2169 2072 1967 1854 1733 1322 1469 1466 1170 1008  839  662  477  284   83
 174  172  558  557 1078 1235 1385 1383 1526 1657 1521 1897 2108 2109 2203 2288 2290 2548 2494 2594 2428 2545 2592 2543 2629 2589 2542 2541 2539 2586 2538 2477 2535 2340 2412 2341 2259 2171 2170 2073 1855 1734 1468 1603 1467 1323 1009  841  663  478  285   84
 369  739  740  738  912 1077 1384 1382 1524 1784 1900 2008 1899 1898 2287 2286 2434 2366 2431 2430 2547 2357 2490 2489 2488 2627 2485 2420 2484 2483 2537 2482 2481 2413 2479 2414 2260 2172 2076 1968 1856 1736 1735 1605 1171  840 1010  842  664  479  286   85
 367  368  556  911 1076 1233 1231 1234 1523 1658 1781 2007 2005 2200 2201 2363 2433 2432 2493 2192 2429 2358 2427 2426 2425 2486 2424 2422 2349 2421 2419 2418 2480 2417 2343 2345 2342 2261 2173 2074 1969 1970 1606 1471 1470 1325 1324  843  665  480  287   86
 559  171  170  555  737 1075 1380 1232 1782 1656 1653 1896 2006 2202 2285 2362 2365 2360 2099 2281 2280 2359 2356 2355 2354 2487 2423 2352 2351 2348 2269 2347 2346 2344 2416 2262 2176 2075 1858 1971 1737 1607 1608 1472 1326 1172 1173 1011  666  481  288   87
 169  366  736  909  910 1074 1381 1230 1654 1652 1655 1780 2106 2107 2199 2284 2282 2361 2195 2278 2194 2189 2191 2275 2274 2353 2185 2272 2186 2350 2182 2268 2415 2180 2179 2081 2263 2174 1860 2078 1973 1857 1738 1609 1327 1174 1012 1013  667  482  289   88
 168  365  554  735  908 1073 1379 1520 1522 1779 1895 2003 2004 2105 2198 2197 2364 2283 2196 2279 2193 2277 2097 2276 2188 2187 2273 2089 2184 2271 2183 2086 2266 2084 2264 2265 2177 2175 1972 2077 1740 1739 1610 1473 1328 1176 1175  844  668  483  290   89
 167  364  553  734  907 1072 1229 1378 1518 1778 1893 1891 2002 2104 2103 1999 1887 2096 2098 1886 1993 2190 2095 2094 2093 2092 1987 2091 2088 2270 2087 2267 2181 2085 2178 2083 2080 2079 1976 1859 1975 1742 1861 1474 1329  847 1014 1015  845  484  291   90
 166  363  552  733  906 1071 1377 1227 1651 1519 1650 1892 1772 1894 1889 1997 2101 2102 1888 2100 1996 1992 1991 1990 1988 1878 2090 1986 1985 1984 1983 1872 1981 1870 1979 2082 1867 1978 1865 1864 1974 1741 1611 1330 1177  669  670  846  673  292  294   91
 165  362  551  732  905 1070 1228 1774 1516 1777 1776 1775 1890 1506 1643 2000 1767 1998 1885 1765 1994 1882 1881 1880 1989 1877 1759 1876 1875 1874 1873 1871 1982 1869 1980 1868 1748 1866 1863 1862 1613 1743 1475 1476 1331 1017 1179  671  485  488  293   92
 164  361  550  731 1225 1067 1226 1376 1517 1648 1368 1510 1645 1366 2001 1770 1644 1769 1766 1883 1884 1763 1760 1635 1632 1758 1497 1757 1756 1755 1754 1753 1752 1751 1750 1749 1747 1977 1746 1745 1744 1614 1612 1477 1178 1332 1016  849  487   95  490   94
 163  360  549  730  904  903 1069 1068 1375 1647 1507 1773 1365 1642 1364 1641 1639 1768 1503 1359 1499 1995 1762 1761 1353 1633 1879 1631 1495 1629 1627 1626 1625 1624 1623 1622 1621 1620 1619 1618 1617 1616 1615 1478 1180 1018  850  672  848  486  674   93
 162  359  548  729  902 1224 1514 1374 1369 1217    0 1061 1367 1646 1508 1505 1361 1504 1637 1764 1358 1634 1502 1501 1357 1355 1356 1493 1351 1628 1492 1491 1490 1489 1488 1487 1486 1485 1484 1483 1482 1481 1480 1479 1333 1182 1181 1019  297  675  489  295
 161  358  547  728  901 1066 1222 1223 1373 1515 1512 1059 1771 1054 1511 1213 1363 1640 1638 1360 1206 1636 1205 1047 1498 1352 1354 1496 1494 1199 1349 1348 1347 1346 1345 1344 1343 1342 1341 1340 1339 1338 1337 1185 1334 1335 1021 1020  852  296  851   96
 160  357  546  727  900 1065 1063 1372 1221 1649 1218 1219  890 1214 1212 1055 1053 1211 1362 1208 1207 1500 1204  879 1045 1203 1630 1350 1041 1200 1198 1197 1196 1195 1194 1193 1192 1191 1190 1189 1188 1187 1186 1184 1336 1183 1022  853  676  491  298   97
 159  356  545  726  899  897 1064  895 1062 1060 1216 1513 1058 1057  888 1509  886  884 1051 1210 1050 1048  706  877  878 1201 1044 1202 1042 1040 1039 1038 1037 1036 1035 1034 1033 1032 1031 1030 1029 1028 1027 1026 1025 1024 1023  854  677  492  299   98
 158  355  544  725  898  722  896  720  719 1370 1371  892 1215 1056  713 1052  711  887  525  882 1209  880  881 1046  703  875 1043  874  698  699  873  872  870  869  868  867  866  865  864  863  862  861  860  859  858  857  856  855  678  493  300   99
 157  354  543  724  723  721  537  893  894  342 1220  718  531  889  715  712  138  885  883  709 1049  708  707  705  704  876  518  701  700  697  696  871  695  694  693  692  691  690  689  688  687  686  685  684  683  682  681  680  679  494  301  100
 156  353  542  541  540  539  538  346  343  344  891  144  532  529  714  337  528  710  526  334  524  523  522  521  520  702  519  517  516  515  514  513  512  511  510  509  508  507  506  505  504  503  502  501  500  499  498  497  496  495  302  101
 155  352  351  350  349  348  347  345  535  716  717  341  533  143  340  140  139  527  136  335  333  332  331  330  329  328  327  326  325  324  323  322  321  320  319  318  317  316  315  314  313  312  311  310  309  308  307  306  305  304  303  102
 154  153  152  151  150  149  148  147  146  534  536  145  142  141  339  530  338  336  137  135  134  133  132  131  130  129  128  127  126  125  124  123  122  121  120  119  118  117  116  115  114  113  112  111  110  109  108  107  106  105  104  103
