# This puzzle is unsolvable
10
 98  65  41  37  67   1   3  43  42  10
 64   2  45  89  17  60   4  87  44  95
 33  19  90  26  32   7  85   6  68  71
 63  29  74   5  30  11  14  34  15  72
 99  80  88  66  35  50  54   0  86  69
 92  83  48  49   8  28  47  75   9  53
 18  61  93  62  40  56  46  22  94  12
 38  51  82  77  16  13  97  55  39  73
 84  76  31  57  70  78  79  91  23  52
 59  96  25  81  58  36  27  24  21  20
