# This puzzle is unsolvable
64
 255  252    5  500  499  257    7    8    9   10   11   12   13   14   15   16   17   18   19   20   21   22   23   24   25  277   26   28   29   30   31   32   33   34   35   36   37   38   39   40   41   42   43   44   45   47   48  299   49   50   51   52  304   53   56  307   57   58   59   60   61  315   62   64
   1    4    2  733    6  256  258  259  260  261  262  263  264  265  266  267  268  269  270  271  272  273  274  275  276  520   27  279  280  281  282  283  528  527  285  286  287  289  290  291  292  293  294  295  296  540  297  300  542  301  302  303   54  548  305   55  308  309  310  311  556  312   63   66
 251  496    3  254  735  498  501  502  503  504  505  506  507  508  509  510  512  746  513  514  515  516  517  754  518  755  278  521  522  524  986  525  526  284  529  530  288  532  533  534  535  536  537  538  539  298   46  541  543  544  546  781  782  547  306  549  550  787  552  553  790  317   65  313
 249  253  495  497  250 1180  736  737  738  739  740  741  742  743  744  745  511  748  975  749  750  751  979  752  519  982  756  757  523  985  988  761  759  760  764  765  531  767  768  769  770  771  772  773  774  775  776  777 1224  778  779  545 1009  783  784  785  551  788 1015  555  554  316  557  314
 248  494  731  732 1182  734 1181  964  965  966  967  968  969  970  971 1192  972  747 1195 1194  977  978  753  980 1200 1412  983 1202  758  984  987 1206  990  763  991  992  766  994  995  996  997  998  999 1000 1001 1002 1003 1004 1005 1007 1227  780 1008 1010 1011 1012  786 1234  789  559  558  318   68   67
 247  493  959  729  962  960 1392 1183 1184 1185 1186 1187 1188 1189 1401 1190  973 1403  974  976 1196 1197 1198 1199 1201 1617  981 1413 1414 1204 1207  762  989 1420 1209 1211  993 1213 1214 1426 1215 1217 1218 1219 1220 1221 1222 1223 1006 1225 1438 1437 1439 1228 1229 1230 1013 1232 1233 1016  791 1019   71   69
 246  730  958  961 1393  490  963 1394 1395 1396 1397 1398 1399 1603 1400 1191 1404 1193 1405 1406 1407 1408 1409 1410 1411 1809 1616 1203 1415 1205 1417 1418 1208 1419 1210 1422 1212 1423 1823 1425 1216 1428 1429 1430 1431 1432 1433 1434 1435 1639 1436 1226 1440 1441 1231 1645 1443 1014 1444 1235 1017  561  320  560
 728  492  956 1178 1390 1179 1596 1597 1598 1599 1600 1601 1602 1604 1799 1402 1605 1607 1608 1609 1610 1611 1612 1613 1810 1811 1614 1812 1618 1416 1620 1622 1623 1624 1421 1625 1626 1424 1628 1427 1630 1631 1632 1633 1634 1635 1636 1637 1638 1834 1640 1641 1642 1643 1442 1239 1647 1445 1018  793  792  562  319   70
 491  488  489  957 1391 1389 1595 1792 1793 1794 1795 1796 1797 1798 1987 1800 1606 1802 1803 1804 1805 1806 2174 1994 1995 1808 1615 1813 1814 1619 2350 1621 1817 1818 1819 1820 1822 1627 2009 1629 1825 2363 2013 1826 1828 1830 1831 1832 2021 2020 1835 1836 1837 1644 1646 1840 1020 1447 1236  797  795  323  321   72
 245  244  726  727 1177 1594 1593 1791 1980 1981 1982 1983 1984 1985 1986 1988 1801 1989 1990 1991 1992 2172 1993 1807 1996 1997 2179 2177 1999 1816 1815 2002 2004 2005 2006 2007 1821 2008 2011 2191 2010 2014 1827 2016 1829 2017 2018 2019 1833 2200 2022 2023 2024 1838 1839 2026 1648 1448 1446 1021  794  563  564   73
 243  725  955  954 1176 1388 1790 1789 1979 2160 2161 2162 2163 2335 2164 2166 2167 2338 2169 2170 2171    0 2173 2345 2175 2176 1998 2348 2001 2000 2180 2003 2181 2184 2185 2187 2522 2358 2188 2192 1824 2012 2364 2015 2195 2196 2197 2198 2199 2371 2201 2202 2203 2025 2027 1842 1240 1450 1238 1241 1022  322  566   74
 242  487  724  953 1175 1387 1174 1592 1978 2159 2332 2333 2497 2334 2165 2337 2339 2168 2340 2341 2342 2343 2344 2508 2346 2347 2349 2178 2351 2352 2353 2182 2183 2354 2356 2186 2357 2189 2360 2190 2361 2362 2194 2193 2366 2367 2368 2369 2370 2534 2372 2374 2536 2204 2028 1650 1841 1449 1651 1652 1237  796   75   76
 241  486  723  952 1173 1386 1591 1976 1977 2156 2158 2331 2496 2498 2336 2499 2501 2502 2503 2504 2505 2506 2507 2509 2664 2510 2511 2512 2513 2514 2515 2516 2517 2355 2519 2520 2359 2521 2523 2524 2828 2526 2528 2365 2529 2970 2531 2532 2688 2533 2537 2373 2029 2205 1843 1846 1649 1844  565  801  567  799  325   77
 240  485  722  951 1172 1385 1787 1788 2157 1975 2330 2495 2652 2653 2654 2500 2803 2656 2658 2659 2660 2661 2662 2811 2665 2812 2666 2667 2668 2669 2670 2671 2672 2518 2674 2675 2676 2677 2679 2680 2525 2681 2527 2683 2530 2685 2686 2835 2687 2690 2836 2376 2375 2207 2030 2535 1845 1451 1242 1023 1024  800  798  324
 239  484  721  950 1170 1588 1590 1589 1974 2155 2329 2494 2651 2800 2801 2655 2802 2657 2805 2806 2807 2808 2809 2950 2949 2810 2813 2814 2815 2816 2817 2818 2819 2673 2821 2822 2823 2824 2678 2825 2827 2831 2684 2682 2830 2972 3101 3226 2693 2689 2691 2692 2538 2032 2206 2377 1653 1452 1026 1025  568  326   80   78
 238  483  948  949 1169 1786 1383 1784 1785 2328 2327 2493 2650 2799 2940 3073 2941 2804 2944 2945 2946 2947 2948 2663 2951 2952 3083 2953 2954 3087 2955 2957 2958 2820 2959 2960 2961 2963 2964 2826 2965 2966 2967 2829 2968 2834 2832 2837 3106 2695 2379 2839 2539 2031 1847 1654 1454 1027 1455  802  806  569  327  803
 237  482  720  947 1171 1384 1382 1783 1973 2154 2326 2492 2649 2798 3072 3074 2943 2942 3075 3199 3076 3079 3202 3080 3081 3082 3084 3207 3085 3086 2956 3088 3089 3090 3091 3092 2962 3094 3095 3096 3097 3098 3099 2969 2971 3103 3341 2833 3105 2974 2977 2542 2380 2378 2210 2033 1848 1245 1028 1243 1246  329  330  328
 236  481  719  718 1168 1381 1587 1586 1972 2152 2153 2491 2648 2797 2939 3071 3196 3420 3197 3198 3077 3201 3078 3203 3204 3205 3206 3208 3323 3209 3210 3211 3212 3213 3214 3215 3093 3217 3218 3219 3221 3335 3338 3100 3102 3107 2973 3227 3223 3104 2541 2381 2540 2208 2209 1850 1656 1030 1247  804  571  805   82   79
 235  480  717  946 1167 1380 1585 1782 1971 2325 2490 2489 2647 2796 2937 3195 3312 3311 3419 3315 3200 3316 3317 3318 3319 3320 3431 3527 3321 3430 3325 3326 3327 3328 3329 3330 3216 3331 3333 3334 3442 3220 3222 3544 3224 2694 2975 2979 2838 2976 2840 2212 2211 2035 2034 1655 1849 1658 1456 1244 1453  570   81   83
 234  479  716  945 1166 1379 1584 1781 1970 2151 2324 2488 2646 2794 2938 2795 3194 3314 3313 3421 3613 3422 3425 3426 3427 3428 3620 3429 3322 3324 3432 3433 3434 3435 3436 3437 3439 3332 3440 3441 3443 3542 3444 3337 3339 3229 3445 3109 2842 2978 2696 2543 2382 2213 2036 1851 1657 1458 1457 1248 1029  572  573  331
 233  478  715  944 1165 1378 1583 1780 1969 2149 2150 2323 2645 2644 2935 3070 3193 3310 3309 3611 3423 3424 3522 3523 3525 3615 3526 3528 3529 3530 3531 3532 3533 3534 3535 3536 3438 3537 3539 3540 3541 3545 3336 3546 3343 3447 3340 3225 2980 3108 2697 2544 2383 2214 1853 1852 1659 1249 1032  807 1031  333  332   84
 232  714  943 1164 1163 1377 1582 1779 1968 2322 2321 2487 2643 2934 2793 2792 3067 3191 3520 3307 3612 3521 3614 3616 3698 3701 3617 3618 3619 3621 3622 3623 3624 3625 3626 3627 3628 3538 3629 3631 3633 3543 3636 3634 3342 3228 3344 2981 2843 2841 2698 2545 2384 2215 2037 2038 1660 1459 1250 1033  808  574   85   86
 231  477  713  942 1376 1777 1375 1580 1778 1967 2641 2148 2790 2932 2642 3192 2936 3190 3418 3518 3696 3517 3697 3774 3773 3524 3777 3700 3703 3704 3705 3706 3707 3708 3709 3711 3852 3712 3630 3713 3714 3635 3791 3717 3446 3449 3111 3230 3231 2844 2699 2546 2385 2216 2039 1854 1661 1460 1251 1034  576  575  335  334
 475  476  712  941 1162 1374 1776 1581 1966 2147 2146 2486 2791 2788 2933 3068 3066 3416 3308 3519 3515 3417 3772 3771 3776 3699 3842 3702 3778 3779 3780 3781 3782 3783 3785 3710 3787 3788 3789 3854 3632 3716 3448 3719 3547 3345 3110 3232 2982 2845 2700 2547 2386 2217 2040 1855 1662 1461 1252 1035  809  578  577   87
 230  473  474  940 1161 1373 1579 1965 1964 2319 2485 2317 2482 2789 2931 3069 3189 3064 3306 3514 3606 3609 3770 3900 3840 3841 3775 3845 3903 3846 3847 3907 3848 3849 3784 3912 3786 3914 3856 3718 3715 3790 3638 3450 3452 3346 3233 3112 2983 2846 2701 2548 2387 2218 2041 1856 1663 1462 1253 1036  810  811  336   88
 710  229  711  939  938 1160 1578 1775 1963 2145 2320 2484 2639 3065 2640 3063 3188 3413 3305 3516 3695 3608 3607 3610 3839 3902 3843 3844 3955 3904 3906 3908 3909 3961 3850 3962 3963 3853 3857 3855 3720 3637 3548 3549 3451 3347 3234 3113 2984 2847 2702 2549 2388 2219 2042 1857 1664 1463 1254 1037  812  579  337  338
 228  472  708  937  709 1372 1576 1577 1774 2144 2483 2318 2481 2929 2930 2787 3062 3187 3513 3415 3605 3694 3838 3769 3901 3952 3953 3997 4033 3954 4036 3958 3959 4003 3911 3851 3913 3965 3915 3858 3792 3793 3639 3550 3453 3348 3235 3114 2985 2848 2703 2550 2389 2220 2043 1858 1665 1464 1255 1038  813  580   90   89
 227  470  471  707 1159 1158 1371 1773 1962 2315 2316 2480 2638 2786 2927 2928 3186 3414 3304 3693 3767 3837 3835 3836 3899 3996 3950 4032 3998 4035 3960 3957 4001 3910 4002 3964 4005 4006 3916 3859 3794 3640 3721 3551 3454 3349 3236 3115 2986 2849 2704 2551 2390 2221 2044 1859 1666 1465 1256 1039  814  581  339   91
 226  706  469 1157 1370 1369 1575 1772 1960 2143 1961 2636 2634 2637 3059 3061 3185 3303 3511 3412 3692 3691 3768 3898 3951 3897 3995 4060 3999 3956 4000 3905 4038 4066 4067 4004 4040 4007 3966 3860 3795 3722 3641 3552 3455 3350 3237 3116 2987 2850 2705 2552 2391 2045 1860 1861 1667 1466 1257 1040  815  582  340   92
 225  705  935  934  936 1156 1574 1771 2142 2313 2314 2478 2635 2479 3058 3183 3060 3301 3512 3690 3411 3689 3896 3765 3949 3834 3994 4030 4031 4034 4062 4063 4064 4085 4039 4041 4009 4008 3917 3918 3796 3723 3642 3553 3456 3351 3238 3117 2988 2851 2706 2553 2392 2223 2222 1862 1668 1467 1258 1041  585  584  341   93
 223  224  704 1154 1153 1368 1573 1770 1959 2141 2140 2785 2784 2926 3184 3300 3299 3302 3410 3509 3604 3603 3688 3766 3895 3948 3993 4029 4059 4081 4061 4082 4037 4084 4065 4042 3968 3919 3967 3861 3797 3724 3643 3554 3457 3352 3240 3239 3118 2852 2707 2554 2393 2224 2046 2047 1669 1468 1259  818  816  817  583  343
 467  468  703  933 1155 1572 1571 1769 1958 2139 2312 2477 2633 2924 2925 3298 3056 3182 3510 3409 3601 3602 3687 3892 3946 3833 3894 3947 4058 4080 4092 4093 4083 4068 4069 4043 4010 3969 3863 3862 3798 3725 3644 3555 3458 3353 3241 3119 2989 2853 2708 2555 2394 2225 2048 1863 1670 1469 1260 1042 1043  344  342   94
 222  465  466 1152  931 1366 1367 1768 1957 2138 2311 2476 2632 2783 2923 3057 3408 3180 3406 3407 3508 3763 3764 3832 3893 3990 3991 4028 4057 4079 4078 4095 4094 4087 4086 4044 4011 3970 3920 3800 3864 3726 3645 3556 3459 3354 3120 2990 2991 2854 2709 2556 2395 2226 2049 1864 1671 1470 1261 1044  586  345   96   95
 221  220  702  930  932 1365 1570 1767 1956 2137 2310 2475 2631 2782 2922 2921 3181 3055 3297 3507 3600 3686 3685 3762 3831 3992 3945 4027 4056 4077 4091 4089 4088 4072 4070 4045 4012 3922 3921 3865 3799 3728 3646 3557 3460 3355 3242 3121 2992 2855 2710 2557 2396 2227 2050 1865 1672 1471 1262 1045  819  589  346   97
 219  464  701 1151 1150 1364 1569 1766 1955 2136 2309 2474 2780 2781 2779 3054 3179 3296 3405 3506 3599 3684 3761 3830 3891 3944 3989 4026 4055 4076 4090 4075 4074 4050 4071 4046 4013 3971 3923 3866 3727 3801 3647 3558 3461 3356 3243 3122 2994 2993 2856 2711 2558 2397 2051 1866 1673 1472 1263 1046  587  820   98   99
 217  218  700  929 1149 1363 1568 1765 1954 2135 2308 2473 2630 2920 3053 3178 3295 3404 3505 3598 3683 3682 3760 3829 3890 3943 3988 4025 4054 4053 4052 4051 4019 4048 4016 4014 3973 3972 3924 3867 3802 3729 3648 3559 3462 3357 3244 3123 2858 2995 2857 2559 2398 2228 2229 2052 1867 1473 1264 1047  588  821  348  347
 216  463  462  699  928 1362 1567 1764 1953 2134 2307 2472 2629 2778 2919 3052 3177 3294 3403 3504 3597 3681 3759 3828 3889 3942 3987 4024 4023 4022 4021 4073 4049 4018 4047 3978 4015 3974 3925 3868 3803 3730 3649 3560 3463 3358 3245 3124 2996 2713 2712 2399 2400 2230 2053 1674 1474 1475 1265 1049  822 1048  349  100
 215  461  698  927 1148 1361 1566 1763 1952 2133 2306 2471 2628 2777 2918 3051 3176 3293 3402 3503 3596 3758 3757 3827 3888 3941 3986 3985 3984 3983 3982 4020 3981 3980 4017 3979 3930 3975 3926 3869 3804 3731 3650 3561 3464 3359 3246 3125 2859 2714 2561 2231 2054 2402 1869 1868 1677 1266 1267 1050  350  591  351  101
 214  460  697  926 1147 1360 1565 1762 1951 2132 2305 2470 2627 2776 2917 3050 3175 3292 3401 3502 3595 3680 3826 3825 3887 3940 3939 3938 3937 3936 3935 3934 3933 3932 3931 3976 3977 3929 3870 3872 3805 3732 3651 3362 3563 3361 3360 3126 2997 2715 2401 2560 2562 2056 2055 1476 1478 1675 1268  824  590  592  825  102
 213  459  696  925 1146 1359 1564 1761 1950 2131 2304 2469 2626 2775 2916 3049 3174 3291 3400 3501 3594 3679 3756 3886 3823 3885 3884 3883 3882 3881 3880 3879 3878 3877 3876 3875 3928 3927 3873 3871 3806 3733 3652 3466 3562 3467 3247 3127 2998 2860 2861 2564 2403 2563 2232 1676 1872 1678 1051  823 1052  593  352  103
 212  458  695  924 1145 1358 1760 1949 1948 2130 2303 2468 2625 2774 2915 3048 3173 3290 3399 3500 3593 3755 3677 3753 3824 3822 3821 3820 3819 3818 3817 3816 3815 3814 3813 3810 3874 3739 3809 3736 3807 3734 3564 3465 3469 3250 3248 3000 2999 2718 2716 2717 2404 2233 2057 1870 1679 1477 1479  594  827  826  353  104
 457  694  923 1144 1357 1356 1563 1759 2129 2302 2301 2467 2624 2773 2914 3047 3172 3289 3398 3499 3592 3678 3674 3675 3752 3751 3750 3749 3748 3747 3746 3745 3744 3743 3811 3812 3661 3573 3808 3737 3658 3656 3735 3655 3565 3365 3128 3249 3130 2862 2863 2565 2235 2236 2234 1871 1873 1270 1680 1269  828  595  354  105
 211  456  692  693  922 1355 1562 1758 2128 2466 2465 2772 2771 2913 2911 3046 3171 3288 3397 3498 3591 3676 3754 3673 3491 3586 3489 3671 3670 3668 3667 3666 3665 3664 3742 3663 3741 3740 3660 3572 3570 3657 3653 3654 3363 3468 3364 3251 2720 2865 3001 2719 2406 2566 2058 2407 1874 1681 1053 1271  832  829  355  106
 210  455 1354 1143 1141 1142 1561 1946 1947 2127 2300 2464 2623 2622 2912 3045 3170 3287 3396 3497 3590 3589 3588 3587 3672 3584 3386 3583 3669 3486 3580 3579 3483 3576 3578 3662 3575 3478 3738 3571 3659 3569 3474 3566 3567 3470 3252 3253 2722 3131 2567 2405 2237 1876 2060 1875 1683 1480 1054 1055 1272  596  107  357
 209  454  691  920 1560 1558 1353 1757 1945 2126 2124 2619 2621 2620 2770 3044 3286 3285 3395 3496 3495 3494 3493 3492 3387 3276 3585 3487 3581 3485 3382 3484 3380 3481 3480 3577 3376 3479 3375 3476 3475 3473 3568 3472 3471 3366 3132 3129 3003 3002 2864 2866 2061 2059 2062 1056 1682 1482 1685 1273  598  600  830  108
 208  453  919 1140  921 1559 1755 1756 1754 2125 2298 2299 2297 2909 2910 3043 3169 3394 3393 3392 3279 3391 3390 3389 3275 3488 3385 3384 3582 3271 3381 3270 3379 3482 3378 3574 3377 3373 3477 3016 3142 3371 3369 3258 3368 3367 3254 3133 2724 2569 2867 2723 2568 2238 2240 1877 1684 1485 1275 1481 1484  599  597  831
 452  689  690 1138  918 1139 1557 1941 1944 2123 2462 2463 2769 2768 3041 3284 3168 3165 3283 3282 3162 3281 3278 3277 3490 3031 3388 3157 3274 3383 3151 3152 3269 3267 3148 3266 3146 3265 3264 3372 3262 3370 3141 3259 3138 3256 3255 3134 3004 2721 2570 2408 2242 2239 2410 1878 1483 1277 1060  601  358  110  356  109
 207  451  688  917 1137 1352 1556 1942 1753 2296 2294 2461 2618 2767 3040 3042 3167 3037 3164 3036 3038 3034 3280 3161 3159 3158 3032 3029 3154 3272 3273 3024 3149 3268 3020 3147 2883 3145 3374 3263 3015 3261 3260 3257 3139 3137 3135 3006 3005 2868 2725 2411 2409 2241 1879 2063 1274 1686 1276 1057 1058  359  361  111
 206  450  687  916 1350 1351 1555 1752 2122 1943 2460 2459 2617 2907 3039 2905 2904 3166 2902 3163 3160 3035 2898 3033 2753 2896 2893 3027 3153 2747 3023 3150 3022 2885 3019 3021 3018 2740 3143 3144 3014 3140 3012 3011 3136 3010 3009 3008 2870 2869 2572 2571 2412 2064 2065 1880 1687 1486 1059  834  833  113  360  114
 205  686  915 1136 1554 1135 1349 1751 1939 1750 2295 2614 2616 2765 2763 2908 2762 2903 2759 2901 2900 2899 2897 3030 2754 3156 3155 2895 2749 2889 2890 3025 2746 2887 2886 2592 2884 3017 2739 2881 2879 2878 3013 2875 2876 2874 2873 2730 3007 2872 2726 2573 2413 2243 2066 1881 1688 1487 1061  836  603  602  112  115
 204  202  914  684 1348  913 1749 1551 1553 2120 2292 2121 2458 2766 2764 2906 2611 2609 2758 2606 2605 2757 2755 2756 2894 3028 2600 2892 2891 3026 2748 2745 2888 2744 2591 2590 2741 2882 2588 2737 2586 2735 2734 2877 2733 2732 2731 2579 2729 2871 2727 2574 2244 2067 2068 1882 1689 1488 1278 1062  835  604  363  362
 201  203  449 1134 1347  685 1552 1550 1938 1940 2119 2293 2613 2615 2612 2452 2761 2610 2760 2607 2281 2604 2445 2603 2602 2443 2599 2750 2598 2597 2596 2595 2594 2743 2593 2742 2431 2589 2428 2261 2880 2736 2585 2583 2582 2581 2580 2578 2577 2728 2576 2575 2414 2245 1883 1884 1690 1489 1279 1063  837  605  365  364
 445  682  912  446  683 1133 1549 1346 2291 2290 2115 2456 2455 2454 2285 2450 2282 2449 2608 2448 2447 2446 2444 2442 2275 2751 2441 2440 2439 2438 2437 2436 2435 2267 2433 2432 2089 2430 2587 2738 2426 2259 2584 2424 2423 2422 2421 2420 2419 2418 2417 2416 2415 2246 2069 1490 1491 1492 1280 1064  838  606  118  367
 200  448  911 1132 1747 1342 1746 1937 2118 2116 1932 2289 2457 2288 2453 2451 2286 2284 2107 2106 2280 2278 2277 2752 2601 2276 2274 2273 2272 2271 2270 2269 2268 2264 2434 2265 2088 2262 2429 2260 2427 2258 2425 2257 2256 2255 2254 2253 2252 2251 2250 2249 2248 2247 2070 1691 1692 1283 1281 1065  839  840  366  119
 199  444  447  681 1345 1130 1343 1344 2117 1936 1933 2114 2112 2111 2287 1927 2109 1925 2283 2105 2104 2279 2103 2102 2101 2100 2099 2098 2097 2096 2095 2094 2093 2092 2266 2091 2090 2263 2087 2086 1903 2083 1900 2082 2081 2080 2079 2078 2077 2076 2075 2074 2073 2072 2071 1885 1886 1284 1282 1493  841  607  116  609
 442  197  443  680  910 1745 1935 1545 1744 1748 1742 1931 2113 1930 2110 1928 1735 2108 1926 1923 1922 1921 1920 1919 1918 1917 1916 1915 1914 1913 1912 1911 1910 1909 1908 1907 1906 1905 1904 1902 2085 2084 1709 1899 1898 1897 1896 1895 1894 1893 1892 1891 1890 1889 1888 1887 1693 1694 1285 1066  842  608  368  117
 678  441  198  679 1131 1129  909 1547 1934 1336 1740 1541 1738 1929 1737 1736 1536 1734 1924 1532 1732 1730 1729 1728 1727 1726 1725 1724 1723 1722 1721 1720 1719 1718 1717 1716 1715 1714 1713 1712 1901 1511 1710 1708 1707 1706 1705 1704 1703 1702 1701 1700 1699 1698 1697 1696 1695 1494 1068 1067  843  610  369  120
 196  438  676  906  907 1548 1128 1341 1546 1741 1544 1540 1539 1332 1538 1330 1329 1535 1733 1533 1731 1531 1530 1529 1528 1527 1526 1525 1524 1523 1522 1521 1520 1519 1518 1517 1516 1515 1514 1513 1711 1512 1510 1509 1508 1507 1506 1505 1504 1503 1502 1501 1500 1499 1498 1497 1496 1495 1286 1069  844  611  370  121
 195  439 1127  908 1124  670 1340 1743 1339 1543 1542 1739 1334 1116 1537 1331 1328 1327 1534 1326 1325 1324 1323 1322 1321 1320 1319 1318 1317 1316 1315 1314 1313 1312 1311 1310 1309 1308 1307 1306 1305 1304 1303 1302 1301 1300 1299 1298 1297 1296 1295 1294 1293 1292 1291 1290 1289 1288 1287 1070  845  612  371  122
 194  440  904  672 1125 1123 1122  900  897 1338 1335 1119 1333  894 1117 1115 1114 1113 1112 1111 1110 1109 1108 1107 1106 1105 1104 1103 1102 1101 1100 1099 1098 1097 1096 1095 1094 1093 1092 1091 1090 1089 1088 1087 1086 1085 1084 1083 1082 1081 1080 1079 1078 1077 1076 1075 1074 1073 1072 1071  846  613  372  123
 193  677  675  905  671  902 1126  898 1337  899 1120 1121 1118  895  893  892  891  890  889  888  887  886  885  884  883  882  881  880  879  878  877  876  875  874  873  872  871  870  869  868  867  866  865  864  863  862  861  860  859  858  857  856  855  854  853  852  851  850  849  848  847  614  373  124
 192  437  674  903  673  431  669  430  667  665  666  896  664  663  662  661  660  659  658  657  656  655  654  653  652  651  650  649  648  647  646  645  644  643  642  641  640  639  638  637  636  635  634  633  632  631  630  629  628  627  626  625  624  623  622  621  620  619  618  617  616  615  374  125
 191  436  434  433  187  901  185  429  668  181  427  179  425  424  423  422  421  420  419  418  417  416  415  414  413  412  411  410  409  408  407  406  405  404  403  402  401  400  399  398  397  396  395  394  393  392  391  390  389  388  387  386  385  384  383  382  381  380  379  378  377  376  375  126
 190  189  435  188  186  184  432  183  182  180  426  428  178  177  176  175  174  173  172  171  170  169  168  167  166  165  164  163  162  161  160  159  158  157  156  155  154  153  152  151  150  149  148  147  146  145  144  143  142  141  140  139  138  137  136  135  134  133  132  131  130  129  128  127
