# This puzzle is unsolvable
59
   2    1    3    4    6  237    7    8    9   10   11   12   13   14   15   16   17   18   19   20   21   22   23   24   25   26   27   28   29   30   31   32   33   34   35   36   37   38   39   40   41   42   43   44   45   46   47   48   49   50   51   55   54  509   56   57   59  288   60
 232  233  234  235    5  238  461  239  240  241  242  243  244  245  246  248  249  472  250  251  252  253  254  255  256  257  258  259  260  261  262  263  264  265  266  268  491  269  270  271  272  273  274  275  276  277  278  279  281  282  283  506   53   52  508  285  287   58  290
 231  456  457  459  236  460  676  462  463  464  465  467  682  468  469  470  247  471  473  474  475  476  477  478  479  480  481  482  483  484  485  486  487  488  489  490  267  492  493  494  495  496  497  498  499  500  501  502  280  720  719  721  722  507  510  286  512  289  511
 230  455  672  458  674  675  677  678  885  679  681  888  466  683  892  893  684  687  688  689  690  691  692  693  694  695  696  697  698  699  700  701  702  703  704  913  705  707  708  709  710  711  712  713  714  715  716  503  717  718  504 1127  284  724  929  725   64   62   61
 229  454  671  673  881  882  883  884 1084  887  680  889  890  891  685  686 1092  894  895  896  897  898  899  900  901  902  903  904  905  906  907  908  909  911 1110 1302 1112  914  915  916  917  918  919  920 1120  921 1313 1123  923  505  927 1317  928  723  514  727  726  292  294
 228  453  670  880 1080 1081 1082 1083 1085  886 1086 1087 1088 1089 1090 1091 1093 1094 1285 1095 1096 1097 1098 1099 1100 1101 1102 1103 1104 1105 1106 1107 1108 1109  912  706  910 1113 1114 1115 1116 1117 1118 1119 1310 1495  922 1121  924  926 1125 1675 1128  930  933  931  729   65  291
 227  452  669  879 1079 1272 1273 1274 1275 1276 1277 1278 1279 1280 1281 1282 1283 1284 1468 1286 1287 1288 1289 1290 1291 1292 1293 1294 1295 1296 1297 1298 1300 1111 1301 1485 1303 1304 1305 1489 1306 1307 1309 1493 1311 1312 1124 1314  925 1318 1674 1500 1126 1130  932  513  293   63   66
 451  450  877  878 1078 1271 1456 1457 1458 1459 1460 1461 1462 1463 1464 1465 1466 1642 1467 1469 1470 1471 1472 1473 1474 1475 1476 1477 1478 1479 1480 1481 1299 1482 1484 1827 1486 1488 1830 1664 1490 1308 1491 1492 1496 1672 1671 1498 1499 1122 1129 1319 1502 1501 1320  515  730  516  295
 226  449  668  876 1077 1270 1455 1632 1633 1634 1635 1636 1637 1638 1639 1640 1807 1809 1643 1644 1645 1646 1647 1648 1649 1650 1651 1652 1653 1654 1655 1656 1657 1483 1659 1661 1662 1487 1663 1831 1666 1993 1835 1670 1836 1494 1837 1497 1315 1840 1316 1504 1132 1131  517  936  728  296   67
 225  666  667  875 1076 1269 1454 1631 1800 1801 1802 1803 1963 1804 1806 1965 1641 1808 1810 1811 1812 1813 1814 1815 1816 1817 1818 1819 1820 1821 1822 1823 1824 1658 1660 1825 1828 1989 1990 1665 1832 1667 1992 1668 1994 1996 1838 1841 1673 1321 1133 1677 1676  935  934  520  732  518   68
 224  448  665  874 1075 1268 1453 1630 1799 1960 1961 1962 1805 2116 2117 1966 1967 1968 1969 1970 1971 1972 1973 1974 1975 1976 1977 1978 1979 1980 1981 1982 1983 1984 1826 1985 1829 1986 1988 2141 1834 1833 2145 1669 2146 2147 1997 1999 2000 1503 1323 1322 1324 1134  937  299  731  519  521
 223  447  664  873 1074 1267 1452 1629 1798 1959 2113 2255 2114 1964 2258 2118 2261 2119 2120 2121 2122 2123 2124 2125 2126 2127 2128 2129 2130 2131 2132 2133 2134 2135 2280 2137 1987 2139 2140 2284 1991 2143 2144 1995 2148 2149 1839 1998 2001 1844 1505 1680 1325 1136 1135  938  298   69   70
 222  446  663  872 1073 1266 1451 1628 1797 1958 2112 2256 2257 2259 2394 2395 2524 2263 2398 2265 2400 2266 2267 2268 2269 2270 2271 2272 2273 2274 2275 2276 2277 2278 2136 2279 2138 2282 2283 2285 2142 2286 2287 2288 2289 2425 2290 2150 1679 1843 1842 1506 1326  942  733  300   71  297   72
 221  220  662  871 1072 1265 1450 1626 1627 2110 1796 2111 2392 2393 2115 2260 2262 2397 2399 2264 2401 2528 2402 2403 2404 2405 2406 2407 2408 2409 2410 2411 2412 2413 2414 2415 2281 2417 2418 2419 2420 2421 2422 2423 2424 2426 2292 2291 2002 1681 1138 1508  734  941  736  735  302 1137  522
 219  445  661  443  870 1070 1264 1449 1955 1795 1957 2254 2391 2520 2640 2396 2522 2643 2525 2526 2527 2529 2648 2530 2531 2532 2533 2534 2535 2536 2537 2538 2539 2540 2541 2542 2416 2544 2545 2546 2547 2667 2548 2549 2551 2428 2152 2151 2427 1510 1507 1682 1678  940  523  737  939  301   74
 218  444  869 1069  868 1448 1625 1794 1793 1956 2109 2108 2253 2519 2639 2521 2753 2523 2644 2645 2646 2647 2759 2649 2650 2651 2652 2653 2654 2655 2656 2657 2658 2659 2660 2661 2543 2662 2663 2664 2666 2778 2668 2550 2552 2154 2429 2294 2293 1846 1683 2003 1328 1327 1139  943  738   73  303
 217  442  660 1262 1068 1071 1263 1624 1791 1792 2107 2251 2252 2518 2389 2642 2752 2856 2755 2756 2757 2861 2758 2760 2761 2762 2763 2764 2765 2766 2767 2768 2769 2770 2771 2772 2773 2774 2775 2665 2777 2670 2779 2669 2553 2296 2298 2153 2005 2007 1845 2004 1329 1140  739  305  524  525   75
 216  657  659  867 1261 1446 1447 1623 1790 1954 2106 2250 2388 2390 2638 2751 2754 2641 2857 2858 2859 2860 2862 2863 2864 2865 2866 2867 2868 2869 2870 2871 2872 2873 2874 2875 2876 2877 2878 2776 2881 2975 2780 2882 2554 2555 2295 1849 1684 1511 1847 1685 1330 1331 1141  944  306  304   76
 215  658  441  866 1067 1260 1445 1622 1953 1952 2105 2387 2516 2515 2517 2750 2855 2952 2953 2954 2955 2956 2957 2958 2959 2960 2961 2962 2963 2964 2965 2966 2967 2968 2969 2970 2971 2972 2973 2879 2880 2782 2673 2671 2672 2556 2156 2006 2155 1848 1144 1509 1332  946  740  527  531  528  526
 214  440  656  865 1066 1259 1444 1621 1951 1950 2104 2249 2386 2636 2637 2749 2854 2951 3040 3041 3042 3043 3044 3045 3046 3047 3048 3049 3050 3051 3052 3053 3054 3055 3056 3057 3058 3059 3060 2974 2883 2977 2781 2431 2674 2157 2158 2430 1686 1852 2008 1333 1850  945  741  742   77  529  307
 213  439  438  864 1065 1258 1443 1620 1789 1949 2103 2248 2385 2514 2635 2748 2853 2950 3039 3120 3121 3122 3123 3124 3125 3126 3127 3128 3129 3130 3131 3132 3133 3134 3135 3136 3137 3138 3139 3061 2976 2978 2884 2675 2557 2432 2297 2009 1851 1687 1516 1512 1514  948 1145 1142  532   78  308
 212  655  436  863 1064 1257 1442 1619 1787 2102 2101 2247 2384 2513 2634 2747 2852 2949 3038 3119 3192 3194 3256 3195 3196 3197 3198 3199 3200 3201 3202 3203 3204 3205 3206 3207 3208 3209 3140 3064 3062 3063 2783 2885 2558 2434 2299 2433 2159 1854 1515 1517 1334 1513 1143  309  947   79   80
 211  437  654  653 1063 1256 1441 1618 1948 1947 1788 2246 2383 2512 2633 2746 2851 2948 3037 3118 3191 3255 3193 3258 3259 3260 3261 3262 3263 3264 3265 3266 3267 3268 3269 3270 3271 3210 3141 3065 2979 2886 2784 2676 2559 2435 2300 2011 1853 2010 1688 1518 1335  743  949  744  530  310   81
 210  435  652  862 1252 1062 1617 1785 1616 1946 1786 2245 2382 2511 2632 2745 2850 2947 3036 3117 3190 3310 3257 3313 3314 3315 3316 3317 3318 3319 3320 3321 3323 3370 3324 3325 3272 3211 3142 2980 2887 2786 2785 2677 2560 2301 2161 2160 2012 1690 1689 1337 1336  950 1146 1148  311   82   83
 209  434  860  859  861 1255 1440 1615 2098 1614 2100 2244 2381 2510 2631 2743 2744 2946 3034 3035 3116 3189 3312 3311 3359 3362 3363 3364 3365 3367 3407 3369 3408 3322 3371 3326 3273 3212 3143 3066 2981 2888 2787 2678 2561 2436 2302 2304 2013 1856 1855 1691  951 1147  745  746  533  313  312
 208  433  651  429 1254 1439 1253 1783 1437 1945 2099 2243 2380 2509 2629 2849 2848 2945 3033 3115 3188 3254 3253 3361 3360 3400 3402 3403 3404 3366 3368 3438 3439 3409 3372 3327 3274 3213 3144 3067 2982 2889 2679 2562 2437 2305 2162 2303 2163 2014 1519 1339 1338 1149  952  747  534   84   85
 206  207  858 1061 1059 1060 1438 1784 1943 1944 2097 2242 2379 2741 2847 2630 2627 2944 3114 3113 3187 3252 3309 3358 3399 3401 3433 3405 3457 3435 3406 3437 3440 3410 3373 3328 3275 3214 3145 3068 2983 2890 2788 2789 2563 2438 2306 2164 1858 1857 1692 1693 1520 1150  953  748  535  315  314
 205  649 1782  431 1435 1058 1436 1613 1612 2096 2241 2240 2377 2505 2742 2508 2507 3032 2844 3112 3186 3251 3308 3357 3398 3432 3434 3431 3458 3436 3459 3460 3461 3411 3374 3329 3276 3215 3146 3069 2984 2891 2790 2564 2680 2565 2165 2166 2015 2016 1859 1521 1340 1151  954  536  316   87  537
 648  432  650  857  647 1251 1609 1781 1611 1942 1778 2626 2378 2740 2845 2941 2943 2846 3030 3031 3185 3250 3307 3356 3397 3430 3455 3456 3472 3473 3475 3462 3441 3412 3375 3330 3277 3216 3147 3070 2985 2892 2681 2791 2439 2682 2440 2307 2018 1860 1694 1341 1342  955  749  751  750   86   88
 204 1057  855  854 1249 1434 1250 1940 1780 1941 2095 2239 2737 2506 2738 2736 2628 2940 2739 3111 3184 3249 3306 3355 3396 3429 3454 3471 3480 3474 3476 3463 3442 3413 3376 3331 3278 3217 3148 3071 2986 2893 2792 2683 2566 2441 2308 2017 2167 1861 1695 1696 1522 1152 1153  539  318  538   89
 646  203  856  430 1053 1248 1055 1938 1779 2094 2375 2092 2624 2842 2502 2501 2942 2939 3029 3110 3183 3248 3305 3354 3395 3428 3453 3470 3479 3478 3477 3464 3443 3414 3377 3332 3279 3218 3149 3072 2987 2894 2793 2684 2567 2442 2309 2168 2019 1862 1524 1523 1343  957  956  319  752  317   90
 427  201  426  645 1056 1431 1246 1247 1433 2093 2238 2237 2376 2843 2503 2623 2841 3028 3108 3109 3182 3247 3304 3353 3394 3427 3452 3469 3468 3467 3466 3465 3444 3415 3378 3333 3280 3219 3150 3073 2988 2895 2794 2685 2568 2443 2310 2020 1863 1698 1697 1525 1155 1154 1156  959  958  753  540
 428  202  644  643  851  852 1608  853 1939 1936 1937 2087 2374 2373 2504 2622 2734 2625 3107 3026 3181 3246 3303 3352 3393 3426 3451 3450 3449 3448 3447 3446 3445 3416 3379 3334 3281 3220 3151 3074 2989 2896 2795 2686 2569 2444 2311 2169 2021 1864 1699 1526 1344 1158  756  754  541  320   91
 198  199  642 1051 1054 1245 1429 1605 1432 1777 1776 2236 2235 2091 2371 2621 3027 2839 2937 3106 3180 3245 3302 3351 3392 3425 3424 3423 3422 3421 3420 3419 3418 3417 3380 3335 3282 3221 3152 3075 2990 2897 2796 2687 2570 2445 2312 2170 2022 1865 1700 1527 1345  961  960  543  542  321   92
 424  200  425  849 1052 1610 1603 1430 1607 1774 2233 2234 2372 2370 2840 2935 2619 3025 2936 3105 3179 3244 3301 3350 3391 3390 3389 3388 3387 3386 3385 3384 3383 3381 3338 3336 3283 3222 3153 3076 2991 2898 2797 2688 2571 2446 2313 2171 2023 1867 1866 1702 1701 1346 1157 1347  755  322   93
 641  850  639  640 1050 1606 1244 1427 1935 2090 1773 1934 2089 2733 2500 2938 2732 2735 3023 3024 3178 3243 3300 3349 3348 3347 3346 3345 3344 3343 3341 3288 3289 3340 3382 3337 3284 3223 3154 3077 2992 2899 2798 2689 2572 2447 2314 2172 2024 1868 1529 1348 1528 1159  962  757  544  323   94
 197  638  421  422 1049 1243 1241 1242 1933 1772 2088 2369 2499 2497 2618 2730 2838 2934 2836 3104 3177 3242 3299 3298 3297 3296 3295 3294 3293 3292 3342 3164 3290 3339 3287 3286 3226 3285 3155 3078 2993 2900 2799 2690 2573 2448 2315 2173 2025 1703 1704 1530 1349 1160  963  758  545  324   95
 420  423  637  844  846 1428 1426 1604 2086 1775 2231 2230 2232 2367 2620 2368 2837 2731 3022 2933 3176 3241 3240 3239 3238 3237 3236 3235 3234 3233 3291 3232 3230 3228 3087 3227 2908 3159 3224 3079 3080 2994 2901 2800 2574 2449 2316 2174 2026 1705 1869 1532 1161 1162  759  760  546  325   96
 193  195  845  848  419  635 1425 1769 1602 1048 2083 1932 2496 2498 2617 2729 2835 2931 2932 3103 3102 3099 3174 3173 3171 3170 3169 3168 3165 2916 3231 3005 3163 3229 3161 3160 3001 3157 3158 3156 2902 2801 2693 2691 2575 2317 2176 2175 2177 1870 1351 1531 1350  964 1352  761  547  326   97
 636  196  634  847 1045 1240 1239 1601 1770 1771 2229 1930 2084 2365 2615 2616 2834 2833 3101 3021 3175 3100 3098 3172 3097 3095 3094 3167 2918 3090 3007 3162 3092 3008 3088 3002 2909 3083 3082 3000 2995 2903 2692 2576 2451 2450 2452 2027 2318 1871 1706 1533 1163 1164  965  762  548  327   98
 190  194  418  843 1238 1047 1424 1423 1768 1931 2085 2227 2228 2366 2614 2727 2728 2930 3020 3018 3017 3016 3015 3014 3096 3012 3011 3009 2819 3093 3166 2917 2815 3003 2706 2813 3086 2999 2809 2998 2996 2904 2802 2578 2321 2454 2180 2030 2028 1872 1707 1534 1353 1165  967  966  549  328   99
 192  417  842 1046 1237 1236 1422 1600 1599 2081 2082 2364 2494 2495 2726 2831 2929 2928 3019 2828 2927 2925 2922 2924 3013 2823 2921 2920 3010 3091 2816 3004 2913 2914 2912 2811 2911 3085 2807 3081 2907 2805 2577 2803 2453 2905 2319 2029 2178 1873 1709 1708 1535 1355  968  763  550  329  100
 191  416  841 1044 1421 1420 1419 1598 1767 1929 1928 2226 2491 2493 2362 2832 2724 2830 2829 2926 2604 2923 2826 2717 2824 2822 2821 2820 2919 3089 2818 3006 2915 2814 2705 2588 3225 2910 2997 2702 2808 2804 2694 2582 2579 2585 2320 2179 1874 2032 1536 1537 1166 1354  969  764  551  330  101
 413 1043  632  633 1235 1234 1596 1597 1766 1927 2080 2225 2363 2490 2612 2608 2609 2607 2606 2485 2605 2720 2603 2719 2716 2715 2714 2712 2711 2817 2710 2337 2708 2707 2812 2810 2587 2586 2465 2906 2584 2701 2699 2695 2697 2322 2580 2182 2181 2033 1875 1710 1356 1167  970  765  552  331  102
 414  189 1042  415  839 1041 1233 1595 1765 1926 2079 2224 2361 2611 2492 2613 2725 2354 2722 2721 2827 2825 2348 2601 2600 2476 2475 2599 2597 2473 2595 2709 2593 2594 2589 2590 2704 2332 3084 2463 2333 2698 2461 2458 2581 2323 2455 2456 2031 1711 1538 1539 1357 1168  971  766  553  332  103
 631  188  630  840 1039 1040 1418 1764 1925 1924 2223 2222 2360 2488 2357 2610 2723 2216 2484 2480 2479 2718 2349 2477 2478 2346 2343 2474 2596 2056 2339 2471 2338 2591 2467 2466 2335 2703 2194 2462 2700 2190 2459 2583 2457 2696 2183 2034 2035 1876 1877 1170 1540 1359  972  767  554  333  104
 187  412  629  837  838 1232 1417 1594 1763 2077 2078 2358 2220 2489 2356 2487 2355 2353 2214 2482 2483 2602 2351 2210 2347 2598 2205 2202 2342 2054 2340 1899 2472 2592 2468 2336 2196 2334 2464 2329 2460 2806 2187 2328 2327 2326 2324 2184 2036 1879 1712 1541 1358 1169  973  768  555  334  105
 186  411  628 1038 1037 1231 1416 1593 1762 1923 2076 2221 2219 2072 2359 2218 2486 2066 2213 2352 2481 2212 2350 2209 2208 2345 2059 2713 2341 1900 2057 2470 1898 2469 2198 2050 2197 2195 1893 2331 2044 2330 2189 2042 2188 2186 2185 2039 1878 2037 1713 1714 1360 1171  974  769  556  335  106
 184  410  625  627 1036 1230 1415 1592 1761 1922 2075 2074 2073 2071 2070 2217 2069 1914 2215 1912 2211 2064 2063 2062 2061 2344 1905 2206 2204 1902 1568 1739 2200 2203 2051 1894 1559 2048 1891 2192    0 2043 1888 2191 2041 1884 2325 1883 1880 1881 1715 1542 1361 1172  975  770  557  336  107
 409  185  836  626  835 1229 1414 1591 1760 1921 1920 1919 1918 1917 1752 1753 1915 1750 2067 1748 1911 1908 1745 1907 2060 2207 1903 2058 1738 1735 1737 2199 2053 1897 1733 2049 2047 1730 2046 2045 2193 1890 1889 1887 1723 1720 2040 1882 1719 2038 1716 1543 1362 1173  976  771  558  337  108
 183  182  834  833 1035 1228 1413 1590 1759 1758 1757 1756 1583 1582 1913 1751 1747 1749 1576 2065 1910 1909 1574 1744 1906 1742 1904 1390 1741 1567 1901 2055 1564 2052 1896 1895 1731 1193 1892 1728 1727 1726 1724 1552 1722 1721 1885 1886 1548 1718 1717 1544 1363 1174  977  772  559  338  109
 407  624  408 1034 1033 1227 1412 1589 1588 1587 1586 1584 1754 1916 1755 1402 1579 1578 2068 1577 1575 1746 1573 1572 1743 1392 1571 1570 1569 1565 2201 1388 1736 1563 1734 1732 1560 1379 1729 1557 1556 1555 1725 1554 1553 1551 1550 1549 1369 1547 1546 1545 1364 1175  978  773  560  339  110
 622  404  180  831  832 1411 1028 1410 1408 1220 1023 1585 1406 1404 1581 1403 1580 1215 1399 1398 1397 1396 1208 1394 1393 1205 1391 1389 1387 1740 1566 1386 1385 1383 1561 1562 1382 1558 1194 1378 1377 1376 1375 1374 1373 1372 1371 1370 1368 1181 1367 1366 1365 1176  979  774  561  340  111
 181  406  405 1032 1225 1029 1223 1027 1221 1407 1025 1219 1405 1218 1216 1214 1401 1400 1213 1211 1210 1209 1013 1395 1207 1206 1204 1203 1202 1201 1200 1199 1198 1384 1196 1000 1195 1380 1381 1192 1191 1190 1189 1188 1187 1186  989 1184 1183 1182 1180 1179 1178 1177  980  775  562  341  112
 621  179  178  830 1031 1226 1030 1224 1409 1026  821  820 1022 1217 1021 1020 1019 1018 1212 1016 1015 1014  810 1012 1011 1010 1009 1008 1007 1006 1005 1004 1003 1197 1002 1001  999  998  997  996  995  994  993  992  991 1185  990  786  987  986  985  984  983  982  981  776  563  342  113
 620  619  172  623  617  827  174  823 1222 1024  609  822  610  819  818  817  816  815 1017  814  812  811  599  809  808  807  806  805  804  803  802  801  800  799  798  797  796  795  794  793  792  791  790  789  788  787  785  988  784  783  782  781  780  779  778  777  564  343  114
 403  399  402  829  170  826  828  614  825  393  615  612  390  608  607  606  605  604  603  813  380  600  598  152  597  595  376  594  593  592  591  590  589  588  587  586  585  584  583  582  581  580  579  578  577  576  575  574  573  572  571  570  569  568  567  566  565  344  115
 177  400  401  618  171  616  397  167  824  613  611  391  163  389  388  387  386  385  157  602  156  155  601  378  377  150  596  375  374  373  372  371  370  369  368  367  366  365  364  363  362  361  360  359  358  357  356  355  354  353  352  351  350  349  348  347  346  345  116
 175  176  173  398  396  169  168  395  394  166  392  165  164  162  161  160  159  158  383  381  384  382  379  154  153  151  149  148  147  146  145  144  143  142  141  140  139  138  137  136  135  134  133  132  131  130  129  128  127  126  125  124  123  122  121  120  119  118  117
