# This puzzle is unsolvable
8
37 31 45 23 61  1 20  6
39 50 21 22 55 41 30 60
28 52 35 36  7 33 53 18
59 29 19  4 17 25 47  9
48 14 54 16 58 15 49 42
26  8  5 27  0 38 24 46
 2 12 62 44 34 56 13 11
 3 32 51 43 40 10 57 63
