# This puzzle is unsolvable
44
   3  172    1  493    6  179  340    8    9   11  183  182  184  506  187   16  188   17   18   21   22  356   24  357   25  194   26   27   28   29   31   32   33   34   36  206   37   38   39   40   41   42   43   44
 169  174  171  492    4  178  497  343  341  181   10   12   15  350   13  186  504  189   19  658   23  191  193  196  195  359  198   30  364  516  202  203  204  205   35  207  208  209  210  211  212  213  214   45
 334    2  337  338  642    5    7  783  645  180  346  185  347  502  348  791  651  355  349  354  352  657  508  358  515  360  362  200  363  201  365  366  522  367  368  369  371  372  373  374  375  376  215   46
 170  335  495  491  175  344  177  498  345  499  342  649  650  503  792  923  653  505  652  796   20  656  192  514  798  513  802  197  199  664  665  668  521  523  524  370  526  527  528  529  530  216  378   47
 490  173  641  332  912  176  496  339  500  646  647  501  922  789   14  507  654  351  655  510  190  800  512  928  797  662  661  801  518  517  520  666  669  670  671  525  673  674  675  676  531  377  217   48
 336  333    0  640  494  913  644  914  784  785  786  648  788 1042 1043  790  921  353 1049  793  511  795 1168 1273  660  933  361 1170  667  804  806  938  807  810  811  812  943  815  814  533  678  532  218   49
 165  638  166  637  779  778  910  911  915 1038  916 1040  787  917 1044  919  925  794 1163 1166  509 1052 1169  659  930 1172  803  663  805  519  936 1059  808  809  941  940 1066  816  813  677  534  381  380   50
 164  167  168  488  909 1035  635  643 1152 1039 1041 1156  918 1158 1045 1159  924  926  927 1051 1050  929  799 1053  932 1057  934  931 1173 1175 1176 1060  939 1063 1182 1181  672  942  944  817  383  379  382  219
 486  163  331  330  906  780 1260  781 1036 1261 1153 1155 1264 1157  920 1160 1046 1047 1161 1048 1054 1272 1275 1056 1277 1278 1377 1058  935 1174 1061 1062 1178 1064 1179 1065 1068  680  679  947  535  946  224  220
 636  774  489  908  634 1149  782 1037 1258 1154 1262 1362 1263 1265 1266 1267 1268 1369 1269 1164 1463 1371 1165 1276 1167 1376 1055 1279 1281 1282  937 1283 1177 1383 1384 1067 1070 1180  818  948  536  222  221   51
 329  162  487  777  639  485 1151 1033  907 1259 1452 1361 1364 1365 1366 1539 1540 1368 1270 1162 1546 1372 1465 1274 1469 1551 1380 1550 1280 1381 1382 1284 1285 1287 1385 1286 1069  945  682  681  537  223   54   52
 483  632  327  776  484  775 1034 1148 1358 1360 1359 1454 1363 1455 1457 1367 1616 1461 1370 1271 1462 1464 1373 1374 1375 1470 1171 1553 1379 1471 1472 1473 1387 1474 1386 1288 1183  820  819  683  386   53   56   55
 160  328  161 1032  633 1031 1255 1030 1150 1257 1357 1453 1537 1538 1541 1456 1459 1458 1460 1544 1545 1686 1548 1466 1549 1467 1468 1693 1628 1555 1556 1475 1476 1184 1289 1071  950  949  951  385  538  539   57   58
 326  481  772  631  325  904 1147 1256 1451 1450 1536 1535 1612 1614 1681 1617 1542 1684 1618 1619 1547 1620 1622 1623 1624 1625 1552 1378 1626 1554 1630 1557 1477 1388 1292 1185 1186 1072  541  684  952  685  226  227
 323  482  159  630  905  773 1029 1254 1146 1448 1356 1449 1611 1680 1613 1615 1683 1743 1543 1685 1687 1621 1689 1690 1750 1691 1692 1694 1627 1755 1629 1695 1631 1290 1389 1291 1073 1074  821  225  384  387   59  229
 158  324  478  321  771  629 1028 1145 1355 1354 1447 1534 1610 1679 1740 1682 1741 1744 1795 1745 1746 1688 1748 1749 1801 1751 1752 1754 1634 1698 1633 1558 1559 1478 1293 1187 1075  953  954  823  822  686  230   60
 156  479  628  480  769  770  903 1142 1143 1253 1532 1533 1609 1678 1739 1793 1742 1794 1796 1840 1747 1841 1798 1800 1844 1802 1803 1696 1699 1756 1700 1632 1479 1390 1294 1188  543  826  689  688  388  393  390  389
 322  477  627  768  902  900 1252 1027 1144 1353 1446 1531 1608 1737 1872 1738 1836 1837 1874 1838 1797 1799 1843 1879 1845 1881 1753 1701 1804 1757 1560 1697 1480 1391 1392 1189 1076  687  825  824  392   61   62  228
 154  157  155  476  767  899  901 1026 1025 1352 1445 1530 1677 1736 1791 1873 1790 1870 1835 1839 1875 1905 1842 1878 1880 1847 1846 1758 1805 1561 1635 1562 1481 1296 1295 1078 1077  957  827  542  544  540  232  231
 319  320  625  626  766  898 1024 1141 1251 1250 1444 1529 1607 1733 1676 1792 1788 1832 1871 1901 1902 1877 1904 1924 1906 1848 1807 1806 1808 1636 1394 1565 1482 1191 1190 1192 1079  690  955  396  828  545   63  546
 153  318  475  765 1023  764 1140 1249 1248 1351 1443 1605 1606 1675 1525 1789 1674 1833 1920 1930 1903 1876 1922 1925 1907 1883 1882 1849 1809 1760 1702 1484 1564 1483 1298 1297  958  959  829  691  692  391  234   64
 152  317  474  624  763  896  897 1022 1139 1350 1349 1524 1528 1785 1734 1735 1900 1834 1831 1919 1898 1923 1935 1934 1908 1884 1850 1810 1563 1759 1638 1637 1396 1485 1393 1080 1081  830  832  693  548  956  694  394
 150  316  473  623  622 1021 1020 1137 1138 1247 1526 1441 1527 1732 1673 1786 1787 1897 1921 1932 1931 1933 1929 1926 1909 1885 1851 1762 1640 1703 1704 1639 1398 1194 1193 1395  960  695  237  395  397  550   67  238
 315  151  472  762  895  761 1019 1246 1346 1348 1442 1347 1672 1784 1604 1728 1899 1869 1868 1918 1891 1916 1928 1927 1910 1852 1811 1812 1708 1761 1567 1641 1397 1299 1300 1195  834 1082  549  547  233  398   68   65
 149  314  470  621  620  893  894 1136 1345 1245 1440 1523 1603 1730 1731 1827 1866 1830 1867 1893 1895 1917 1912 1890 1911 1886 1763 1764 1705 1706 1566 1487 1486 1399 1301 1083  961 1086  697  831  696  399   69   66
 148  313  619  471  760 1018 1017 1135 1438 1344 1783 1671 1439 1601 1781 1600 1670 1829 1896 1894 1861 1892 1914 1858 1889 1887 1853 1813 1707 1709 1642 1568 1569 1488 1302 1196  963  964  962  835  551  401  240  235
 147  312  469  618  759  892 1134 1133 1244 1437 1599 1602 1668 1669 1727 1729 1865 1828 1864 1822 1859 1915 1860 1913 1888 1857 1854 1855 1765 1643 1490 1644 1489 1400 1303 1085 1197  965  833  837  236  404  701   70
 146  311  468  617  758  891 1016 1132 1243 1343 1521 1522 1598 1667 1780 1778 1782 1824 1863 1862 1823 1716 1820 1655 1714 1652 1816 1815 1766 1767 1570 1402 1401 1492 1304 1088 1199 1084  966  698  239  552   71  402
 145  310  467  616  757  890 1015 1241 1242 1342 1436 1597 1666 1665 1779 1725 1826 1825 1777 1776 1773 1775 1718 1717 1818 1856 1817 1769 1768 1710 1645 1571 1491 1305 1306 1200 1198  700 1087  553  702  699  242  403
 144  309  466  615  756  889 1014 1131 1240 1341 1435 1596 1664 1593 1726 1662 1724 1723 1659 1722 1721 1656 1657 1719 1653 1814 1771 1770 1713 1646 1573 1574 1572 1404 1403 1201  836  840  556  241  400  243   74   72
 143  308  465  614  755  888 1013 1130 1239 1340 1433 1520 1519 1663 1592 1515 1591 1661 1660 1658 1720 1585 1821 1772 1583 1819 1651 1650 1649 1711 1648 1575 1493 1494 1307  968 1203  838  839  555  554   73  246   76
 142  307  464  613  754  887 1012 1129 1238 1338 1517 1434 1518 1514 1424 1426 1513 1589 1587 1588 1774 1586 1584 1582 1581 1502 1580 1579 1577 1712 1576 1495 1496 1309 1308 1405  970  971  967  558  405  406  559   75
 141  306  463  612  753  886 1011 1128 1237 1432 1339 1594 1595 1331 1511 1512 1590 1510 1422 1326 1507 1419 1715 1506 1654 1503 1501 1500 1578 1499 1647 1498 1497 1407 1406 1092 1093 1090  703  841  407 1089  245  244
 140  305  462  752  751  885 1010 1127 1236 1337 1429 1431 1516 1332 1427 1423 1329 1421 1509 1420 1505 1323 1322 1417 1504 1415 1414 1413 1412 1316 1410 1409 1209 1313 1311 1202 1206 1091  972  707  408  969  705  557
 139  304  461  611  750  884 1009 1126 1235 1336 1430 1335 1428 1334 1229 1425 1327 1328 1223 1224 1325 1324 1508 1220 1416 1321 1319 1318 1317 1315 1411 1211 1312 1204 1207 1094  843  842  973  706  247  704  561   78
 138  303  460  610  883  882 1008 1125 1234 1232 1121 1231 1333 1228 1330 1227 1226 1114 1225 1112 1222 1219 1418 1218 1217 1320 1216 1215 1214 1213 1212 1408 1314 1210 1205 1310  976 1095  844  562  560   77   79   80
 136  137  608  609  749 1007 1005 1004 1123 1233 1002 1120 1230 1119 1118 1116 1115  868 1113  993 1110 1221 1109 1108 1107 1106 1105 1104 1103 1102 1101 1100 1099 1098 1208 1097  977  846  708  709  563  409  249   81
 135  302  459  607  748  881 1006  878  875  877 1122 1001 1000  998 1117  996  870  995  867  994 1111  991  990  989  988  987  986  985  984  983  982  981  980  979  715 1096  975  974  845  564  410  248  411  250
 134  300  301  606  880  746  742 1124  741  740  876  874  873  999  871  735  997  733  866  865  992  864  863  862  861  860  859  858  857  856  855  854  853  852  978  851  849  850  847  710  412  251  252   82
 133  299  458  605  453  450  291  743  744 1003  448  739  737  872  592  591  593  734  732  731  730  729  728  727  726  725  724  723  722  721  720  719  718  717  573  716  714  848  713  711  565  414  413   83
 298  132  457  126  745  601  452  122  289  600  598  596  738  736  594  441  869  590  589  588  587  586  585  584  583  582  581  580  579  578  577  576  575  574  572  421  571  570  712  566  568  567  415   85
 131  127  604  294  456  747  879  599  290  449  597  446  444  595  443  283  440  439  438  437  436  435  434  433  432  431  430  429  428  427  426  425  424  423  422  262  420  419  569  417  416   84  253  254
 296  128  129  454  297  602  293  447  120  287  445  285  119  117  282  442  281  280  279  278  277  276  275  274  273  272  271  270  269  268  267  266  265  264  263  261  260  259  418  258  257  256  255   86
 130  295  125  455  292  451  603  124  123  288  121  286  118  116  284  115  114  113  112  111  110  109  108  107  106  105  104  103  102  101  100   99   98   97   96   95   94   93   92   91   90   89   88   87
