# This puzzle is unsolvable
15
 60   6  61 151   9  62  55 110  66  11 112  15  68  12  14
 52   1  54   3  63   7 107  10 182  65 111 119  67  70  69
  2 172  57 148  51 176 149 144 150   8 154  13 183  19  16
196 104 147 140 108 146 217 198 113 205 115 114  17  77  72
 58 105 106  97 142 173 175 162  71   4 159 156 208 186 118
 56  53 139 137 103   5 202  23 200 178 184  64 116 117  73
177 169  98  59 109 211 199 221 127 152 185  18  22 121  20
129 101 138 100  99 180 223  21 163 179 153 219 124  79  81
 91  95 181 215 210 201  87 194  50 158  25 191 120  24 204
 48  45  46 195 206 224 170 207 131 192  35 155 190  28 123
165 135 102 141 216 133 145  89 214  74 161 122   0 160 125
174  44  38  90  47 222 143  42  33 189 157  75 126  76  29
 37  88  43 136 168  92 197  83 128  86  34 166 188  84 218
212  94  40  96 171  85  80  93  78 130  41  31  27  82 220
213 167  39  49 203 132 134 193  36 164 187  32 209  30  26
