# This puzzle is unsolvable
9
29 80  9 74 33  5 39  8  6
45  0 79 76  2 34 30  7 14
26 13 15  4 20 11 16 23 73
56 22 55 59 38 78  1 54  3
71 41 17 42 25 12 67 57 63
69 65 53 36 62 18 48 52 24
58 44 32 61 72 70 46 77 64
60 35 28 47 19 75 40 50 37
31 68 51 27 10 43 49 21 66
