# This puzzle is unsolvable
71
   2    1    3    4    5    6    7    8    9   10   11   12   13   14   15   16   17   18   19   20   21   22   23   24   25   26   27   28   29   30   31   32   33   34   35   36   37   38  318   39   41   42   44  323   45   46   47   48   49   50   51   52   53   54   55   56   57   58   59   60   61   62   63   64   65   66   67   68   69   70   71
 280  281  282  283  284  285  286  287  288  289  290  291  292  293  294  295  296  297  298  299  300  301  302  303  304  305  306  307  308  309  310  311  312  313  314  315  316  317   40  590  319  320   43  857  324  325  326  327  328  329  330  331  332  333  334  335  336  337  338  339  340  341  342  343  344  345  346  347  348  349   72
 279  552  553  554  555  556  557  558  559  560  561  562  563  564  565  566  567  568  569  570  571  572  573  574  575  576  577  578  579  580  581  582  583  584  585  586  587  588  589  854  591  592  594  322  595  596  597  598  599  600  601  602  603  604  605  606  607  608  609  610  611  612  613  614  615  616  617  618  619  350   73
 278  551  816  817  818  819  820  821  822  823  824  825  826  827  828  829  830  831  832  833  834  835  836  837  838  839  840  841  842  843  844  845  846  847  848  849  850  851  853  855  856  321 1111  593  858  859  860  861  862  863  864  865  866  867  868  869  870  871  872  873  874  875  876  877  878  879  880  881  620  351   74
 277  550  815 1072 1073 1074 1075 1076 1077 1078 1079 1080 1081 1082 1083 1084 1085 1086 1087 1088 1089 1090 1091 1092 1093 1094 1095 1096 1097 1098 1099 1100 1101 1102 1103 1104 1105 1106  852 1108 1109 1110 1112 1359 1113 1114 1115 1116 1117 1118 1119 1120 1121 1122 1123 1124 1125 1126 1127 1128 1129 1130 1131 1132 1133 1134 1135  882  621  352   75
 276  549  814 1071 1320 1321 1322 1323 1324 1325 1326 1327 1328 1329 1330 1331 1332 1333 1334 1335 1336 1337 1338 1339 1340 1341 1342 1343 1344 1345 1346 1347 1348 1349 1350 1351 1352 1353 1107 1354 1355 1356 1358 1598 1360 1361 1362 1363 1364 1365 1366 1367 1368 1369 1370 1371 1372 1373 1374 1375 1376 1377 1378 1379 1380 1381 1136  883  622  353   76
 275  548  813 1070 1319 1560 1561 1562 1563 1564 1565 1566 1567 1568 1569 1570 1571 1572 1573 1574 1575 1576 1577 1578 1579 1580 1581 1582 1583 1584 1585 1586 1587 1588 1589 1590 1591 1592 1593 1594 1595 1357 1830 1599 1829 2054 1600 1602 1603 1604 1605 1606 1607 1608 1609 1610 1611 1612 1613 1614 1615 1616 1617 1618 1619 1382 1137  884  623  354   77
 274  547  812 1069 1318 1559 1792 1793 1794 1795 1796 1797 1798 1799 1800 1801 1802 1803 1804 1805 1806 1807 1808 1809 1810 1811 1812 1813 1814 1815 1816 1817 1818 1819 1820 2044 2045 1824 1825 2048 1827 2050 1596 1597 2053 1832 1601 1833 1834 1835 1836 1837 1838 1839 1840 1841 1842 1843 1844 1845 1846 1847 1848 1849 1620 1383 1138  885  624  355   78
 273  546  811 1068 1317 1558 1791 2016 2017 2018 2019 2020 2021 2022 2023 2024 2025 2026 2027 2028 2029 2030 2031 2032 2033 2034 2035 2036 2037 2038 2039 2040 2041 2042 2043 1823 1821 1822 2047 2049 2264 1826 1828 2051 1831 2475 2055 2056 2057 2058 2059 2060 2061 2062 2063 2064 2065 2066 2067 2068 2069 2070 2071 1850 1621 1384 1139  886  625  356   79
 272  545  810 1067 1316 1557 1790 2015 2232 2233 2234 2235 2236 2237 2238 2239 2240 2241 2242 2243 2244 2245 2246 2247 2248 2249 2250 2251 2252 2253 2254 2255 2256 2257 2258 2259 2260 2046 2261 2263 2265 2266 2473 2052 2267 2269 2270 2271 2272 2273 2274 2275 2276 2277 2278 2279 2280 2281 2282 2283 2284 2285 2072 1851 1622 1385 1140  887  626  357   80
 271  544  809 1066 1315 1556 1789 2014 2231 2440 2441 2442 2443 2444 2445 2446 2447 2448 2449 2450 2451 2452 2453 2454 2455 2456 2457 2458 2459 2460 2461 2462 2463 2464 2465 2466 2467 2468 2262 2469 2471 2472 2671 2474 2268 2476 2477 2478 2479 2480 2481 2482 2483 2484 2485 2486 2487 2488 2489 2490 2491 2286 2073 1852 1623 1386 1141  888  627  358   81
 270  543  808 1065 1314 1555 1788 2013 2230 2439 2640 2641 2642 2643 2644 2645 2646 2647 2648 2649 2650 2651 2652 2653 2654 2655 2656 2657 2658 2659 2660 2661 2662 2663 2664 2665 2666 2667 2470 2669 2670 2862 2863 2672 2673 2675 2676 2677 2869 2678 2680 2681 2682 2683 2684 2685 2686 2687 2688 2689 2492 2287 2074 1853 1624 1387 1142  889  628  359   82
 269  542  807 1064 1313 1554 1787 2012 2229 2438 2639 2832 2833 2834 2835 2836 2837 2838 2839 2840 2841 2842 2843 2844 2845 2846 2847 2848 2849 2850 2851 2852 2853 2854 2855 2856 3040 2859 2668 2860 2861 3044 3046 2865 2674 2866 2867 2868 3227 2679 2871 2872 2873 2874 2875 2876 2877 2878 2879 2690 2493 2288 2075 1854 1625 1388 1143  890  629  360   83
 268  541  806 1063 1312 1553 1786 2011 2228 2437 2638 2831 3016 3017 3018 3019 3020 3021 3022 3023 3024 3025 3026 3027 3028 3029 3030 3031 3032 3033 3034 3035 3036 3037 3038 3039 2858 2857 3216 3042 3043 3045 3221 2864 3047 3048 3049 3051 3052 2870 3054 3055 3056 3057 3058 3059 3060 3061 2880 2691 2494 2289 2076 1855 1626 1389 1144  891  630  361   84
 267  540  805 1062 1311 1552 1785 2010 2227 2436 2637 2830 3015 3192 3193 3194 3195 3196 3197 3198 3199 3200 3201 3202 3203 3204 3205 3206 3207 3208 3209 3210 3211 3212 3213 3214 3215 3383 3041 3218 3386 3219 3220 3222 3223 3224 3050 3226 3228 3053 3229 3230 3231 3232 3233 3234 3235 3062 2881 2692 2495 2290 2077 1856 1627 1390 1145  631  893  362   85
 266  539  804 1061 1310 1551 1784 2009 2226 2435 2636 2829 3014 3191 3360 3361 3362 3363 3364 3365 3366 3367 3368 3369 3370 3371 3372 3373 3374 3375 3376 3377 3378 3379 3380 3381 3382 3384 3217 3544 3385 3387 3388 3389 3390 3392 3225 3393 3394 3395 3396 3397 3398 3399 3400 3401 3236 3063 2882 2693 2496 2291 2078 1857 1628 1391 1146  892  632  363   86
 265  538  803 1060 1309 1550 1783 2008 2225 2434 2635 2828 3013 3190 3359 3520 3521 3522 3523 3524 3525 3526 3527 3528 3529 3530 3531 3532 3533 3534 3535 3536 3537 3538 3539 3540 3541 3542 3543 3545 3546 3547 3548 3699 3549 3391 3702 3552 3553 3554 3555 3556 3557 3558 3559 3402 3237 3064 2883 2694 2497 2292 2079 1858 1629 1392 1147  894  633   88  364
 264  537  802 1059 1308 1549 1782 2007 2224 2433 2634 2827 3012 3189 3358 3519 3672 3673 3674 3675 3676 3677 3678 3679 3680 3681 3682 3683 3684 3685 3686 3687 3688 3689 3690 3691 3692 3693 3694 3695 3696 3697 3698 3842 3700 3551 3703 3847 3704 3850 3849 3706 3708 3709 3560 3403 3238 3065 2884 2695 2498 2293 2080 1859 1630 1393 1148  634  365   87   89
 263  536  801 1058 1307 1548 1781 2006 2223 2432 2633 2826 3011 3188 3357 3518 3671 3816 3817 3818 3819 3820 3821 3822 3823 3824 3825 3826 3827 3828 3829 3830 3831 3832 3833 3834 3835 3836 3837 3838 3840 3974 3841 3843 3978 3701 3550 3846 3982 3705 3848 3707 3851 3710 3561 3404 3239 3066 2885 2696 2499 2294 2081 1860 1631 1394 1149  895  635  366  367
 262  535  800 1057 1306 1547 1780 2005 2222 2431 2632 2825 3010 3187 3356 3517 3670 3815 3952 3953 3954 3955 3956 3957 3958 3959 3960 3961 3962 3963 3964 3965 3966 3967 3968 3969 3970 3971 3972 4100 3973 4101 3975 3977 4225 3979 3844 3845 4109 4111 3985 3852 3853 3711 3562 3405 3240 3067 2886 2697 2500 2295 2082 1861 1395 1396 1150  896  897  636   90
 261  534  799 1056 1305 1546 1779 2004 2221 2430 2631 2824 3009 3186 3355 3516 3669 3814 3951 4080 4081 4082 4083 4084 4085 4086 4087 4088 4089 4090 4091 4092 4093 4094 4095 4096 4097 4098 4099 4102 3839 4221 4103 4105 4336 4108 3980 3981 4226 3983 3984 3986 3854 3712 3563 3406 3241 3068 2887 2698 2501 2296 2083 1863 1862 1632 1151  898  637  368   91
 260  533  798 1055 1304 1545 1778 2003 2220 2429 2630 2823 3008 3185 3354 3515 3668 3813 3950 4079 4200 4201 4202 4203 4204 4205 4206 4207 4208 4209 4210 4211 4212 4213 4214 4215 4327 4216 4217 4219 4332 4333 3976 4222 4104 4107 4227 4335 4110 4113 4112 3989 3987 3713 3564 3407 3242 3069 2888 2699 2502 2297 2084 1864 1633 1397 1153  899  638  369   92
 259  532  797 1054 1303 1544 1777 2002 2219 2428 2629 2822 3007 3184 3353 3514 3667 3812 3949 4078 4199 4312 4313 4314 4315 4316 4317 4318 4319 4320 4321 4322 4323 4324 4326 4428 4430 4329 4218 4330 4220 4331 4223 4437 4334 4438 4224 4106 4230 4228 3988 3856 3855 3714 3565 3408 3243 3070 2889 2700 2504 2503 2298 2085 1634 1152 1398  900  901  640   93
 258  531  796 1053 1302 1543 1776 2001 2218 2427 2628 2821 3006 3183 3352 3513 3666 3811 3948 4077 4198 4311 4416 4417 4418 4419 4420 4421 4422 4423 4424 4425 4426 4427 4325 4524 4429 4525 4613 4432 4433 4434 4436 4532 4533 4337 4441 4229 4338 4339 4340 4232 3857 3715 3566 3409 3244 2891 3071 2702 2299 2086 1865 1866 1635 1636 1154  902  370  641  371
 257  530  795 1052 1301 1542 1775 2000 2217 2426 2627 2820 3005 3182 3351 3512 3665 3810 3947 4076 4197 4310 4415 4512 4513 4514 4515 4516 4517 4518 4519 4520 4521 4522 4523 4431 4328 4526 4527 4616 4530 4435 4617 4619 4620 4439 4534 4535 4114 3991 4231 4115 3859 3716 3567 3410 3245 3072 2701 2892 2505 2300 2087 1638 1400 1399 1155  373  372  639   94
 256  529  794 1051 1300 1541 1774 1999 2216 2425 2626 2819 3004 3181 3350 3511 3664 3809 3946 4075 4196 4309 4414 4511 4600 4601 4602 4603 4604 4605 4606 4607 4608 4609 4689 4610 4690 4612 4692 4614 4528 4695 4531 4618 4699 4536 4440 4442 4443 3990 4341 3858 3860 3717 3568 3411 3246 2890 3073 2703 2506 2088 2302 1867 1637 1401 1156  903  643  642   95
 255  528  793 1050 1299 1540 1773 1998 2215 2424 2625 2818 3003 3180 3349 3510 3663 3808 3945 4074 4195 4308 4413 4510 4599 4680 4681 4682 4683 4684 4685 4686 4687 4688 4691 4611 4762 4881 4694 4765 4832 4696 4697 4698 4622 4621 4537 4234 4343 4117 4342 4233 3993 3718 3569 3412 3247 3074 2893 2704 1868 2507 2303 1869 1639 1402 1157  905  374   97   96
 254  527  792 1049 1298 1539 1772 1997 2214 2423 2624 2817 3002 3179 3348 3509 3662 3807 3944 4073 4307 4412 4411 4509 4598 4679 4752 4753 4754 4755 4756 4757 4758 4760 4823 4761 4763 4693 4826 4615 4529 4764 4769 4701 4623 4539 4538 4444 4344 4445 3992 4116 3861 3719 3570 3413 3248 3075 2509 2705 2706 2304 2301 2089 1640 1403  906  375  904  644   98
 253  526  791 1048 1297 1538 1771 1996 2213 2422 2623 2816 3001 3178 3347 3508 3661 3806 3943 4193 4194 4306 4410 4508 4597 4678 4751 4816 4817 4818 4819 4820 4822 4759 4824 4927 4825 4928 4827 4828 4830 4831 4767 4885 4700 4624 4446 4345 4346 4235 4118 3994 3862 3720 3571 3414 3415 3249 2895 2508 2707 2090 1872 1641 1405 2092 1404  376  645  378   99
 252  525  790 1047 1296 1537 1770 1995 2212 2421 2622 2815 3000 3177 3346 3507 3660 3942 4071 4072 4192 4305 4409 4507 4596 4677 4750 4815 4872 4873 4874 4875 4821 4877 4878 4879 4929 4882 4884 4883 4766 4829 4768 4625 4770 4540 4447 4237 4236 4120 4119 3995 3721 3722 3572 3573 3416 3250 2894 2709 2510 2305 2306 1870 1871 1161 1158 1159  377  908  100
 251  524  789 1046 1295 1536 1769 1994 2211 2420 2621 2814 2999 3176 3345 3506 3659 3805 3941 4070 4191 4304 4408 4506 4505 4595 4676 4814 4871 4920 4921 4922 4876 4923 4964 4924 4880 4967 4968 4930 4886 4887 4702 4834 4771 4626 4542 4541 4448 4238 4122 3997 3996 3863 3723 3417 3418 3251 2896 3079 2511 2307 2093 2091 1162 1644  909 1160  647  646  907
 250  523  788 1045 1294 1535 1768 1993 2210 2419 2620 2813 2998 3175 3344 3505 3658 3804 3940 4069 4068 4302 4303 4594 4675 4747 4749 4813 4870 4919 4960 4961 4962 4996 4994 4926 4925 4998 4969 4931 4932 4775 4833 4773 4772 4703 4449 4450 4121 4347 4239 3864 3866 3574 3252 3253 3076 2708 2512 2513 2308 1645 2095 1874 1642 2094 1163  910  648  380  101
 249  522  787 1044 1293 1534 1767 1992 2209 2418 2619 2812 2997 3174 3343 3504 3657 3803 3939 4189 4190 4407 4406 4504 4593 4748 4674 4812 4869 4918 4959 4992 4993 4963 4965 4997 5020 5000 5021 4999 4970 4888 4889 4836 4706 4705 4627 4544 4543 4349 4348 3998 3725 3865 3724 3575 3080 2899 3077 2897 3078 2309 1876 1406 1873 1875 1643  379  381  649  102
 248  521  786 1043 1292 1532 1533 1991 2207 2208 2618 2811 2996 3342 3503 3502 3801 3802 3938 4067 4188 4301 4405 4503 4592 4673 4746 4811 4868 4917 4958 4991 5016 5018 4995 5034 5019 5022 4966 4933 4971 4972 4890 4835 4707 4704 4628 4451 4241 4240 4124 4123 4125 3577 3576 3254 3082 3083 3081 2900 2711 2710 2310 1407 1409  912  651 1164  650  106  103
 247  520  785 1041 1042 1291 1766 1765 1990 2417 2416 2810 3172 3173 3341 3655 3656 3800 3937 4066 4187 4299 4300 4502 4591 4672 4745 4810 4867 4916 4990 5015 5017 5030 5040 5014 5036 5035 5001 4973 4934 4837 4777 4774 4708 4629 4545 4452 4350 4351 4243 4000 3999 3727 3420 3419 3255 3256 2898 2901 2713 2515 2096 2098 1408 1165 1166  911  105  383  104
 246  519  784 1289 1290 1531 1764 1989 2204 2414 2617 2809 2995 3171 3340 3501 3654 3799 3936 4065 4185 4186 4404 4501 4590 4671 4744 4809 4956 4955 4912 4989 4914 5032 5033 5023 5037 5002 5003 4937 4936 4891 4776 4935 4632 4630 4546 4453 4352 4242 4002 4126 3867 3580 3422 3726 3421 2712 2902 2514 2517 2516 2099 1646 1648 1410  653 1167  382  652  107
 245  518  783 1288 1530 1762 1763 2415 2205 2616 2808 2993 2994 3170 3339 3500 3653 3798 3935 4064 4184 4298 4403 4500 4589 4670 4743 4808 4866 4988 4805 4913 5029 4915 5010 5038 5031 5024 5006 5026 5025 4839 4778 4838 4779 4631 4547 4454 4353 4128 4244 4127 4001 3728 3578 3423 3084 3085 2314 2714 2311 2097 2312 1877 1647 1412 1411  913  914  384  385
 244  517 1529 1039  782 1040 1761 2206 1987 1988 2613 2614 2992 3169 3338 3499 3652 3797 3934 4063 4297 4296 4402 4499 4588 4669 4742 4807 4864 4865 4952 4957 5011 5028 4983 5039 4980 5027 5004 4938 4893 4974 4840 4710 4709 4633 4548 4354 4245 4004 3868 3579 4003 3869 3581 3258 3257 2904 2903 2715 2518 2519 2100 1651 1879 1168 1649  654  916  386  108
 243  516  780  781 1528 1285 2201 1984 2412 2615 2807 2990 2806 3168 3337 3651 3497 3933 3932 4062 4183 4401 4400 4498 4587 4668 4741 4911 4863 4953 4986 4954 4949 5013 5008 5007 4944 4975 4942 4978 5005 4892 4841 4780 4711 4635 4549 4456 4355 4130 4246 4005 3872 3870 3730 3424 3259 3086 2905 2716 1878 2315 2101 1652 1170 1417 1414 1650  915  655  109
 242  515 1284 1038 1524 1759 1287 1985 2413 2203 2805 2991 3335 2988 3496 3336 3650 3796 4061 4182 4181 4294 4295 4497 4586 4667 4740 4862 4910 4861 4951 4907 4984 4851 4981 4945 4943 4901 4940 4895 4941 4894 4842 4781 4712 4550 4455 4458 4457 4247 3871 3873 4129 3729 3731 3425 3260 3087 2906 2717 2313 2316 2102 1415 1416 1653 1413 1169  656  387  110
 241  514 1037 1036 1760 2202 1986 1286 2611 2409 2612 2610 3165 2989 3167 3166 3498 3793 3647 4060 4180 4398 4496 4585 4584 4666 4739 4804 4806 4950 5012 4906 4985 4982 5009 4856 4900 4947 4979 4939 4896 4843 4782 4783 4713 4636 4634 4551 4356 4248 4132 4006 3874 3583 3582 3426 3261 3088 2907 2718 2520 2103 1882 1881 1880  917  919  918  658  657  111
 240  512  513  779 1525 1527 1526 2411 2197 1982 2609 2802 2804 2803 3495 3648 3795 3649 3794 4059 4179 4293 4399 4495 4583 4664 4665 4738 4909 4857 4858 4853 4987 4793 4904 4855 4946 4852 4898 4899 4897 4844 4784 4785 4714 4716 4459 4637 4357 4359 4131 4007 3733 3732 3584 3427 3262 3089 2719 2522 2521 2317 2104 1884 2105 1655 1171 1419  659  388  112
 239  777 1033 1758  778 1283 1757 2410 1983 2199 2408 2407 2987 3164 3334 3494 3792 3646 3931 3930 4058 4292 4397 4494 4581 4737 4803 4801 4860 4908 4800 4796 4795 4854 4794 4730 4790 4902 4977 4976 4849 4787 4786 4715 4639 4640 4553 4358 4250 4249 4133 4008 3875 3734 3585 3428 3263 2910 2908 2909 2720 2523 1883 2106 1418 1656 1654 1172  661  113  114
 238  511  776 1031 1035 1281 1753 1756 1981 2406 2200 2798 2801 2986 3163 3333 3491 3493 3929 4057 4178 4291 4396 4492 4493 4582 4736 4734 4802 4733 4859 4948 4651 4792 4903 4725 4791    0 4848 4847 4721 4789 4846 4845 4552 4461 4460 4638 4360 4252 4134 4009 3876 3735 3586 3429 3264 3090 2721 2524 2318 2320 2319 1886 1885 1173  660  389  920  391  115
 237  775 1280 1032 1523 1755 1034 1522 2198 1980 2608 2800 2984 3162 3332 3791 3331 3789 4056 4055 4177 4290 4395 4491 4580 4663 4662 4659 4799 4655 4798 4797 4653 4728 4654 4722 4650 4850 4648 4564 4788 4646 4719 4718 4641 4642 4554 4462 4251 4361 4135 4010 3877 3736 3587 3430 3265 3091 2911 2722 2525 2108 2321 2107 1657 1420 1174  921  390  392  116
 510  233  509 1520 1521 1030 1282 1979 2196 2195 2405 2606 2799 3161 3330 3490 3492 3645 3928 4053 4176 4289 4394 4490 4660 4661 4735 4658 4657 4732 4574 4731 4729 4571 4652 4905 4723 4724 4649 4565 4645 4720 4644 4643 4717 4558 4555 4463 4362 4253 4136 4011 3878 3737 3588 3431 3266 3092 3093 2724 2723 2526 2322 1887 1177 1421  922 1175  924  662  393
 236  507  508  773 1029 1754 1752 1978 2403 2194 2605 2607 2797 3160 3329 3644 3790 4054 3927 3926 4175 4288 4392 4393 4579 4576 4577 4484 4385 4656 4274 4572 4480 4573 4570 4727 4726 4569 4647 4563 4562 4471 4561 4560 4559 4557 4556 4464 4363 4254 4137 4012 3879 3738 3589 3432 3267 3094 2912 2528 2527 2109 2110 1423 1658 1659 1176  663  923  394  117
 235  506  772  774 1519 1518 1279 1977 2404 2603 2982 2983 2985 3159 3328 3489 3642 3643 3788 3787 4174 4286 4287 4390 4488 4578 4486 4386 4485 4383 4482 4575 4481 4479 4272 4477 4475 4567 4376 4150 4474 4372 4470 4469 4468 4467 4466 4465 4364 4255 4138 4013 3880 3739 3590 3433 3268 2914 2725 2913 2324 2111 2323 1888 1889 1422 1178  665  926  664  118
 234  771 1028 1277 1276 1278 1751 1976 2193 2604 2401 2796 2981 3158 3327 3488 3641 3786 3925 3923 3924 4173 4489 4391 4389 4280 4388 4387 4483 4278 4275 4273 4381 4379 4377 4270 4566 4378 4375 4374 4472 4473 4266 4371 4369 4368 4367 4366 4365 4256 4139 4014 3881 3740 3591 3434 3097 3095 3096 2726 2529 1890 1663 1660 1662 1179 1424  925  395  121  119
 232  505  770 1027 1517 1515 1516 1975 2192 2602 2402 2795 2980 3157 3326 3487 3640 3785 3922 4052 4051 4285 4284 4283 4487 4167 4164 4279 4384 4162 4039 4382 4159 4380 4157 4478 4269 4568 4476 4373 4265 4027 4263 4370 4262 4260 4145 4259 4258 4257 4140 4015 3882 3741 3592 3435 3269 3270 2915 2916 2727 2530 2325 2113 2112 1181 1427 1180  927  120  396
 231  504  769 1025 1026 1275 1750 1974 2191 2400 2601 2794 2979 3156 3325 3486 3639 3784 3921 4050 4172 4170 4169 4168 4282 4042 4281 4163 4277 4040 4037 4160 3905 4158 3904 4271 4155 4154 4153 4268 4028 3896 4264 4148 4147 4261 4022 4144 4143 4142 4141 4016 3883 3742 3593 3436 3271 3098 2917 2728 2531 2327 1892 1425 1426  929 1661 1182  398  397  400
 230  503  768 1024 1274 1748 1749 1972 2190 2399 2600 2793 2978 3155 3324 3485 3638 3783 3920 4049 4171 4048 4046 4045 3913 4044 4166 4165 4038 4161 3907 4035 4036 4034 4031 4156 3900 4030 4152 4267 4151 4026 4149 4025 4024 4146 3891 4021 4020 4019 4018 4017 3884 3743 3594 3437 3272 3099 2918 2729 2326 2532 2114 1891 1893 1664 1183  669  399  666  123
 229  502  767 1273 1747 1514 1973 1513 1746 2398 2599 2792 2977 3154 3323 3484 3637 3782 3919 3778 3917 4047 3916 3914 3774 3911 4041 3908 3771 3770 4276 3909 3766 3902 3903 3765 3761 4029 3899 3898 3897 3757 3894 3893 3892 3753 4023 3890 3889 3888 3887 3886 3885 3744 3595 3438 3273 3100 2919 2730 2533 2328 2115 1894 1665 1428 1184  668  928  670  401
 228  501  766 1023 1272 1512 1971 2189 2188 2397 2598 2791 2976 3153 3322 3483 3636 3781 3779 3918 3630 3776 3915 3775 4043 3773 3912 3910 3769 3622 3620 3767 3906 3619 3764 4033 4032 3762 3760 3759 3610 3758 3895 3755 3754 3752 3605 3751 3750 3749 3748 3747 3746 3745 3596 3439 3274 3101 2920 2731 2534 2329 2116 1895 1666 1430 1429  932  930  667  125
 227  500  765 1022 1271 1511 1745 1970 2187 2396 2597 2975 3152 3321 3320 3482 3634 3480 3780 3633 3632 3777 3629 3473 3628 3627 3772 3624 3623 3468 3768 3621 3617 3618 3763 3901 3615 3614 3613 3612 3455 3454 3756 3453 3608 3606 3450 3604 3603 3602 3601 3600 3599 3598 3597 3440 3275 3102 2921 2732 2535 2330 2117 1897 1896 1667 1185  934  671  124  122
 226  499  764 1021 1270 1510 1969 2186 2185 2395 2789 2790 2973 3151 3481 3317 3635 3145 3478 3477 3631 3476 3475 3474 3472 3471 3626 3469 3305 3306 3466 3467 3465 3464 3462 3616 3460 3459 3457 3456 3611 3291 2941 3609 3451 3607 3287 3449 3448 3447 3446 3445 3444 3443 3442 3441 3276 3103 2922 2733 2536 2331 2118 1668 1431 1186  933  672  931  402  126
 225  498  763 1020 1269 1743 1744 1968 2184 2394 2595 2974 2788 3149 3319 3318 3479 3315 3316 3143 3314 3312 3311 3310 3137 3309 3308 3625 3134 3304 3303 3302 3301 3463 3298 3461 3127 3295 3458 3294 3293 3121 3452 3290 3292 3289 3288 3286 3285 3284 3283 3282 3281 3280 3279 3278 3277 3104 2923 2734 2537 2332 2119 1898 1669 1432 1187  674  404  403  127
 224  497  762 1019 1268 1509 1742 1967 2393 2594 2787 2596 3150 2970 3148 3147 2966 2967 2965 3144 3313 3142 3140 3139 2960 2958 3470 2957 3307 3135 3132 3131 3129 3300 3299 3126 3296 3297 3125 3123 2943 3122 3120 3119 2752 3118 3116 3115 3114 3113 3112 3111 3110 3109 3108 3107 3106 3105 2924 2735 2538 2333 2120 1899 1670 1433 1188  673  935  405  128
 223  496  761 1018 1267 1508 1741 1966 2183 2392 2593 2786 2972 2969 2782 2968 3146 2779 2778 2776 2777 2962 2961 3138 2771 2959 3136 2956 2766 3133 2951 2764 3130 2952 3128 2947 2946 2759 3124 2945 2944 2942 2754 2940 2751 3117 2938 2936 2935 2934 2933 2932 2931 2930 2929 2928 2927 2926 2925 2736 2539 2334 2121 1900 1671 1434 1189  936  675  406  129
 222  495  760 1017 1266 1507 1740 1965 2182 2391 2592 2785 2971 2783 2587 2781 2780 2584 2963 2581 2964 3141 2773 2774 2772 2770 2575 2769 2955 2768 2953 2570 2763 2950 2949 2948 2761 2565 2758 2562 2757 2756 2755 2939 2753 2750 2937 2749 2748 2747 2746 2745 2744 2743 2742 2741 2740 2739 2738 2737 2540 2335 2122 1901 1672 1435 1190  937  676  407  130
 221  494  759 1016 1265 1506 1739 1964 2181 2390 2591 2590 2784 2589 2588 2586 2585 2582 2583 2168 2580 2775 2578 2577 2576 2371 2161 2574 2954 2765 2572 2569 2365 2762 2567 2760 2563 2564 2561 2148 2358 2560 2559 2558 2557 2556 2555 2554 2553 2552 2551 2550 2549 2548 2547 2546 2545 2544 2543 2542 2541 2336 2123 1902 1673 1436 1191  938  677  408  131
 220  493  758 1015 1264 1504 1505 1963 2180 2389 2388 2387 2386 2385 2384 2383 2382 2170 2380 2381 2378 2579 2377 2375 2164 2573 2373 2159 2369 2767 2157 2368 2568 2366 2566 2152 2363 2360 2361 2359 2147 2357 2356 2355 2354 2353 2352 2351 2350 2349 2348 2347 2346 2345 2344 2343 2342 2341 2340 2339 2338 2337 2124 1903 1674 1437 1192  939  678  409  132
 219  492  757 1014 1503 1738 1737 1962 2179 2178 2177 2176 1955 2175 2173 2172 1952 2171 2379 2169 2167 2166 2376 2374 2372 1944 2162 1713 2370 1939 2367 2571 1475 2154 2364 2153 1933 2150 2149 1930 2146 2145 1926 2144 2143 2142 2141 2140 2139 2138 2137 2136 2135 2134 2133 2132 2131 2130 2129 2128 2127 2126 2125 1904 1675 1438 1193  940  679  410  133
 218  490  491  756 1263 1262 1961 1735 1733 1960 1958 1730 1957 1954 1727 1724 1726 1725 1949 1948 1721 1947 1945 2165 2163 1716 1943 1942 2160 2158 1938 2155 2156 1936 1707 1934 2362 1703 1932 1702 1929 1928 1927 1925 1924 1923 1922 1921 1920 1919 1918 1917 1916 1915 1914 1913 1912 1911 1910 1909 1908 1907 1906 1905 1676 1439 1194  941  680  411  134
 217  755 1261 1260 1013 1502 1500 1736 1734 1497 1731 1495 1956 2174 1493 1953 1951 1723 1248 1722 1487 1720 1946 1718 1717 1238 1715 1479 1234 1940 1711 1937 1709 1935 1706 1705 2151 1704 1931 1467 1701 1700 1699 1698 1697 1696 1695 1694 1693 1692 1691 1690 1689 1688 1687 1686 1685 1684 1683 1682 1681 1680 1679 1678 1677 1440 1195  942  681  412  135
 489  215  754 1012 1259 1501 1499 1256 1959 1254 1732 1001 1494 1728 1729 1249 1490 1245 1491 1488 1950 1485 1483  989 1239 1941 1482  984 1714 1712 1476 1710 1230 1708 1472 1471 1470 1469 1225 1468 1466 1465 1464 1463 1462 1461 1460 1459 1458 1457 1456 1455 1454 1453 1452 1451 1450 1449 1448 1447 1446 1445 1444 1443 1442 1441 1196  943  682  413  136
 216  753 1010 1011 1008 1258 1257 1498 1255 1253 1496 1002 1251  998 1250 1247  995 1489  993  992 1486  991 1484 1719  988  987 1480 1236 1478  982 1232  721 1231 1474 1473 1228 1227  974  975 1224 1223 1222 1221 1220 1219 1218 1217 1216 1215 1214 1213 1212 1211 1210 1209 1208 1207 1206 1205 1204 1203 1202 1201 1200 1199 1198 1197  944  683  414  137
 214  488  752 1009  750 1007 1006 1005 1004 1003 1252 1000  999  740 1492  997 1246  469  994 1244  733 1243 1241  990 1240 1237 1481  727  457 1477 1233  981  979  980  719  978  976  716 1226  973  714  971  970  969  968  967  966  965  964  963  962  961  960  959  958  957  956  955  954  953  952  951  950  949  948  947  946  945  684  415  138
 213  487  751  483  749  481  748  747  746  744  743  742  741  739  472  738  195  735  734  468 1242  731  730  728  986  461  459  725 1235  724  983  723  722 1229  720  977  717  449  715  713  972  712  711  710  709  708  707  706  705  704  703  702  701  700  699  698  697  696  695  694  693  692  691  690  689  688  687  686  685  416  139
 212  486  485  482  207  480  479  745  477  201  476  202  474  473  471  996  737  736  467  466  465  732  464  463  462  985  729  185  183  726  456  181  454  453  452  718  451  450  448  447  446  445  444  443  442  441  440  439  438  437  436  435  434  433  432  431  430  429  428  427  426  425  424  423  422  421  420  419  418  417  140
 211  210  484  209  208  206  205  204  478  203  200  475  199  198  197  470  196  194  193  192  191  190  189  188  187  186  460  184  458  455  180  182  179  178  177  176  175  174  173  172  171  170  169  168  167  166  165  164  163  162  161  160  159  158  157  156  155  154  153  152  151  150  149  148  147  146  145  144  143  142  141
