# This puzzle is unsolvable
24
 94   1  95 253  99   9  93 383 323  10 104 191 103 187 190 109  18 106 268 193  19  20  21  24
  4 176   7 249 317 254 100 477 180  13  14 102  11  12 107 265 266 110 269 108 111  22  23 114
  3  92  89 177 379 183   6   8  98 185 324 328 188 105 331 189  16 194  17 336 113 115  25  27
171   2  90  96 181 256 178 320 437 514 101  15 388 330 442 263 264 333 334 192 196  26  28 117
322 179  91 174 175 434 319 182  97 186 386 258 262 387 260 392 195 267 271 112 116 339 118 198
  5 172 255  88  87 382 432 184 326 259 435 438 329 482 389 393 391 332 394  30 335  29 197 202
380 247 251   0 433 325 384 436 385 479 480 483 485 443 520 390 444 338 337 199 201 270 273  31
252  85 375 170 377 378 513 512 516 327 439 481 440 532 484 441 486 445 395 397 274 121  32 120
168 315 173 246 430 164 475 558 478 541 261 517 548 544 545 518 519 446 396 275 119 203 122 200
321 381 169 376 316 476 431 511 510 560 561 257 543 562 572 343 399 489 341 272 276 278 204  33
248 313 250  81 427 312 471 540 474 538 542 515 547 564 565 488 487 546 448 206 344 402 123  35
314 244 428  83 318 557 509 472 539 559 569 573 574 575 522 523 451 449 340 342 346  34 125 124
 84  86  80 426 245 372 507 429 536 533 537 553 552 524 563 549 400 447 521 205 280 345 281  36
 79 166 242  82 243 374 534 473 469 501 568 531 571 406 454 492 490 401 398 279 277 209 207  37
165 167 311 508 241 425 369 505 535 504 555 528 567 525 491 566 461 526 495 208 127 452  38  39
 77 302 310 373 308 364 506 423 368 570 554 496 460 414 457 550 494 407 450 282 210 126 130 128
161 162 370 420 371 307 467 422 416 556 458 415 530 529 527 459 497 409 403 455 211 349 404 347
240 239  78 235 468 365 470 309 465 500 462 358 413 356 357 283 502 405 348 493 453 284  42 129
163 160 367 237 238 421 424 463 503 361 226 417 225 360 498 551 412 410 285 287 139 408 212  45
 75  74 304 155 306 233 362 363 300 419 297 359  55 499 223  54 291 293 350 456 133 351 132  41
157 236  76 158 303  66 231 466 418 228 224 295  57 294 292 222 355 288 141 213  50 352  40  43
 68 305  72 234 151 301 153 298 299 229 147 411  59 142 145 289 143 217 220 216 134  46  49 131
159  70 154  71 232 366 230 150  61 464  60 148  56 296 290 136  58 354 218 286  52 214  44  48
 73  65 156  69 152  67  64  62  63 149 227 146 144 219 353 221 140 215  51  53 137 135 138  47
