# This puzzle is unsolvable
72
   2    1    3    4    5    6    7    8    9  292   10   11   13  298   14  299  300   16   17   20   21  303   22   23   25   26   27   28   29   30   31   32   33   34   35  319   38  322  595  598   42   43  603   45  328   47   48  605  332   50  335   52   53  337   54  338   56   57   59   60   61   62   63   64   65   66   67   68   69   70   71   72
 284  828  285  287  288  289  290  291  567  570  294   12  296  571   15  574  576   19   18  579  580  302  306   24  307  309  310  311  312  313  314  315  316  317  318  594   36   39   40 1376  323  326   44  869  602   46  329  333   49  334  336   51 1136   55  611  613  614   58  341  342  344  345  346  347  348  349  350  351  352  353  354   73
 559  561  286  560  564  831  832  565  569  293  295  572  838  573  297  844  841  301  845  578 1107  581  846  308  850  584  585  586  587  588  589  590  591  592  593  320   37  321  867 1375  324  600  601  327  871  873  330  606  331  607  608  878  610  612  880  615  339  340  616  343  618  619  621  622  623  624  625  626  627  628  355   74
 563  558  282  827 1089  830  566  833  834  568  835  836 1099  839  575 1101  840  577 1106  847 1355 1357  582  583  849  851 1110  854  855  856    0  857  858  859  860  862  863 1122  597  325  596   41  866 1128  604  870  872 1132  875  876  877 1137  609 1139  879 1393  882  883  617  885  887  620  888  889  890  891  892  893  894  629  356   75
 562  826 1087  825 1340 1088 1090 1092 1093 1094 1095  837 1098 1097 1100 1351 1104 1597 1354 1105  305  304  848 1359 2064 1363 1111  853  852 1114 1115 1116 1117 1118 1119 1120  861 1123  864 1124  599  865  868 1618 1129 1130  874 1131 1133 1134 1387 1386 1138 1633 1391 1141  881 1392  884 1144  886 1145 1146 1398 1148 1401 1150 1152  895  630  357   76
 281  557  829  283 1584 1341 1091 1342 1344 1345 1096 1348 1827 1826 1350 1829  843 1595 1102 1599 1358 1602 1108 1836 1109 1360 1112 1841 1113 1365 1366 1367 1368 1369 1370 1121 1373 1372 1374 1852 1621 1126 1380 1379 1381 1624 1382 1383 1384 1385 1629 1388 1390 1632 1634 1140 1635 1142 1143 1395 1396 1397 1641 1147 1149 1400 1151 1153  896  631  358   77
 556 1086  280 1583 1339 1585 1818 1343 1587 1588 1347 1590 1589 1349 1593  842 1594 2056 1596 1598 1833 1356 1600 1603 1840 1604 1362 1605 1364 1607 1609 1611 1612 1613 1849 1615 1614 1371 1854 2081 1619 1377 1622 1378 1623 1859 1625 1626 1627 1863 1628 1135 1389 1631 1867 1869 1636 1871 1394 1638 1639 1640 1399 1643 1878 1644 1402 1403 1154  633  632   78
 279 1337 1085  555 1336 1820 1821 1586 1819 2051 1346 2053 1591 1592 2488 2055 1831 2061 1352 1103 1835 1837 2282 2063 1838 1606 1361 2067 1843 1608 1844 1610 1845 1846 1847 1850 1851 2078 1616 1853 1620 1127 2083 2084 1857 1858 2086 1861 1862 2090 1864 1630 1866 2096 1868 2317 1872 2098 1637 1873 1874 1875 1879 1642 2104 1645 1404 1155  897  898  359   79
 278  823 1338 1582 1084 2269 2048 1580 1822 2049 1823 1825 2052 2274 2054 1828 1830 2058 1834 2279 1601 2062 2283 2059 2066 1839 2068 2069 1842 2070 2071 2072 2073 2075 1848 2076 2297 2080 1617 2299 2511 1125 2513 2085 2304 2305 2306 2089 2308 2519 2091 2092 1865 2094 2097 1870 2527 2316 2319 2101 2321 2102 1876 2103 1877 1646 1405 1156  899  634  360  361
 276  554  553 1333 1817 1816 1581 2046 2268 2050 1824 2271 2272 2484 2273 2276 2277 2060 1832 1353 2491 2278 2057 2493 2065 2284 2286 2287 2288 2289 2290 2291 2292 2074 2294 2295 2077 2296 2079 2082 1855 1856 2300 2302 2303 2516 1860 2088 2307 2310 2311 2312 2093 2523 2095 2314 2315 2318 2100 2099 2322 2531 2324 2323 1880 1647 1406 1157  900  635  362   80
 277  275  552  822 1082 1083 2045 2047 2480 2481 2270 2684 2482 2483 2275 2687 2485 2487 2691 2693 2280 2492 2697 2696 2495 2285 2496 2497 2499 2500 2501 2502 2503 2293 2504 2505 2507 2508 2509 2298 2510 2301 2512 2514 2515 2517 2518 2087 2520 2309 2521 2524 2727 2313 2526 2925 2729 2528 2529 2320 2530 2533 2532 2105 1881 1408 1648 1158  901  636  363   81
 274  824 1577 1080 1578 1335 2044 1334 2479 2478 2267 2881 2685 2686 2689 2690 2486 2489 2888 2887 2490 2494 2694 2281 2698 2894 2699 2498 2702 2703 2704 2705 2706 2707 2708 2506 2710 2711 2907 2713 2714 2715 2716 2717 2718 2719 2720 2721 2722 2723 2724 2522 2725 2728 2923 3111 2525 2731 2732 2733 2734 2107 2325 2106 1649 1409 1407 1160  637  638  364   82
 272  551  819  549  550  821 1815 1813 2266 2265 2682 2880 2683 3068 2688 2884 2885 2886 3074 2692 2889 2890 2695 2892 2893 3081 2896 2701 3263 3084 2900 2902 2903 3089 2904 2709 2905 2712 3094 2908 2909 2910 2911 2912 2913 2914 2915 2916 2917 2918 2919 2920 2726 2921 2922 2924 2730 2926 2928 2735 2736 2536 2534 2108 1882 1650 1159  903  902  365   84   83
1079 1078  820 1077  818 1579 1812 1575 2043 2264 2477 2681 2882 3070 2883 3071 3072 3252 3075 3076 3255 3077 2891 3079 3080 2895 2700 2897 3083 2898 2899 3086 2901 3090 3091 3092 3093 2906 3444 3095 3096 3097 3098 3099 3100 3101 3102 3103 3104 3105 3106 3107 3109 3287 3110 3290 3112 3113 2927 2929 2737 2535 2326 1652 1884 1883 1885 1161  904  639  366   85
 271  273 1081  548  816 1331 1576 2042 2476 2475 2879 2878 3067 3069 3249 3250 3251 3253 3073 3254 3427 3257 3078 3258 3430 3259 3082 3261 3264 3085 3266 3087 3088 3268 3269 3271 3272 3605 3442 3274 3275 3276 3277 3278 3279 3280 3281 3282 3283 3284 3456 3285 3458 3289 3623 3291 3292 3115 3114 2931 2930 2327 2110 1886 1412 1653 1410 1162  905  640  367   86
 270  547  817 1332 1330 1814 2041 2263 2040 2680 2679 3066 3065 3248 3247 3421 3422 3423 3424 3425 3256 3426 3428 3429 3591 3431 3432 3262 3434 3435 3265 3437 3439 3438 3602 3604 3441 3445 3273 3762 3446 3447 3448 3449 3450 3451 3452 3453 3617 3454 3455 3286 3108 3288 3460 3461 3294 3463 3293 3116 2738 2537 2328 2109 1651 1654 1411 1163  906  641  368   87
 269  546  815 1076 1574 1811 1573 2039 2260 2474 2875 2258 3246 3420 3418 3419 3584 3585 3586 3587 3589 3745 3590 3748 3260 3593 3594 3433 3596 3597 3754 3600 3601 3267 3758 3603 3760 3270 3443 3608 3609 3610 3767 3611 3612 3613 3614 3616 3772 3618 3619 3457 3621 3620 3459 3624 3625 3295 3117 2932 2739 2538 2329 2111 1887 1655 1413 1164  907  642  369   88
 268  545  814 1075 1329 1809 1810 2037 2473 2262 2876 2874 3064 2877 3245 3583 3740 3742 3888 3588 3744 3892 3746 3592 3747 3749 3752 3595 3900 3598 3436 3755 3756 3905 3759 3440 3906 3606 3763 3764 3765 3766 3914 4052 3770 3917 3769 3615 3918 3773 3774 3775 3923 3776 3777 3622 3296 3465 3118 2933 2539 2540 2541 2330 2112 1656 1414 1165  908  643  370   89
 267  544  813 1074 1327 1328 2038 1808 2259 2471 2677 2678 3063 3244 3417 3582 3739 3887 3741 4030 4161 3891 3893 3894 3896 3895 3899 4037 4040 3599 3753 3901 3903 3904 4174 4044 3908 3607 3909 3910 3911 3913 4184 4053 3916 4054 3768 4057 3771 4059 3920 3922 4060 3778 3464 3629 3627 3462 3297 3119 2743 2742 2115 2113 1888 1416 1415 1166  909  644  371   90
 266  543  812 1073 1326 1570 1572 1571 2472 2261 2676 2873 3062 3243 3416 3581 3738 3889 4027 3743 4162 4029 4033 4034 4165 3897 3751 3750 3898 4038 4039 3902 4042 3757 4175 4043 4046 4047 3761 4049 4050 4051 3912 4182 3915 4188 4056 4187 4189 4192 4062 4058 3924 3780 3779 3466 3626 3468 3299 2741 2934 2744 2114 2740 1889 1890 1417 1167  910  645  372   91
 265  542  811 1071 1072 1325 1569 2036 2257 2470 2675 2872 3061 3242 3415 3580 3737 3886 4160 3890 4028 4031 4032 4164 4035 4036 4291 4167 4168 4171 4170 4041 4172 4173 4045 4299 3907 4176 4048 4179 4180 4306 4305 4307 4308 4055 4186 4310 3919 4190 3921 4196 4428 3782 3926 4315 3298 3120 2937 3121 2936 2332 2331 2116 1657 1659 1658 1168  911  646  373   92
 264  541  810 1070 1324 1806 1807 2035 2256 2469 2674 2871 3060 3241 3414 3579 3736 3885 4026 4159 4283 4285 4163 4403 4288 4166 4292 4290 4408 4293 4169 4411 4410 4298 4177 4414 4300 4178 4302 4303 4304 4181 4183 4185 4423 4424 4426 4632 4312 4064 4061 4314 4191 3781 4063 3467 3925 3123 3122 2935 2745 2334 2333 2117 1891 1892 1418 1169  912  647  374   93
 263  539  540  809 1322 1568 1805 2034 2255 2468 2673 2870 3059 3240 3413 3578 3735 3884 4025 4157 4401 4284 4286 4287 4509 4406 4289 4610 4407 4516 4295 4296 4412 4519 4297 4413 4301 4417 4416 4526 4419 4420 4528 4421 4530 4535 4309 4532 4425 4427 3928 4313 4065 3628 3783 3469 3630 3125 3302 3124 2543 2542 2335 2118 1893 1660 1419 1170  913  648  375   94
 262  538  808 1323 1069 1567 1804 2033 2254 2467 2672 2869 3058 3239 3412 3577 3734 3883 4024 4282 4158 4400 4398 4399 4404 4512 4405 4609 4513 4294 4409 4514 4517 4518 4520 4620 4415 4714 4625 4418 4527 4422 4718 4627 4529 4531 4631 4534 4429 4311 3927 4195 4194 3785 3929 3631 3471 3470 2746 2938 2544 2545 2336 2119 1894 1661 1420 1171  914  649  376   95
 261  537  807 1068 1321 1566 1803 2032 2253 2466 2671 2868 3057 3238 3411 3576 3733 3882 4023 4156 4281 4508 4608 4510 4611 4511 4402 4612 4613 4515 4615 4616 4618 4709 4619 4870 4522 4524 4713 4623 4626 4717 4800 4628 4629 4722 4630 4536 4431 4316 4193 4068 4066 3931 3784 3300 3632 3301 2940 2939 2747 2546 2337 2120 1895 1662 1421 1172  915  650  377   96
 806  258  805 1067 1564 1320 1802 2031 2252 2465 2670 2867 3056 3237 3410 3575 3732 3881 4022 4155 4280 4397 4507 4607 4700 4701 4702 4703 4704 4614 4706 4789 4707 4617 4792 4621 4712 4525 4796 4521 4622 4716 4942 4803 4719 4721 4533 4538 4634 4430 4198 4319 4197 3787 3930 3633 3472 3303 3126 2941 2547 2548 2338 2121 1896 1663 1422 1173  916  651  378   97
 260  259  536 1066 1565 1065 1801 2030 2251 2464 2669 2866 3055 3236 3409 3574 3731 3880 4021 4154 4279 4396 4506 4505 4699 4784 4785 4786 4862 4787 4705 4790 4708 4791 4867 4710 4793 4715 4797 4624 4874 4876 4799 4802 4720 4804 4723 4633 4537 4317 4432 4067 4069 3932 3786 3634 3473 3304 3127 2942 2748 2751 2339 2122 1897 1664 1423 1174  917  652  379   98
 257  535  803 1317 1319 1318 1800 2029 2250 2463 2668 2865 3054 3235 3408 3573 3730 3879 4020 4153 4278 4395 4504 4606 4698 4783 4860 4928 4861 4788 4863 4865 4866 4934 4711 4868 4523 4795 4798 4997 5000 4940 4801 4877 4878 4805 4724 4635 4433 4434 4320 4318 4199 4070 3788 3635 3474 3305 3128 2750 2749 2549 2340 2123 1898 1665 1424 1175  653  654  380   99
 256  802 1062  804 1561 1563 2028 2249 2248 2462 2667 2864 3053 3234 3407 3572 3729 3878 4019 4152 4277 4394 4604 4696 4697 4782 4859 4926 4929 4930 4864 4931 4932 4933 4794 4869 4873 4871 4939 5093 4998 4875 4943 4944 4879 4806 4725 4636 4539 4435 4321 4200 3934 3933 3789 3636 3307 3306 2945 2946 2943 2550 2551 2124 1899 1666 1425  919  918  921  381  100
 532  534 1562 1064 1316 1799 2027 2026 2461 2460 2666 2863 3233 3405 3571 3570 3728 3877 4017 4276 4393 4502 4503 4605 4603 4781 4858 4988 4927 5040 4989 4990 4991 5044 4936 4994 5048 4937 5047 5051 5049 4941 5002 4945 4880 4807 4726 4637 4540 4436 4322 4201 4071 3935 3790 3637 3475 3476 3131 2944 2752 2342 2341 2343 1900 1667 1426 1178 1177  920  102  382
 533  801 1061 1063 1798 1559 1560 2247 2246 2665 2663 3051 3052 3406 3569 3232 3727 3876 4151 4018 4275 4392 4501 4602 4695 4856 4779 4857 4986 4987 5041 5042 5043 5088 4935 5045 4993 4995 4872 4999 5005 5001 5003 4946 4881 4808 4727 4638 4541 4437 4323 4202 4072 3936 3791 3638 3477 3130 3129 2947 2753 2552 2344 2125 1901 1668 1427 1179 1176  656  101  923
 255  531  800 1314 1315 1796 1797 2025 2458 2459 2862 2664 3050 3231 3725 3726 3875 4016 4015 4150 4273 4391 4500 4601 4694 4780 4855 4925 4985 5039 5084 5085 5086 4992 5089 5046 5090 5125 5126 4938 5050 5052 5053 4947 4882 4809 4728 4639 4542 4324 4203 4204 4073 3937 3792 3639 3478 3132 3309 2949 2754 2127 2128 2346 2126 1669 1428  657  922  655  386  383
 254  252  797 1060 1313 1557 1558 1795 2245 2860 2861 2858 3049 3230 3404 3568 3724 3874 4148 4274 4149 4390 4600 4691 4499 4778 4777 4923 4984 5037 5083 5120 5121 5087 5124 4996 5092 5091 5128 5094 5054 5095 4949 4948 4883 4810 4729 4640 4544 4325 4205 3938 4074 3939 3793 3640 3479 3310 3308 2948 2345 2553 2129 1904 1902 1905 1670 1429  659  384  103  385
 530  799  253  798 1312 1793 2021 2024 2023 2244 2859 2662 3048 3229 3403 3402 3566 3873 4014 4272 4146 4598 4389 4693 4692 4854 4924 4922 4983 5082 5119 5148 5146 5122 5170 5171 5180 5154 5127 5129 5130 5096 5004 4950 4884 4811 4730 4641 4438 4543 4439 4076 4075 4077 3795 3641 3312 3480 3134 2554 2758 2755 2555 2347 1903 1671 1183 1180  924  658  105  104
 251  529  528 1059 1058 1556 2242 1794 1792 2457 2661 3047 3046 3228 3401 3567 3722 3723 4270 4147 4387 4271 4498 4599 4775 5038 4981 4982 5081 5036 5035 5147 5145 5149 5150 5182 5151 5153 5155 5056 5097 5008 5006 5007 4885 4812 4731 4642 4545 4440 4326 4327 3794 4206 3940 3481 3133 3313 2950 2756 3135 2757 2130 2556 2131 1430 1431 1182  660  387  107  106
 250  527  796 1057 1311 1555 2020 2022 2455 2454 2456 2857 3227 3400 3399 3565 3871 4013 3870 4012 4388 4496 4597 4495 4921 4776 4690 4774 4851 4980 5169 5118 5117 5183 5168 5172 5152 5175 5131 5132 5098 5055 5057 4951 4886 4813 4732 4643 4546 4441 4328 4208 4078 3941 3642 3643 3482 3311 3314 3136 2951 2557 2348 1906 1673 1672 1181 1432  925  926  661  108
 249  526  795 1056 1310 1309 1791 2241 2659 2238 2856 3045 3043 3225 3226 3564 3872 3721 4144 4383 4145 4497 4386 4595 4596 4689 4852 4853 5079 4920 5078 5080 5167 5179 5177 5123 5176 5173 5157 5156 5099 5058 5010 4952 4887 4814 4733 4644 4547 4442 4329 4209 4207 3796 3798 3797 3644 3483 3137 2952 2759 2558 2132 1908 2133 1674 1433 1184  927  662  388  389
 248  525  794 1055 1308 1554 1790 2019 2243 2240 2660 2657 2855 3044 3398 3563 3720 4009 4011 3869 4269 4385 4494 4687 4688 4848 4850 4771 4979 5116 5166 5144 5115 5178 5164 5181 5163 5174 5158 5133 5100 5009 5059 4953 4888 4815 4734 4645 4548 4443 4330 4080 4079 3943 3942 3645 3484 3315 3138 2953 2760 2559 2349 2350 1675 1907 1434 1185  928  663  390  109
 247  524  793 1307 1552 1553 1789 2017 2018 2453 2658 2853 2854 3224 3397 3562 3868 4010 4142 4143 4008 4491 4266 4493 4594 4773 4978 4916 4917 4919 5034 5113 5114 5165 5141 5162 5161 5160 5159 5134 5101 5060 5011 4954 4889 4816 4735 4646 4549 4444 4331 4210 4081 3944 3799 3646 3485 3316 3139 2954 2761 2560 2351 2134 1909 1676 1435 1186  929  664  391  110
 246  523  792 1054 1306 1551 1788 2236 2237 2239 2451 2656 3042 3223 3396 3561 3719 3718 4007 4268 4141 4267 4384 4593 4686 4849 4847 4918 5033 5031 5077 5076 5143 5142 5110 5108 5138 5137 5136 5135 5102 5061 5012 4955 4890 4817 4736 4647 4550 4445 4332 4211 4082 3945 3800 3647 3486 3317 3140 2955 2762 2561 2352 2135 1910 1677 1436 1187  930  665  392  111
 245  522  791 1053 1052 1550 2016 1786 2450 2452 2655 2852 3041 3222 3395 3560 3717 3866 4140 3867 4265 4381 4382 4592 4685 4772 4770 4977 5032 5030 5075 5073 5112 5139 5070 5109 5107 5106 5105 5104 5103 5062 5013 4956 4891 4818 4737 4648 4551 4446 4333 4212 4083 3946 3801 3648 3487 3318 3141 2956 2763 2562 2353 2136 1911 1678 1437 1188  931  666  393  112
 244  521  790 1051 1305 1785 1548 1787 2015 2449 2654 2851 3040 3221 3394 3559 3716 3865 4006 4139 4492 4264 4380 4684 4769 4768 4846 4915 4976 5029 5074 5072 5140 5111 5071 5069 5068 5067 5066 5065 5064 5063 5014 4957 4892 4819 4738 4649 4552 4447 4334 4213 4084 3947 3802 3649 3488 3319 3142 2957 2764 2563 2354 2137 1912 1679 1438 1189  932  667  394  113
 243  520 1049 1050 1304 1549 1784 2014 2235 2448 2653 2850 3039 3220 3393 3558 3715 3864 4005 4138 4262 4488 4490 4590 4591 4767 4845 4914 4975 5028 5027 5026 5025 5024 5023 5022 5021 5020 5019 5018 5017 5016 5015 4958 4893 4820 4739 4650 4553 4448 4335 4214 4085 3948 3803 3650 3489 3320 3143 2958 2765 2564 2355 2138 1913 1680 1439 1190  933  668  395  114
 242  518  789  519 1303 1302 1547 2013 2234 2447 2652 2849 3038 3219 3392 3557 3714 3863 4137 4261 4136 4263 4489 4589 4683 4766 4844 4913 4974 4973 4972 4971 4970 4969 4968 4967 4966 4965 4964 4963 4962 4961 4960 4959 4894 4821 4740 4651 4554 4449 4336 4215 4086 3949 3804 3651 3490 3321 3144 2959 2766 2565 2356 2139 1914 1681 1440 1191  934  669  396  115
 241  787 1048  788 1301 1546 1783 2012 2233 2446 2651 2848 3037 3218 3391 3556 3713 3862 4002 4004 4260 4378 4379 4588 4682 4680 4843 4912 4911 4910 4909 4908 4907 4906 4905 4904 4903 4902 4901 4900 4899 4898 4897 4896 4895 4822 4741 4652 4555 4450 4337 4216 4087 3950 3805 3652 3491 3322 3145 2960 2767 2566 2357 2140 1915 1682 1441 1192  935  670  397  116
 240  517  786 1047 1300 1545 1782 2011 2232 2445 2650 2847 3036 3217 3390 3555 3712 3861 4134 4135 4377 4486 4487 4587 4679 4681 4842 4841 4840 4839 4838 4837 4836 4835 4834 4833 4832 4831 4830 4829 4828 4827 4826 4825 4824 4823 4742 4653 4556 4451 4338 4217 4088 3951 3806 3653 3492 3323 3146 2961 2768 2567 2358 2141 1916 1683 1442 1193  936  671  398  117
 239  516  785 1046 1299 1544 1781 2010 2231 2444 2649 2846 3035 3216 3389 3554 3711 3860 4003 4259 4258 4376 4485 4586 4764 4765 4763 4762 4761 4760 4759 4758 4757 4756 4755 4754 4753 4752 4751 4750 4749 4748 4747 4746 4745 4744 4743 4654 4557 4452 4339 4218 4089 3952 3807 3654 3493 3324 3147 2962 2769 2568 2359 2142 1917 1684 1443 1194  937  672  399  118
 238  515  784 1045 1298 1543 1780 2009 2230 2443 2648 2845 3034 3215 3388 3553 3710 3859 4001 4000 4133 4375 4484 4585 4678 4677 4676 4675 4674 4673 4672 4671 4670 4669 4668 4667 4666 4665 4664 4663 4662 4661 4660 4659 4658 4657 4656 4655 4558 4453 4340 4219 4090 3953 3808 3655 3494 3325 3148 2963 2770 2569 2360 2143 1918 1685 1444 1195  938  673  400  119
 237  514  783 1044 1297 1542 1779 2008 2229 2442 2647 2844 3033 3214 3387 3552 3709 3858 3999 4132 4257 4374 4483 4584 4583 4582 4581 4580 4579 4578 4577 4576 4575 4574 4573 4572 4571 4570 4569 4568 4567 4566 4565 4564 4563 4562 4561 4560 4559 4454 4341 4220 4091 3954 3809 3656 3495 3326 3149 2964 2771 2570 2361 2144 1919 1686 1445 1196  939  674  401  120
 236  513  782 1043 1296 1541 1778 2007 2228 2441 2646 2843 3032 3213 3386 3551 3708 3857 3998 4131 4256 4373 4482 4481 4480 4479 4478 4477 4476 4475 4474 4473 4472 4471 4470 4469 4468 4467 4466 4465 4464 4463 4462 4461 4460 4459 4458 4457 4456 4455 4342 4221 4092 3955 3810 3657 3496 3327 3150 2965 2772 2571 2362 2145 1920 1687 1446 1197  940  675  402  121
 235  512  781 1042 1295 1540 1777 2006 2227 2440 2645 2842 3031 3212 3385 3550 3707 3856 3997 4130 4255 4372 4371 4370 4369 4368 4367 4366 4365 4364 4363 4362 4361 4360 4359 4358 4357 4356 4355 4354 4353 4352 4351 4350 4349 4348 4347 4346 4345 4344 4343 4222 4093 3956 3811 3658 3497 3328 3151 2966 2773 2572 2363 2146 1921 1688 1447 1198  941  676  403  122
 234  511  780 1041 1294 1539 1776 2005 2226 2439 2644 2841 3030 3211 3384 3549 3706 3855 3996 4129 4254 4253 4252 4251 4250 4249 4248 4247 4246 4245 4244 4243 4242 4241 4240 4239 4238 4237 4236 4235 4234 4233 4232 4231 4230 4229 4228 4227 4226 4225 4224 4223 4094 3957 3812 3659 3498 3329 3152 2967 2774 2573 2364 2147 1922 1689 1448 1199  942  677  404  123
 233  510  779 1040 1293 1538 1775 2004 2225 2438 2643 2840 3029 3210 3383 3548 3705 3854 3995 4128 4127 4126 4125 4124 4123 4122 4121 4120 4119 4118 4117 4116 4115 4114 4113 4112 4111 4110 4109 4108 4107 4106 4105 4104 4103 4102 4101 4100 4099 4098 4097 4096 4095 3958 3813 3660 3499 3330 3153 2968 2775 2574 2365 2148 1923 1690 1449 1200  943  678  405  124
 232  509  778 1039 1292 1537 1774 2003 2224 2437 2642 2839 3028 3209 3382 3547 3704 3853 3994 3993 3992 3991 3990 3989 3988 3987 3986 3985 3984 3983 3982 3981 3980 3979 3978 3977 3976 3975 3974 3973 3972 3971 3970 3969 3968 3967 3966 3965 3964 3963 3962 3961 3960 3959 3814 3661 3500 3331 3154 2969 2776 2575 2366 2149 1924 1691 1450 1201  944  679  406  125
 231  508  777 1038 1291 1536 1773 2002 2223 2436 2641 2838 3027 3208 3381 3546 3703 3852 3851 3850 3849 3848 3847 3846 3845 3844 3843 3842 3841 3840 3839 3838 3837 3836 3835 3834 3833 3832 3831 3830 3829 3828 3827 3826 3825 3824 3823 3822 3821 3820 3819 3818 3817 3816 3815 3662 3501 3332 3155 2970 2777 2576 2367 2150 1925 1692 1451 1202  945  680  407  126
 230  507  776 1037 1290 1535 1772 2001 2222 2435 2640 2837 3026 3207 3380 3545 3702 3701 3700 3699 3698 3697 3696 3695 3694 3693 3692 3691 3690 3689 3688 3687 3686 3685 3684 3683 3682 3681 3680 3679 3678 3677 3676 3675 3674 3673 3672 3671 3670 3669 3668 3667 3666 3665 3664 3663 3502 3333 3156 2971 2778 2577 2368 2151 1926 1693 1452 1203  946  681  408  127
 229  506  775 1036 1289 1534 1771 2000 2221 2434 2639 2836 3025 3206 3379 3544 3543 3542 3541 3540 3539 3538 3537 3536 3535 3534 3533 3532 3531 3530 3529 3528 3527 3526 3525 3524 3523 3522 3521 3520 3519 3518 3517 3516 3515 3514 3513 3512 3511 3510 3509 3508 3507 3506 3505 3504 3503 3334 3157 2972 2779 2578 2369 2152 1927 1694 1453 1204  947  682  409  128
 228  505  774 1035 1288 1533 1770 1999 2220 2433 2638 2835 3024 3205 3378 3377 3376 3375 3374 3373 3372 3371 3370 3369 3368 3367 3366 3365 3364 3363 3362 3361 3360 3359 3358 3357 3356 3355 3354 3353 3352 3351 3350 3349 3348 3347 3346 3345 3344 3343 3342 3341 3340 3339 3338 3337 3336 3335 3158 2973 2780 2579 2370 2153 1928 1695 1454 1205  948  683  410  129
 227  504  773 1034 1287 1532 1769 1998 2219 2432 2637 2834 3023 3204 3203 3202 3201 3200 3199 3198 3197 3196 3195 3194 3193 3192 3191 3190 3189 3188 3187 3186 3185 3184 3183 3182 3181 3180 3179 3178 3177 3176 3175 3174 3173 3172 3171 3170 3169 3168 3167 3166 3165 3164 3163 3162 3161 3160 3159 2974 2781 2580 2371 2154 1929 1696 1455 1206  949  684  411  130
 226  503  772 1033 1286 1531 1768 1997 2218 2431 2636 2833 3022 3021 3020 3019 3018 3017 3016 3015 3014 3013 3012 3011 3010 3009 3008 3007 3006 3005 3004 3003 3002 3001 3000 2999 2998 2997 2996 2995 2994 2993 2992 2991 2990 2989 2988 2987 2986 2985 2984 2983 2982 2981 2980 2979 2978 2977 2976 2975 2782 2581 2372 2155 1930 1697 1456 1207  950  685  412  131
 225  502  771 1032 1285 1530 1767 1996 2217 2430 2635 2832 2831 2830 2829 2828 2827 2826 2825 2824 2823 2822 2821 2820 2819 2818 2817 2816 2815 2814 2813 2812 2811 2810 2809 2808 2807 2806 2805 2804 2803 2802 2801 2800 2799 2798 2797 2796 2795 2794 2793 2792 2791 2790 2789 2788 2787 2786 2785 2784 2783 2582 2373 2156 1931 1698 1457 1208  951  686  413  132
 224  501  770 1031 1284 1529 1766 1995 2216 2429 2634 2633 2632 2631 2630 2629 2628 2627 2626 2625 2624 2623 2622 2621 2620 2619 2618 2617 2616 2615 2614 2613 2612 2611 2610 2609 2608 2607 2606 2605 2604 2603 2602 2601 2600 2599 2598 2597 2596 2595 2594 2593 2592 2591 2590 2589 2588 2587 2586 2585 2584 2583 2374 2157 1932 1699 1458 1209  952  687  414  133
 223  500  769 1030 1283 1528 1765 1994 2215 2428 2427 2426 2425 2424 2423 2422 2421 2420 2419 2418 2417 2416 2415 2414 2413 2412 2411 2410 2409 2408 2407 2406 2405 2404 2403 2402 2401 2400 2399 2398 2397 2396 2395 2394 2393 2392 2391 2390 2389 2388 2387 2386 2385 2384 2383 2382 2381 2380 2379 2378 2377 2376 2375 2158 1933 1700 1459 1210  953  688  415  134
 222  499  768 1029 1282 1527 1764 1993 2214 2213 2212 2211 2210 2209 2208 2207 2206 2205 2204 2203 2202 2201 2200 2199 2198 2197 2196 2195 2194 2193 2192 2191 2190 2189 2188 2187 2186 2185 2184 2183 2182 2181 2180 2179 2178 2177 2176 2175 2174 2173 2172 2171 2170 2169 2168 2167 2166 2165 2164 2163 2162 2161 2160 2159 1934 1701 1460 1211  954  689  416  135
 221  498  767 1028 1281 1526 1763 1992 1991 1990 1989 1988 1987 1986 1985 1984 1983 1982 1981 1980 1979 1978 1977 1976 1975 1974 1973 1972 1971 1970 1969 1968 1967 1966 1965 1964 1963 1962 1961 1960 1959 1958 1957 1956 1955 1954 1953 1952 1951 1950 1949 1948 1947 1946 1945 1944 1943 1942 1941 1940 1939 1938 1937 1936 1935 1702 1461 1212  955  690  417  136
 220  497  766 1027 1280 1525 1762 1761 1760 1759 1758 1757 1756 1755 1754 1753 1752 1751 1750 1749 1748 1747 1746 1745 1744 1743 1742 1741 1740 1739 1738 1737 1736 1735 1734 1733 1732 1731 1730 1729 1728 1727 1726 1725 1724 1723 1722 1721 1720 1719 1718 1717 1716 1715 1714 1713 1712 1711 1710 1709 1708 1707 1706 1705 1704 1703 1462 1213  956  691  418  137
 219  496  765 1026 1279 1524 1523 1522 1521 1520 1519 1518 1517 1516 1515 1514 1513 1512 1511 1510 1509 1508 1507 1506 1505 1504 1503 1502 1501 1500 1499 1498 1497 1496 1495 1494 1493 1492 1491 1490 1489 1488 1487 1486 1485 1484 1483 1482 1481 1480 1479 1478 1477 1476 1475 1474 1473 1472 1471 1470 1469 1468 1467 1466 1465 1464 1463 1214  957  692  419  138
 218  495  764 1025 1278 1277 1276 1275 1274 1273 1272 1271 1270 1269 1268 1267 1266 1265 1264 1263 1262 1261 1260 1259 1258 1257 1256 1255 1254 1253 1252 1251 1250 1249 1248 1247 1246 1245 1244 1243 1242 1241 1240 1239 1238 1237 1236 1235 1234 1233 1232 1231 1230 1229 1228 1227 1226 1225 1224 1223 1222 1221 1220 1219 1218 1217 1216 1215  958  693  420  139
 217  494  763 1024 1023 1022 1021 1020 1019 1018 1017 1016 1015 1014 1013 1012 1011 1010 1009 1008 1007 1006 1005 1004 1003 1002 1001 1000  999  998  997  996  995  994  993  992  991  990  989  988  987  986  985  984  983  982  981  980  979  978  977  976  975  974  973  972  971  970  969  968  967  966  965  964  963  962  961  960  959  694  421  140
 216  493  762  761  760  759  758  757  756  755  754  753  752  751  750  749  748  747  746  745  744  743  742  741  740  739  738  737  736  735  734  733  732  731  730  729  728  727  726  725  724  723  722  721  720  719  718  717  716  715  714  713  712  711  710  709  708  707  706  705  704  703  702  701  700  699  698  697  696  695  422  141
 215  492  491  490  489  488  487  486  485  484  483  482  481  480  479  478  477  476  475  474  473  472  471  470  469  468  467  466  465  464  463  462  461  460  459  458  457  456  455  454  453  452  451  450  449  448  447  446  445  444  443  442  441  440  439  438  437  436  435  434  433  432  431  430  429  428  427  426  425  424  423  142
 214  213  212  211  210  209  208  207  206  205  204  203  202  201  200  199  198  197  196  195  194  193  192  191  190  189  188  187  186  185  184  183  182  181  180  179  178  177  176  175  174  173  172  171  170  169  168  167  166  165  164  163  162  161  160  159  158  157  156  155  154  153  152  151  150  149  148  147  146  145  144  143
