# This puzzle is unsolvable
65
   2    1    3    4    5    6    7    8    9   10   11   12   13   14   15   16   17   18   19   20   21   22   23   24   25   26   27   28   29   30   31   32   33   34   35   36   37   38   39   40   41   42   43   44   45   46  549   47   48  306  308  310   54   53   55   57  311   61  318  316  563  321  562  314   66
 256  257  258  259  260  261  262  263  264  265  266  267  268  269  270  271  272  273  274  275  276  277  278  279  280  281  282  283  284  285  286  287  288  289  290  291  292  293  294  295  296  297  298  299  300  301  302   51  303   49   52 1024  793  309  796  559   58  560  313  315  803  565   65   63   64
 255  504  505  506  507  508  509  510  511  512  513  514  515  516  517  518  519  520  521  522  523  524  525  526  527  528  529  530  531  532  533  534  535  536  537  538  539  540  541  542  543  544  545  546  547  548  788  551   50  552  305  792 1026  554 1464  312 1030  561  319   60  564  568   67   62   68
 254  503  744  745  746  747  748  749  750  751  752  753  754  755  756  757  758  759  760  761  762  763  764  765  766  767  768  769  770  771  772  773  774  775  776  777  778  779  780  781  782  783  784  785  786  787  550  789  307  304  555 1669  556  553  558 1251  798   59  797 1255 1256  317  322  566   71
 253  502  743  976  977  978  979  980  981  982  983  984  985  986  987  988  989  990  991  992  993  994  995  996  997  998  999 1000 1001 1002 1003 1004 1005 1006 1007 1008 1009 1010 1011 1012 1013 1014 1015 1016 1017 1020 1241 1666  790  791 1247 1244 1023 1027   56 1466 1250  799  801 1031  320 1033 1254 1035   70
 252  501  742  975 1200 1201 1202 1203 1204 1205 1206 1207 1208 1209 1210 1211 1212 1213 1214 1215 1216 1217 1218 1219 1220 1221 1222 1223 1224 1225 1226 1227 1228 1229 1230 1231 1232 1233 1234 1235 1236 1237 1238 1239 1240 1018 1242 2056 1243 1021 1025 1668 1249  557  795 1248 1253 1032  800  567  802  804  569   69  324
 251  500  741  974 1199 1416 1417 1418 1419 1420 1421 1422 1423 1424 1425 1426 1427 1428 1429 1430 1431 1432 1433 1434 1435 1436 1437 1438 1439 1440 1441 1442 1443 1444 1445 1446 1447 1448 1449 1450 1451 1452 1453 1454 1455 1456 1019 1457 1664 1022 1670 1463 1028 1671  794 1672 1029 1252 1468 1469 1034  805  570  806  323
 250  499  740  973 1198 1415 1624 1625 1626 1627 1628 1629 1630 1631 1632 1633 1634 1635 1636 1637 1638 1639 1640 1641 1642 1643 1644 1645 1646 1647 1648 1649 1650 1651 1652 1653 1654 1655 1656 1657 1658 1659 1660 1661 1662 1663 1864 1458 1460 1461 1246 1667 1462 2058 1465 1673 1467 1675 1470 1257 1036  807  325   76   72
 249  498  739  972 1197 1414 1623 1824 1825 1826 1827 1828 1829 1830 1831 1832 1833 1834 1835 1836 1837 1839 1840 1841 2032 1842 1843 1844 1845 1846 1847 1848 1849 1850 1851 1852 1853 1854 1855 1856 1857 1858 1859 1860 1861 1863 1665 2238 1245 1867 1868 2417 2060 1869 1870 2245 1674 1676 1471 1258 1037  808  572  326   73
 248  497  738  971 1196 1413 1622 1823 2016 2017 2018 2019 2020 2021 2022 2023 2024 2025 2026 2027 2028 1838 2212 2214 2031 2033 2034 2035 2036 2037 2038 2039 2040 2041 2042 2043 2044 2045 2046 2047 2048 2049 2050 2051 2235 1862 2054 2055 1865 2240 1459 1866 2065 2061 1871 2062 2063 1873 1472 1259  810  809  328   74  571
 247  496  737  970 1195 1412 1621 1822 2015 2200 2201 2202 2203 2204 2205 2206 2207 2208 2384 2209 2213 2029 2030 2389 2215 2216 2218 2393 2219 2220 2221 2222 2223 2224 2225 2226 2227 2228 2229 2230 2231 2232 2233 2234 2410 2052 2237 2239 2413 2057 2416 2243 2059 2246 1872 2244 1874 1677 1473 1260 1038  330 1039  327   75
 246  495  736  969 1194 1411 1620 1821 2014 2199 2376 2377 2378 2379 2380 2381 2382 2383 2551 2211 2386 2387 2390 2557 2391 2392 2217 2394 2561 2395 2396 2397 2398 2399 2400 2401 2402 2403 2404 2405 2406 2407 2408 2409 2236 2053 2411 2412 2414 2582 2415 2241 2242 2418 2419 2066 2064 1678 1679 1261  811 1040  573  575  329
 245  494  735  968 1193 1410 1619 1820 2013 2198 2375 2544 2545 2546 2547 2548 2549 2550 2385 2210 2554 2714 2388 2555 2716 2556 2559 2560 2720 2722 2562 2564 2565 2566 2567 2568 2569 2570 2571 2572 2573 2574 2575 2576 2577 2578 2579 2738 2740 2581 2583 2584 2585 2420 2247 1875 1680 1475 1474 1262  574 1041  576  333   77
 244  493  734  967 1192 1409 1617 1618 1819 2012 2374 2543 2704 2705 2706 2707 2708 2860 2711 2553 2712 2713 2865 2715 3009 2558 2717 2719 2870 2721 2563 2723 2724 2725 2726 2727 2728 2729 2730 2731 2732 2733 2734 2735 2736 2889 2739 2580 2891 2741 2742 2743 2586 2421 2248 2067 1877 1682 1681 1263  812  814  331  813   79
 243  492  733  966 1191 1408 1818 1817 2011 2197 2373 2542 2855 2703 2856 2857 2858 2710 2709 2552 2863 2864 2866 2867 3010 2868 2718 2871 2872 2873 3016 2874 2875 2876 2877 2878 2879 2880 2881 2882 2883 2884 2885 2886 3030 2737 2888 2890 2892 2893 2894 2423 2587 2249 2068 1876 1879 1878 1476 1264 1042 1043   81  577   78
 242  491  732  965 1190 1407 1616 2010 2009 2196 2195 2372 2541 3000 2999 3001 3139 3003 2861 2862 3006 3007 3008 3271 3145 3012 2869 3014 3149 3015 3017 3152 3018 3019 3020 3021 3022 3023 3024 3025 3026 3027 3028 3029 3031 2887 3032 3033 3034 3036 3035 2744 2588 2422 2250 2070 2069 1880 1477 1044 1265  332  816  815   80
 241  490  731  964 1189 1406 1615 1815 2193 2369 2371 2539 2701 2853 2998 3138 2859 3265 3004 3005 3140 3143 3389 3270 3144 3011 3146 3506 3394 3277 3150 3151 3153 3154 3155 3156 3157 3158 3159 3160 3161 3162 3163 3164 3165 3166 3167 3168 3169 3037 2895 2745 2589 2424 2252 2251 1881 1683 1478 1479 1266 1045  336  578   82
 240  489  730  963 1188 1405 1614 1814 1816 2194 2538 2368 2997 2699 2996 3002 3137 3266 3267 3268 3142 3141 3269 3272 3273 3274 3013 3148 3609 3395 3276 3279 3280 3281 3282 3283 3284 3285 3286 3287 3288 3289 3290 3291 3292 3293 3294 3295 3170 2897 2746 2747 2590 2426 2425 2071 1882 1684 1686 1046 1268  579  334  580   83
 239  488  729  962 1187 1612 1613 2007 2370 2008 2540 2191 2700 2851 2854 3136 3135 3384 3385 3386 3387 3388 3500 3390 3391 3392 3504 3393 3505 3396 3278 3398 3397 3399 3401 3402 3403 3404 3406 3517 3407 3408 3409 3410 3411 3412 3413 3297 3296 3038 3171 2896 2591 2253 2254 2072 1883 1685 1480 1481  817 1267  818  335   84
 238  487  728  961 1185 1186 1403 1813 2006 2004 2702 2367 2852 2995 3134 3264 3262 3383 3263 3497 3498 3499 3603 3501 3503 3607 3606 3147 3704 3508 3610 3509 3400 3511 3512 3513 3514 3515 3405 3619 3518 3623 3519 3521 3522 3523 3414 3172 3174 3173 2898 2748 2593 2592 2427 2073 1884 1687 1047 1482 1269  819  582  581  337
 237  486  727  960  957 1404 1811 1611 2005 2186 2192 2696 2537 2994 2850 2849 3261 3382 3496 3495 3601 3697 3604 3700 3502 3605 3608 3275 3791 3507 3708 3611 3612 3710 3616 3617 3618 3516 3715 3714 3620 3622 3520 3624 3625 3524 3415 3298 3039 2899 2900 2749 2750 2428 2255 2074 1885 1688 1483 1049 1048  820  583  338   85
 236  485  955 1401  958 1402 1812 1608 2003 1809 2365 2366 2536 3132 2697 3133 3381 3494 3599 3600 3696 3698 3602 3786 3701 3788 3702 3703 3705 3707 3709 3613 3510 3615 3614 3797 3713 3799 3712 3802 3621 3717 3718 3719 3626 3525 3416 3040 3300 3041 2901 2751 2594 2429 2256 2075 1886 1484 1271 1270 1050  821  584  339   86
 235  483 1182 1184  959 1400 2190 2188 1609 1999 2189 2698 2695 2848 2993 3131 3260 3380 3493 3598 3695 3864 3699 3785 3865 3787 3789 3790 3870 3792 3706 3794 3795 3796 3798 3711 3800 3880 3879 3951 3716 3803 3805 3720 3526 3628 3417 3299 3175 3042 2752 2753 2595 2430 2257 2076 1690 1689 1485 1272 1051  822  585  340   87
 234  723  726  484  482  956 1810 1397 2361 2364 2534 2535 2694 2992 3129 3130 3259 3258 3492 3597 3694 3784 3863 3936 3866 3867 3868 3869 3871 3872 3793 3873 3874 3875 3876 3877 3878 3950 3801 3881 3882 3804 3883 3721 3627 3527 3419 3418 3176 3177 3043 2902 2596 2431 2258 2077 1887 1888 1486 1273 1052  823  586  341   88
 233  724  725  954  722 1396 1183 2001 2002 1605 2533 2692 2693 2847 2991 3128 3257 3379 3378 3490 3596 3783 3782 3934 3937 3938 3940 4002 3941 3942 3943 3944 3945 3946 3947 3948 3949 4014 3952 4015 3884 3885 3806 3807 3723 3530 3630 3301 3303 3302 2903 2754 2597 2432 2259 2078 1891 1691 1274 1275 1053  824  587  342   89
 232  481  720 1398 1399 1181 1610 1808 2360 2363 2187 2532 2844 2531 2845 3127 3256 3377 3489 3491 3693 3781 3862 3861 3935 4000 4001 3939 4004 4005 4006 4007 4008 4009 4010 4011 4012 4013 4069 4016 3809 3954 3886 3722 3629 3178 3045 3529 2904 3046 3044 2755 2598 2433 2261 2260 1692 1890 1693 1487 1054  825  588  343   90
 231  480 1177 1606 1180 1806 1805 1807 2185 2000 2184 2362 2846 2843 2990 3254 3255 3375 3376 3595 3692 3691 3780 3932 3999 4056 4057 4003 4059 4060 4061 4062 4063 4064 4065 4066 4067 4068 4070 3955 3953 3808 3724 3631 3531 3632 3528 3421 3047 3180 2905 2756 2599 2435 2434 2080 1889 2079 1488 1276 1055  826  589  344   91
 229  478  721 1179  230 1602 1395 1998 1997 1607 2182 2690 2691 2842 2988 3252 3374 3593 3592 3594 3690 3779 3860 3997 3998 4055 4105 4058 4106 4107 4108 4109 4110 4150 4111 4113 4153 4114 4115 4017 3956 3887 3810 3726 3725 3420 3422 3304 3181 3179 2906 2757 2600 2262 2263 1892 1695 1893 1694 1490 1056  827  590  345   92
 228  479  719  476 1394 1604 1804 1996 2183 2529 2530 2528 2689 3122 2841 3126 3488 2989 3373 3487 3591 3689 3778 3859 3931 4054 4104 4103 4145 4146 4147 4148 4149 4181 4112 4151 4183 4116 4071 4018 3957 3888 3811 3728 3633 3532 3423 3305 3048 3049 2907 2758 2601 2436 2083 2081 2082 1489 1491 1277 1278 1057  591  346   93
 477  953 1176  949 1393 1178 1803 1603 1802 1995 2359 2527 2687 2985 3251 3125 2987 3124 2986 3372 3687 3688 3857 3858 3933 3996 4102 4144 4142 4200 4178 4177 4179 4180 4182 4152 4154 4117 4072 4019 3958 3889 3812 3634 3636 3533 3307 3306 3182 2908 2759 2760 2602 2437 2264 1894 1697 1696 1492 1279 1058  828  592  347   94
 227  717  952  951  950 1175 1392 1801 1800 2181 1994 2525 2984 2840 3121 3253 3250 3590 3775 3486 3777 3856 3855 3930 3995 4053 4101 4141 4176 4174 4199 4202 4203 4204 4205 4184 4118 4073 4020 4022 3959 3960 3890 3727 3813 3534 3424 3425 3638 3183 3050 2909 2603 2438 2265 2084 1895 1698 1493 1280 1059  829  830  348   95
 225  715  718  716 1173 1174 1601 1993 2179 2357 2526 2358 2356 2839 3123 3120 2982 3485 3587 3483 3484 3776 3929 3928 3994 4052 4051 4100 4143 4175 4198 4216 4217 4219 4206 4185 4155 4119 4074 4075 4021 3815 3814 3729 3637 3536 3427 3426 3308 3051 2910 2761 2604 2439 2266 2085 1896 1699 1494 1281 1060  831  593  349   96
 226  474  714  948 1172 1391 1390 1600 1992 2355 2688 2524 2686 2838 3119 3249 3248 3371 3481 3685 3589 3686 3854 3774 3993 4050 4099 4140 4173 4215 4201 4224 4218 4220 4207 4186 4156 4120 4076 3961 3891 3816 3731 3730 3635 3185 3428 3052 3184 3309 2911 2762 2605 2440 2267 2086 1897 1700 1495 1282  832  596  594  350   97
 475  473  712 1598  470 1171 1599 2178 1799 2177 2180 2523 2685 2684 2837 3118 3370 3588 3482 3683 3684 3773 3925 3927 3992 4049 4098 4139 4172 4197 4214 4223 4222 4221 4208 4187 4157 4158 4077 3963 3962 3892 3537 3732 3538 3639 3535 3311 3310 2912 2763 2764 2441 2442 2268 2087 1898 1702 1497 1062 1061  595  833  351   98
 472  713  947  944 1387  946 1597 1991 1990 2176 2354 2522 2980 2836 2834 3246 3247 3369 3368 3586 3853 3772 3926 3924 3991 4048 4097 4138 4171 4196 4213 4212 4211 4210 4209 4188 4159 4121 4122 4025 4024 3893 3817 3640 3429 3539 3312 3187 3186 3053 3055 2765 2606 2443 2269 2088 1899 1283 1285 1496 1063  834  597  352   99
 224  223  943  471  945 1389 1596 1798 2175 2521 2353 2683 2983 2981 2835 3117 3367 3479 3478 3681 3771 3682 3852 4047 3989 4046 4096 4137 4170 4195 4194 4193 4192 4191 4190 4189 4160 4123 4023 3965 3964 3895 3894 3818 3734 3733 3430 3313 3188 2914 2913 2608 2607 2444 2270 2089 1900 1701 1703 1284 1499  837  354  598  100
 221  222  469 1386 1170 1988 2173 1797 1593 2174 2351 2520 2352 2833 3116 2977 3245 3366 3585 3480 3769 3680 3850 3851 4095 3987 4136 4135 4169 4168 4167 4166 4165 4164 4163 4162 4161 4026 4078 4027 3966 3896 3819 3642 3540 3541 3314 3189 3054 2915 2767 2916 2609 2445 2271 2272 1902 2090 1498 1286  835  601  836  353  101
 220  710  711 1169 1167 1168 1595 1388 1989 2172 2350 2681 2682 2831 2832 2979 3363 3244 3365 3364 3849 3770 3477 3923 3990 4094 4093 4134 4133 4090 4132 4131 4130 4129 4128 4127 4126 4079 4124 4028 3897 3820 3735 3641 3643 3433 3431 3432 3057 3056 2766 2768 2612 2610 2273 1901 1708 1704 1500 1287 1064  599 1065  355  102
 219  468  709 1165 1594 1385 1796 1795 1987 2349 2348 2518 2519 2678 3115 2978 3583 3362 3679 3584 3581 3768 3921 3848 4045 4044 4042 4041 4040 4091 4089 4088 4087 4086 4085 4084 4083 4125 4080 4081 3967 3898 3821 3542 3645 3435 3317 3190 3315 3191 3058 2446 2769 2447 2275 2091 1905 1705 1706 1501 1066  838  600  839  602
 218  467  707  942 1383 1384 1793 1794 1986 2171 2517 2680 2679 2830 2976 3114 3242 3474 3243 3678 3580 3582 3847 3922 3988 3986 4043 4092 3981 4039 3979 4037 4036 4035 4034 4033 4032 4082 4030 4029 3968 3899 3822 3644 3736 3543 3316 3192 3059 2918 2917 2611 2613 2274 2092 1904 2093 1502 1288 1068 1067  841  358  103  356
 217  465  466  708 1381 1382 1592 1985 2168 2170 2347 2516 2676 2677 2975 3111 3113 3360 3361 3475 3677 3767 3766 3846 3985 3984 3983 3982 4038 3913 3980 3978 3976 3909 3975 3974 3972 4031 3971 3970 3969 3901 3900 3823 3737 3434 3546 3193 3060 3062 2919 2770 2448 2449 2094 2095 1903 1707 1290 1289  840  603  357  604  104
 216  940  941 1591 1164 1166 1589 1791 1983 1984 2346 2515 2675 2829 2974 3241 3112 3476 3473 3579 3676 3765 3919 3920 3918 3917 3916 3915 3914 3838 3912 3977 3908 3751 3831 3906 3973 3905 3904 3827 3902 3743 3824 3647 3646 3738 3544 3318 3194 3063 3061 2920 2771 2614 2276    0 1906 1709 1503 1504 1069 1070  361  360  105
 215  706  464 1162  939  938 1590 1792 1790 2169 2345 2513 2514 2972 2973 3110 3240 3358 3238 3578 3675 3764 3845 3844 3843 3842 3841 3840 3839 3755 3837 3911 3834 3832 3907 3833 3830 3747 3829 3903 3828 3826 3739 3547 3648 3436 3740 3319 3195 3064 2921 2772 2615 2450 2277 2096 1907 1710 1293 1291 1292  842  843  605  359
 214  463  705  704 1379 1588 1380 1789 1982 2167 2343 2344 2828 2827 3109 3471 3108 3237 3359 3577 3674 3763 3762 3761 3760 3759 3758 3757 3756 3754 3836 3910 3752 3661 3750 3749 3657 3748 3746 3745 3744 3653 3651 3742 3545 3649 3437 3321 3196 3065 2922 2773 2616 2451 2278 2097 1908 1711 1505 1506 1071 1294  362  108  106
 213  462  703  937 1163 1161 1378 1788 1981 2166 2342 2673 2674 2826 2971 3106 3239 3470 3472 3576 3673 3672 3671 3670 3669 3668 3667 3666 3665 3664 3753 3835 3663 3662 3659 3658 3656 3557 3655 3555 3825 3652 3650 3741 3444 3320 3439 3322 3197 3198 2923 2774 2617 2452 2279 2098 1909 1712 1507  606 1073 1072  107  608  109
 212  461  702  936 1160 1159 1587 1586 1980 2164 2165 2512 2672 2671 2825 3107 3357 3467 3356 3575 3574 3573 3572 3571 3570 3569 3568 3567 3566 3565 3564 3563 3562 3660 3561 3560 3558 3450 3556 3554 3654 3553 3445 3550 3443 3548 3549 3440 3323 3066 2924 2777 2775 2453 2280 2099 1910 1713 1508 1074  845  844  363  607  110
 211  460  934  935 1158 1377 1376 1787 1979 2163 2341 2511 2510 2823 2969 2970 3236 3355 3354 3466 3353 3468 3351 3464 3463 3462 3461 3460 3459 3458 3457 3456 3455 3454 3453 3559 3337 3451 3449 3448 3446 3208 3330 3552 3327 3438 3441 3324 3200 3199 2776 2283 2618 2454 2281 2100 1911 1714 1509 1295 1075  846  609  364  111
 210  700  701  932  933 1375 1786 1585 1978 2162 2340 2509 2670 2824 2967 2822 3233 3235 3104 3229 3099 3228 3465 3349 3348 3347 3346 3345 3344 3343 3342 3341 3340 3339 3338 3336 3452 3335 3334 3333 3447 3209 3331 3329 3205 3551 3326 3071 3067 2926 2925 2619 2621 2282 2455 2101 1912 1715 1510 1296 1076  847  610  365  112
 458  459  698  699 1157 1374 1584 1785 1583 1977 2339 2507 2508 2669 2821 2968 3105 3101 3469 3352 3231 3227 3350 3226 3225 3224 3223 3222 3221 3220 3219 3218 3217 3216 3215 3214 3213 3212 3211 3210 3332 3207 3074 3442 3075 3328 3325 3204 3202 3201 2778 2622 2620 2284 2456 2102 1913 1716 1298 1297 1078 1077  611  366  113
 209  456  457  931 1156 1373 1582 1784 1783 1976 2338 2668 2966 2965 2820 3103 3234 3100 3232 3230 3098 3097 3096 3095 3094 3093 3092 3091 3090 3089 3088 3087 3086 3085 3084 3083 3082 3081 3080 3079 3078 3077 3076 2936 3206 3073 3203 3072 3070 3068 2927 2928 2779 2457 2285 2103 1717 1299 1511 1300  850  848  612  367  114
 208  207  455  930 1155 1372 1581 1975 2160 2161 2337 2506 2666 2667 2819 2964 3102 2963 2961 2960 2959 2958 2957 2956 2955 2954 2953 2952 2951 2950 2949 2948 2947 2946 2945 2944 2943 2942 2941 2940 2939 2938 2790 2937 2935 2934 2933 2932 2931 3069 2782 2929 2623 2624 2104 1915 1914 1718 1512 1513 1514  849  613  368  115
 206  696  697  929 1154 1371 1580 1782 2158 1973 2159 2336 2505 2818 2817 2816 2815 2962 2814 2813 2812 2811 2810 2809 2808 2807 2806 2805 2804 2803 2802 2801 2800 2799 2798 2797 2796 2795 2794 2793 2792 2791 2789 2634 2788 2787 2786 2785 2784 2930 2627 2780 2781 2458 2286 2105 1916 1719 1079 1301 1081  851  614  369  116
 205  454  695  928 1153 1370 1579 1781 1780 1974 2335 2504 2665 2664 2663 2662 2661 2660 2659 2658 2657 2656 2655 2654 2653 2652 2651 2650 2649 2648 2647 2646 2645 2644 2643 2642 2641 2640 2639 2638 2637 2636 2635 2471 2633 2632 2631 2630 2465 2783 2625 2463 2462 2459 2287 2106 1917 1720 1304 1080 1515  852  615  370  117
 204  453  694  927 1152 1369 1578 1779 1972 2157 2334 2503 2502 2501 2500 2499 2498 2497 2496 2495 2494 2493 2492 2491 2490 2489 2488 2487 2486 2485 2484 2483 2482 2481 2480 2479 2478 2477 2476 2475 2474 2473 2472 2469 2300 2298 2468 2467 2464 2629 2626 2113 2290 2460 2461 2107 1918 1516 1303 1302 1082  853  616  371  118
 203  452  693  926 1151 1368 1577 1778 1971 2156 2333 2332 2331 2330 2329 2328 2327 2326 2325 2324 2323 2322 2321 2320 2319 2318 2317 2316 2315 2314 2313 2312 2311 2310 2309 2308 2307 2306 2305 2304 2303 2302 2301 2470 2120 2299 2297 2296 2466 2295 2114 2293 2112 2291 2289 2108 1724 1722 1517 1083  855  854  617  372  119
 202  451  692  925 1150 1367 1576 1777 1970 2155 2154 2153 2152 2151 2150 2149 2148 2147 2146 2145 2144 2143 2142 2141 2140 2139 2138 2137 2136 2135 2134 2133 2132 2131 2130 2129 2128 2127 2126 2125 2124 2123 2122 1934 2121 2119 2118 1930 2628 2294 1928 2292 1926 2288 2110 1919 1921 1721 1518 1305 1085  619 1084  122  373
 201  450  691  924 1149 1366 1575 1776 1969 1968 1967 1966 1965 1964 1963 1962 1961 1960 1959 1958 1957 1956 1955 1954 1953 1952 1951 1950 1949 1948 1947 1946 1945 1944 1943 1942 1941 1940 1939 1938 1538 1937 1740 1935 1933 1932 1736 1734 2117 2115 1927 1924 1925 1922 1923 1920 1723 1519 1311  618  857  376 1086  856  120
 200  449  690  923 1148 1365 1574 1775 1774 1773 1772 1771 1770 1769 1768 1767 1766 1765 1764 1763 1762 1761 1760 1759 1758 1757 1756 1755 1754 1753 1752 1751 1750 1749 1748 1747 1746 1745 1744 1743 1936 1537 1741 1739 1738 1737 1735 1929 2116 1733 1732 1730 1729 2111 1523 2109 1522 1725 1306 1308 1520 1521  375  377  620
 199  448  689  922 1147 1364 1573 1572 1571 1570 1569 1568 1567 1566 1565 1564 1563 1562 1561 1560 1559 1558 1557 1556 1555 1554 1553 1552 1551 1550 1549 1548 1547 1546 1545 1544 1543 1542 1541 1329 1742 1328 1326 1536 1535 1534 1533 1931 1529 1319 1317 1731 1527 1526 1525 1728 1727 1726 1310 1309  621 1307  374 1089  121
 198  447  688  921 1146 1363 1362 1361 1360 1359 1358 1357 1356 1355 1354 1353 1352 1351 1350 1349 1348 1347 1346 1345 1344 1343 1342 1341 1340 1339 1338 1337 1336 1335 1334 1333 1332 1331 1330 1539 1540 1327 1325 1105 1324 1322 1321 1531 1101 1320 1528 1099 1097 1315 1314 1313 1524 1312 1087 1090  858  859 1088  379  123
 197  446  687  920 1145 1144 1143 1142 1141 1140 1139 1138 1137 1136 1135 1134 1133 1132 1131 1130 1129 1128 1127 1126 1125 1124 1123 1122 1121 1120 1119 1118 1117 1116 1115 1114 1113 1112 1111 1110 1109 1108 1107  878 1323 1104  641 1532 1530 1098 1096  871 1316  868 1094 1092 1093  865 1091  863  860  380  378  124  125
 196  445  686  919  918  917  916  915  914  913  912  911  910  909  908  907  906  905  904  903  902  901  900  899  898  897  896  895  894  893  892  891  890  889  888  887  886  885  884  883  882  646  880 1106 1103  398  875 1102  874  872  396 1100  869 1095  867  389  633  631  864  628  862  861  624  623  126
 195  444  685  684  683  682  681  680  679  678  677  676  675  674  673  672  671  670  669  668  667  666  665  664  663  662  661  660  659  658  657  656  655  654  653  652  651  650  649  648  403  404  881  879  877  644  400  873  876  638 1318  870  635  393  391  390  630  866  387  629  627  626  382  127  622
 194  443  442  441  440  439  438  437  436  435  434  433  432  431  430  429  428  427  426  425  424  423  422  421  420  419  418  417  416  415  414  413  412  411  410  409  408  407  406  405  647  402  645  401  643  399  642  397  145  144  640  637  639  140  634  137  632  138  388  386  385  132  131  625  128
 193  192  191  190  189  188  187  186  185  184  183  182  181  180  179  178  177  176  175  174  173  172  171  170  169  168  167  166  165  164  163  162  161  160  159  158  157  156  155  154  153  152  151  150  149  148  147  146  143  395  636  394  139  142  141  392  135  136  134  133  383  384  130  381  129
