# This puzzle is unsolvable
76
   2    1    3    4    5    6    7    8    9   10   11   12   13   14   15   16   17   18   19   20   21   22   23   24   25   26   27   28  329  328   30   32   33   34   35   36   37   38   39   40   41  633   42   43   45   47  636   48  348   50   51   52   53   54   55   56   57   58   59  359   60  360  652   61  364   65   66   68   67   70   71   72   73  664   74   76
 300  301  302  303  304  305  306  307  308  309  310  311  312  313  314  315  316  317  318  319  320  321  322  323  324  325  326  327   29  620   31  331  332  333  335  334  627  336  629  339  340  342  632   44  344  635   46  345  347  640  351  352  643  353  354  355  356  357  358  651  650  362  655   64  363  658  657  368   69  370  371  945  663  372   75  374
 299  592  593  594  595  596  597  598  599  600  601  602  603  604  605  606  607  608  609  610  611  612  613  614  615  616  617  618  619  903  330  621  622  623  624  911  910  912  631  338  628  341 1458  918  914  634  919   49  349  923  642  921  641  644  645  646  930  649  931  932   62  934  936   63  654  656  366  367  659  369  944  662  947  373  666   77
 298  591  876  877  878  879  880  881  882  883  884  885  886  887  888  889  890  891  892  893  894  895  896  897  898  899  900  901  902 1178  904  905  906  907  625 1184 1186 1456  337  909 1188 1457  343 1192  920 1194  346  638 1197 1463  639  350  925  927  928  929 1472  647 1207 1209  935  653 1479  937  365 1214  940  941  942  661  943  948  667  665   79  375
 297  590  875 1152 1153 1154 1155 1156 1157 1158 1159 1160 1161 1162 1163 1164 1165 1166 1167 1168 1169 1170 1171 1172 1173 1174 1175 1176 1444 1177 1179 1180 1448 1181  908  913 1187  626 1453  630 1715 1717  917  916  637 1195 1462 1465 1466 1198  922 1201  926 1202 1204 1205 1206  648 1474 1208  933  361 1210 1213  938 1481  939 1216 1217  660 1487 1220 1219  376   78   81
 296  589  874 1151 1420 1421 1422 1423 1424 1425 1426 1427 1428 1429 1430 1431 1432 1433 1434 1435 1436 1437 1438 1439 1440 1441 1442 1702 1443 1445 1446 1447 1707 1182 1709 1183 1452 1185 1454 1189 1190  915 1967 1191 1193 1720 1722 1461 1199  924 1200 1467 1468 1469 1203 1471 1473 1983 1733 1475 1477 1478 1211 1212 1215 1480 1740 1482 1484 1486 1488 1483 1218  946  377   80
 295  588  873 1150 1419 1680 1681 1682 1683 1684 1685 1686 1687 1688 1689 1690 1691 1692 1693 1694 1695 1696 1697 1698 1699 1700 1701 1703 1704 1955 1705 1706 1450 1708 1449 1451 1711 1712 1713 1965 1716 1968 2213 1969 1719 1460 1464 1724 1196 1723 1976 1726 1727 1729 1470 1730 1732 1982 1734 1985 1476 1735 1737 1989 1738 1741 1742 1743 1744 1745 1485 1221 1222  950  668  378
 294  587  872 1149 1418 1679 1932 1933 1934 1935 1936 1937 1938 1939 1940 1941 1942 1943 1944 1945 1946 1947 1948 1949 1950 1951 1952 1953 2197 1956 2199 1957 1958 1959 1960 1710 2206 1963 1964 1714 1455 1966 1459 2210 2447 1971 1721 1974 1973 1725 1975 1977 2222 1728 1979 1981 2226 2463 1731 1986 2464 1736 2229 1987 1739 1991 1992 1993 1994 1996  669 1489  949  379   83   82
 293  586  871 1148 1417 1678 1931 2176 2177 2178 2179 2180 2181 2182 2183 2184 2185 2186 2187 2188 2189 2190 2191 2192 2428 2193 2658 2196 1954 2660 2434 2201 2202 2437 1961 1962 2440 2205 2441 2443 2208 2209 1718 1972 1970 2448 2214 2215 2217 2220 2219 2221 1978 2457 1980 2223 2224 2691 1984 2462 2228 2230 1988 2232 1990 2233 2234 2235 2236 1746 1999  671  670 1227  380  381
 292  585  870 1147 1416 1677 1930 2175 2412 2413 2414 2415 2416 2417 2418 2419 2420 2421 2422 2423 2424 2425 2426 2427 2429 2195 2194 2430 2432 2198 2435 2200 2436 2438 2203 2204 2439 2442 2669 2207 2444 2211 2212 2446 2675 2450 2451 2216 2452 2218 2680 2455 2683 2456 2687 2685 2459 2225 2227 2689 2690 2465 2231 2467 2468 2469 2470 2237 1995 1224 1492 1223 1491  672  382   84
 291  584  869 1146 1415 1676 1929 2174 2411 2640 2641 2642 2643 2644 2645 2646 2647 2648 2649 2650 2651 2652 2653 2654 2655 2656 2433 2877 2431 2880 2879 2662 2663 2664 2665 2666 2667 2668 2670 2671 2891 2445 2673 2674 2676 2449 2677 2678 2679 2454 2453 2901 2682 2684 2458 2906 2460 2461 2907 2688 2692 2911 2466 2694 2695 2696 2471 1997 1748 1225  951 1226  952  383  384   85
 290  583  868 1145 1414 1675 1928 2173 2410 2639 2860 2861 2862 2863 2864 2865 2866 2867 2868 2869 2870 2871 2872 2873 2874 2876 3088 2657 3090 3089 2661 2881 2882 2883 2884 2885 2886 2887 3099 2888 2889 2672 2892 2893 2894 2895 2896 2897 2898 2899 2681 2900 2902 2904 3116 3115 2905 2910 3322 2908 3120 2912 2693 3123 2914 2697 2472 2238 2239 1490 1747  953  673   87  385  674
 289  582  867 1144 1413 1674 1927 2172 2409 2638 2859 3072 3073 3074 3075 3076 3077 3078 3079 3080 3081 3082 3083 3084 3085 2875 3292 3291 2878 2659 3091 3092 3093 3094 3298 3095 3097 3098 3302 3100 3101 3305 3102 3104 3105 3106 3310 3107 3108 3109 3111 3113 3317 2903 3114 3319 3320 2686 3321 2909 3119 3121 3124 2913 2915 2698 2473 2241 1749 1493 1750 1229  954  955   86   89
 288  581  866 1143 1412 1673 1926 2171 2408 2637 2858 3071 3276 3277 3278 3279 3280 3281 3282 3283 3284 3285 3286 3287 3288 3485 3086 3289 3486 3293 3294 3295 3296 3297 3096 3495 3300 3497 3303 3304 2890 3103 3307 3690 3308 3504 3309 3311 3312 3110 3314 3112 3315 3512 3318 3117 3516 3515 3118 3323 3519 3122 3326 3125 2916 2699 2475 2474 2240 1998 1751 1494   88  956   90   91
 287  580  865 1142 1411 1672 1925 2170 2407 2636 2857 3070 3275 3472 3473 3475 3840 3476 3477 3478 3479 3480 3481 3482 3483 3484 3087 3290 3487 3488 3489 3490 3491 3492 3494 3299 3682 3301 3496 3498 3499 3501 3689 3306 4038 3503 3505 3507 3508 3313 3509 3510 3316 3513 3701 3514 3517 3702 3325 3703 3706 3520 3327 3126 2917 2700 2242 2001 2000 1752 1228 1230  676  675  386   92
 286  579  864 1141 1410 1671 1924 2169 2406 2635 2856 3069 3274 3471 3661 3474 3663 3664 3843 3665 3844 3667 3668 3669 3670 3850 3671 3673 3674 3675 3676 3677 3678 3679 3493 3681 3861 3684 3862 3685 3687 3867 3500 3868 3502 3691 3693 3506 3694 3695 3696 3697 3698 3511 3699 3880 3883 3708 3704 3324 3884 3705 3328 3127 2918 2701 2476 2243 2002 1753 1495 1496  957  387  388   93
 285  578  863 1140 1409 1670 1923 2168 2405 2634 2855 3068 3273 3470 3660 3841 3662 4013 3842 3845 3666 3846 3847 3848 4020 3849 3672 3852 3853 3854 3855 3856 3857 3858 3680 3859 4034 4032 3683 4197 3865 4036 4201 3688 3869 3871 3692 3872 3873 3874 3875 3876 3877 3878 3700 4051 3882 3518 4054 3707 3522 3521 3329 3128 2919 2702 2477 2244 2003 1754 1497 1231 1232  958  677  678
 284  577  862 1139 1408 1669 1922 2167 2404 2633 2854 3067 3272 3469 3659 3839 4012 4176 4014 4015 4016 4017 4018 4019 4183 4021 3851 4023 4024 4025 4026 4027 4028 4029 4030 3860 4031 4035 4196 3863 3686 3864 3866 4202 4039 3870 4042 4043 4044 4045 4046 4047 4048 4049 3879 4214 3881 4053 4216 3885 3523 3524 3330 3129 2920 2703 2478 2245 2004 1755 1498  680  960  959  389  391
 283  576  861 1138 1407 1667 1921 1668 2166 2632 2853 3066 3271 3468 3658 3838 4010 4177 4178 4179 4334 4180 4181 4182 4339 4022 4184 4186 4187 4188 4189 4190 4346 4191 4193 4496 4033 4351 4352 4354 4198 4037 4200 4357 4204 4041 4205 4206 4207 4208 4209 4512 4210 4211 4213 4050 4052 4215 3886 4056 3709 3710 3130 2921 2922 2704 2479 2246 2005 1756 1499 1233 1234  392  682   94
 282  575  860 1137 1406 1666 2165 1920 2403 2630 2631 3270 3269 3467 3657 4011 3836 3837 4175 4479 4335 4482 4336 4337 4486 4185 4488 4340 4341 4343 4344 4631 4492 4348 4495 4195 4497 4636 4498 4639 4199 4355 4356 4203 4040 4359 4360 4361 4362 4364 4511 4650 4212 4365 4368 4369 4370 4219 4371 4055 3527 3332 3331 3131 2705 2706 2480 2007 2247 1757 1500  961  679  390  394   95
 281  574  859 1135 1136 1405 2401 2402 2850 2629 3065 3064 3268 3466 3656 3835 4009 4174 4332 4481 4333 4621 4483 4485 4338 4625 4626 4489 4342 4490 4491 4762 4763 4345 4192 4349 4194 4350 4353 4638 4501 4502 4503 4504 4358 4506 4507 4508 4509 4363 4510 4654 4366 4514 4516 4517 4373 4057 4217 3887 3525 3711 3133 3333 2923 2481 2248 2006 1760 1501 1502  962  681 1237  683   96
 280  573  858 1134 1404 1918 1919 2400 2163 2851 2628 3063 2852 3465 3655 3653 4008 4330 4480 4620 4619 4751 4622 4484 4754 4624 4758 4881 4627 4628 4761 4630 4632 4493 4634 4765 4766 4500 4499 4770 4640 4641 4642 4644 4505 4645 4646 4647 4648 4649 4783 4513 4651 4653 4515 4367 4519 4058 3889 3888 3890 3714 3528 3132 2924 2707 2482 2249 1503 1759 1235 1236  963  393   97   99
 572 1133  857 1403 1664 1665 1917 2164 2162 2399 2848 2849 3267 3464 3654 4007 4172 4173 4331 4329 4752 4477 4753 4755 4623 4757 4995 4756 4759 4629 4760 4633 4494 4347 4764 4635 4767 4637 4768 4769 4771 4772 4896 4643 4774 4776 4777 4778 4779 4781 4904 4652 4906 4784 4655 4372 4220 4059 4222 3891 3526 3712 3134 3135 2925 2708 2483 2009 2010  964 1758  967 1238  395   98  100
 279  571  855 1402 1401 1663 1916 2161 2398 2627 3062 3266 3265 3463 3651 3834 3832 4006 4171 4328 4478 4326 4876 4877 4878 4487 4880 4882 5105 4883 4884 4885 4886 4889 5003 4890 4891 5005 4892 4893 4894 4895 4898 4773 4775 4899 4900 4902 4903 4780 5020 4782 5021 4785 4657 4374 4518 4218 4060 3894 3713 3715 3336 3334 2926 2709 2484 2250 2012 2008  965  684  687  101  686  685
 278  277  854  856 1132 1662 1915 2160 2397 2626 2847 3264 3060 3462 3833 3652 4005 4003 4170 4476 4618 4616 4750 4875 4992 4993 4879 4996 4997 4998 4999 5000 5001 4887 5110 5002 4888 5004 5006 5008 5009 5010 5011 4897 5120 5012 5016 4901 5017 5128 5018 4905 4907 4787 4520 4658 4375 4223 4221 3335 3892 3529 3531 3136 2927 2710 2486 2011 1761 1504 1763 1240 1505 1239  399  966
 276  570  569 1131 1400 1660 1914 2159 2396 2625 2846 3061 3461 3827 3650 3829 4002 4004 4327 4474 4749 4617 4874 4991 5100 4994 5292 5101 5102 5104 5107 5206 5108 5109 5210 5112 5113 5212 5007 5115 5116 5117 5118 5013 5121 5015 5014 5122 5123 5127 5126 5022 5019 4786 4522 4656 4521 4224 4061 3716 3532 3530 3338 3137 2928 2487 2251 2485 2014 1241 1762 1508  968  397  400  102
 275  568  853 1399 1661 1659 1913 2158 2395 2844 2845 3059 3263 3460 4168 3648 3831 4169 4324 4615 4475 4748 4873 4990 5099 5200 5202 5203 5103 5106 5205 5297 5207 5209 5300 5111 5211 5213 5114 5214 5215 5216 5217 5119 5219 5220 5221 5222 5124 5125 5224 4790 4788 4789 4659 4377 4376 4063 4062 4064 3893 3718 3337 3339 2712 2711 2253 2252 2713 1766  396  970 1506 1507  969  398
 274  567  852 1130 1129 1398 1912 2157 2394 2624 2623 3261 3057 3459 3457 3649 4325 4167 4473 4472 4614 4747 4872 4989 5098 5199 5293 5201 5294 5204 5295 5296 5298 5381 5208 5301 5302 5303 5304 5305 5389 5306 5308 5218 5310 5311 5313 5396 5223 5314 5225 5023 4910 4909 4908 4523 4378 4225 3895 3896 3717 3533 3340 2931 2929 2488 2255 2254 1511 2013 1764 1243 1244  688  689  103
 273  566  851 1128 1397 1658 1911 2156 2393 2622 2843 3262 3058 3830 3646 3828 4001 4165 4166 4323 4612 4746 4871 4988 5097 5198 5291 5376 5377 5378 5379 5380 5299 5382 5383 5384 5386 5461 5387 5388 5307 5391 5467 5309 5470 5394 5312 5315 5316 5129 5025 5024 4911 4912 4660 4524 4379 4226 4066 4065 3719 3341 3534 3139 3138 2930 2714 2489 2256 1765 1510  690 1509  973  401  104
 272  565  850 1127 1396 1657 1910 2392 2391 2842 3055 3056 3458 3260 3645 3826 3825 4000 4322 4613 4471 4745 4870 4987 5096 5197 5290 5375 5452 5520 5453 5455 5457 5458 5459 5460 5385 5528 5462 5463 5464 5390 5392 5534 5393 5468 5395 5397 5317 5226 5026 5131 4792 4791 4662 4525 4380 4227 4067 3897 3720 3535 3342 3140 3141 2715 2490 2257 2015  972  975 1247 1245  693 1242  105
 271  564  849 1126 1395 1656 1909 2155 2620 2621 2841 3054 3259 3456 3824 3999 3647 3998 4321 4470 4611 4744 4869 4986 5095 5196 5289 5374 5451 5580 5454 5521 5456 5523 5526 5585 5527 5529 5530 5531 5532 5465 5466 5533 5535 5469 5471 5398 5228 5227 5130 4913 4661 4663 4526 4527 4381 4229 4228 3898 3536 3537 3343 3142 2932 2716 2491 2017 2016 1767 1768 1246  974  692  691  107
 270  563  848 1125 1655 1654 1908 2154 2153 2619 2840 3053 3258 3455 3454 3644 4163 4164 4320 4469 4610 4743 4868 4985 5094 5195 5288 5373 5450 5519 5522 5581 5582 5524 5583 5525 5586 5587 5588 5589 5590 5591 5592 5593 5594 5536 5472 5399 5318 5230 5229 5132 4914 4793 4664 4528 4382 4230 4068 3899 3721 3344 3143 2934 2933 2935 2717 2258 2018 1769 1512 1513  402  971  106  108
 269  562 1124 1393 1394 1907 2152 2389 2390 2618 2839 3052 3257 3452 2838 3643 3453 4162 4319 4467 4468 4742 4867 4984 5093 5194 5287 5372 5518 5578 5579 5633 5634 5678 5584 5636 5637 5638 5639 5640 5641 5642 5643 5644 5595 5537 5473 5400 5319 5231 5133 5027 4915 4794 4666 4665 4383 4231 3723 3901 3722 3538 3345 3144 2936 2718 2492 2259 2260 2019 1770  976  403 1248  405  404
 268 1122  561  560 1392 1653 1906 2151 2388 2616 2617 3049 3255 3641 3821 3642 3997 3996 4318 4465 4609 4741 4983 5092 5091 5193 5286 5517 5449 5447 5631 5632 5676 5635 5712 5679 5680 5681 5682 5683 5684 5685 5686 5645 5539 5538 5540 5474 5321 5320 5134 5028 4916 4795 4667 4529 4384 4070 4069 3900 3724 3539 3346 3145 2719 2494 2493 2261 2020 1771 1514 1249  695  696  406  109
 559  847  846 1123 1390 1391 1652 2150 2387 2615 2837 3256 3639 3050 3822 3823 4315 3995 4317 4608 4466 4607 4606 4982 5090 5192 5285 5371 5370 5448 5577 5630 5675 5713 5677 5714 5715 5716 5717 5718 5719 5720 5687 5646 5596 5475 5597 5401 5402 5136 5030 5029 5031 4796 4530 4531 4385 4232 4071 3902 3725 3540 3347 3146 2937 2720 2495 2262 2021 1772 1515  978  694  977  407  110
 266  843  267  844 1389 1651 1905 2149 2386 2614 2836 3254 3051 3451 3638 4314 4316 4160 4161 4159 4863 4865 4866 4864 4981 5191 5190 5369 5446 5516 5515 5629 5674 5711 5740 5741 5742 5743 5744 5745 5746 5721 5688 5647 5598 5541 5476 5403 5232 5322 5135 4918 4917 4797 4669 4668 4386 4233 4072 3903 3726 3541 3348 3147 2938 2721 2496 2263 2022 1773 1516 1250 1251  697  408  111
 265 1121  845 1119 1386 1650 1904 1902 1903 2613 2385 2835 3640 3819 3818 3991 3994 4313 4157 4605 4738 4739 4740 4862 4980 5189 5284 5368 5444 5574 5576 5628 5673 5710 5739 5760 5761 5762 5763 5764 5747 5722 5689 5648 5599 5542 5477 5404 5323 5233 5234 5032 4920 4919 4798 4532 4387 4234 4073 3904 3727 3542 3349 3148 2939 2722 2497 2264 2023 1774 1517 1252  979  698  409  112
 264  558 1118 1120 1388 2146 1647 2383 2148 3046 3047 3048 3449 3448 3992 3993 3820 4604 4601 4461 4736 4602 4463 4979 5089 5188 5283 5282 5365 5514 5575 5627 5672 5709 5738 5759 5772 5773 5774 5765 5748 5723 5690 5649 5600 5543 5478 5405 5324 5138 5137 5034 5033 4799 4670 4533 4388 4235 4074 3905 3728 3543 3350 3149 2940 2723 2498 2265 2024 1775 1518 1253  980  699  410  113
 263  842  556 1117  841 1901 2145 2384 2147 2612 2834 3251 3450 3253 3636 3637 3250 4158 4462 4603 4464 4860 4737 4978 5088 5087 5187 5281 5443 5367 5445 5572 5671 5708 5737 5758 5771 5769 5775 5766 5749 5724 5691 5650 5601 5544 5479 5406 5325 5235 5139 5035 4921 4800 4671 4534 4389 4236 4075 3906 3729 3544 3351 3150 2941 2724 2499 2266 2025 1776 1519 1254  981  700  411  114
 262  557  840 1116 1648 1387 1649 1899 1900 2611 2833 3045 3044 3447 3634 4153 3990 3816    0 4311 4460 4735 4734 4861 5086 5280 5364 5512 5513 5571 5511 5573 5670 5707 5735 5736 5757 5770 5768 5767 5750 5725 5692 5651 5602 5545 5480 5407 5326 5236 5140 4922 4923 4801 4672 4535 4390 4237 4076 3907 3730 3545 3352 3151 2942 2725 2500 2267 2026 1777 1520 1255  982  701  412  115
 260  554  555  839 1385 1646 1898 2142 1645 2144 2832 3248 2831 3252 3445 3989 3817 4312 4154 4156 4600 4733 4859 4977 5085 5186 5278 5442 5366 5441 5625 5626 5624 5669 5734 5756 5755 5754 5753 5752 5751 5726 5693 5652 5603 5546 5481 5408 5327 5237 5141 5036 4924 4802 4673 4536 4391 4238 4077 3908 3731 3546 3353 3152 2943 2726 2501 2268 2027 1778 1521 1256  983  702  413  116
 552  838 1115  837 1383 1384 1644 2382 2610 2380 2381 2830 3249 3444 3446 3814 4152 4155 3988 4310 4599 4858 4976 4975 5083 5084 5185 5279 5362 5510 5570 5668 5704 5667 5705 5733 5732 5731 5730 5729 5728 5727 5694 5653 5604 5547 5482 5409 5239 5238 5142 5037 4925 4803 4674 4537 4392 4239 4078 3909 3732 3547 3354 3153 2944 2727 2502 2269 2028 1779 1522 1257  984  703  414  117
 258  261  553 1113 1114 1897 2143 2379 2609 2607 3043 3042 3247 3246 3635 3632 3815 4309 4308 4459 4598 4732 4857 4974 5184 5363 5277 5439 5440 5508 5623 5568 5622 5706 5665 5702 5701 5700 5699 5698 5697 5696 5695 5654 5605 5548 5483 5410 5328 5240 5039 5144 5038 4804 4675 4538 4393 4240 4079 3910 3733 3548 3355 3154 2945 2728 2503 2270 2029 1780 1523 1258  985  704  415  118
 551  550  259  836 1382 1643 1896 2141 2608 2828 2827 3040 3443 3633 3442 3986 3985 3987 4151 4458 4457 4731 4973 5082 5081 5183 5276 5438 5509 5507 5621 5569 5666 5664 5703 5663 5662 5661 5660 5659 5658 5657 5656 5655 5606 5549 5484 5411 5329 5330 5241 5143 4926 4805 4676 4539 4394 4241 4080 3911 3734 3549 3356 3155 2946 2729 2504 2271 2030 1781 1524 1259  986  705  416  119
 257  549  835 1112 1381 1642 2140 2376 2378 2377 2829 2605 2606 3041 3631 3813 3809 4149 4307 4456 4597 4854 4730 4856 4972 5182 5275 5361 5437 5506 5567 5620 5619 5618 5617 5616 5615 5614 5613 5612 5611 5610 5609 5608 5607 5550 5485 5412 5331 5242 5145 5040 4927 4806 4677 4540 4395 4242 4081 3912 3735 3550 3357 3156 2947 2730 2505 2272 2031 1782 1525 1260  987  706  417  120
 255  256 1111 1380 1641 1895 1893 1894 2826 2824 2825 3441 3245 3440 3811 3812 4150 4306 4305 4728 4455 4596 4971 4970 5080 5181 5359 5360 5436 5505 5566 5565 5564 5563 5562 5561 5560 5559 5558 5557 5556 5555 5554 5553 5552 5551 5486 5413 5332 5243 5146 5041 4928 4807 4678 4541 4396 4243 4082 3913 3736 3551 3358 3157 2948 2731 2506 2273 2032 1783 1526 1261  988  707  418  121
 548  833  834 1110 1379 1640 1892 2375 2604 2603 3039 3244 3243 3629 3630 3984 4147 3810 4148 3983 4594 4855 4729 4853 5079 5180 5274 5358 5435 5504 5503 5502 5501 5500 5499 5498 5497 5496 5495 5494 5493 5492 5491 5490 5489 5488 5487 5414 5333 5244 5147 5042 4929 4808 4679 4542 4397 4244 4083 3914 3737 3552 3359 3158 2949 2732 2507 2274 2033 1784 1527 1262  989  708  419  122
 254  547  832 1109 1378 1639 2137 2138 2139 2602 3037 3038 3242 3439 3628 3808 3981 4146 4304 4595 4593 4727 4852 4969 5078 5179 5273 5272 5434 5355 5432 5431 5430 5429 5428 5427 5426 5425 5424 5423 5422 5421 5420 5419 5418 5417 5416 5415 5334 5245 5148 5043 4930 4809 4680 4543 4398 4245 4084 3915 3738 3553 3360 3159 2950 2733 2508 2275 2034 1785 1528 1263  990  709  420  123
 253  546  831 1108 1377 1638 1890 2136 2374 2373 2823 3036 3241 3438 3627 4454 3980 4303 3982 4451 4726 4851 4850 4968 5077 5178 5173 5357 5174 5433 5353 5352 5351 5350 5349 5348 5347 5346 5345 5344 5343 5342 5341 5340 5339 5338 5337 5336 5335 5246 5149 5044 4931 4810 4681 4544 4399 4246 4085 3916 3739 3554 3361 3160 2951 2734 2509 2276 2035 1786 1529 1264  991  710  421  124
 252  545  830 1107 1376 1637 2135 1891 2372 2601 2822 3035 3240 3437 3626 3807 3979 4145 4302 4592 4452 4725 4849 5076 5177 5175 5356 5271 5269 5354 5267 5265 5264 5263 5262 5261 5260 5259 5258 5257 5256 5255 5254 5253 5252 5251 5250 5249 5248 5247 5150 5045 4932 4811 4682 4545 4400 4247 4086 3917 3740 3555 3362 3161 2952 2735 2510 2277 2036 1787 1530 1265  992  711  422  125
 251  544  829 1106 1375 1636 1889 2134 2371 2600 2821 3034 3239 3436 3625 3806 4144 4300 4453 4450 4591 4724 4966 4967 5074 5270 5176 5268 5172 5171 5266 5068 5169 5168 5167 5166 5165 5164 5163 5162 5161 5160 5159 5158 5157 5156 5155 5154 5153 5152 5151 5046 4933 4812 4683 4546 4401 4248 4087 3918 3741 3556 3363 3162 2953 2736 2511 2278 2037 1788 1531 1266  993  712  423  126
 250  543  828 1105 1374 1635 1888 2133 2370 2599 2820 3033 3238 3435 3624 3805 3978 4301 4143 4449 4590 4847 4965 5075 4964 4962 5072 5071 5070 4957 5067 5170 5066 5065 5064 5063 5062 5061 5060 5059 5058 5057 5056 5055 5054 5053 5052 5051 5050 5049 5048 5047 4934 4813 4684 4547 4402 4249 4088 3919 3742 3557 3364 3163 2954 2737 2512 2279 2038 1789 1532 1267  994  713  424  127
 249  542  827 1104 1373 1634 1887 2132 2369 2598 2819 3032 3237 3434 3803 3623 3977 4142 4299 4448 4589 4848 4723 5073 4846 4963 4961 4960 4959 5069 4956 4955 4954 4953 4834 4952 4951 4950 4949 4948 4947 4946 4945 4944 4943 4942 4941 4940 4939 4938 4937 4936 4935 4814 4685 4548 4403 4250 4089 3920 3743 3558 3365 3164 2955 2738 2513 2280 2039 1790 1533 1268  995  714  425  128
 248  541  826 1103 1372 1633 1886 2131 2368 2597 2818 3031 3236 3621 3433 3804 3976 4141 4297 4298 4588 4845 4844 4583 4718 4843 4842 4841 4839 4958 4838 4710 4837 4836 4835 4833 4832 4831 4830 4829 4828 4827 4826 4825 4824 4823 4822 4821 4820 4819 4818 4817 4816 4815 4686 4549 4404 4251 4090 3921 3744 3559 3366 3165 2956 2739 2514 2281 2040 1791 1534 1269  996  715  426  129
 247  540  825 1102 1371 1632 1885 2130 2367 2596 2817 3030 3235 3622 3802 3975 3973 4140 4447 4587 4586 4722 4719 4717 4716 4715 4714 4579 4840 4712 4711 4575 4709 4708 4707 4706 4705 4704 4703 4702 4701 4700 4699 4698 4697 4696 4695 4694 4693 4692 4691 4690 4689 4688 4687 4550 4405 4252 4091 3922 3745 3560 3367 3166 2957 2740 2515 2282 2041 1792 1535 1270  997  716  427  130
 246  539  824 1101 1370 1631 1884 2129 2366 2595 2816 3029 3234 3432 3431 3801 3974 4138 4139 4446 4585 4721 4584 4439 4440 4581 4580 4578 4713 4577 4576 4574 4431 4573 4572 4571 4570 4569 4568 4567 4566 4565 4564 4563 4562 4561 4560 4559 4558 4557 4556 4555 4554 4553 4552 4551 4406 4253 4092 3923 3746 3561 3368 3167 2958 2741 2516 2283 2042 1793 1536 1271  998  717  428  131
 245  538  823 1100 1369 1630 1883 2128 2365 2594 2815 3028 3233 3619 3620 3800 3972 4296 4137 4443 4720 4442 4290 4441 4582 4438 4437 4436 4435 4434 4282 4433 4432 4430 4429 4428 4427 4426 4425 4424 4423 4422 4421 4420 4419 4418 4417 4416 4415 4414 4413 4412 4411 4410 4409 4408 4407 4254 4093 3924 3747 3562 3369 3168 2959 2742 2517 2284 2043 1794 1537 1272  999  718  429  132
 244  537  822 1099 1368 1629 1882 2127 2364 2593 2814 3027 3232 3430 3429 3618 3799 3969 4445 4295 4444 4292 4289 4288 4129 4287 4286 4285 4125 4284 4283 4281 4280 4279 4278 4277 4276 4275 4274 4273 4272 4271 4270 4269 4268 4267 4266 4265 4264 4263 4262 4261 4260 4259 4258 4257 4256 4255 4094 3925 3748 3563 3370 3169 2960 2743 2518 2285 2044 1795 1538 1273 1000  719  430  133
 243  536  821 1098 1367 1628 1881 2126 2363 2592 2813 3026 3231 3428 3617 3798 4136 3608 4294 4293 4133 4291 4131 3963 4130 4128 4127 4126 3958 4124 4123 4122 4121 4120 4119 4118 4117 4116 4115 4114 4113 4112 4111 4110 4109 4108 4107 4106 4105 4104 4103 4102 4101 4100 4099 4098 4097 4096 4095 3926 3749 3564 3371 3170 2961 2744 2519 2286 2045 1796 1539 1274 1001  720  431  134
 242  535  820 1097 1366 1627 1880 2125 2362 2591 2812 3025 3230 3427 3616 3797 3971 3970 4134 4135 3966 4132 3965 3606 3787 3962 3961 3960 3959 3957 3956 3780 3953 3778 3952 3951 3950 3949 3948 3947 3946 3945 3944 3943 3942 3941 3940 3939 3938 3937 3936 3935 3934 3933 3932 3931 3930 3929 3928 3927 3750 3565 3372 3171 2962 2745 2520 2287 2046 1797 1540 1275 1002  721  432  135
 241  534  819 1096 1365 1626 1879 2124 2361 2590 2811 3024 3229 3426 3615 3796 3795 3967 3610 3968 3792 3790 3789 3964 3785 3412 3602 3784 3783 3782 3955 3779 3596 3954 3777 3776 3775 3774 3773 3772 3771 3770 3769 3768 3767 3766 3765 3764 3763 3762 3761 3760 3759 3758 3757 3756 3755 3754 3753 3752 3751 3566 3373 3172 2963 2746 2521 2288 2047 1798 1541 1276 1003  722  433  136
 240  533  818 1095 1364 1625 1878 2123 2360 2589 2810 3023 3228 3425 3614 3612 3793 3611 3794 3791 3417 3607 3605 3603 3214 3414 3786 3601 3600 3599 3781 3598 3404 3205 3595 3593 3592 3591 3590 3589 3588 3587 3586 3585 3584 3583 3582 3581 3580 3579 3578 3577 3576 3575 3574 3573 3572 3571 3570 3569 3568 3567 3374 3173 2964 2747 2522 2289 2048 1799 1542 1277 1004  723  434  137
 239  532  817 1094 1363 1624 1877 2122 2359 2588 2809 3022 3424 3020 3421 3613 3222 3419 3420 3609 3416 3217 3788 3413 3415 3604 3411 3410 3409 3408 3407 3597 3406 3204 3594 3402 3401 3400 3399 3398 3397 3396 3395 3394 3393 3392 3391 3390 3389 3388 3387 3386 3385 3384 3383 3382 3381 3380 3379 3378 3377 3376 3375 3174 2965 2748 2523 2290 2049 1800 1543 1278 1005  724  435  138
 238  531  816 1093 1362 1623 1876 2121 2358 2587 3021 3226 3227 3225 3016 3224 3223 3221 3418 3219 2796 3218 3009 3216 3215 3213 3006 3211 3210 3209 3208 3405 3207 3206 3403 3203 3202 3201 3200 3199 3198 3197 3196 3195 3194 3193 3192 3191 3190 3189 3188 3187 3186 3185 3184 3183 3182 3181 3180 3179 3178 3177 3176 3175 2966 2749 2524 2291 2050 1801 1544 1279 1006  725  436  139
 237  530  815 1092 1361 1622 1875 2120 2357 2586 2808 2581 2807 2805 3423 3017 3422 3015 3013 3220 3012 3011 3010 3008 3007 3005 3212 3004 3003 3002 3001 3000 2999 2998 2997 2996 2995 2994 2993 2992 2991 2990 2989 2988 2987 2986 2985 2984 2983 2982 2981 2980 2979 2978 2977 2976 2975 2974 2973 2972 2971 2970 2969 2968 2967 2750 2525 2292 2051 1802 1545 1280 1007  726  437  140
 236  529  814 1091 1360 1621 1874 2119 2356 2585 2804 2583 2806 2351 3018 2577 2576 3014 2799 2798 2797 2795 2794 2793 2792 2791 2790 2789 2788 2787 2786 2785 2784 2783 2782 2781 2780 2779 2778 2777 2776 2775 2774 2773 2772 2771 2770 2769 2768 2767 2766 2765 2764 2763 2762 2761 2760 2759 2758 2757 2756 2755 2754 2753 2752 2751 2526 2293 2052 1803 1546 1281 1008  727  438  141
 235  528  813 1090 1359 1620 1873 2118 2355 2352 2353 2802 2349 2578 3019 2800 2345 2575 2574 2573 2342 2572 2571 2570 2569 2568 2567 2566 2565 2564 2563 2562 2561 2560 2559 2558 2557 2556 2555 2554 2553 2552 2551 2550 2549 2548 2547 2546 2545 2544 2543 2542 2541 2540 2539 2538 2537 2536 2535 2534 2533 2532 2531 2530 2529 2528 2527 2294 2053 1804 1547 1282 1009  728  439  142
 234  527  812 1089 1358 1619 1872 2117 2354 2584 2350 2112 2111 2580 2803 2801 2108 2106 2344 2343 2103 2341 2340 2339 2338 2337 2336 2335 2334 2333 2332 2331 2330 2329 2328 2327 2326 2325 2324 2323 2322 2321 2320 2319 2318 2317 2316 2315 2314 2313 2312 2311 2310 2309 2308 2307 2306 2305 2304 2303 2302 2301 2300 2299 2298 2297 2296 2295 2054 1805 1548 1283 1010  729  440  143
 233  526  811 1088 1357 1618 1871 2116 2115 2114 2582 1866 1864 2110 2347 2579 2107 2346 2105 2104 1856 2102 2101 2100 2099 2098 2097 2096 2095 2094 2093 2092 2091 2090 2089 2088 2087 2086 2085 2084 2083 2082 2081 2080 2079 2078 2077 2076 2075 2074 2073 2072 2071 2070 2069 2068 2067 2066 2065 2064 2063 2062 2061 2060 2059 2058 2057 2056 2055 1806 1549 1284 1011  730  441  144
 232  525  810 1087 1356 1617 1870 1869 1868 1867 1865 1610 2113 2109 2348 1606 1861 1859 1858 1857 1855 1600 1854 1853 1852 1851 1850 1849 1848 1847 1846 1845 1844 1843 1842 1841 1840 1839 1838 1837 1836 1835 1834 1833 1832 1831 1830 1829 1828 1827 1826 1825 1824 1823 1822 1821 1820 1819 1818 1817 1816 1815 1814 1813 1812 1811 1810 1809 1808 1807 1550 1285 1012  731  442  145
 231  524  809 1086 1355 1616 1615 1614 1613 1612 1611 1609 1346 1863 1862 1343 1860 1605 1604 1603 1338 1601 1599 1598 1597 1596 1595 1594 1593 1592 1591 1590 1589 1588 1587 1586 1585 1584 1583 1582 1581 1580 1579 1578 1577 1576 1575 1574 1573 1572 1571 1570 1569 1568 1567 1566 1565 1564 1563 1562 1561 1560 1559 1558 1557 1556 1555 1554 1553 1552 1551 1286 1013  732  443  146
 230  523  808 1085 1354 1353 1352 1351 1350 1349 1348 1347 1345 1608 1607 1344 1342 1341 1340 1602 1339 1337 1336 1335 1334 1333 1332 1331 1330 1329 1328 1327 1326 1325 1324 1323 1322 1321 1320 1319 1318 1317 1316 1315 1314 1313 1312 1311 1310 1309 1308 1307 1306 1305 1304 1303 1302 1301 1300 1299 1298 1297 1296 1295 1294 1293 1292 1291 1290 1289 1288 1287 1014  733  444  147
 229  522  807 1084 1083 1082 1081 1080 1079 1078 1077 1076 1075 1074 1073 1072 1071 1070 1069 1066 1067  787  785 1065 1063 1062 1061 1060 1059 1058 1057 1056 1055 1054 1053 1052 1051 1050 1049 1048 1047 1046 1045 1044 1043 1042 1041 1040 1039 1038 1037 1036 1035 1034 1033 1032 1031 1030 1029 1028 1027 1026 1025 1024 1023 1022 1021 1020 1019 1018 1017 1016 1015  734  445  148
 228  521  806  805  804  803  802  801  800  798  510  797  796  795  508  506  792  791  503 1068  790  788  500 1064  784  783  782  781  780  779  778  777  776  775  774  773  772  771  770  769  768  767  766  765  764  763  762  761  760  759  758  757  756  755  754  753  752  751  750  749  748  747  746  745  744  743  742  741  740  739  738  737  736  735  446  149
 227  520  519  518  517  516  515  514  513  799  512  215  509  213  794  507  505  504  502  206  789  499  786  498  497  496  495  494  493  492  491  490  489  488  487  486  485  484  483  482  481  480  479  478  477  476  475  474  473  472  471  470  469  468  467  466  465  464  463  462  461  460  459  458  457  456  455  454  453  452  451  450  449  448  447  150
 226  225  224  223  222  221  220  219  218  217  511  216  214  212  793  211  210  209  208  501  207  205  204  203  202  201  200  199  198  197  196  195  194  193  192  191  190  189  188  187  186  185  184  183  182  181  180  179  178  177  176  175  174  173  172  171  170  169  168  167  166  165  164  163  162  161  160  159  158  157  156  155  154  153  152  151
