# This puzzle is unsolvable
8
12 34 48 45 50 15  8 24
22  3 30 49 10 27 11  2
28 62  6 29 18 21 63 13
58 23 44 20 60 53  9  1
51 40 47 59 46 25 41 16
32 36 55 43 19 14 37 26
39 54  7 52 56 35 38 17
31 61 33  4  5 57  0 42
