# This puzzle is unsolvable
74
   2    1    3    4    5    6  298    7    8    9   10  302   14   16  305   17  308   20  594  309   21   23  314   24   25   26   27   28  321   29   31   32   33   34   35   36  329   37   39   40   41   42   43   44   45   46  622   47   48   50   51   52   53   54   55   56   57   58   59   60   61   62   63   64   65   66   67   68   69   70   71   72   73   74
 292  293  294  295  579  296  299  300  583  301  585   11   12  588  306   15  591  593  311   18  870  312  315  598  316  317  318  319  320   30  322  323  324  325  326  611  327   38  330  331  332  333  334  335  619  336  337  339   49  624  342  343  344  345  346  347  348  349  350  351  352  353  354  355  356  357  358  359  360  361  362  363  364   75
 291  852  575  576  578  297  581  582  858  586   13  587  862 1130  304 1392  865  307   19 1137  872   22  595  313  599  600  601  603  878  604  879  606 1408  608  610  885  328  612  613  614  615  616  617  618  894  620  623  338  341  340  625  626  627  628  629  630  631  632  633  634  635  636  637  638  639  640  641  642  643  644  645  646  365   76
 289  290  853  577  854  580  855  856  857  584  860  303  863  590  864  589  310  866 1135  592 1395  871  596  873  874  875  876  602  605  882  881 1148  609 1660  883 1152  887 1154  888  889  890  891  892  893  895  621 1164  896  897  899  900  901  902  903  904  905  906  907  908  909  910  911  912  913  914  915  916  917  918  919  920  647  366   77
 574  851  850 1377 1120 1121 1123 1124 1384  859 1125 1387  861 1390 1131 1132 1644 1133 1134  868 1136 1396 1139 1140 1141 1142 1143 1144  877 1146 1145 1147  607 1661 1410 1153 1413 1412 1155 1156 1157 1158 1159 1419 1162 1421 1163 1165  898 1166 1167 1168 1169 1170 1171 1172 1173 1174 1175 1176 1177 1178 1179 1180 1181 1182 1183 1184 1185 1186  921  648  367   78
 573  572 1118 1379 1380 1633 1122 1383 1635 1637 1127 1388 1129 1640 1389 1393 1394 1646 1645  869  597 1397 1398 1399 1400 1401 1402 1654 1403 1656  880 1149  886 1902  884 1662 1663 1664 1414 1415 1416 1417 1418 1161 1160 1422 1423 1424 1675 1425 1426 1427 1428 1429 1430 1431 1432 1433 1434 1435 1436 1437 1438 1439 1440 1441 1442 1443 1444 1187  922  649  368   79
 288  849 1119 1117 1381 1382 1634 1879 1126 1385 1638 1128 1881 1885 1641 1391 1887  867 1643 1647 1138 1648 1649 1650 1652 1653 1896 1655 1657 1404 1405 1406 1407 1409 1150 1151 1411 1905 1665 1666 1667 1668 1669 1670 1420 1671 1915 1673 1674 1676 1677 1920 1678 1680 1681 1682 1683 1684 1685 1686 1687 1688 1689 1690 1691 1692 1693 1694 1445 1188  923  650  369   80
 287  571  847 1116 1376 1632 1877 1875 1878 1636 1880 1386 1639 2120 1883 1886 2121 2122 1888 1889 1890 1891 1892 1894 1651 1895 2131 2132 1898 2135 1900 1658 1903 1659 1904 1906 2141 1907 1908 1909 1910 1911 1912 1913 1914 2150 1672 1918 1919 2153 1921 2156 1922 1679 1923 1925 1926 1927 1928 1929 1930 1931 1932 1933 1934 1935 1936 1695 1446 1189  924  651  370   81
 286  285  570  848 1631 2111 1630 2110 2113 2115 2341 2117 1882 2343 2345 2346 1642 2123 2351 2124 2125 2126 2127 1893 2128 2130 2133 1897 2361 1899 2134 1901 2137 2138 2139 2140 2368 2142 2143 2145 2146 2147 2148 2375 2377 2807 2152 1917 2151 2381 2154 2155 2157 2158 1924 2159 2161 2162 2163 2164 2165 2166 2167 2168 2169 2170 1937 1696 1447 1190  925  652  371   82
 569  846 1378 1114 1115 1876 1628 2112 2339 2340 2114 2116 2342 2344 2776 2348 2568 2350 2349 2570 2571 2572 2353 2354 2355 2357 2358 2790 2359 2360 2362 2136 2364 2365 2366 2367 2587 2369 2590 2370 2144 2372 2802 2374 1916 2149 2594 2379 2380 2382 2383 2384 2603 2385 2386 2387 2388 2389 2390 2391 2392 2393 2394 2395 2396 2171 1938 1697 1448 1191  926  653  372   83
 284  568  844 1629 1627 1113 1874 2560 1873 2559 2561 2562 2563 2775 1884 2347 2564 2779 2983 2984 2782 3180 2573 2575 2129 2578 2789 2579 3189 2791 2581 2363 2583 2584 2585 2586 2798 2588 2371 2804 2373 3006 2595 2593 2376 2596 2598 2809 2599 2600 2601 2602 2814 2605 2606 2607 2160 2608 2609 2610 2611 2612 2613 2614 2397 2172 1939 1698 1449 1192  927  654  373   84
 283  843 1375  845  567 1871 1872 2336 2338 2109 2976 2774 2977 2118 2119 2777 2566 2780 3178 2569 2352 2987 2783 2574 2787 2577 3187 2788    0 2580 2793 2997 2795 2796 2999 2797 2799 3002 2589 3004 2801 2803 2805 3008 2806 2378 3207 2810 3013 2811 2812 2813 3017 2604 3019 2818 3021 2819 2820 2821 2822 2823 2824 2615 2398 2173 1940 1699 1450 1193  928  655  374   85
 566  282  842 1112 1374 1373 1870 2337 2557 2772 2773 2771 3172 2979 2978 2980 2567 2982 2985 2781 3179 3367 2786 2988 2356 2990 2576 2992 2993 2994 2582 2996 2794 3193 3194 3000 3382 2800 3001 3003 2591 3007 2592 3202 3390 3206 2597 3009 3014 3210 3209 3016 2815 2816 2817 3215 3020 3022 3023 3024 3025 3026 2825 2616 2399 2174 1941 1700 1451 1194  929  656  375   86
 281  280  564 1111 1372 1625 2334 2108 1626 2556 2770 2975 3360 2565 3175 3176 2778 2981 3177 3365 3369 3181 3182 3372 2785 2784 3373 3188 3190 2792 2995 3191 3192 3380 3381 3195 3196 3384 3197 3199 3200 3005 3201 3203 3204 3011 2808 3393 3012 3396 3015 3211 3212 3018 3401 3214 3216 3217 3218 3219 3220 3027 2826 2617 2400 2175 1942 1701 1452 1195  930  657  376   87
 565  278  841 1110 1371 1624 1869 2107 2106 2335 2769 2974 3173 3174 3361 3362 3363 3364 3544 3545 2986 3548 3183 3186 3184 3371 3722 3374 3375 3376 3377 3379 3729 2998 3731 3560 3561 3383 3198 3386 3387 3388 3389 3392 3391 3010 3205 3395 3208 3397 3398 3399 3400 3750 3579 3402 3403 3404 3222 3405 3221 3028 2827 2618 2401 2176 1943 1702 1453 1196  931  658  377   88
 277  279  839  840 1370 1623 1868 2558 2767 2555 2768 3168 3171 3359 3540 3541 3542 3714 3543 3547 3366 3546 3549 2989 3550 3185 2991 3552 3553 3554 3555 3557 3556 3558 3559 3562 3734 3564 3385 3565 3566 3739 3567 3569 3571 3742 3573 3394 3574 3575 3578 3577 3749 3751 3581 3582 3583 3754 3584 3406 3029 3030 2828 2619 2402 2177 1944 1703 1454 1197  932  659  378   89
 561  837  838 1109 1108 1622 1867 2104 2333 2105 2972 3170 2973 3169 3358 3539 3712 3713 3715 3716 3718 3368 3719 3370 3721 3885 3551 3723 3725 3887 3891 3890 3378 3730 3732 3563 3896 3735 3736 3737 3900 3568 3740 3741 3570 3743 3572 3744 3746 3909 3576 3747 3748 3580 3213 3752 3916 3753 3407 3409 3408 2829 2620 2621 2403 2178 1945 1704 1455 1198  933  660  379   90
 276  275  560 1107 1621 1866 1865 2332 2553 2554 2766 2971 3167 3357 3538 3711 3876 3877 3878 3880 3717 3881 3882 3720 3884 3886 4042 3724 3889 3727 4046 3726 3728 4049 3893 4051 3897 3898 3899 4054 3901 3738 3902 3903 3904 3905 3906 3907 3908 4066 4065 3911 3912 3913 3914 4070 3915 3755 3585 3586 3031 3223 3033 2830 2404 2179 1946 1705 1456 1199  934  661  380   91
 562  563 1106 1368 1369 1620 2102 2103 2331 2552 2765 2970 3356 3355 3537 3710 3875 4032 4033 3879 4181 4036 4037 3883 4038 4039 4040 4329 3888 4045 3892 4194 4047 3894 4197 4196 3733 3895 4200 4055 4056 4203 4057 4058 4059 4346 4060 4062 3910 3745 4063 4214 4213 4215 4216 4068 3917 3756 3410 3587 3224 2831 2624 2622 2405 2180 1947 1706 1457 1200  935  662  381   92
 274  559  836 1105 1367 1366 1864 2101 2330 2551 2764 2969 3166 3354 3708 3536 3874 4031 4180 4035 4183 4182 4323 4184 4185 4187 4041 4188 4043 4044 4191 4193 4190 4195 4048 4334 4198 4052 4053 4201 4341 4202 4204 4205 4206 4347 4061 4208 4210 4064 4351 4212 4067 4069 4217 4071 3919 3918 3588 3758 3225 3032 3034 2832 2406 2181 1948 1707 1458 1201  936  663  382   93
 273  558  835 1104 1365 1619 1618 2100 2329 2550 2763 2968 3165 3535 3534 3709 3873 4030 4179 4320 4321 4452 4034 4456 4186 4325 4326 4189 4331 4192 4463 4586 4462 4335 4050 4467 4336 4337 4199 4338 4340 4342 4343 4344 4476 4345 4207 4209 4348 4211 4482 4352 4355 4353 4218 4073 4072 3589 3757 3411 3412 3226 3227 2623 2407 2182 1949 1708 1459 1202  937  664  383   94
 272  557  834 1103 1364 1617 1863 1862 2328 2549 2762 2967 3164 3352 3353 3707 3872 4029 4178 4319 4451 4322 4453 4324 4455 4457 4458 4327 4328 4584 4583 4587 4332 4465 4589 4466 4468 4469 4339 4471 4472 4473 4474 4475 4477 4823 4599 4479 4349 4350 4483 4484 4485 4354 4219 3921 3920 3760 3590 3413 3228 3035 2833 2834 2408 2183 1950 1709 1460 1203  938  665  384   95
 271  556  833 1102 1363 1616 1861 2099 2098 2327 2761 2966 3163 3533 3532 3705 3706 4028 4177 4318 4576 4450 4454 4578 4579 4695 4580 4582 4460 4330 4461 4702 4588 4333 4590 4705 4706 4707 4470 4593 4595 4596 4597 4715 4712 4478 4717 4480 4481 4603 4605 4606 4487 4357 4074 4075 3759 3761 3591 3414 3229 3036 2835 2625 2626 2184 1951 1710 1461 1204  939  666  385   96
 270  555  832 1101 1362 1615 1860 2097 2326 2548 2760 2965 3162 3351 3531 3871 3870 4027 4176 4317 4449 4575 4577 4693 4694 4802 4696 4581 4805 4698 4699 4907 4807 4464 4811 4591 4592 5087 5003 4594 4710 4711 4819 4598 4714 4713 4716 4822 4827 4826 4719 4720 4220 4076 4358 4221 3923 3922 3592 3231 3416 3230 3037 2411 2409 2627 1952 1711 1462 1205  940  667  386   97
 269  554  831 1100 1361 1614 1859 2096 2325 2547 2546 2964 3161 3350 3530 3704 3869 4026 4175 4315 4316 4690 4692 4691 4801 4803 4697 4459 4804 4806 4700 4585 4809 4704 4703 4814 4913 4708 4709 4816 4817 4818 4600 4820 4920 4922 4602 4601 5012 4925 4825 4607 4609 4608 4356 4078 3926 3593 3594 3415 3039 2837 2836 2628 2410 2185 2186 1953 1464 1463  941  668  387   98
 268  553  830 1099 1360 1613 1858 2095 2324 2545 2759 2963 3160 3349 3529 3702 3703 4025 4173 4174 4448 4574 4573 4689 4900 4901 4902 4903 4904 4905 4808 5082 4701 4810 5000 4911 4813 4914 4815 4916 5167 4917 4919 4918 5010 4821 4718 5015 4824 4604 4724 4610 4723 4359 3924 4486 3764 4077 3420 3595 3418 3038 2838 2629 2412 2187 1954 1712 1713 1206  942  669  388   99
 267  552  829 1098 1359 1612 1857 2094 2323 2544 2758 2962 3347 3159 3700 3868 3866 3867 4172 4314 4447 4572 4799 4800 4798 4992 4993 4994 4995 4997 4906 4998 5081 4999 4909 4908 5085 5004 5005 4915 5008 5097 5232 5009 5093 5094 4924 4722 5014 4829 4926 4721 4488 4360 4361 4222 4223 3763 3925 3040 3234 3041 2839 2630 2413 2188 1714 1207 1208  944 1209  670  389  100
 266  551  828 1097 1358 1611 1856 2093 2322 2543 2757 2961 3348 3527 3345 3346 3528 4024 4312 4446 4445 4688 4797 4898 4899 4991 5076 5077 5078 4996 5080 5225 5157 5083 5001 4912 4812 5163 4910 5089 5092 5293 5007 5095 5170 4927 4921 4923 5016 4830 4828 4611 4489 4362 4080 3765 3927 3419 3417 3235 3232 3233 2840 2631 2414 2189 1955 1715 1466 1465  943  671  390  101
 265  550  827 1096 1357 1610 1855 2092 2321 2542 2756 2960 3158 3156 3344 4022 3701 4023 4313 3864 4571 4687 4686 4796 4897 4990 5075 5152 5153 5079 5154 5156 5160 5285 5086 5159 5337 5006 5164 5090 5161 5091 5168 5236 5011 5096 5098 4832 5013 4726 4725 4612 4490 4491 4224 4083 3596 3762 3598 3236 3044 2633 2841 2632 2415 2190 1956 1716 1467 1210  945  672  391  102
 264  549  826 1095 1356 1609 1854 2091 2319 2539 2755 2754 3525 3155 3157 3699 4021 3865 4311 4171 4310 4570 4795 4794 4896 4989 5074 5151 5220 5280 5223 5224 5226 5158 5002 5287 5084 5227 5386 5288 5088 5229 5343 5165 5169 5172 5171 4928 5017 4727 4831 4613 4492 4363 4225 4226 3766 3928 3421 3768 2842 3042 2843 2416 2191 1958 1957 1717 1468 1211  946  673  392  103
 263  548  825 1094 1355 1608 1853 2090 2540 2541 2320 2958 3526 3343 3698 3696 2959 4169 4170 4443 4168 4569 4895 4793 4894 4988 5073 5150 5219 5279 5221 5281 5332 5335 5284 5415 5228 5162 5230 5290 5233 5294 5342 5234 5238 5237 5101 4930 4929 4833 4614 4493 4364 4227 4081 4082 4079 3767 3929 3423 3422 3238 2636 2844 2634 2192 1959 1718 1469 1212  947  674  393  104
 262  547  824 1093 1354 1607 1852 2089 2538 2752 2753 3153 3154 3524 3697 3863 3862 4020 4019 4567 4444 4685 4684 4987 4986 5071 4985 5149 5218 5278 5155 5282 5283 5286 5380 5379 5289 5338 5339 5341 5291 5295 5344 5345 5235 5173 5018 5099 5100 5019 4728 4615 4494 4365 4228 3930 3771 3769 3597 3599 3425 3237 2635 2845 2417 2193 1960 1719 1470 1213  948  675  394  105
 261  546  823 1092 1353 1606 1851 2088 2318 2317 2957 2751 3342 2956 3523 3695 4018 4308 4309 4441 4442 4568 4683 4792 4893 5072 5070 5148 5217 5331 5222 5377 5333 5334 5378 5336 5414 5381 5231 5384 5166 5385 5296 5292 5239 5174 5020 4931 4835 4834 4729 4616 4495 4366 4229 4084 3931 3601 3600 3045 3043 3046 3047 2419 2418 2194 1961 1720 1471 1214  949  676  395  106
 260  545  822 1091 1352 1605 1850 2087 2316 2537 2750 2955 3152 3341 3522 3860 3861 4166 4167 4307 4440 4565 4566 4791 4892 4984 5069 5147 5215 5329 5375 5376 5412 5413 5442 5416 5382 5383 5418 5419 5340 5387 5346 5297 5240 5175 5102 5021 4932 4836 4730 4617 4496 4367 4230 4085 3933 3932 3770 3239 2846 3048 3424 2637 2420 2195 1962 1721 1472 1215  950  677  396  107
 259  544  821 1090 1351 1604 1849 2086 2315 2536 2749 2954 3151 3340 3521 3694 4016 4017 4165 4306 4439 4564 4682 4681 4891 4983 5146 5145 5277 5276 5216 5374 5411 5440 5461 5441 5444 5417 5445 5464 5447 5388 5347 5298 5241 5176 5103 5023 5022 4933 4731 4618 4497 4368 4231 4086 3934 3602 3772 3603 3240 3427 2847 2639 2421 1963 1964 1722 1473  951  678  679  397  108
 258  543  820 1089 1350 1603 1848 2085 2314 2535 2748 2953 3150 3339 3520 3693 3859 3858 4015 4305 4438 4680 4789 4790 4888 4982 5068 5214 5275 5328 5330 5373 5410 5439 5460 5462 5443 5463 5465 5420 5421 5390 5389 5348 5299 5242 5177 5104 4934 4837 4732 4619 4498 4369 4232 4087 3935 3773 3242 3241 3050 3049 2848 2425 2851 2638 2197 1723 1474 1216  953  952  398  109
 257  542  819 1088 1349 1602 1847 2084 2313 2534 2747 2952 3149 3338 3519 3692 3857 4014 4164 4304 4437 4563 4679 4890 4787 4889 5067 5144 5213 5274 5327 5372 5438 5459 5437 5469 5472 5473 5448 5446 5422 5423 5349 5300 5243 5178 5105 5024 4935 4838 4733 4620 4499 4370 4233 4088 3936 3774 3604 3605 3426 3243 2850 2849 2422 2196 2423 1965 1724 1476  954  680  399  110
 256  541  818 1087 1348 1601 1846 2083 2312 2533 2746 2951 3148 3337 3518 3691 3856 4013 4163 4303 4436 4561 4562 4788 4981 4980 5066 5143 5212 5273 5326 5371 5409 5408 5471 5475 5470 5474 5466 5449 5424 5391 5350 5301 5244 5179 5106 5025 4936 4839 4734 4621 4500 4371 4234 4089 3937 3775 3606 3429 3428 3051 2642 2424 2641 1966 1725 1477 1219 1475 1218  682  400  111
 255  540  817 1086 1347 1600 1845 2082 2311 2532 2745 2950 3147 3336 3517 3690 4012 4161 4162 4302 4560 4676 4678 4887 4786 5065 5063 5142 5211 5272 5325 5370 5406 5407 5456 5457 5468 5453 5467 5450 5425 5392 5351 5302 5245 5180 5107 5026 4937 4840 4735 4622 4501 4373 4372 4235 3776 3607 3430 3245 3244 3052 2200 2640 2199 2198 2201 1217 1726 1220  681  955  401  113
 254  539  816 1085 1346 1599 1844 2081 2310 2531 2744 2949 3146 3335 3516 3689 3855 3854 4160 4301 4435 4559 4675 4677 4784 4886 4978 5064 5210 5271 5324 5369 5436 5434 5435 5455 5458 5454 5452 5451 5426 5393 5352 5303 5246 5181 5108 5027 4938 4841 4736 4623 4502 4374 4236 4090 4091 3777 3608 3431 3246 3053 2852 2643 2426 1968 1967 1727 1478 1222  957  683  684  114
 253  538  815 1084 1345 1598 1843 2080 2309 2530 2743 2948 3145 3334 3515 3688 3853 4011 4159 4432 4300 4434 4884 4783 5141 4977 4979 5209 5139 5270 5323 5368 5404 5405 5402 5432 5431 5430 5429 5428 5427 5394 5353 5304 5247 5182 5109 5028 4939 4842 4737 4624 4503 4375 4237 3939 3778 3938 3610 3432 3247 3054 2853 2644 2427 2203 1969 1728 1221 1480  956  402  112  403
 252  537  814 1083 1344 1597 1842 2079 2308 2529 2742 2947 3144 3333 3514 3687 3852 4010 4009 4299 4558 4673 4785 4885 4883 5062 5061 5140 5207 5208 5322 5366 5367 5433 5403 5401 5400 5399 5398 5397 5396 5395 5354 5305 5248 5183 5110 5029 4940 4843 4738 4625 4504 4376 4094 4092 3940 3609 3779 3433 3248 3055 2854 2645 2428 1970 1971 1729 1479  960  958  685  405  115
 251  536  813 1082 1343 1596 1841 2078 2307 2528 2741 2946 3143 3332 3513 3686 3851 4008 4158 4298 4433 4431 4557 4556 4782 4975 4976 5138 5269 5267 5268 5321 5365 5364 5363 5362 5361 5360 5359 5358 5357 5356 5355 5306 5249 5184 5111 5030 4941 4844 4739 4626 4505 4239 4093 4238 3941 3780 3611 3434 3249 3056 2855 2646 2429 2204 1973 2202 1481 1223  686  688  116  404
 250  535  812 1081 1342 1595 1840 2077 2306 2527 2740 2945 3142 3331 3512 3685 3850 4156 4157 4297 4430 4555 4672 4779 4674 4881 5060 5137 5206 5266 5319 5318 5317 5262 5316 5315 5314 5313 5312 5311 5310 5309 5308 5307 5250 5185 5112 5031 4942 4845 4740 4627 4506 4377 4240 4095 3942 3781 3612 3435 3250 3057 2856 2647 2430 1730 2206 1972 1224 1225  961  959  406  687
 249  534  811 1080 1341 1594 1839 2076 2305 2526 2739 2944 3141 3330 3511 3684 3849 4007 4006 4296 4429 4554 4670 4781 4882 4671 5059 5136 5205 5203 5265 5201 5264 5199 5261 5260 5259 5258 5257 5256 5255 5254 5253 5252 5251 5186 5113 5032 4943 4846 4741 4628 4507 4378 4241 4096 3943 3782 3613 3436 3251 3058 2857 2648 2431 2205 1731 1483 1482 1226 1227  689  117  407
 248  533  810 1079 1340 1593 1838 2075 2304 2525 2738 2943 3140 3329 3510 3683 3848 4005 4155 4154 4428 4553 4669 4880 4973 4780 5058 5135 5133 5204 5320 5202 5263 5200 5126 5127 5196 5195 5194 5193 5192 5191 5190 5189 5188 5187 5114 5033 4944 4847 4742 4629 4508 4379 4242 4097 3944 3783 3614 3437 3252 3059 2858 2649 2432 2207 1732 1733 1484 1228  963  962  118  120
 247  532  809 1078 1339 1592 1837 2074 2303 2524 2737 2942 3139 3509 3682 3847 4004 4150 4151 4295 4427 4552 4778 4777 4972 4974 5057 5134 5054 5132 5131 5129 5051 5198 5197 5047 5125 5124 5123 5122 5121 5120 5119 5118 5117 5116 5115 5034 4945 4848 4743 4630 4509 4380 4243 4098 3945 3784 3615 3438 3253 3060 2859 2650 2433 2208 1974 1975 1485 1229  690  409  119  408
 246  531  808 1077 1338 1591 1836 2073 2302 2523 2736 2941 3327 3328 3508 3681 3846 4292 4293 4294 4426 4551 4668 4878 4877 4879 4971 5056 5055 5053 5052 5130 5050 5128 5049 4960 5046 5045 5044 5043 5042 5041 5040 5039 5038 5037 5036 5035 4946 4849 4744 4631 4510 4381 4244 4099 3946 3785 3616 3439 3254 3061 2860 2651 2434 2209 1976 1734 1486  691  964  692  410  121
 245  530  807 1076 1337 1590 1835 2072 2301 2522 2735 2940 3138 3137 3326 3679 3507 4152 4153 4291 4425 4550 4667 4775 4776 4970 4969 4968 4967 4966 4965 4964 4963 4962 5048 4865 4959 4958 4957 4956 4955 4954 4953 4952 4951 4950 4949 4948 4947 4850 4745 4632 4511 4382 4245 4100 3947 3786 3617 3440 3255 3062 2861 2652 2435 2210 1977 1735 1487  966  965  694  411  122
 244  529  806 1075 1336 1589 1834 2071 2300 2521 2734 2939 3136 3324 3325 3680 3845 4003 3844 4002 4424 4549 4666 4773 4774 4876 4874 4873 4872 4871 4870 4869 4868 4867 4961 4866 4864 4863 4862 4861 4860 4859 4858 4857 4856 4855 4854 4853 4852 4851 4746 4633 4512 4383 4246 4101 3948 3787 3618 3441 3256 3063 2862 2653 2436 2211 1978 1736 1737 1230 1231  412  413  123
 243  528  805 1074 1335 1588 1833 2070 2299 2520 2733 2938 3135 3323 3678 3506 3843 4001 4149 4290 4423 4548 4665 4663 4772 4875 4771 4770 4769 4768 4767 4766 4765 4764 4763 4762 4761 4760 4759 4758 4757 4756 4755 4754 4753 4752 4751 4750 4749 4748 4747 4634 4513 4384 4247 4102 3949 3788 3619 3442 3257 3064 2863 2654 2438 2212 1979 1488 1232 1489  693  967  124  125
 242  527  804 1073 1334 1587 1832 2069 2298 2519 2732 2937 3134 3504 3841 3677 3842 4000 4148 4289 4422 4547 4664 4544 4662 4661 4660 4659 4658 4657 4656 4655 4654 4653 4652 4651 4650 4649 4648 4647 4646 4645 4644 4643 4642 4641 4640 4639 4638 4637 4636 4635 4514 4385 4248 4103 3950 3789 3620 3443 3258 3065 2865 2864 2214 2437 1980 1738 1490  969 1233  695  415  414
 241  526  803 1072 1333 1586 1831 2068 2297 2518 2731 2936 3133 3322 3505 3503 3998 3999 4147 4288 4421 4546 4545 4417 4543 4542 4541 4540 4539 4538 4537 4536 4535 4534 4533 4532 4531 4530 4529 4528 4527 4526 4525 4524 4523 4522 4521 4520 4519 4518 4517 4516 4515 4386 4249 4104 3951 3790 3621 3444 3259 3066 2655 2440 2213 2439 1981 1739 1740 1236  968  696  416  126
 240  525  802 1071 1332 1585 1830 2067 2296 2517 2730 2935 3132 3321 3675 3676 3840 3997 4146 4287 4420 4419 4418 4282 4416 4415 4414 4413 4412 4411 4410 4409 4408 4407 4406 4405 4404 4403 4402 4401 4400 4399 4398 4397 4396 4395 4394 4393 4392 4391 4390 4389 4388 4387 4250 4105 3952 3791 3622 3445 3260 3067 2866 2656 2657 2215 1983 1741 1492 1491 1235  697  417  127
 239  524  801 1070 1331 1584 1829 2066 2295 2516 2729 2934 3131 3320 3502 3674 3839 3996 4145 4286 4285 4284 4140 4283 4281 4280 4279 4278 4277 4276 4275 4274 4273 4272 4271 4270 4269 4268 4267 4266 4265 4264 4263 4262 4261 4260 4259 4258 4257 4256 4255 4254 4253 4252 4251 4106 3953 3792 3623 3446 3261 3068 2867 2658 2441 1493 2217 1982 1743 1234  970  971  418  128
 238  523  800 1069 1330 1583 1828 2065 2294 2515 2728 2933 3319 3500 3501 3673 3838 3995 4144 4143 4142 4141 4139 4138 4137 4136 3985 4135 4134 4133 4132 4131 4130 4129 4128 4127 4126 4125 4124 4123 4122 4121 4120 4119 4118 4117 4116 4115 4114 4113 4112 4111 4110 4109 4108 4107 3954 3793 3624 3447 3262 3264 2868 2659 2442 2216 1984 1742 1744 1237 1494  698  699  129
 237  522  799 1068 1329 1582 1827 2064 2293 2514 2727 2932 3130 3318 3499 3672 3837 3994 3993 3992 3991 3990 3989 3988 3987 3986 3984 3825 3983 3982 3981 3980 3979 3978 3977 3976 3975 3974 3973 3972 3971 3970 3969 3968 3967 3966 3965 3964 3963 3962 3961 3960 3959 3958 3957 3956 3955 3794 3625 3448 3069 3070 2660 2661 2218 1986 1745 1238 1495  973  972  700  419  130
 236  521  798 1067 1328 1581 1826 2063 2292 2513 2726 3128 3129 3317 3498 3671 3836 3835 3834 3833 3832 3831 3830 3829 3828 3827 3826 3658 3824 3823 3822 3821 3820 3819 3818 3817 3816 3815 3814 3813 3812 3811 3810 3809 3808 3807 3806 3805 3804 3803 3802 3801 3800 3799 3798 3797 3796 3795 3626 3449 3263 3071 2869 2444 2219 1987 1746 1985 1496 1239  974  701  420  131
 235  520  797 1066 1327 1580 1825 2062 2291 2512 2725 2931 2930 3316 3497 3670 3669 3668 3667 3666 3665 3664 3663 3662 3661 3659 3483 3484 3657 3655 3480 3654 3653 3652 3651 3650 3649 3648 3647 3646 3645 3644 3643 3642 3641 3640 3639 3638 3637 3636 3635 3634 3633 3632 3631 3630 3629 3628 3627 3450 3265 3072 2870 2871 2443 2445 2220 1498 1497 1240  975  702  421  132
 234  519  796 1065 1326 1579 1824 2061 2511 2510 2724 3126 3127 3315 3496 3495 3494 3493 3492 3491 3490 3489 3488 3486 3302 3660 3485 3482 3481 3656 3297 3479 3478 3477 3476 3475 3474 3473 3472 3471 3470 3469 3468 3467 3466 3465 3464 3463 3462 3461 3460 3459 3458 3457 3456 3455 3454 3453 3452 3451 3266 3073 2872 2662 2221 2222 1747 1988 1499 1241  976  703  422  133
 233  518  795 1064 1325 1578 1823 2060 2290 2723 2722 2929 3125 3314 3313 3312 3311 3119 3310 3309 3307 3306 3305 3487 3304 3303 3301 3300 3299 3298 3106 3296 3295 3294 3293 3292 3291 3290 3289 3288 3287 3286 3285 3284 3283 3282 3281 3280 3279 3278 3277 3276 3275 3274 3273 3272 3271 3270 3269 3077 3268 2874 2873 2663 2664 2447 1750 1748 1243 1749  977  424  704  134
 232  517  794 1063 1324 1577 1822 2059 2289 2509 2927 2928 3124 3123 3122 3121 3120 3118 3308 2918 3117 3115 3114 3113 3112 3111 2911 3110 2909 3108 2907 3105 3104 3103 3102 3101 3100 3099 3098 3097 3096 3095 3094 3093 3092 3091 3090 3089 3088 3087 3086 3085 3084 3083 3082 3081 3080 3079 3078 3076 3074 3267 3075 2446 2448 2223 1991 1990 1500  978  705  706  423  135
 231  516  793 1062 1323 1576 1821 2287 2288 2508 2721 2926 2925 2924 2923 2922 2921 2920 2712 2919 3116 2917 2916 2915 2914 2913 3109 2910 2702 3107 2700 2906 2905 2904 2903 2902 2901 2900 2899 2898 2897 2896 2895 2894 2893 2892 2891 2890 2889 2888 2887 2886 2885 2884 2883 2882 2881 2880 2879 2878 2877 2876 2875 2665 2666 2224 1992 1501 1242 1989  425  136  426  137
 230  515  792 1061 1322 1575 1820 2058 2286 2507 2720 2719 2718 2717 2716 2715 2714 2498 2713 2711 2710 2271 2709 2707 2706 2912 2705 2488 2703 2908 2701 2699 2698 2697 2696 2695 2694 2693 2692 2691 2690 2689 2688 2687 2686 2685 2684 2683 2682 2681 2680 2679 2678 2677 2676 2675 2674 2673 2672 2671 2670 2669 2668 2667 2449 2225 1751 1245  980 1502  979 1244  707  138
 229  514  791 1060 1321 1574 1819 2057 2285 2506 2505 2504 2503 2502 2501 2500 2499 2275 2497 2496 2495 2708 2494 2493 2492 2490 2704 2489 2487 2486 2485 2484 2483 2482 2481 2480 2479 2478 2477 2476 2475 2474 2473 2472 2471 2470 2469 2468 2467 2466 2465 2464 2463 2462 2461 2460 2459 2458 2457 2456 2455 2454 2453 2452 2450 2451 2226 1752 1503 1246  982  981  427  139
 228  513  790 1059 1320 1573 1818 2056 2284 2283 2282 2281 2280 2279 2047 2278 2277 2276 2274 2273 2042 2272 2270 2268 2491 2267 2266 2265 2264 2263 2262 2261 2260 2259 2258 2257 2256 2255 2254 2253 2252 2251 2250 2249 2248 2247 2246 2245 2244 2243 2242 2241 2240 2239 2238 2237 2236 2235 2234 2233 2232 2231 2230 2229 2228 2227 1993 1753 1504 1248 1247  708  428  140
 227  512  789 1058 1319 1572 1817 2055 2053 2052 2051 2050 2049 1809 2048 2046 2045 2044 2043 1803 2041 1554 2040 2269 2039 2036 2035 2034 2033 2032 2031 2030 2029 2028 2027 2026 2025 2024 2023 2022 2021 2020 2019 2018 2017 2016 2015 2014 2013 2012 2011 2010 2009 2008 2007 2006 2005 2004 2003 2002 2001 2000 1999 1998 1997 1996 1994 1995 1754 1505  983  709  429  141
 226  511  788 1057 1318 1571 1816 2054 1814 1813 1812 1811 1563 1810 1808 1807 1806 1805 1804 1802 1801 1553 2038 1798 2037 1797 1796 1795 1794 1793 1792 1791 1790 1789 1788 1787 1786 1785 1784 1783 1782 1781 1780 1779 1778 1777 1776 1775 1774 1773 1772 1771 1770 1769 1768 1767 1766 1765 1764 1763 1762 1761 1760 1759 1758 1757 1756 1755 1506 1249  984  710  711  430
 225  510  787 1056 1317 1570 1569 1815 1568 1566 1565 1309 1564 1562 1561 1560 1559 1558 1557 1556 1555 1552 1800 1296 1551 1550 1549 1548 1547 1546 1545 1544 1543 1542 1541 1540 1539 1538 1537 1536 1535 1534 1533 1532 1531 1530 1529 1528 1527 1526 1525 1524 1523 1522 1521 1520 1519 1518 1517 1516 1515 1514 1513 1512 1511 1510 1509 1508 1507 1250  985  712  431  142
 224  509  786 1055 1316 1315 1314 1313 1567 1312 1047 1310 1046 1307 1306 1305 1304 1303 1302 1301 1300 1299 1298 1799 1297 1295 1032 1293 1292 1291 1290 1289 1288 1287 1286 1285 1284 1283 1282 1281 1280 1279 1278 1277 1276 1275 1274 1273 1272 1271 1270 1269 1268 1267 1266 1265 1264 1263 1262 1261 1260 1259 1258 1257 1256 1255 1254 1253 1252 1251  986  713  432  143
 223  508  785 1054 1053 1052 1051 1050 1049 1311 1048 1045 1308  774 1043 1042 1041 1040 1039 1038 1037 1036 1035 1034 1033  761 1294 1030 1029 1028 1027 1026 1025 1024 1023 1022 1021 1020 1019 1018 1017 1016 1015 1014 1013 1012 1011 1010 1009 1008 1007 1006 1005 1004 1003 1002 1001 1000  999  998  997  996  995  994  993  992  991  990  989  988  987  714  433  144
 222  507  784  783  782  781  780  779  778  777  776  775  773 1044  494  771  770  769  768  767  766  765  764  763  762  760 1031  481  758  757  756  755  754  753  752  751  750  749  748  747  746  745  744  743  742  741  740  739  738  737  736  735  734  733  732  731  730  729  728  727  726  725  724  723  722  721  720  719  718  717  716  715  434  145
 221  506  505  504  503  502  501  500  499  498  497  496  495  493  772  492  491  490  489  488  487  486  485  484  483  482  480  759  479  478  477  476  475  474  473  472  471  470  469  468  467  466  465  464  463  462  461  460  459  458  457  456  455  454  453  452  451  450  449  448  447  446  445  444  443  442  441  440  439  438  437  436  435  146
 220  219  218  217  216  215  214  213  212  211  210  209  208  207  206  205  204  203  202  201  200  199  198  197  196  195  194  193  192  191  190  189  188  187  186  185  184  183  182  181  180  179  178  177  176  175  174  173  172  171  170  169  168  167  166  165  164  163  162  161  160  159  158  157  156  155  154  153  152  151  150  149  148  147
