# This puzzle is unsolvable
68
   2    1    3    4    5    6    7    8    9   10   11   12   13   14   15   16   17   18   19   20   21   22   23   24   25   26   27   28   29   30   31   32   33   34   35   36   37   38   39   40   41   42   43   44   45   46   47   48   49   50   51   52   53   54   55   56   57   58  326   59   62  587   63  331  333   66   71   68
 268  269  270  271  272  273  274  275  276  277  278  279  280  281  282  283  284  285  286  287  288  289  290  291  292  293  294  295  296  297  298  299  300  301  302  303  304  305  306  307  308  309  310  311  312  313  314  315  316  317  318  319  320  321  322  323  324  325  327   61   60  590  328  589   65   64  334  336
 267  528  529  530  531  532  533  534  535  536  537  538  539  540  541  542  543  544  545  546  547  548  549  550  551  552  553  554  555  556  557  558  559  560  561  562  563  564  565  566  567  568  569  570  571  572  573  574  575  576  577  578  579  580  581  582  583  584  585  586  588  329  840  330  842  592  591  332
 266  527  780  781  782  783  784  785  786  787  788  789  790  791  792  793  794  795  796  797  798  799  800  801  802  803  804  805  806  807  808  809  810  811  812  813  814  815  816  817  818  819  820  821  822  823  824  825  826  827  828  829  830  831  832  833  834  835  836  837  838  839 1318 1544  593  335   67  595
 265  526  779 1024 1025 1026 1027 1028 1029 1030 1031 1032 1033 1034 1035 1036 1037 1038 1039 1040 1041 1042 1043 1044 1045 1046 1047 1048 1049 1050 1051 1052 1053 1054 1055 1056 1057 1058 1059 1060 1061 1062 1063 1064 1065 1066 1067 1068 1069 1070 1071 1072 1073 1074 1075 1076 1077 1078 1079 1080 1081 1083 1085  841 1084   70   73  337
 264  525  778 1023 1260 1261 1262 1263 1264 1265 1266 1267 1268 1269 1270 1271 1272 1273 1274 1275 1276 1277 1278 1279 1280 1281 1282 1283 1284 1285 1286 1287 1288 1289 1290 1291 1292 1293 1294 1295 1296 1297 1298 1299 1300 1301 1302 1303 1304 1305 1306 1307 1308 1309 1310 1311 1312 1313 1314 1315 1545 1319 1082  843  844   76   75   69
 263  524  777 1022 1259 1488 1489 1490 1491 1492 1493 1494 1495 1496 1497 1498 1499 1500 1501 1502 1503 1504 1505 1506 1507 1508 1509 1510 1511 1512 1513 1514 1515 1516 1517 1518 1519 1520 1521 1522 1523 1524 1525 1526 1527 1528 1529 1530 1531 1532 1533 1534 1535 1536 1537 1538 1758 1539 1541 1542 1543 1317 1322  845   72  339  594  338
 262  523  776 1021 1258 1487 1708 1709 1710 1711 1712 1713 1714 1715 1716 1717 1718 1719 1720 1721 1722 1723 1724 1725 1726 1727 1728 1729 1730 1731 1732 1733 1734 1735 1736 1737 1738 1739 1740 1741 1742 1743 1744 1745 1746 1747 1748 1749 1750 1751 1752 1753 1754 1755 1756 1757 1759 1760 1540 1761 1316 1320 1087  846  596   79  340   74
 261  522  775 1020 1257 1486 1707 1920 1921 1922 1923 1924 1925 1926 1927 1928 1929 1930 1931 1932 1933 1934 1935 1936 1937 1938 1939 1940 1941 1942 1943 1944 1945 1946 1947 1948 1949 1950 1951 1952 1953 1954 1955 1956 1957 1958 1959 1960 1961 1962 1963 1964 1965 1966 1967 1968 1970 2174 1972 1546 1762 1548 1321 1088 1086  597   77   80
 260  521  774 1019 1256 1485 1706 1919 2124 2125 2126 2127 2128 2129 2130 2131 2132 2133 2134 2135 2136 2137 2138 2139 2140 2141 2142 2143 2144 2145 2146 2147 2148 2149 2150 2151 2152 2153 2154 2155 2156 2157 2158 2159 2160 2161 2162 2163 2164 2165 2166 2167 2168 2169 2170 2171 1969 1971 1973 1764 1765 1550 1763 1547 1089  848  598   78
 259  520  773 1018 1255 1484 1705 1918 2123 2320 2321 2322 2323 2324 2325 2326 2327 2328 2329 2330 2331 2332 2333 2334 2335 2336 2337 2338 2339 2340 2341 2342 2343 2344 2345 2346 2347 2348 2349 2350 2351 2352 2353 2354 2355 2356 2357 2358 2359 2360 2361 2362 2363 2364 2365 2366 2172 2173 2367 1974 1549 1327 1323 1090  847  342  341 1091
 258  519  772 1017 1254 1483 1704 1917 2122 2319 2508 2509 2510 2511 2512 2513 2514 2515 2516 2517 2518 2519 2520 2521 2522 2523 2524 2525 2526 2527 2528 2529 2530 2531 2532 2533 2534 2535 2536 2537 2538 2539 2540 2541 2542 2543 2544 2545 2546 2547 2548 2549 2550 2551 2553 2554 2732 2369 2175 1766 1552 1976 1326  849  599  343  344  600
 257  518  771 1016 1253 1482 1703 1916 2121 2318 2507 2688 2689 2690 2691 2692 2693 2694 2695 2696 2697 2698 2699 2700 2701 2702 2703 2704 2705 2706 2707 2708 2709 2710 2711 2712 2713 2714 2715 2716 2717 2718 2719 2720 2721 2722 2723 2724 2725 2726 2727 2728 2729 2730 2552 2556 2731 2370 2176 2177 2178 1093 1768  851  602  601  346   81
 256  517  770 1015 1252 1481 1702 1915 2120 2317 2506 2687 2860 2861 2862 2863 2864 2865 2866 2867 2868 2869 2870 2871 2872 2873 2874 2875 2876 2877 2878 2879 2880 2881 2882 2883 2884 2885 2886 2887 2888 2889 2890 2891 2892 2893 2894 2895 2896 2897 2898 2899 2900 2901 2902 2368 2555 2371 1977 2179 1978 1767 1324 1095  852  850  345   83
 255  516  769 1014 1251 1480 1701 1914 2119 2316 2505 2686 2859 3024 3025 3026 3027 3028 3029 3030 3031 3032 3033 3034 3035 3036 3037 3038 3039 3040 3041 3042 3043 3044 3045 3046 3047 3048 3049 3050 3051 3052 3053 3054 3055 3056 3057 3058 3059 3060 3061 3062 3063 3064 2903 2733 2557 2373 1325 2372 1551 1096 1092 1330  853  854 1094  603
 254  515  768 1013 1250 1479 1700 1913 2118 2315 2504 2685 2858 3023 3180 3181 3182 3183 3184 3185 3186 3187 3188 3189 3190 3191 3192 3193 3194 3195 3196 3197 3198 3199 3200 3201 3202 3203 3204 3205 3206 3207 3208 3209 3210 3211 3212 3213 3214 3215 3216 3217 3218 3065 2904 2734 2374 2375 2180 1975 1771 1770  606 1979  607   82  604  347
 253  514  767 1012 1249 1478 1699 1912 2117 2314 2503 2684 2857 3022 3179 3328 3329 3330 3331 3332 3333 3334 3335 3336 3337 3338 3339 3340 3341 3342 3343 3344 3345 3346 3347 3348 3349 3350 3351 3352 3353 3354 3355 3356 3357 3358 3359 3360 3361 3362 3363 3364 3219 3066 2905 2735 2558 2737 2181 1981 1772 1556 1769 1328  605  350  348   85
 252  513  766 1011 1248 1477 1698 1911 2116 2313 2502 2683 2856 3021 3178 3327 3468 3469 3470 3471 3472 3473 3474 3475 3476 3477 3478 3479 3480 3481 3482 3483 3484 3485 3486 3487 3488 3489 3490 3491 3492 3493 3494 3495 3496 3497 3498 3499 3500 3501 3502 3365 3220 3067 2906 2559 2739 2561 2182 1980 1553 1555 1329 1331 1097  349   84   86
 251  512  765 1010 1247 1476 1697 1910 2115 2312 2501 2682 2855 3020 3177 3326 3467 3600 3601 3602 3603 3604 3605 3606 3607 3608 3609 3610 3611 3612 3613 3614 3615 3616 3617 3618 3619 3620 3621 3622 3623 3624 3625 3626 3627 3628 3629 3630 3631 3632 3503 3366 3221 3068 2908 2907 2736 2560 2183 1983 1558 1554  855 1332  608  856  351   87
 250  511  764 1009 1246 1475 1696 1909 2114 2311 2500 2681 2854 3019 3176 3325 3466 3599 3724 3725 3726 3727 3728 3729 3730 3731 3732 3733 3734 3735 3736 3737 3738 3739 3740 3741 3742 3743 3744 3745 3746 3747 3748 3749 3750 3751 3752 3753 3754 3633 3504 3367 3222 3069 2740 2738 2376 2184 2378 1333 1775 1982 1557 1098  857  858  609  352
 249  510  763 1008 1245 1474 1695 1908 2113 2310 2499 2680 2853 3018 3175 3324 3465 3598 3723 3840 3841 3842 3843 3844 3845 3846 3847 3848 3849 3850 3851 3853 3854 3855 4062 3857 3963 3858 3859 3860 3861 3862 3863 3864 3865 3866 3867 3868 3755 3634 3505 3368 3223 3070 2909 2562 2563 2377 2186 1773 1335 1774 1100 1101  610  611  353   88
 248  509  762 1007 1244 1473 1694 1907 2112 2309 2498 2679 2852 3017 3174 3323 3464 3597 3722 3839 3948 3949 3950 3951 3952 3953 3954 3955 3956 3957 3958 3852 3960 4060 3962 3856 3964 3966 3967 4066 3968 3969 3970 3971 3972 3973 3974 3869 3756 3635 3506 3369 3225 3224 2741 2743 2742 2564 1986 1984 2185 1985 1102 1099  860  612  354   89
 247  508  761 1006 1243 1472 1693 1906 2111 2308 2497 2678 2851 3016 3173 3322 3463 3596 3721 3838 3947 4048 4049 4050 4051 4052 4053 4054 4055 4056 4057 3959 4058 3961 4063 4064 4154 3965 4065 4067 4158 4068 4069 4070 4071 4072 3975 3870 3757 3636 3507 3370 3071 3073 2910 2567 3072 2379 2188 1776 1777 1560 1559 1103  859  861  355   90
 246  507  760 1005 1242 1471 1692 1905 2110 2307 2496 2677 2850 3015 3172 3321 3462 3595 3720 3837 3946 4047 4140 4141 4142 4143 4144 4145 4147 4229 4148 4149 4151 4059 4152 4061 4237 4155 4156 4157 4159 4160 4243 4161 4162 4073 3976 3871 3758 3637 3508 3371 3226 2911 2745 2568 2912 2187 2381 1987 1561 1336 1334 1104  862  613  356   91
 245  506  759 1004 1241 1470 1691 1904 2109 2306 2495 2676 2849 3014 3171 3320 3461 3594 3719 3836 3945 4046 4139 4224 4225 4226 4227 4228 4146 4306 4307 4373 4150 4234 4235 4153 4313 4312 4239 4240 4241 4242 4318 4244 4163 4074 3977 3872 3759 3638 3509 3373 3372 3227 3074 2565 2744 2382 2566 1779 1778 1562 1338 1337  863  614  357   92
 244  505  758 1003 1240 1469 1690 1903 2108 2305 2494 2675 2848 3013 3170 3319 3460 3593 3718 3835 3944 4045 4138 4223 4300 4301 4302 4304 4305 4231 4230 4374 4232 4233 4310 4236 4311 4238 4314 4315 4316 4317 4319 4245 4164 4075 3978 3873 3760 3510 3512 3374 3228 3076 2913 2189 2914 2383 2380 1989 1780 1564 1339 1105  864  615  358   93
 243  504  757 1002 1239 1468 1689 1902 2107 2304 2493 2674 2847 3012 3169 3318 3459 3592 3717 3834 3943 4044 4137 4222 4299 4368 4370 4303 4371 4372 4431 4308 4375 4309 4377 4378 4379 4380 4381 4382 4385 4442 4384 4246 4165 4076 3979 3874 3640 3639 3511 3229 3230 3077 3075 2569 2384 2190 1988 2191 1990 1563 1781 1106  865  616  359   94
 242  503  756 1001 1238 1467 1688 1901 2106 2303 2492 2673 2846 3011 3168 3317 3458 3591 3716 3833 3942 4043 4136 4221 4298 4367 4369 4429 4430 4482 4432 4433 4434 4376 4436 4437 4489 4438 4440 4441 4383 4387 4386 4320 4247 4077 3980 3761 3763 3762 3513 3641 3231 2916 2915 2746 2570 2385 2192 1782 2193 1783 1340 1107  866  617  360   95
 241  502  755 1000 1237 1466 1687 1900 2105 2302 2491 2672 2845 3010 3167 3316 3457 3590 3715 3832 3941 4042 4135 4220 4297 4366 4428 4480 4481 4525 4527 4526 4484 4435 4485 4488 4532 4439 4491 4492 4443 4321 4322 4167 4166 4078 3981 3875 3876 3642 3764 3375 3232 3078 2917 2747 2749 2748 2194 1991 1993 1565 1566 1341  867  618  361   96
 240  501  754  999 1236 1465 1686 1899 2104 2301 2490 2671 2844 3009 3166 3315 3456 3589 3714 3831 3940 4041 4134 4219 4296 4365 4427 4426 4479 4524 4483 4529 4564 4486 4487 4566 4531 4490 4534 4493 4494 4323 4444 4248 4079 3982 4080 3879 3515 3878 3643 3376 3377 3079 2918 2571 2572 2386 2196 1992 1784 1567 1342 1108  868  619  362   97
 239  500  753  998 1235 1464 1685 1898 2103 2300 2489 2670 2843 3008 3165 3314 3455 3588 3713 3830 3939 4040 4133 4218 4295 4364 4425 4478 4523 4560 4589 4562 4563 4565 4590 4530 4533 4536 4569 4535 4445 4388 4324 4249 4168 4169 3984 3983 3877 3644 3514 3378 3233 3080 2919 2750 2573 2387 2388 2195 1785 1568 1343 1109  869  620  363   98
 238  499  752  997 1234 1463 1684 1897 2102 2299 2488 2669 2842 3007 3164 3313 3454 3587 3712 3829 3938 4039 4132 4217 4294 4363 4424 4477 4522 4559 4561 4608 4609 4528 4591 4567 4593 4595 4594 4446 4447 4495 4170 4250 4251 4081 3985 3765 3645 3767 3379 3380 3083 3234 2920 2751 2574 2389 1994 1786 1787 1344 1111 1110  870  621  364   99
 237  498  751  996 1233 1462 1683 1896 2101 2298 2487 2668 2841 3006 3163 3312 3453 3586 3711 3828 3937 4038 4131 4216 4362 4423 4476 4521 4520 4558 4588 4587 4611 4620 4592 4612 4596 4570 4496 4571 4390 4391 4325 4389 4252 4171 3987 3880 3766 3516 3381 3236 3383 3081 2921 2752 2575 2390 2197 1995 1570 1569 1345 1112  871  622  365  100
 236  497  750  995 1232 1461 1682 1895 2100 2297 2486 2667 2840 3005 3162 3311 3452 3585 3710 3827 3936 4037 4130 4215 4293 4361 4422 4552 4519 4555 4557 4619 4607 4616 4610 4613 4622 4573 4568 4537 4497 4449 4326 4253 4083 4082 3986 3768 3770 3646 3517 3082 3084 3235 2922 2753 2576 2391 2198 1996 1788 1571 1346 1113  872  623  366  101
 235  496  749  994 1231 1460 1681 1894 2099 2296 2485 2666 2839 3004 3161 3310 3451 3584 3709 3826 3935 4036 4129 4214 4292 4290 4360 4421 4475 4420 4586 4606 4623 4603 4617 4615 4614 4392 4538 4572 4448 4329 4327 4254 4172 4085 3882 4084 3883 3647 3518 3519 3382 3086 3085 2577 2578 2393 1998 1997 1573 1789 1572 1114  873  624  367  102
 234  495  748  993 1230 1459 1680 1893 2098 2295 2484 2665 2838 3003 3160 3309 3450 3583 3708 3825 3934 4035 4128 4213 4291 4358 4359 4556 4554 4553 4585 4605 4618 4621 4601 4578 4598 4597 4539 4498 4452 4450 4328 4255 4174 3990 3769 3881 3650 3648 3649 3237 3238 2925 2755 2394 2756 2199 2392 1999 1790 1574 1347 1348  874  625  368  103
 233  494  747  992 1229 1458 1679 1892 2097 2294 2483 2664 2837 3002 3159 3308 3449 3582 3707 3824 3933 4034 4127 4212 4289 4472 4419 4474 4473 4584 4517 4581 4602 4600 4577 4599 4576 4541 4540 4500 4451 4393 4394 4256 3988 4175 4086 3771 3989 3521 3520 3239 2924 2926 2579 2757 2754 2395 2200 2201 2000 1349 1116 1115  875  626  369  104
 232  493  746  991 1228 1457 1678 1891 2096 2293 2482 2663 2836 3001 3158 3307 3448 3581 3706 3823 3932 4033 4126 4211 4288 4357 4417 4418 4471 4518 4583 4582 4604 4580 4579 4546 4575 4574 4542 4499 4396 4395 4330 4176 4087 4173 3885 3772 3884 3652 3385 3384 3240 3087 2581 2923 2397 2202 2580 1575 2002 1576 1351 1117  876  627  370  105
 231  492  745  990 1227 1456 1677 1890 2095 2292 2481 2662 2835 3000 3157 3306 3447 3580 3705 3822 3931 4032 4125 4210 4287 4356 4416 4470 4516 4513 4551 4550 4549 4548 4508 4547 4545 4544 4502 4501 4453 4397 4331 4177 4178 4088 3991 3886 3651 3653 3522 3386 3242 3241 3089 2927 2396 2204 2001 2003 2203 1791 1350 1118  877  628  371  106
 230  491  744  989 1226 1455 1676 1889 2094 2291 2480 2661 2834 2999 3156 3305 3446 3579 3704 3821 3930 4031 4124 4209 4286 4355 4469 4515 4467 4514 4512 4511 4510 4462 4509 4506 4507 4459 4543 4505 4503 4332 4258 4257 4179 4089 3992 3887 3773 3774 3523 3387 3243 3088 2928 2758 2582 2583 2205 1792 1794 1577 1119 1120  878  629  372  107
 229  490  743  988 1225 1454 1675 1888 2093 2290 2479 2660 2833 2998 3155 3304 3445 3578 3703 3820 3929 4030 4123 4208 4285 4354 4415 4468 4412 4466 4465 4464 4408 4463 4461 4405 4460 4458 4504 4456 4454 4398 4333 4260 4180 4090 3993 3888 3775 3654 3524 3525 3388 2929 2759 2760 2584 2398 2004 1795 1578 1352 1793 1121  879  373  109  374
 228  489  742  987 1224 1453 1674 1887 2092 2289 2478 2659 2832 2997 3154 3303 3444 3577 3702 3819 3928 4029 4122 4207 4284 4353 4414 4350 4413 4411 4410 4409 4345 4407 4406 4271 4403 4339 4457 4401 4455 4400 4334 4259 4261 4091 3994 3889 3776 3655 3526 3389 3244 3090 3091 2585 2762 2399 2005 1796 1579 1354 1353 1122  631  630  375  108
 227  488  741  986 1223 1452 1673 1886 2091 2288 2477 2658 2831 2996 3153 3302 3443 3576 3701 3818 3927 4028 4121 4206 4283 4352 4351 4349 4278 4347 4346 4344 4274 4273 4342 4341 4269 4404 4402 4337 4336 4399 4335 4262 4181 4092 3995 3890 3777 3656 3527 3390 3245 3093 3092 2931 2930 2400 2206 2006 1797 1580 1355  881  880  633  632  110
 226  487  740  985 1222 1451 1672 1885 2090 2287 2476 2657 2830 2995 3152 3301 3442 3575 3700 3817 3926 4027 4120 4205 4282 4281 4280 4279 4277 4348 4276 4275 4195 4194 4343 4340 4268 4190 4267 4338 4266 4265 4264 4263 4182 4093 3996 3891 3778 3657 3528 3391 3246 2932 2933 2761 2586 2401 2207 2007 1798 1581 1356 1123  882  634  376  111
 225  486  739  984 1221 1450 1671 1884 2089 2286 2475 2656 2829 2994 3151 3300 3441 3574 3699 3816 3925 4026 4119 4204 4203 4202 4201 4200 4199 4198 4197 4196 4193 4272 4191 4192 4104 4270 4189 4188 4187 4186 4185 4184 4183 4094 3997 3892 3779 3658 3529 3392 3248 3247 3094 2763 2587 2402 2208 2008 1799 1582 1357 1124  884  883  377  112
 224  485  738  983 1220 1449 1670 1883 2088 2285 2474 2655 2828 2993 3150 3299 3440 3573 3698 3815 3924 4025 4118 4117 4116 4115 4114 4113 4112 4111 4110 4109 4108 4107 4106 4105 4009 4007 4103 4101 4100 4099 4098 4097 4096 4095 3999 3998 3780 3659 3393 3531 3394 3095 2934 2764 2765 2588 2209 2210 1584 1801 1358 1125  885  378  379  113
 223  484  737  982 1219 1448 1669 1882 2087 2284 2473 2654 2827 2992 3149 3298 3439 3572 3697 3814 3923 4024 4023 4022 4021 4020 4019 4018 4017 4016 4015 4014 4013 4012 4011 4010 4008 4102 3904 4006 4005 4004 4003 4002 4001 4000 3785 3893 3781 3661 3530 3250 3395 3249 2935 2589 2404 2403 2011 2009 1583 1800 1359 1126  887  886  635  115
 222  483  736  981 1218 1447 1668 1881 2086 2283 2472 2653 2826 2991 3148 3297 3438 3571 3696 3813 3922 3921 3920 3919 3918 3917 3916 3915 3914 3913 3912 3911 3910 3909 3908 3907 3906 3905 3793 3903 3902 3901 3900 3899 3898 3897 3894 3782 3664 3097 3660 3533 3251 3096 2767 2766 2405 2406 2010 2211 1586 1587 1803 1360  888  636  114  380
 221  482  735  980 1217 1446 1667 1880 2085 2282 2471 2652 2825 2990 3147 3296 3437 3570 3695 3812 3811 3810 3809 3808 3807 3806 3805 3804 3803 3802 3801 3800 3799 3798 3797 3796 3795 3794 3674 3792 3791 3790 3789 3788 3787 3786 3784 3896 3895 3396 3535 3532 3397 2936 2937 2590 2768 2212 2213 2012 1802 1585 1127 1128  382  638  381  116
 220  481  734  979 1216 1445 1666 1879 2084 2281 2470 2651 2824 2989 3146 3295 3436 3569 3694 3693 3692 3691 3690 3689 3688 3687 3686 3685 3684 3683 3682 3681 3680 3679 3678 3677 3676 3675 3547 3673 3672 3671 3670 3669 3668 3667 3666 3783 3259 3537 3536 3663 3252 3100 3099 2938 2592 2591 2214 2013 1362 1361 1129 1363  889  383  637  119
 219  480  733  978 1215 1444 1665 1878 2083 2280 2469 2650 2823 2988 3145 3294 3435 3568 3567 3566 3565 3564 3563 3562 3561 3560 3559 3558 3557 3556 3555 3554 3553 3552 3551 3550 3549 3548 3546 3411 3545 3543 3542 3541 3406 3540 3539 3402 3665 3538 3254 3534 2939 3101 3098 2769 2593 2407 2014 1805 1807 1804 1130 1588  639  642  890  117
 218  479  732  977 1214 1443 1664 1877 2082 2279 2468 2649 2822 2987 3144 3293 3434 3433 3432 3431 3430 3429 3428 3427 3426 3425 3424 3423 3422 3421 3420 3419 3418 3417 3416 3415 3414 3413 3412 3410 3409 3544 3408 3264 3407 3261 3404 3401 3399 3662 3253 3398 3102 3255 2770 2771 2594 2215 2408 2216 2015 1589 1806 1365 1131  641  640  118
 217  478  731  976 1213 1442 1663 1876 2081 2278 2467 2648 2821 2986 3143 3292 3291 3290 3289 3288 3287 3286 3285 3284 3283 3282 3281 3280 3279 3278 3277 3276 3275 3274 3273 3272 3271 3270 3269 3268 3267 3266 3265 3113 3263 3405 3262 3403 3260 3257 3400 3256 2779 3104 2941 2773 2411 2772 2410 2219 2016 1591 1590  643  385  891  384  120
 216  477  730  975 1212 1441 1662 1875 2080 2277 2466 2647 2820 2985 3142 3141 3140 3139 3138 3137 3136 3135 3134 3133 3132 3131 3130 3129 3128 3127 3126 3125 3124 3123 3122 3121 3120 3119 3118 3117 3116 3115 2954 2953 2952 3111 3110 3107 3108 3258 3106 3105 2604 2943 2940 2774 2412 2409 2217 2218 1364 1808 1132  892 1367 1592  644  121
 215  476  729  974 1211 1440 1661 1874 2079 2276 2465 2646 2819 2984 2983 2982 2981 2980 2979 2978 2977 2976 2975 2974 2973 2972 2971 2970 2969 2968 2967 2966 2965 2964 2963 2962 2961 2960 2959 2791 2958 2956 2788 2955 2951 3112 2950 3109 2782 2949 2947 2946 3103 2942 2776 2596 2595 2220 2598 2597 2017 1366 2021 1809  123  387  386  122
 214  475  728  973 1210 1439 1660 1873 2078 2275 2464 2645 2818 2817 2816 2815 2814 2813 2812 2811 2810 2809 2808 2807 2806 2805 2804 2803 2802 2801 2800 2799 2798 2797 2796 2795 2794 2793 2792 2957 2789 2238 2427 3114 2787 2610 2784 2783 2607 2948 2780 2420 2945 2778 2600 2019 2599 2020 2025 2222 2018 1133 1369 1372  893  896  388  124
 213  474  727  972 1209 1438 1659 1872 2077 2274 2463 2644 2643 2642 2641 2640 2639 2638 2637 2636 2635 2634 2633 2632 2631 2630 2629 2628 2627 2626 2625 2624 2623 2622 2621 2620 2619 2618 2617 2616 2790 2429 2612 2786 2785 2236 2609 2608 2232 2781 2231 2601 2418 2602 2944 2224 2225 1384 2413 1368 1136 1810 1135  648  126  646  645  389
 212  473  726  971 1208 1437 1658 1871 2076 2273 2462 2461 2460 2459 2458 2457 2456 2455 2454 2453 2452 2451 2450 2449 2448 2447 2446 2445 2444 2443 2442 2441 2440 2439 2438 2437 2436 2435 2434 2433 2614 2613 2239 2611 2039 2235 2424 2234 2423 2422 2230 2603 2417 2416 2775 1820 2414 2415 1370 1597 1596 1594  894  899 1373  128  898  391
 211  472  725  970 1207 1436 1657 1870 2075 2272 2271 2270 2269 2268 2267 2266 2265 2264 2263 2262 2261 2260 2259 2258 2257 2256 2255 2254 2253 2252 2251 2250 2249 2248 2247 2246 2245 2244 2243 2242 2430 2615 2432 2237 2428 2036 2425 2034 2233 2032 2031 2421 2228 2606 2226 2227 2221 1811 1605 1812  895  647 1138 1134 1371 2023  897  127
 210  471  724  969 1206 1435 1656 1869 2074 2073 2072 2071 2070 2069 2068 2067 2066 2065 2064 2063 2062 2061 2060 2059 2058 2057 2056 2055 2054 2053 2052 2051 2050 2049 2048 2047 2046 2045 2042 1836 2431 2241 2041 2240 2037 2038 1829 2426 2033 1610 1825 2030 1386 2777 2026 1819 1595 1602 2223 1818 1814 1593 1140 1146 1137  393  652  390
 209  470  723  968 1205 1434 1655 1868 1867 1866 1865 1864 1863 1862 1861 1860 1859 1858 1857 1856 1855 1854 1853 1852 1851 1850 1849 1848 1847 1846 1845 1844 1843 1842 1841 1840 1839 1838 2044 1837 2043 1834 1620 2040 1832 1830 2035 1828 1611 1826 2605 2229 1607 1824 2419 1604 1821 1813 2024 1601 1598  659 1599 1600  649  135 1375  651
 208  469  722  967 1204 1433 1654 1653 1652 1651 1650 1649 1648 1647 1646 1645 1644 1643 1642 1641 1640 1639 1638 1637 1636 1635 1634 1633 1632 1631 1630 1629 1628 1627 1626 1625 1624 1623 1622 1621 1835 1619 1833 1163 1831 1616 1390 1614 1612 1827 1157 1608 1822 2029 1606 1153 1381 1816  907 1603 2022 1374 1142  906  392  125  394  900
 207  468  721  966 1203 1432 1431 1430 1429 1428 1427 1426 1425 1424 1423 1422 1421 1420 1419 1418 1417 1416 1415 1414 1413 1412 1411 1410 1409 1408 1407 1406 1405 1404 1403 1402 1401 1400 1399 1398 1397 1394 1618 1392 1617 1615 1162 1613 1155 1388  415 1380 1609 1823  916 2027  911  145  909 1378  143 1144 1141 1145 1143  650  129    0
 206  467  720  965 1202 1201 1200 1199 1198 1197 1196 1195 1194 1193 1192 1191 1190 1189 1188 1187 1186 1185 1184 1183 1182 1181 1180 1179 1178 1177 1176 1175 1174 1173 1172 1171 1170 1169 1168 1167 1166 1395 1164 1165 1393 1161  921 1154 1158  673  416  918  412 2028  914  665 1147  410 1150  908 1377  407  905 1139  902  132  396  395
 205  466  719  964  963  962  961  960  959  958  957  956  955  954  953  952  951  950  949  948  947  946  945  944  943  942  941  940  939  938  937  936  935  934  933  932  931  930  929  928  927 1396  925  924  923 1159 1160 1387 1391  670 1389  919 1385 1156  669 1152 1817 1151  910  144 1376  660  901  654  653  399  655  131
 204  465  718  717  716  715  714  713  712  711  710  709  708  707  706  705  704  703  702  701  700  699  698  697  696  695  694  693  692  691  690  689  688  687  686  685  684  683  682  681  679  926  678  677  676  922  675  672  674  418  417  917  667 1382  148 1379  912 1148 1149 1815  141  904  400  405  903  130  398  133
 203  464  463  462  461  460  459  458  457  456  455  454  453  452  451  450  449  448  447  446  445  444  443  442  441  440  439  438  437  436  435  434  433  432  431  430  429  428  427  426  680  425  423  422  420  158  419  671  920  154  152  414  668  411  666 1383  664  146  662  915  406  661  657  658  656  139  397  402
 202  201  200  199  198  197  196  195  194  193  192  191  190  189  188  187  186  185  184  183  182  181  180  179  178  177  176  175  174  173  172  171  170  169  168  167  166  165  164  163  162  424  161  160  159  421  157  156  155  153  150  151  413  663  149  408  409  147  913  138  142  404  140  403  401  137  136  134
