# This puzzle is unsolvable
18
260   1  64   4 130  76 182   6  71  74  11  81 190  10 138  18  79 193
129 177   3  65  70 179  77 135 137   9  14  12 141  84 142 189 195  21
 68 128 132  72  67  75 133 181 229  80 232 265  78 144  83 140  13  85
119  73 127 126 183 185 227 188   8 186 270 267  15  86  16  19  20  82
223 125  66 180   7 134 184 139 136 294 231 234 191  17 192 235  22  25
 69 221 283 219 123 131 285 258 317 187  24 268 236 240 145  88 196 194
  2 124 259   5 261 178 228 293 296 263 269 271 239  89 233 197 146 143
122 220 222 286 288 311 290 282 321 264 314 297 295 298  23  29 147  90
173 218 226 257 307 281  57 287 289 313 308 322 237 238 200 151  27  31
121 262 306 284 255 176 304 224 225 244 266 302 320 148  95 241  93  92
116 256 216 120  53 303 161 318 305 230 300 292 319  87 150 274  91  94
 62 252  60 213 291 246 249 316 156 278 210 309  35 312 272 154  26 159
175  61  63 172 251  54 301 310 254 250 279 273 299 199  96 149 160 275
 56 165 170 168 164 207 217 214 247 323 276  44 198  97 202  30  38 242
 55   0  52 115 174 117 253 110 162 209 203 103 102 157 152  36 208 155
118 113 171  59 108  58 163 106 158 105 204  33 153  99  32 205  41  39
 50 167 212 169  48  46 215 109 107 104  42  40  43 248 101  28  98 100
114  51 166  49 112  47  45 280 277 111 211  37 243 315 245  34 206 201
