# This puzzle is unsolvable
72
   2    1    3    4    5    6    7    8    9   10   11   12   13   14   15   16   17   18   19   20   21   22   23   24   25   26   27   28   29   30   31   32   33   34   35   36   37   38   39   40   41   42   43   44   45   46  331   47   49   50   51   52   54  337   56   57   58  341   59   60  344   61   62  346   65   63  350   68   69   70   71   72
 284  285  286  287  288  289  290  291  292  293  294  295  296  297  298  299  300  301  302  303  304  305  306  307  308  309  310  311  312  313  314  315  316  317  318  319  320  321  322  323  324  325  326  327  328  329   48  873  608  332  334  336   53  338   55  339  615 1140  343  618  619  345  347   64  623   66  349   67  352  353  354   73
 283  560  561  562  563  564  565  566  567  568  569  570  571  572  573  574  575  576  577  578  579  580  581  582  583  584  585  586  587  588  589  590  591  592  593  594  595  596  597  598  599  600  601  602  603  605  330  874  333 1133  609  610  611  878  613 1138  614  616  883  342  886  620  621  622  348  625  626  351  627  628  355   74
 282  559  828  829  830  831  832  833  834  835  836  837  838  839  840  841  842  843  844  845  846  847  848  849  850  851  852  853  854  855  856  857  858  859  860  861  862  863  864  865  866  867  868  869  604  872  607  875 1132 1135  335  877 1137  879  880  340  884 1143  617 1393  885  887  888  889  891  624  892  893  894  629  356   75
 281  558  827 1088 1089 1090 1091 1092 1093 1094 1095 1096 1097 1098 1099 1100 1101 1102 1103 1104 1105 1106 1107 1108 1109 1110 1111 1112 1113 1114 1115 1116 1117 1118 1119 1120 1121 1122 1123 1124 1125 1126 1378 1127  870 1130  606  871 1134  876 1131 1387  612 1389  882 1141 1636 1392 1142 1638 1144 1146 1147 1399  890 1150 1151 1152  895  630  357   76
 280  557  826 1087 1340 1341 1342 1343 1344 1345 1346 1347 1348 1349 1350 1351 1352 1353 1354 1355 1356 1357 1358 1359 1360 1361 1362 1363 1364 1365 1366 1367 1368 1369 1370 1371 1372 1373 1374 1375 1376 1377 1621 1379 1129 1381 1382 1383 1384 1628 1136 1386 1865 1631 1139  881 1633 1871 1395 1397 1639 1640 1398 1149 1148 1401 1402 1153  896  631  358   77
 279  556  825 1086 1339 1584 1585 1586 1587 1588 1589 1590 1591 1592 1593 1594 1595 1596 1597 1598 1599 1600 1601 1602 1603 1604 1605 1606 1607 1608 1609 1610 1611 1612 1613 1614 1615 1616 1617 1618 1619 1620 1622 1128 1380 1624 1625 1626 1627 1630 1385 1388 2094 2092 1868 1390 1632 1637 1394 1873 1145 1396 1641 1642 1400 1643 1403 1154  897  632  359   78
 278  555  824 1085 1338 1583 1820 1821 1822 1823 1824 1825 1826 1827 1828 1829 1830 1831 1832 1833 1834 1835 1836 1837 1838 1839 1840 1841 1842 1843 1844 1845 1846 1847 1848 1849 1850 1851 1852 1853 1854 1855 1856 1857 1623 1858 1860 1861 2089 1862 1863 2091 1867 1866 1391 1635 1869 1634 1872 1874 1875 1876 1877 1880 1645 1644 1404 1155  633  634  360   79
 277  554  823 1084 1337 1582 1819 2048 2049 2050 2051 2052 2053 2054 2055 2056 2057 2058 2059 2060 2061 2062 2063 2064 2065 2066 2067 2068 2069 2070 2071 2072 2073 2074 2075 2076 2077 2078 2079 2080 2081 2082 2083 2084 2085 1859 2086 2088 2308 2090 1629 2310 1864 2315 2095 1870 2097 2098 2099 2100 2101 2102 2104 2321 1878 1405  899 1406  898  361  362   80
 276  553  822 1083 1336 1581 1818 2047 2268 2269 2270 2271 2272 2273 2274 2275 2276 2277 2278 2279 2280 2281 2282 2283 2284 2285 2286 2287 2288 2289 2290 2291 2292 2293 2294 2295 2296 2297 2298 2299 2300 2301 2302 2303 2304 2306 2087 2518 2307 2309 2521 2311 2093 2313 2314 2096 2527 2316 2529 2318 2319 2320 2103 2106 1646 1879 1156 1158 1157  900  635   81
 275  552  821 1082 1335 1580 1817 2046 2267 2480 2481 2482 2483 2484 2485 2486 2487 2488 2489 2490 2491 2492 2493 2494 2495 2496 2497 2498 2499 2500 2501 2502 2503 2504 2505 2506 2507 2508 2509 2510 2511 2512 2513 2514 2515 2305 2517 2720 2519 2520 2724 2522 2312 2523 2923 2526 2317 2528 2927 2530 2531 2532 2105 2322 2108 1647 1648 1159 1407  902  636   82
 274  551  820 1081 1334 1579 1816 2045 2266 2479 2684 2685 2686 2687 2688 2689 2690 2691 2692 2693 2694 2890 2695 2696 2698 2699 2700 2701 2702 2704 2899 2705 2706 2707 2708 2709 2710 2711 2712 2713 2714 2715 2716 2717 2718 2516 2915 2719 2722 2723 2725 2920 2921 2726 2525 2727 2731 2732 2928 2929 2533 2735 2323 1881 1649 1650 1408  638  903  365  363   83
 273  550  819 1080 1333 1578 1815 2044 2265 2478 2683 2880 2881 2882 2883 2884 2885 2886 2887 2888 3076 2889 2891 2697 2893 2894 2895 2896 2897 2703 2900 2901 3088 2902 2903 2904 2905 2906 2907 2908 2909 2910 2912 2913 3101 2914 2721 2916 2917 2918 3286 2919 3106 3460 2729 2524 2733 2730 2924 3112 2734 2326 1882 2324 2107 1883 1160 1410  637  364   84  367
 272  549  818 1079 1332 1577 1814 2043 2264 2477 2682 2879 3068 3069 3070 3071 3072 3073 3074 3075 3077 3078 3258 2892 3080 3081 3082 3083 3084 2898 3086 3087 3089 3268 3090 3091 3092 3093 3094 3095 3096 3097 2911 3100 3279 3103 3283 3453 3104 3284 3285 3105 3456 3110 3291 2922 3290 2925 2537 2930 2535 2737 2736 2110 2327 1163 1409 1161  904  640  639  366
 271  548  817 1078 1331 1576 1813 2041 2042 2263 2476 2878 3067 3248 3249 3250 3251 3252 3253 3254 3255 3256 3257 3079 3259 3260 3261 3262 3263 3085 3437 3265 3267 3439 3269 3270 3271 3272 3273 3445 3274 3276 3098 3099 3450 3102 3282 3618 3454 3455 3774 3107 3108 3109 3111 3289 2728 3113 3114 3115 2112 2538 2325 2109 1885 1653 1412 1411  905  901   86   85
 270  547  816 1077 1330 1574 1575 2262 2261 2475 2681 2877 3066 3247 3420 3421 3422 3423 3424 3425 3426 3427 3429 3749 3430 3431 3432 3433 3434 3264 3436 3266 3601 3438 3440 3441 3442 3443 3444 3446 3608 3448 3278 3449 3614 3280 3281 3451 3617 3619 3921 3287 3288 3778 3622 3461 3462 2926 2931 3118 2534 3116 2738 1888 2111 1654 1651 1413 1162   88  641  368
 269  546  815 1076 1329 1573 1812 2040 2474 2680 2876 3065 3064 3246 3419 3584 3585 3587 3742 3588 3589 3591 3428 3592 3747 3748 3594 3596 3597 3435 3599 3755 3600 3602 3603 3604 3605 3606 3607 3609 3764 3610 3277 3766 3612 3613 3770 3615 3452 3775 3616 3776 3925 3624 3458 3465 3625 3463 3293 3292 2739 2330 2114 2539 1886 1884 1166 1164  906  642  372  369
 268  545  814 1075 1328 1572 1811 2039 2260 2473 2679 2875 3245 3417 3583 3740 3739 3586 3743 3744 3745 3590 3746 3894 3895 3593 3751 3595 3752 3598 3753 3902 3756 3757 3758 3759 3760 3761 3762 3275 3765 3447 3913 3611 3767 3769 3917 3771 3920 3772 3620 3923 3621 3777 3459 2536 3295 3117 3294 2932 2934 2541 2328 2329 1656 1655 1652 1165  907  908  643   89
 267  544  813 1074 1327 1810 2258 2038 2677 2676 2678 2874 2873 3418 3416 3581 3738 3741 3888 3890 3891 3892 3893 4033 4034 3896 3750 3899 4038 3901 4040 3754 3903 3904 3905 3906 3907 3908 3910 3763 3911 3912 3914 4184 3768 3916 4056 4058 4060 4190 3922 3457 3779 4062 3466 3464 3627 3296 3119 2741 2740 2933 2331 1887 2115 1657 1414 1167  909  370  645   87
 266  543 1073 1325 1326 1571 1809 1808 2256 2472 2872 3062 3063 3244 3580 3582 3737 3887 3889 4159 4029 4031 4032 4164 4165 4035 3898 3897 4169 3900 4171 4041 4043 4044 4175 4045 4046 4047 3909 4049 4050 4051 4052 4053 3915 4054 3918 4189 3919 4193 3780 4063 4061 3924 3781 3623 3626 3298 3120 2935 2542 2332 1890 2113 1891 1889 1415 1416  910  646   90  371
 265  810  812  811 1072 1570 2257 2259 2037 2471 2470 2675 3061 3242 3243 3578 3579 3886 4028 4160 4030 4161 4163 4288 4166 4036 4167 4037 4170 4039 4172 4295 4042 4174 4298 4176 4177 4178 4048 4180 4305 4182 4183 4055 4308 4187 4309 4188 4059 4057 3773 4312 4192 3928 3927 3628 3297 3467 3121 2936 2742 2743 2333 2540 2116 1658 1417 1168  911  647  644   91
 541  542  540 1071 1324 1569 1806 1807 2036 2673 2469 2674 2871 3241 3415 3414 3884 3736 4283 4027 4285 4162 4286 4287 4403 4289 4291 4168 4292 4293 4410 4297 4173 4519 4413 4299 4300 4301 4179 4303 4181 4304 4307 4421 4306 4424 4186 4313 4310 4316 4314 4066 3926 4191 3782 3629 3468 3299 3122 2937 2744 2543 2334 2117 1892 1659 1418 1169  912  374  373   92
 264  263  539 1070 1323 1568 1805 2255 2035 2672 2869 2870 3060 3412 3413 3885 3883 3882 4026 4158 4282 4284 4507 4401 4510 4404 4290 4406 4407 4408 4294 4409 4296 4617 4414 4415 4416 4523 4302 4417 4419 4420 4528 4531 4423 4530 4532 4425 4195 4428 4065 4067 4315 4064 3783 3630 3469 3300 3123 2938 2745 2544 2335 2118 1893 1660 1419 1170  913  648  375   93
 262  809  808 1069 1322 1803 2032 1567 2468 2033 2671 3058 3059 3240 3239 3576 3577 4025 3881 4024 4157 4400 4508 4402 4509 4512 4611 4513 4405 4515 4516 4411 4517 4412 4520 4521 4522 4524 4525 4418 4526 4527 4719 4628 4185 4529 4533 4311 4534 4429 4427 4317 4068 3929 3784 3631 3470 3301 3124 2939 2746 2545 2336 2119 1894 1661 1420 1171  914  649  376   94
 261  537  807 1068 1566 1565 2034 2253 2464 2467 3057 3056 2868 3238 3411 3410 3735 3734 4156 4281 4280 4399 4608 4609 4610 4511 4702 4514 4703 4615 4616 4518 4708 4618 4619 4620 4621 4622 4623 4624 4716 4625 4718 4422 4630 4631 4632 4535 4536 4430 4194 4320 4196 3931 3785 3632 3471 3302 3125 2940 2747 2546 2337 2120 1895 1662 1421 1172  915  650   96   95
 260  806  538 1067 1321 1802 1804 2252 2466 2463 2465 2866 2867 3236 3409 3575 3733 4021 4023 3880 4397 4398 4700 4606 4697 4860 4701 4612 4705 4614 4706 4707 4791 4709 4710 4711 4712 4713 4714 4798 4715 4717 4626 4627 4629 4720 4722 4634 4537 4426 4318 3930 4069 3932 3786 3633 3472 3303 3126 2941 2748 2547 2338 2121 1896 1663 1422 1173  916  651  377   97
 259  536  804 1066 1320 1564 1801 2031 2254 2251 2670 2669 3054 2865 3237 3573 3731 4022 4154 4278 4279 4396 4607 4784 4506 4698 4783 4862 4613 4704 4864 4789 4790 4792 4793 4794 4795 4796 4797 4873 4800 4802 4801 4803 4878 4721 4633 4635 4431 4432 4199 4197 4198 3933 3787 3634 3473 3304 3127 2942 2749 2548 2339 2122 1897 1664 1423 1174  917  652  378  379
 258  535 1065  805 1319 1563 1800 2030 2029 2250 2668 3055 3408 3574 3572 3730 3879 3732 4020 4155 4277 4505 4504 4395 4699 4605 4785 4787 4786 4788 4863 4865 4866 4867 4868 4869 4870 4871 4939 4872 4799 4875 4876 4944 4877 4804 4723 4724 4538 4539 4321 4319 4070 3788 3789 3635 3474 3305 3128 2943 2750 2549 2340 2123 1898 1665 1424 1175  918  653  380   98
 257  534  803 1064 1318 1562 1799 2028 2249 2462 2667 2864 3053 3407 3234 3571 3729 3878 4019 4153 4152 4394 4503 4603 4696 4782 4859 4928 4929 4930 4931 4932 4933 4934 4935 4936 4937 4938 4999 4940 4874 4942 4943 4945 4879 4805 4806 4636 4434 4433 4322 4200 4071 3790 3934 3636 3475 3306 3129 2944 2751 2550 2341 2124 1899 1666 1425 1176  919  654  381   99
 256  533  802 1316 1317 1798 1797 2027 2248 2461 2666 2863 3052 3235 3233 3406 3728 3877 4018 4151 4276 4393 4502 4695 4604 4781 4861 4927 4988 4989 4990 4991 4992 4993 4994 4995 4996 4997 4998 4941 5000 5001 5003 5002 4880 4807 4725 4638 4540 4435 4202 4072 4073 3935 3791 3637 3476 3307 3130 2945 2752 2551 2342 2125 1900 1667 1426 1177  655  382  101  100
 255  800 1062 1061 1561 1315 1560 2026 2247 2460 2665 2862 3051 3232 3405 3570 3727 3876 4017 4150 4275 4392 4501 4602 4780 4857 4858 4856 4926 5040 5041 5042 5043 5044 5045 5046 5047 5048 5049 5128 5050 5051 5052 4946 4881 4808 4637 4726 4542 4541 4436 4201 3936 3937 3638 3639 3477 3308 3131 2946 2753 2552 2343 2126 1901 1668 1427 1178  920  656  383  102
 254  801  532 1314 1063 1559 1796 2025 2246 2459 2664 2861 3050 3231 3404 3569 3726 3875 4016 4149 4274 4391 4499 4601 4694 4779 4925 4986 4987 5039 5084 5085 5086 5087 5088 5089 5090 5092 5093 5095 5005 5053 5004 4947 4882 4809 4727 4639 4324 4323 4437 4203 4074 3938 3792 3640 3478 3309 3132 2947 2754 2553 2344 2127 1902 1669 1428  923  921  922  104  384
 530  531  799 1060 1313 1558 1795 2024 2245 2458 2663 2860 3049 3230 3403 3568 3725 3874 4015 4148 4273 4390 4600 4500 4693 4778 4855 4924 4985 5038 5083 5120 5121 5122 5123 5124 5152 5091 5126 5129 5094 5096 4948 4949 4883 4810 4728 4640 4543 4438 4325 4205 3939 4075 3793 3641 3479 3310 3133 2948 2755 2554 2345 2128 1903 1429 1180  658 1179  657  385  103
 253  252 1058  798 1312 1557 1794 2023 2244 2457 2662 2859 3048 3229 3402 3567 3724 3873 4014 4147 4272 4389 4498 4599 4692 4777 4854 4923 4984 5037 5082 5119 5148 5149 5150 5151 5171 5125 5127 5055 5097 5054 5006 4951 4884 4730 4729 4642 4641 4544 4326 4204 4077 3941 3795 3794 3480 3311 3134 2949 2756 2555 2346 2129 1904 1670 1430 1181  924  659  386  105
 251  529  797 1059 1311 1556 1793 2022 2243 2456 2661 2858 3047 3228 3401 3566 3723 3872 4013 4146 4271 4388 4497 4598 4691 4776 4853 4922 4983 5036 5081 5118 5147 5168 5169 5170 5182 5154 5155 5130 5057 5007 5009 4885 4812 4811 4731 4440 4545 4328 4327 4076 4078 3940 3797 3642 3481 3312 3135 2950 2757 2556 2347 2130 1905 1671 1431 1182  925  660  387  106
 250  528  527 1057 1310 1555 1792 2021 2242 2455 2660 2857 3046 3227 3400 3565 3722 3871 4012 4145 4270 4387 4496 4597 4690 4775 4852 4921 4982 5035 5080 5117 5146 5167 5180 5181 5172 5153 5156 5131 5056 5058 4950 5008 4886 4813 4732 4643 4441 4439 4329 4206 4207 3796 3798 3482 3483 3313 3136 2951 2758 2557 2348 2131 1906 1672 1432 1183  926  661  388  107
 526  795  796 1056 1309 1554 1791 2020 2241 2454 2659 2856 3045 3226 3399 3564 3721 3870 4011 4144 4269 4386 4495 4596 4689 4774 4851 4920 4981 5034 5079 5116 5145 5166 5179 5183 5174 5173 5157 5132 5098 5099 4952 4887 4888 4814 4733 4546 4443 4547 4442 4209 4079 3943 3643 3644 3485 3314 3137 2952 2759 2558 2349 2132 1907 1673 1433 1184  927  662  389  108
 249  248  524 1055 1308 1553 1790 2019 2240 2453 2658 2855 3044 3225 3398 3563 3720 3869 4010 4143 4268 4385 4494 4595 4688 4773 4850 4919 4980 5033 5078 5115 5144 5165 5178 5177 5176 5175 5158 5133 5100 5059 5010 4953 4815 4734 4646 4644 4645 4208 4548 4331 4080 3799 3484 3645 3315 3139 3138 2953 2760 2559 2133 2134 1908 1674 1434 1185  928  663  390  109
 247  794  525 1054 1307 1552 1789 2018 2239 2452 2657 2854 3043 3224 3397 3562 3719 3868 4009 4142 4267 4384 4493 4594 4687 4772 4849 4918 4979 5032 5077 5114 5143 5164 5163 5162 5161 5160 5159 5134 5101 5060 5011 4954 4890 4889 4735 4648 4445 4549 4211 4330 3942 3944 3646 3800 3317 2955 3140 2954 2761 2560 2350 1909 1676 1675 1435 1186  929  664  391  110
 246  523  793  792 1306 1551 1788 2017 2238 2451 2656 2853 3042 3223 3396 3561 3718 3867 4008 4141 4266 4383 4492 4593 4686 4771 4848 4917 4978 5031 5076 5113 5142 5141 5140 5139 5138 5137 5136 5135 5102 5061 5012 4955 4816 4817 4736 4737 4551 4444 4332 4081 4210 3945 3488 3486 3648 3316 2762 2956 2561 2352 2351 2135 1910 1677 1436 1187  930  665  392  111
 245  522  791 1053 1052 1550 1787 2015 2016 2450 2655 2852 3041 3222 3395 3560 3717 3866 4007 4140 4265 4382 4491 4592 4685 4770 4847 4916 4977 5030 5075 5112 5111 5110 5109 5108 5107 5106 5105 5104 5103 5063 5062 5013 4956 4818 4647 4550 4446 4333 4212 4082 4083 3946 3649 3801 3647 3319 3318 2957 2763 2562 2353 2136 1911 1678 1437 1188  931  666  112  113
 244  521  790 1051 1305 1304 1549 1786 2237 2449 2654 2851 3040 3221 3394 3559 3716 3865 4006 4139 4264 4381 4490 4591 4769 4846 4768 4915 4976 5029 5074 5073 5072 5071 5070 5069 5068 5067 5066 5018 5065 5064 4892 4957 4891 4819 4739 4553 4552 4334 4335 4214 4213 4084 4085 3650 3487 3489 3141 2958 2764 2563 2354 2137 1912 1679 1438 1189  932  667  393  114
 243  520  789 1050 1303 1548 1785 2014 2236 2448 2653 2850 3039 3220 3393 3558 3715 3864 4005 4138 4263 4380 4489 4590 4684 4683 4845 4914 4975 5028 5027 5026 5025 5024 5023 5022 5021 5020 5019 5017 5016 4958 5015 5014 4821 4820 4650 4649 4447 4738 4215 4448 3947 3948 3652 3803 3320 3143 3142 2765 2766 2564 2355 2138 1913 1680 1439 1190  933  668  395  394
 242  519  788 1049 1302 1547 1784 2013 2235 2447 2652 2849 3038 3218 3219 3557 3714 3862 3863 4004 4262 4379 4488 4589 4682 4767 4844 4913 4974 4973 4972 4971 4970 4969 4968 4967 4966 4965 4964 4963 4962 4961 4960 4959 4893 4740 4651 4449 4554 4451 4337 3949 4087 3804 3802 3490 3323 3321 3144 2959 2767 2565 2356 2139 1914 1681 1191  396  934  398  397  115
 241  518  787 1048 1301 1546 1783 2233 2234 2232 2650 2651 2848 3037 3392 3391 3712 3713 4003 4002 4136 4261 4487 4588 4681 4766 4843 4912 4911 4910 4909 4908 4907 4906 4905 4904 4903 4902 4901 4900 4899 4827 4898 4897 4823 4894 4741 4555 4450 4086 4216 4218 4088 3950 3651 3492 3653 3324 3322 3145 2960 2566 2357 2140 1915 1682 1440  935  671  117  400  116
 240  517  786 1047 1046 1299 1300 2012 2446 2444 2445 2847 3036 3217 3390 3556 3555 3861 4001 4137 4260 4378 4486 4586 4587 4765 4842 4841 4840 4839 4838 4837 4836 4835 4834 4754 4833 4831 4830 4829 4828 4747 4826 4896 4825 4654 4653 4744 4336 4556 4339 4338 4217 3951 3806 3491 3493 3326 3146 2961 2768 2567 2358 2141 1916 1684 1192 1193 1442  672  669 1195
 239  516  784  785 1298 2009 1782 2231 2011 2230 2649 2846 3035 3216 3389 3554 3711 3860 4000 4135 4376 4377 4485 4680 4678 4679 4764 4762 4761 4760 4759 4671 4758 4756 4755 4667 4832 4753 4751 4663 4750 4749 4824 4746 4742 4657 4652 4557 4743 4453 4452 4093 4090 4089 3807 3805 3654 3655 3147 2962 2769 2568 2359 2142 1917 1685 1441  936  670  399  937  118
 238  515 1045 1544 1542 1543 1545 1781 2010 2443 2647 2845 3034 3215 3388 3553 3710 3859 4133 4134 4259 4374 4375 4484 4677 4582 4763 4675 4674 4673 4577 4672 4757 4669 4668 4572 4666 4752 4665 4568 4566 4748 4661 4660 4745 4659 4656 4655 4895 4340 3954 3955 4220 4219 3952 3953 3494 3148 2963 2964 2569 2771 2360 2143 1686 1918 1683 1444  939  402  119  401
 237  514 1044 1297 1296 1541 1779 1780 2229 2440 2442 2844 3033 3214 3387 3552 3709 3858 3999 4132 4258 4257 4483 4585 4584 4583 4580 4477 4579 4578 4474 4576 4670 4575 4573 4469 4571 4570 4664 4569 4662 4567 4565 4564 4658 4562 4822 4455 4558 4559 4343 3956 4091 4341 3809 3808 3810 3327 2965 3149 2770 2571 2361 2362 2570 1446 1443 1687  673 1197  938  120
 236  783  513 1043 1042 1778 1539 2008 2228 2648 2441 2843 3032 3213 3386 3551 3708 3857 3998 4131 4256 4373 4482 4481 4480 4676 4479 4581 4366 4364 4475 4473 4472 4574 4471 4470 4468 4357 4467 4465 4464 4463 4462 4460 4563 4459 4458 4561 4560 4227 4226 4094 4342 3957 3495 3656 3325 3150 3151 2774 2772 2572 2363 2144 1919 1196 1447 1445 1194  940  674  121
 235  512  782  781 1775 1540 2007 2006 2226 2227 2646 2842 3031 3212 3385 3550 3707 3856 3997 4130 4255 4372 4371 4370 4369 4368 4367 4478 4476 4244 4245 4362 4361 4360 4359 4358 4238 4356 4466 4354 4353 4352 4231 4461 4350 4349 4346 4099 4345 3822 4092 4454 3958 4344 3329 3812 3657 3496 3152 2966 2967 2773 2146 2145 1688 1920 1198  941  676  403  675  122
 234  511  780 1041 1295 1776 1777 2005 2439 2644 2645 2841 3030 3211 3384 3549 3706 3855 3996 4129 4254 4253 4252 4251 4250 4249 4365 4120 4247 4118 4363 4243 4242 4241 4240 4239 4236 4110 4355 4237 4234 4233 4351 4232 3968 4348 4228 3961 4096 4100 4457 4456 4095 4223 3658 3811 3500 3498 3328 2968 2573 2364 2366 2147 1689 1921 1448 1199  942  677  404  123
 233  510  779 1040 1294 1293 1537 2004 2225 2438 2643 2840 3029 3210 3383 3548 3705 3854 3995 4128 4127 4126 4125 4124 4123 4122 4121 4246 4248 4119 3982 4116 4115 4114 3977 4112 3976 4111 4109 4235 4107 4106 4105 4230 4103 4347 4229 4101 3959 4225 4221 4097 3662 4098 3660 3813 3497 3330 3153 2775 2777 2365 2149 1924 2148 1690 1449 1200  943  678  405  124
 232  509  778 1039 1292 1774 1538 2003 2224 2437 2642 2839 3028 3209 3382 3547 3704 3853 3994 3993 3992 3991 3990 3989 3988 3987 3986 3985 3984 4117 3839 3981 3980 3978 4113 3835 3833 3975 3974 4108 3972 3971 3970 3967 3516 4104 3825 4102 3964 3819 4224 4222 3963 3814 3816 3499 3659 3331 3154 2574 2969 2776 2575 2367 1922 1925 1450 1201  944  679  406  125
 231  508  777 1038 1291 1536 1773 2002 2223 2436 2641 2838 3027 3208 3381 3546 3703 3852 3851 3850 3849 3848 3847 3846 3845 3844 3843 3842 3841 3983 3840 3838 3837 3979 3685 3834 3682 3832 3831 3973 3828 3518 3675 3674 3969 3965 3514 3966 3820 3669 3818 3960 3665 3666 3667 3815 3502 3332 3155 2971 2970 2576 2151 1923 1691 1692 1451 1202  945  680  407  126
 230  507  776 1037 1290 1535 1772 2001 2222 2435 2640 2837 3026 3207 3380 3545 3702 3701 3700 3699 3698 3697 3696 3695 3694 3693 3692 3691 3690 3689 3688 3687 3686 3836 3525 3684 3683 3681 3680 3678 3830 3827 3829 3826 3677 3673 3671 3821 3962 3345 3169 3670 3507 3661 3817 3501 3503 3333 3156 2972 2778 2577 2150 2368 1926 1693 1452 1203  946  681  408  127
 229  506  775 1036 1289 1534 1771 2000 2221 2434 2639 2836 3025 3206 3379 3544 3543 3542 3541 3540 3539 3538 3537 3536 3535 3534 3533 3532 3531 3530 3529 3528 3527 3359 3526 3524 3522 3355 3352 3679 3353 3519 3676 3515 3824 3823 3346 3672 3513 3668 3509 3341 3505 3506 3664 3663 3336 3334 3157 2973 2779 2578 2369 2152 1927 1694 1453 1204  947  682  409  128
 228  505  774 1035 1288 1533 1770 1999 2220 2433 2638 2835 3024 3205 3378 3377 3376 3375 3374 3373 3372 3371 3370 3369 3368 3367 3366 3365 3364 3363 3362 3361 3360 3184 3358 3356 3523 3180 3176 3521 3354 3351 3350 3174 3349 3348    0 3343 2986 3342 3508 3166 3165 3340 3339 3504 3335 3159 3158 2974 2780 2580 2370 2153 1928 1695 1454 1205  948  683  410  129
 227  504  773 1034 1287 1532 1769 1998 2219 2432 2637 2834 3023 3204 3203 3202 3201 3200 3199 3198 3197 3196 3195 3194 3193 3192 3191 3190 3189 3188 3187 3186 3185 3183 3182 3357 3181 2996 2995 3179 3178 3177 3517 3173 2991 3172 3511 3347 2796 2984 3510 2792 2982 3164 3162 3338 3337 3161 3160 2975 2579 2781 2371 2154 1929 1696 1455 1206  949  684  411  130
 226  503  772 1033 1286 1531 1768 1997 2218 2431 2636 2833 3022 3021 3020 3019 3018 3017 3016 3015 3014 3013 3012 3011 3010 3009 3008 3007 3006 3005 3004 3003 3002 3001 3000 2999 2807 2998 2805 2994 2802 3175 3520 2992 2989 3170 3171 3512 2987 3344 2985 3168 2983 2981 3163 2979 2978 2976 2786 2784 2782 2372 2373 2155 1930 1697 1456 1207  950  685  412  131
 225  502  771 1032 1285 1530 1767 1996 2217 2430 2635 2832 2831 2830 2829 2828 2827 2826 2825 2824 2823 2822 2821 2820 2819 2818 2817 2816 2815 2814 2813 2812 2811 2810 2610 2809 2808 2806 2606 2804 2993 2803 2801 2600 2990 2988 2798 2797 2595 3167 2793 2594 2791 2790 2980 2789 2787 2788 2977 2785 2783 2581 2374 2156 1931 1698 1457 1208  951  686  413  132
 224  501  770 1031 1284 1529 1766 1995 2216 2429 2634 2633 2632 2631 2630 2629 2628 2627 2626 2625 2624 2623 2622 2621 2620 2619 2618 2617 2616 2615 2614 2613 2612 2611 2403 2608 2607 2185 2997 2398 2605 2603 2800 2601 2395 2799 2175 2391 2598 2794 2596 2171 2386 2591 2590 2589 2588 2587 2586 2585 2582 2376 2583 2157 1932 1699 1458 1209  952  687  414  133
 223  500  769 1030 1283 1528 1765 1994 2215 2428 2427 2426 2425 2424 2423 2422 2421 2420 2419 2418 2417 2416 2415 2414 2413 2412 2411 2410 2409 2408 2407 2406 2405 2189 2404 2609 2186 2401 2399 2397 2182 2604 1725 2178 2390 2599 2176 2389 2597 2388 2593 2387 2592 2384 2383 2382 2381 2380 2379 2378 2584 2377 2160 2158 1933 1700 1459 1210  953  688  415  134
 222  499  768 1029 1282 1527 1764 1993 2214 2213 2212 2211 2210 2209 2208 2207 2206 2205 2204 2203 2202 2201 2200 2199 2198 2197 2196 1972 2195 2194 2193 2192 2191 2190 2187 2402 1964 2184 2400 2183 1958 2181 2394 2396 2393 2795 2392 1952 2174 2173 1947 1949 2385 2169 2168 2167 2166 2165 2164 2163 2162 2375 1937 2159 1934 1701 1460 1211  954  689  416  135
 221  498  767 1028 1281 1526 1763 1992 1991 1990 1989 1988 1987 1986 1985 1984 1983 1982 1981 1980 1979 1978 1977 1976 1975 1974 1971 1970 1501 1739 1969 1968 1967 1966 2188 1965 1731 1962 1961 1960 1726 1959 1728 2177 1957 1954 1722 1953 1950 2172 1719 1948 2170 1946 1945 1944 1943 1942 1941 1940 1939 2161 1938 1936 1935 1702 1461 1212  955  690  417  136
 220  497  766 1027 1280 1525 1762 1761 1760 1759 1758 1757 1756 1755 1754 1753 1752 1751 1750 1749 1748 1747 1746 1745 1744 1743 1973 1741 1740 1500 1738 1737 1736 1735 1734 1732 1963 1492 1730 1729 1724 2179 2180 2602 1488 1485 1721 1720 1481 1951 1718 1717 1716 1715 1714 1713 1712 1711 1710 1709 1708 1707 1706 1705 1704 1703 1462 1213  956  691  418  137
 219  496  765 1026 1279 1524 1523 1522 1521 1520 1519 1518 1517 1516 1515 1514 1513 1512 1511 1510 1509 1508 1507 1506 1505 1504 1742 1502 1000 1254 1499 1498 1497 1496 1495 1733 1494 1246 1490 1244 1727 1487 1240 1955 1723 1956 1484 1483 1482 1480 1479 1478 1477 1476 1475 1474 1473 1472 1471 1470 1469 1468 1467 1466 1465 1464 1463 1214  957  692  419  138
 218  495  764 1025 1278 1277 1276 1275 1274 1273 1272 1271 1270 1269 1268 1267 1266 1265 1264 1263 1262 1261 1260 1259 1258 1257 1503  737 1256 1253 1252 1251 1250  994 1249 1247  991 1493 1491 1242  987 1489 1239 1486  983  981 1237  980 1234 1233 1232 1231 1230 1229 1228 1227 1226 1225 1224 1223 1222 1221 1220 1219 1218 1217 1216 1215  958  693  420  139
 217  494  763 1024 1023 1022 1021 1020 1019 1018 1017 1016 1015 1014 1013 1012 1011 1010 1009 1008 1007 1006 1005 1004 1003 1002 1001 1255  999  998  997  996  995 1248  993  992  728  988 1245 1243  724 1241  986  984  982  450 1236  979 1235  978  977  976  975  974  973  972  971  970  969  968  967  966  965  964  963  962  961  960  959  694  421  140
 216  493  762  761  760  759  758  757  756  755  754  753  752  751  750  749  748  747  746  745  744  743  742  741  740  739  738  736  464  465  734  733  732  731  730  458  990  989  726  725  723  722  985  449 1238  718  446  167  716  715  714  713  712  711  710  709  708  707  706  705  704  703  702  701  700  699  698  697  696  695  422  141
 215  492  491  490  489  488  487  486  485  484  483  482  481  480  479  478  477  476  475  474  473  472  471  470  469  189  468  466  735  185  463  462  461  460  459  456  729  457  455  454  453  452  451  721  719  720  447  445  717  444  443  442  441  440  439  438  437  436  435  434  433  432  431  430  429  428  427  426  425  424  423  142
 214  213  212  211  210  209  208  207  206  205  204  203  202  201  200  199  198  197  196  195  194  193  192  191  190  467  188  187  186  184  183  182  181  180  179  177  178  727  176  175  174  173  172  171  170  448  169  168  166  165  164  163  162  161  160  159  158  157  156  155  154  153  152  151  150  149  148  147  146  145  144  143
