# This puzzle is unsolvable
75
   2    1    3    4    5    6    7    8    9   10   11   12   13   14   15   16   17   18   19   20   21   22   23   24   25   26   27   28   29   30   31   32   33   34   35   36   37   38   39   40   41   42   43   44   45   46   47  907   48   51  633  347   52   55   54  349  350  352   59   61  357  355  644  358   65  647  362   68   69   70   71   72   73   74   75
 296  297  298  299  300  301  302  303  304  305  306  307  308  309  310  311  312  313  314  315  316  317  318  319  320  321  322  323  324  325  326  327  328  329  330  331  332  333  334  335  336  337  338  340  341  910  908  628   49  632  345  914  634   53  348  639   58 1189   57  353   63  356  645   64  361   66  363  650  365  652  366  367  368  369   76
 295  584  585  586  587  588  589  590  591  592  593  594  595  596  597  598  599  600  601  602  603  604  605  606  607  608  609  610  611  612  613  614  615  616  617  618  619  620  621  622  623  624  625  339  626  342  629 1698  631   50  913  346  637  635  636   56  918  919  920  922   62  359  646  360 1197  648   67  651  364  931  653  654  655  370   77
 294  583  864  865  866  867  868  869  870  871  872  873  874  875  876  877  878  879  880  881  882  883  884  885  886  887  888  889  890  891  892  893  894  895  896  897  898  899  900  901  902  903  904  905  627  906 1179  344  343 1445  911  912  915  351  638  640 1188  641  642  354  643  923  924  926  925 1196  649  929  930 1202  932  933  656  371   78
 293  582  863 1136 1137 1138 1139 1140 1141 1142 1143 1144 1145 1146 1147 1148 1149 1150 1151 1152 1153 1154 1155 1156 1157 1158 1159 1160 1161 1162 1163 1164 1165 1166 1167 1168 1169 1170 1171 1172 1173 1174 1175 1176 1177 1178 1180  909  630 1181 1182 1183 1184 1186 1187  916  917 1453  921 1192   60 1193 1195 1462 1460  928 1200 1463 1201 1205 1465  659  934  372   79
 292  581  862 1135 1400 1401 1402 1403 1404 1405 1406 1407 1408 1409 1410 1411 1412 1413 1414 1415 1416 1417 1418 1419 1420 1421 1422 1423 1424 1425 1426 1427 1428 1429 1430 1431 1432 1433 1434 1435 1436 1437 1438 1439 1440 1441 1442 1444 1443 1700 1447 1703 1185 1449 1706 1450 1190 1452 1456 1956 1455 1191 1194 1959  927 1198 1199 1718 1464 1466  658 1206  373  374   80
 291  580  861 1134 1399 1656 1657 1658 1659 1660 1661 1662 1663 1664 1665 1666 1667 1668 1669 1670 1671 1672 1673 1674 1675 1676 1677 1678 1679 1680 1681 1682 1683 1684 1685 1686 1687 1688 1689 1690 1691 1692 1693 1694 1695 1696 1697 1699 1946 1701 1446 1448 1704 1952 1451 1707 1954 2195 2426 1711 1459 1457 1714 1715 1461 1716 1717 1964 1719  935 1203  660  657  375   81
 290  579  860 1133 1398 1655 1904 1905 1906 1907 1908 1909 1910 1911 1912 1913 1914 1915 1916 1917 1918 1919 1920 1921 1922 1923 1924 1925 1926 1927 1928 1929 1930 1931 1932 1933 1934 1935 1936 1937 1938 1939 1940 1941 1942 1943 1944 1945 1947 1949 1702 1948 2190 1705 1951 1953 1709 1454 1708 1710 1958 1712 1962 2433 2202 1963 2203 1721 1722 1720 1467  936  937   82   83
 289  578  859 1132 1397 1654 1903 2144 2145 2146 2147 2148 2149 2150 2151 2152 2153 2154 2155 2156 2157 2158 2159 2160 2161 2162 2163 2164 2165 2166 2167 2168 2169 2170 2171 2172 2173 2174 2175 2176 2177 2178 2179 2180 2181 2182 2183 2184 2185 2187 2417 1950 2189 2420 2191 2192 2193 1955 2194 1957 2201 1960 2197 1458 2431 1961 1966 1965 1469 1468 1204  938  661  376   84
 288  577  858 1131 1396 1653 1902 2143 2376 2377 2378 2379 2380 2381 2382 2383 2384 2385 2386 2387 2388 2389 2390 2391 2392 2393 2394 2395 2396 2397 2398 2399 2400 2401 2402 2403 2404 2405 2406 2407 2408 2409 2410 2411 2412 2413 2414 2415 2416 2186 2418 2188 2643 2421 2423 2646 2424 2425 2651 2196 2429 2200 2869 1713 2652 2653 2432 1967 1470 1209 1207  939  662  377   85
 287  576  857 1130 1395 1652 1901 2142 2375 2600 2601 2602 2603 2604 2605 2606 2607 2608 2609 2610 2611 2612 2613 2614 2615 2616 2617 2618 2619 2620 2621 2622 2623 2624 2625 2626 2627 2628 2629 2630 2631 2632 2633 2634 2635 2636 2637 2638 2640 2641 2642 2419 2644 2859 2422 2862 2647 2864 2649 2865 2427 2199 2868 2430 2657 2870 2434 2204 1970 1723 1208  941  663  378   86
 286  575  856 1129 1394 1651 1900 2141 2374 2599 2816 2817 2818 2819 2820 2821 2822 2823 2824 2825 2826 2827 2828 2829 2830 2831 2832 2833 2834 2835 2836 2837 2838 2839 2840 2841 2842 2843 2844 2845 2846 2847 2848 2849 2850 2851 2852 2853 2639 2855 2856 2857 2858 2860 2645 2863 3270 2648 2650 3072 2428 3074 2866 2435 2654 2205 1968 1969 1724 1471  940 1210  664  379   87
 285  574  855 1128 1393 1650 1899 2140 2373 2598 2815 3024 3025 3026 3027 3028 3029 3030 3031 3032 3033 3034 3035 3036 3037 3038 3039 3040 3041 3042 3043 3044 3045 3046 3047 3048 3049 3050 3051 3052 3053 3054 3055 3056 3057 3058 3059 2854 3062 3453 3063 3262 3065 3068 3067 2861 3268 3069 3071 2198 2867 3273 3272 2872 2658 2656 2436 2206 1725 1472 1211  942  665  380   88
 284  573  854 1127 1392 1649 1898 2139 2372 2597 2814 3023 3224 3225 3226 3227 3228 3229 3230 3231 3232 3233 3234 3235 3236 3237 3238 3239 3240 3241 3242 3243 3244 3245 3246 3247 3248 3249 3250 3251 3252 3253 3254 3255 3256 3257 3259 3060 3061 3263 3064 3454 3456 3066 3457 3267 3070 3271 3073 3463 3277 3464 2655 2659 3075 2208 2207 1971 1726 1473 1212  943  666  381   89
 283  572  853 1126 1391 1648 1897 2138 2371 2596 2813 3022 3223 3416 3417 3418 3419 3420 3421 3422 3423 3424 3425 3426 3427 3428 3429 3430 3431 3432 3433 3434 3435 3436 3437 3438 3439 3440 3441 3442 3443 3444 3445 3447 3448 3449 3258 3451 3260 3261 3452 3811 3264 3266 3641 3817 3816 3459 3645 3462 3275 3646 2873 2660 2438 2209 1972 1973 1727 1474 1213  944  667  382   90
 282  571  852 1125 1390 1647 1896 2137 2370 2595 2812 3021 3222 3415 3600 3601 3602 3603 3604 3605 3606 3607 3608 3609 3610 3611 3612 3613 3614 3615 3616 3617 3618 3619 3620 3621 3622 3623 3624 3625 3626 3627 3628 3446 3630 3631 3632 3450 3633 3635 3636 3455 3265 3639 3640 3458 3984 3460 3269 3461 2871 3077 3076 3078 2661 2437 2211 2210 1728 1475 1214  945  668  383   91
 281  570  851 1124 1389 1646 1895 2136 2369 2594 2811 3020 3221 3414 3599 3776 3777 3778 3779 3780 3781 3782 3783 3784 3785 3786 3787 3788 3789 3790 3791 3792 3793 3794 3795 3796 3797 3798 3799 3800 3801 3802 3803 3629 3805 3973 3806 3808 3809 3634 3637 3810 3638 3814 3983 3982 3642 3644 3818 3819 3821 3274 3079 2874 2439 2440 2212 1974 1729 1476 1215  946  669  384   92
 280  569  850 1123 1388 1645 1894 2135 2368 2593 2810 3019 3220 3413 3598 3775 3944 3945 3946 3947 3948 3949 3950 3951 3952 3953 3954 3955 3956 3957 3958 3959 3960 3961 3962 3963 3964 3965 3967 4126 3968 4128 3969 3804 3972 3807 3974 4134 3975 4136 3976 3979 3812 3981 4141 3815 4142 3643 3985 3465 3279 3080 2875 3081 2441 2442 2215 1975 1730 1477 1216  947  670  385   93
 279  568  849 1122 1387 1644 1893 2134 2367 2592 2809 3018 3219 3412 3597 3774 3943 4104 4105 4106 4107 4108 4109 4110 4111 4112 4113 4114 4115 4116 4117 4118 4119 4120 4121 4122 4123 4124 4125 3966 4279 4278 3971 3970 4131 4132 4284 4133 4135 4137 3977 3813 3980 4140 4290 4293 3986 3987 3280 3469 3820 3281 2881 3468 2662 2213 2443 1731 1979 1478 1217  948  671  386   94
 278  567  848 1121 1386 1643 1892 2133 2366 2591 2808 3017 3218 3411 3596 3773 3942 4103 4256 4257 4258 4259 4260 4261 4262 4263 4264 4265 4266 4267 4268 4269 4270 4271 4272 4274 4416 4275 4277 4420 4127 4129 4130 4281 4282 4283 4427 4285 4286 4431 3978 4289 4291 4292 4296 4144 4143 3466 3822 3649 3470 3467 3278 3082 2445 2446 2216 1978 1976 1480 1977  949  672  388  387
 277  566  847 1120 1385 1642 1891 2132 2365 2590 2807 3016 3217 3410 3595 3772 3941 4102 4255 4400 4401 4402 4403 4404 4405 4406 4407 4408 4409 4410 4411 4412 4413 4414 4415 4553 4417 4418 4419 4276 4421 4422 4423 4280 4424 4426 4562 4428 4430 4429 4287 4288 4567 4139 4433 4294 4145 3648 3989 3825 3652 3471 2665 3650 2666 3083 2214 2664 1481 1219 1218  950  673   95   96
 276  565  846 1119 1384 1641 2131 2130 2364 2589 2806 3015 3216 3409 3594 3771 3940 4101 4254 4399 4536 4537 4538 4539 4540 4541 4542 4543 4544 4545 4546 4547 4549 4675 4550 4678 4273 4679 4554 4555 4556 4557 4805 4425 4560 4563 4690 4691 4564 4566 4138 4692 4565 4432 4436 4434 4435 3988 3826 3827 3276 3284 2877 2876 2878 2663 2218 2444 1479 1732 1734 1220  951  674  389
 275  564  845 1118 1383 1640 1890 2129 2363 2588 2805 3014 3215 3408 3593 3770 3939 4100 4253 4398 4535 4664 4665 4666 4667 4668 4669 4670 4671 4672 4673 4674 4548 4676 4677 4798 4799 4551 4682 4800 4683 4684 4685 4558 4559 4561 4689 4922 4696 4693 4925 4568 4694 4569 4295 4147 4297 3990 3651 4148 3647 3823 3655 2217 2879 3086 3282 1737 1735 1482 1221  952  675  390   97
 274  563  844 1117 1382 1639 1889 2128 2362 2587 2804 3013 3214 3407 3592 3769 3938 4099 4252 4397 4534 4663 4784 4785 4786 4787 4788 4789 4790 4791 4792 4793 4794 4795 4796 4908 4680 4910 4681 4801 4802 4803 4804 4687 4807 4686 5117 4809 4810 5025 4811 4695 4697 4571 4437 4146 4149 4299 3653 3085 3283 2880 3084 3285 2447 2667 1981 1736 1980 1483 1222  953  676  391   98
 272  273  562  843 1116 1381 1638 1888 2361 2586 2803 3012 3213 3406 3591 3768 3937 4098 4251 4396 4533 4662 4783 4896 4897 4898 4899 4900 4901 4902 4903 4904 4905 4906 4907 4909 4797 4552 4911 4913 4914 4915 5018 4916 4917 4688 4808 4919 4920 4923 5027 4813 4300 4814 4439 4150 3654 4298 3993 3656 3087 1738 3089 2884 2669 1982 2449 1739 1733 1484 1223  954  677  392   99
 270  271  842 1115 1380 1637 1887 2127 2360 2585 2802 3011 3212 3405 3590 3767 3936 4097 4250 4395 4532 4661 4782 4895 5000 5001 5002 5003 5004 5005 5006 5007 5008 5009 5010 5011 5012 5013 5014 4912 5016 5017 5113 5019 4806 5021 4918 5023 4921 5024 4812 5026 4570 4443 4926 3474 4438 3994 3830 2882 3476 3472 3473 3286 2883 3088 2220 2222 1983 1485 1224  955  678  393  100
 561  841    0 1114 1379 1885 1886 2126 2359 2584 2801 3010 3211 3404 3589 3766 3935 4096 4249 4394 4531 4660 4781 4894 4999 5096 5097 5098 5099 5100 5101 5102 5103 5104 5105 5106 5107 5108 5110 5015 5111 5112 5200 5114 5020 5022 5116 5118 5119 4699 4924 4441 4440 4574 4575 4572 3992 3991 3828 3657 3824 3287 3288 2448 2219 2668 2223 1984 1740 1486 1225  956  679  394  101
 559  560  840 1113 1378 1636 1884 2125 2358 2583 2800 3009 3210 3403 3588 3765 3934 4095 4248 4393 4530 4659 4780 4893 4998 5095 5184 5185 5186 5187 5188 5189 5190 5191 5192 5193 5194 5195 5109 5196 5197 5279 5202 5281 5115 5203 5204 5205 5120 5028 4815 4700 4698 4703 4702 4701 4151 3829 3998 3997 3475 3831 3658 2671 3092 2672 2670 2673 2221 1226  957  680  681  395  102
 269  558  838 1112 1634 1635 1883 2124 2357 2582 2799 3008 3209 3402 3587 3764 3933 4094 4247 4392 4529 4658 4779 4892 4997 5094 5183 5264 5265 5266 5267 5268 5269 5270 5271 5272 5273 5274 5275 5276 5278 5198 5199 5280 5352 5282 5283 5206 5121 4928 4927 4816 4818 4303 4576 4153 4442 3832 4152 3659 3478 3477 3090 2450 1986 2452 1741 2224 1487 1489 1227  958  682  396  103
 268  839  837 1111 1377 1633 1882 2123 2356 2581 2798 3007 3208 3401 3586 3763 3932 4093 4246 4391 4528 4657 4778 4891 4996 5093 5182 5263 5336 5337 5338 5339 5340 5341 5342 5343 5344 5345 5346 5348 5277 5349 5350 5201 5415 5353 5284 5207 5122 5029 4444 4301 4573 4577 4302 4304 4154 3995 3996 3290 3833 2886 2887 2675 2453 2451 1985 1988 1742 1488 1228  959  683  104  105
 267  557  556 1110 1376 1375 1881 2122 2355 2580 2797 3006 3207 3400 3585 3762 3931 4092 4245 4390 4527 4656 4777 4890 4995 5092 5181 5262 5335 5400 5401 5402 5403 5404 5405 5406 5407 5408 5410 5347 5411 5412 5413 5351 5414 5355 5285 5208 5123 5030 4817 4821 4819 4820 4446 4445 4155 3660 3479 3661 3291 2889 2674 3091 2885 2226 1987 1744 1989 1490 1229  960  398  397  106
 266  555  836 1109 1374 1632 1879 2121 2354 2579 2796 3005 3206 3399 3584 3761 3930 4091 4244 4389 4526 4655 4776 4889 4994 5091 5180 5261 5334 5399 5456 5457 5458 5459 5460 5461 5462 5463 5409 5465 5466 5467 5468 5469 5354 5416 5286 5209 5124 5031 4929 4930 4705 4704 4447 4305 4156 3835 3834 3292 3094 3093 3095 3289 2888 2225 2457 1743 1745 1491 1230  961  684  399  107
 265  554  835 1108 1630 1880 1878 2120 2353 2578 2795 3004 3205 3398 3583 3760 3929 4090 4243 4388 4525 4654 4775 4888 4993 5090 5179 5260 5333 5398 5455 5504 5505 5506 5507 5508 5509 5510 5464 5511 5512 5553 5515 5470 5417 5356 5287 5210 5125 5032 4931 4822 4580 4578 4579 4306 4157 3999 4000 3662 3480 3293 2890 2456 2676 2227 2455 1990 1991 1492  963 1232  962  685  400
 264  553  834 1107 1373 1631 1628 2119 2352 2577 2794 3003 3204 3397 3582 3759 3928 4089 4242 4387 4524 4653 4774 4887 4992 5089 5178 5259 5332 5397 5454 5503 5544 5545 5546 5547 5548 5549 5550 5551 5514 5552 5516 5471 5418 5357 5288 5211 5126 5033 4932 4823 4706 4581 4448 4307 4158 4001 3836 3663 3481 3096 3097 2891 2679 2677 2678 2228 1747 1494 1231  686  401  108  109
 552  833 1106 1371 1629 1372 1877 2118 2351 2576 2793 3002 3203 3396 3581 3758 3927 4088 4241 4386 4523 4652 4773 4886 4991 5088 5177 5258 5331 5396 5453 5502 5543 5576 5577 5578 5579 5580 5581 5582 5554 5513 5517 5472 5419 5358 5289 5212 5127 5034 4933 4824 4707 4582 4449 4308 4159 4002 3837 3664 3482 3295 3294 2454 2892 2458 2229 1992 1233 1746 1493  964  687  402  110
 263  551  832 1105 1370 1627 1876 2117 2350 2575 2792 3001 3202 3395 3580 3757 3926 4087 4240 4385 4522 4651 4772 4885 4990 5087 5176 5257 5330 5395 5452 5501 5542 5575 5600 5601 5602 5603 5604 5605 5583 5555 5518 5473 5420 5359 5290 5213 5128 5035 4934 4825 4708 4583 4450 4309 4160 4003 3665 3839 3483 3485 3484 2893 2680 2459 2230 1993 1748 1495 1234  965  688  403  111
 262  550  831 1104 1369 1626 1875 2116 2349 2574 2791 3000 3201 3394 3579 3756 3925 4086 4239 4384 4521 4650 4771 4884 4989 5086 5175 5256 5329 5394 5451 5500 5541 5574 5599 5616 5617 5618 5606 5585 5584 5556 5519 5474 5421 5360 5291 5214 5129 5036 4935 4826 4709 4584 4451 4310 4161 4004 3838 3666 3486 3099 3098 2894 2681 2460 2231 1994 1749 1496 1235  966  689  404  112
 261  549  830 1103 1368 1625 1874 2115 2348 2573 2790 2999 3200 3393 3578 3755 3924 4085 4238 4383 4520 4649 4770 4883 4988 5085 5174 5255 5328 5393 5450 5499 5540 5573 5598 5615 5624 5620 5619 5607 5586 5557 5520 5475 5422 5361 5292 5215 5130 5037 4936 4827 4710 4585 4452 4311 4162 4005 3840 3667 3297 3296 3100 2895 2682 2461 2232 1995 1750 1497 1236  967  690  405  113
 260  548  829 1102 1367 1624 1873 2114 2347 2572 2789 2998 3199 3392 3577 3754 3923 4084 4237 4382 4519 4648 4769 4882 4987 5084 5173 5254 5327 5392 5449 5498 5539 5572 5597 5614 5623 5622 5621 5608 5587 5558 5521 5476 5423 5362 5293 5216 5131 5038 4937 4828 4711 4586 4453 4312 4163 4006 3841 3668 3487 3298 3101 2896 2683 2462 2233 1996 1751 1498 1237  968  691  407  406
 259  258  547 1101 1366 1623 1872 2113 2346 2571 2788 2997 3198 3391 3576 3753 3922 4083 4236 4381 4518 4647 4768 4881 4986 5083 5172 5253 5326 5391 5448 5497 5538 5571 5596 5613 5612 5611 5610 5609 5588 5559 5522 5477 5424 5363 5294 5217 5132 5039 4938 4829 4712 4587 4454 4313 4164 4007 3842 3669 3488 3299 3102 2897 2684 2463 2234 1997 1752 1499 1238  969  692  408  114
 257  827  828 1100 1365 1622 1871 2112 2345 2570 2787 2996 3197 3390 3575 3752 3921 4082 4235 4380 4517 4646 4767 4880 4985 5082 5171 5252 5325 5390 5447 5496 5537 5570 5595 5594 5593 5592 5591 5590 5589 5560 5523 5478 5425 5364 5295 5218 5133 5040 4939 4830 4713 4588 4455 4314 4165 4008 3843 3670 3489 3300 3103 2898 2685 2464 2235 1998 1753 1500 1239  970  693  115  116
 256  546  826 1099 1364 1621 1870 2111 2344 2569 2786 2995 3196 3389 3574 3751 3920 4081 4234 4379 4516 4645 4766 4879 4984 5081 5170 5251 5324 5389 5446 5495 5536 5569 5568 5567 5566 5565 5564 5563 5562 5561 5524 5479 5426 5365 5296 5219 5134 5041 4940 4831 4714 4589 4456 4315 4166 4009 3844 3671 3490 3301 3104 2899 2686 2465 2236 1999 1754 1501 1240  971  694  409  117
 255  545  544 1098 1363 1620 1869 2110 2343 2568 2785 2994 3195 3388 3573 3750 3919 4080 4233 4378 4515 4644 4765 4878 4983 5080 5169 5250 5323 5388 5445 5494 5535 5534 5533 5532 5531 5530 5529 5528 5527 5526 5525 5480 5427 5366 5297 5220 5135 5042 4941 4832 4715 4590 4457 4316 4167 4010 3845 3672 3491 3302 3105 2900 2687 2466 2237 2000 1755 1502 1241  972  696  695  410
 254  543  825 1097 1362 1619 1868 2109 2342 2567 2784 2993 3194 3387 3572 3749 3918 4079 4232 4377 4514 4643 4764 4877 4982 5079 5168 5249 5322 5387 5444 5493 5492 5491 5490 5489 5488 5487 5486 5485 5484 5483 5482 5481 5428 5367 5298 5221 5136 5043 4942 4833 4716 4591 4458 4317 4168 4011 3846 3673 3492 3303 3106 2901 2688 2467 2238 2001 1756 1503 1242  973  697  411  118
 253  542  824  823 1361 1618 1867 2108 2341 2566 2783 2992 3193 3386 3571 3748 3917 4078 4231 4376 4513 4642 4763 4876 4981 5078 5167 5248 5321 5386 5443 5442 5441 5440 5439 5438 5437 5436 5435 5434 5433 5432 5431 5430 5429 5368 5299 5222 5137 5044 4943 4834 4717 4592 4459 4318 4169 4012 3848 3847 3494 3493 3107 2902 2689 2468 2239 2002 1757 1504 1244 1243  974  412  119
 252  541 1095 1096 1360 1617 1866 2107 2340 2565 2782 2991 3192 3385 3570 3747 3916 4077 4230 4375 4512 4641 4762 4875 4980 5077 5166 5247 5320 5385 5384 5383 5382 5381 5380 5379 5378 5377 5376 5375 5374 5373 5372 5371 5370 5369 5300 5138 5045 5140 4944 4835 4597 4718 4460 4319 4170 4013 3849 3674 3675 3304 3108 2903 2690 2469 2240 2003 1758 1506 1505  975  698  413  120
 251  540  822 1094 1359 1616 1865 2106 2339 2564 2781 2990 3191 3384 3569 3746 3915 4076 4229 4374 4511 4640 4761 4874 4979 5076 5165 5246 5319 5318 5317 5316 5315 5314 5313 5312 5311 5310 5309 5308 5307 5306 5305 5304 5303 5302 5301 5223 5224 5046 4945 4719 4595 4593 4461 4321 4320 4014 3850 3676 3495 3307 3305 3306 2904 2470 2241 2005 2004 1759 1245  976  699  414  121
 250  819  821 1093 1358 1615 1864 2105 2338 2563 2780 2989 3190 3383 3568 3745 3914 4075 4228 4373 4510 4639 4760 4873 4978 5075 5164 5245 5244 5243 5242 5241 5240 5239 5238 5237 5236 5235 5151 5234 5233 5231 5230 5229 5228 5227 5226 5225 5047 4947 5139 5049 4594 4837 4596 4462 4322 4171 3851 3677 3496 3109 3111 3110 2691 2471 2243 2242 1760 1507 1246  977  700  415  122
 538  820  539 1092 1357 1614 1863 2104 2337 2562 2779 2988 3189 3382 3567 3744 3913 4074 4227 4372 4509 4638 4759 4872 4977 5074 5163 5162 5161 5160 5159 5158 5157 5156 5155 5154 5153 5152 5060 5150 5232 5149 5148 5147 5145 5144 5143 5050 4950 5141 4720 4838 5048 4946 4721 4463 4172 4015 3678 3499 3498 3679 2906 2905 2692 2473 2472 2006 1761 1508 1247  978  701  416  123
 817  248  537  818 1356 1613 1862 2103 2336 2561 2778 2987 3188 3381 3566 3743 3912 4073 4226 4371 4508 4637 4758 4871 4976 5073 5072 5071 5070 5069 5068 5067 5066 5065 5064 5063 5062 5061 4961 5059 5058 5057 5056 5146 5054 4954 5053 5142 5051 4836 4840 4948 4839 4723 4464 4173 4017 4016 3853 3852 3680 3308 3309 2907 2908 2694 2245 2007 1762 1509 1248  979  702  417  124
 249  536 1354 1091  816 1612 2101 1861 2335 2560 2777 2986 3187 3380 3565 3742 3911 4072 4225 4370 4507 4636 4757 4870 4975 4974 4973 4972 4971 4970 4969 4968 4967 4966 4965 4964 4963 4962 4854 4960 4959 4958 4957 5055 4955 4847 5052 4953 4952 4951 4949 4725 4722 4465 4724 4324 4174 4176 4018 3497 3681 3500 3112 2695 2693 2244 2474 2008 1763 1510 1249  980  703  418  125
 247  246  535 1355 1090 1860 1610 2102 2334 2559 2776 2985 3186 3379 3564 3741 3910 4071 4224 4369 4506 4635 4756 4869 4868 4867 4866 4865 4864 4863 4862 4861 4860 4859 4858 4857 4856 4855 4739 4853 4852 4850 4734 4956 4849 4733 4609 4845 4844 4843 4842 4841 4598 4467 4466 4323 4325 4175 3854 3311 3310 3113 3114 2909 2696 2475 2246 2009 1764 1511 1250  981  704  419  126
 245  534  815 1089 1088 1352 1859 2100 2333 2558 2775 2984 3185 3378 3563 3740 3909 4070 4223 4368 4505 4634 4755 4754 4753 4752 4751 4750 4749 4748 4747 4746 4745 4744 4743 4742 4741 4740 4738 4737 4614 4851 4736 4479 4846 4848 4731 4730 4729 4727 4602 4604 4600 4726 4177 4021 4019 4020 3855 3682 3501 3312 3115 2910 2697 2476 2247 2010 1765 1512 1251  982  705  420  127
 244  533  813  814 1087 1353 1609 2099 2332 2557 2774 2983 3184 3377 3562 3739 3908 4069 4222 4367 4504 4633 4632 4631 4630 4498 4629 4627 4626 4625 4624 4623 4622 4621 4620 4619 4618 4617 4616 4615 4482 4613 4612 4342 4476 4339 4477 4607 4606 4471 4728 4334 4601 4599 4468 4326 4178 4022 3857 3856 3502 3313 3116 2911 2698 2477 2248 2011 1766 1513 1252  983  706  421  128
 532  811 1086 1085 1351 1611 1858 2098 2331 2556 2773 2982 3183 3376 3561 3738 3907 4068 4221 4366 4503 4363 4502 4500 4499 4359 4628 4497 4496 4494 4493 4492 4491 4490 4489 4488 4486 4485 4484 4483 4481 4735 4480 4611 4610 4608 4338 4732 4475 4336 4605 4470 4472 4184 4469 4327 4328 4180 4179 3683 3503 3314 3117 2912 2699 2478 2249 2012 1767 1514 1253  984  707  422  129
 241  243 1084  812 1606 1350 1856 2097 2330 2555 2772 2981 3182 3375 3560 3737 3906 4067 4220 4365 4364 4501 4215 4362 4360 4212 4358 4357 4495 4356 4354 4353 4352 4351 4350 4349 4487 4348 4347 4345 4344 4343 4340 4341 4478 4191 4190 4036 4189 4473 4333 4332 4603 4331 4330 4329 4181 4023 3858 3684 3504 3315 3118 2913 2700 2479 2250 2013 1768 1515 1254  985  708  423  130
 242  531 1349  810 1348 1608 1857 2096 2329 2554 2771 2980 3181 3374 3559 3736 3905 4066 4219 4218 4217 4216 4060 4361 4214 4213 4211 3891 4210 4209 4355 4206 4205 4204 4203 4202 4201 4200 4346 4199 4198 4196 4195 4039 4194 4192 4193 4474 4337 4335 4188 4187 4186 4185 4183 4182 4026 4024 3686 3685 3505 3316 3119 2914 2701 2480 2251 2014 1769 1516 1255  986  709  424  131
 240  530 1347 1346  809 1607 1854 2095 2094 2553 2770 2979 3180 3373 3558 3735 3904 4065 4064 4063 4062 4061 3897 4059 4058 4057 4056 3894 4055 4207 4208 4051 4050 4049 4048 4047 4046 4045 4044 4043 4197 4041 4040 3876 4038 4037 4035 3872 4034 4033 4032 4031 4030 4029 4028 4027 3863 3860 3859 3687 3506 3317 3120 2915 2702 2481 2252 2015 1770 1517 1256  987  710  425  132
 239  528 1083  529 1855 1602 1604 1605 2328 2552 2769 2978 3179 3372 3556 3557 3903 3901 3730 3900 3899 3898 3726 3896 3895 3721 3892 4054 3890 4052 3889 3888 3887 3886 3885 3884 3883 3882 3881 3880 4042 3878 3877 3875 3874 3873 3701 3702 3871 3870 3869 3868 3867 3866 3865 3864 3862 4025 3861 3688 3507 3318 3121 2916 2703 2482 2253 2016 1771 1518 1257  988  711  426  133
 238  527  808 1082 1345 1853 1852 2093 2327 2551 2768 2977 3178 3371 3733 3555 3732 3364 3902 3550 3728 3727 3725 3546 3723 3893 3720 3542 4053 3718 3717 3716 3537 3715 3714 3713 3712 3711 3710 3709 3879 3707 3706 3705 3704 3703 3522 3700 3521 3699 3698 3697 3696 3695 3694 3693 3692 3691 3690 3689 3508 3319 3122 2917 2704 2483 2254 2017 1772 1519 1258  989  712  427  134
 237  525  526 1081 1344 2324 1603 2325 2326 2550 2767 2976 3177 3370 3734 3554 3552 3365 3731 3551 3549 3548 3547 3545 3724 3544 3722 3354 3355 3719 3540 3539 3538 3536 3535 3534 3533 3532 3531 3530 3708 3528 3340 3527 3523 3524 3526 3336 3334 3520 3519 3518 3517 3516 3515 3514 3513 3512 3511 3510 3509 3320 3123 2918 2705 2484 2255 2018 1773 1520 1259  990  713  428  135
 236  806 1080  807 1079 1601 2092 2549 2323 2548 2766 2975 3176 3369 3368 3367 3553 3170 3729 3363 3362 3361 3360 3164 3358 3357 3543 3353 3541 3158 3352 3351 3350 3349 3348 3347 3346 3345 3344 3343 3529 3342 3145 3341 3339 3337 3140 3335 3333 3138 3332 3331 3330 3329 3328 3327 3326 3325 3324 3323 3322 3321 3124 2919 2706 2485 2256 2019 1774 1521 1260  991  714  429  136
 235  524  805 1078 1343 1600 2089 1850 2547 2765 2974 3175 2972 3174 3172 3171 3366 2967 3169 3168 2963 3167 3165 3162 3359 3161 3356 2956 3159 2955 3157 3156 3155 3154 3153 3152 3151 3150 3149 3148 3147 3146 3144 3143 3525 3338 3141 2507 3139 2935 3137 3136 3135 3134 3133 3132 3131 3130 3129 3128 3127 3126 3125 2920 2707 2486 2257 2020 1775 1522 1261  992  715  430  137
 234  523  804 1077 1342 1599 1851 2091 2090 1849 2546 2081 2973 2970 3173 2969 2968 2966 2755 2965 2964 3166 2962 2961 3163 2959 2958 3160 2957 2745 2954 2953 2952 2951 2950 2949 2948 2947 2946 2945 2944 2943 2942 2941 2940 2939 2726 2937 2938 2724 2934 2933 2932 2931 2930 2929 2928 2927 2926 2925 2924 2923 2922 2921 2708 2487 2258 2021 1776 1523 1262  993  716  431  138
 233  522  803 1076 1341 1598 1848 1847 2322 2763 2762 2764 2761 2971 2760 2759 2757 2756 2536 2754 2753 2752 2750 2749 2960 2748 2747 2746 2526 2743 2742 2741 2522 2740 2739 2738 2737 2736 2735 2734 2733 2732 2731 2730 2510 2729 3142 2281 2936 2505 2723 2722 2721 2720 2499 2719 2717 2716 2715 2714 2713 2712 2711 2710 2709 2488 2259 2022 1777 1524 1263  994  717  432  139
 232  521  802 1075 1340 1597 1845 2088 2321 2320 2543 2319 2314 2541 2539 2313 2538 2537 2535 2310 2534 2305 2751 2531 2530 2529 2528 2527 2744 2524 2298 2297 2523 2521 2520 2519 2518 2517 2516 2514 2287 2513 2512 2511 2283 2508 2727 2280 2725 2503 2042 2276 2502 2500 2273 2718 2498 2497 2496 2495 2494 2493 2492 2491 2490 2489 2260 2023 1778 1525 1264  995  718  433  140
 231  520  801 1074 1339 2085 1596 1846 1590 2544 2545 1837 2315 2316 2079 2758 2312 2076 2311 2072 2309 2532 2533 2304 2068 2302 2301 2300 2299 2525 2295 1569 2294 2059 2293 2292 2290 2055 2289 2515 1810 2286 2285 2284 2048 2728 2282 2504 2278 2044 2279 2277 2040 2038 2274 2272 2271 2270 2269 2268 2267 2266 2265 2264 2263 2262 2261 2024 1779 1526 1265  996  719  434  141
 230  519  799  800 1843 2084 1595 2087 2086 2083 2317 2080 1835 2540 2078 2542 2075 2074 2073 2307 1830 2306 2071 2303 2069 1824 2067 2065 2063 1571 1818 1568 2296 1304 2058 2057 2056 2291 2054 2288 2051 2050 1808 2049 2046 2047 2509 2045 2506 1800 2043 2275 1796 2041 2501 2037 2036 2035 2034 2033 2032 2031 2030 2029 2028 2027 2026 2025 1780 1527 1266  997  720  435  142
 229  518  517 1073 1337 1338 1594 1331 1842 2082 2318 1836 1585 1059 1834 1582 1832 1321 1831 1829 2308 1828 2070 1827 1826 1825 2066 1822 2064 1042 2061 1816 1041 1817 1815 1814 1813 1812 1811 1299 1559 2053 1809 1555 1806 1803 1552 1804 1802 1801 1799 1798 2039 1546 1795 1794 1793 1792 1791 1790 1789 1788 1787 1786 1785 1784 1783 1782 1781 1528 1267  998  721  436  143
 228  516 1072 1071 1844 1593 1592 1591 1840 1332 1839 1328 1838 1586 1325 1326 1584 1580 1579 1053 1320 1578 1576 1575 1574 1573 1823 1821 1570 1820 1819 1311 1308 2060 1564 1562 1303 1561 1560 1300 2052 1557 1807 1556 1805 1554 1292 1293 1550 1549 1548 1547 1286 1797 1544 1543 1542 1541 1540 1539 1538 1537 1536 1535 1534 1533 1532 1531 1530 1529 1268  999  722  437  144
 227  798  797 1070 1336 1333  508 1065  788 1589 1063 1062 1588 1060 1058 2077 1323 1833 1055 1052 1319 1577 1317 1316 1314 1047 1313 1572  769 1310 1309 1306 2062 1563 1566 1307 1037 1302 1301 1033 1298 1558 1297 1295 1294 1553 1026 1551 1291 1023 1290 1288 1287 1545 1285 1284 1283 1282 1281 1280 1279 1278 1277 1276 1275 1274 1273 1272 1271 1270 1269 1000  723  438  145
 225  226  795  794 1335 1334 1066 1330 1329 1841 1327 1587  502 1061  785 1583 1324  780 1322  778  495 1318 1049 1048 1315 1046 1045 1312  768 1044 1567  483 1040  766 1039  763 1036  760 1035 1034 1032 1030 1029 1296 1028  752 1027 1025 1024  748 1289 1021 1020 1019 1018 1017 1016 1015 1014 1013 1012 1011 1010 1009 1008 1007 1006 1005 1004 1003 1002 1001  724  439  146
 513  515  796 1069 1068  791 1067  216  790  786  214  503  501 1057  783  782 1581 1056  779  496 1051 1050  492  776  490  773  772  771  195  767  484 1043 1305  481  764 1038  762  761  759  758  757  473  756  471  754  753  468  749  466  174 1022  746  745  744  743  742  741  740  739  738  737  736  735  734  733  732  731  730  729  728  727  726  725  440  147
 512  224  222  793  510  220  792  789 1064  504  507  787  212  784  500  499  781  206  204  494  203  777  493  775  774  491  488  770  486  194  485 1565  191  482  480  479  478  477  476  475  474  182 1031  472  470  751  750  176  465  173  747  463  462  461  460  459  458  457  456  455  454  453  452  451  450  449  448  447  446  445  444  443  442  441  148
 223  221  514  219  511  218  509  217  505  215  506  213  211  210  209  208  207  498 1054  497  205  202  201  200  199  489  198  197  487  196  193  192  765  190  189  188  187  186  185  184  183  181  755  180  179  469  178  177  467  175  464  172  171  170  169  168  167  166  165  164  163  162  161  160  159  158  157  156  155  154  153  152  151  150  149
