# This puzzle is unsolvable
37
 145    1    2  147    3    5    6    7    8   10  155  154   13   14   15   16   17   18   19   20   22  165   23   24   25   26   27   28   29   30   31   32   33   34   35   36   37
 144  280  146    0    4  149  151  286    9   11   12  290  156  292  419  159  160  161  162  163   21  300  166  167  168  169  170  171  172  173  174  175  176  177  178  179   38
 143  281  408  282  148  411  150  287  414  152  288  289  537  293  158  294  295  296  297  298  164  301  302  429  303  304  305  306  307  308  309  310  311  312  313  180   39
 142  279  409  410  283  285  284  532  153  415  416  417  157  291  539  420  422  423  424  425  299  426  427  547  430  431  432  433  434  435  436  437  438  439  314  181   40
 278  277  407  528  529  530  412  533  413  535  646  536  418  648  538  421  541  542  543  544  545  546  548  550  661  549  551  552  553  554  555  556  557  440  315  182   41
 141  139  406  527  640  744  531  642  746  643  534  934  752  846  651  540  652  653  654  655  656  658  760  761  659  764  662  663  664  665  666  667  558  441  316  183   42
 138  140  405  526  639  745  641  644  748  749  647  753  750  649  754  848  755  756  757  758  759  657  855  856  763  660  765  766  767  768  769  668  559  442  184  185   43
 137  276  404  525  638  743  840  747  645  751  844  845  933  932  847  650  850  851  852  940  853  854  943  428  857  945  860  861  862  863  770  669  560  318  317  186   44
 275  274  403  524  637  636  841  842  929  843 1010  931 1012  935  936  849  937  939 1020 1019  941  942 1022  762  944  858  946  947  948  864  771  670  444  443  319  445   45
 135  136  402  523  839  741  742  928 1009  930 1083 1011 1013 1085 1084 1015 1016  938 1017 1018 1155 1093 1021 1023  859 1024 1026 1027  949  950  773  772  561  320  187   46   47
 272  134  521  522  635  739 1006  927 1081 1080 1144 1079 1203 1146 1014 1149 1148 1090 1088 1089 1092 1091 1211 1095 1158 1025 1097 1028  866  865  671  562  563  446  189  322  188
 273  271  398  738  925  634  837 1008  923 1142 1078 1082  836 1320 1145 1201 1086 1087 1153 1209 1210 1156 1157 1096 1159 1098 1099 1029  951  952  774  672  673  564  448  321   48
 133  400  737  270  838  835  924  736  926 1007 1200 1150 1077 1248 1202 1147 1151 1206 1152 1207 1154 1258 1296 1094 1213 1160 1030 1031  953  867  775  674  565  323  324  190   49
 269  132  633  520  834  631  922 1004  833  740 1005 1247 1143 1290 1289 1204 1291 1324 1348 1208 1255 1257 1297 1212 1259 1161 1101 1100  954  868  776  675  566  447  450   50   51
 130  268  517  401  396  832  921  735 1074 1003 1199 1076 1249 1288 1205 1250 1251 1252 1254 1292 1327 1298 1260 1261 1214 1162 1103 1032  955  869  777  676  567  325  449  192  191
 267  131  397  399  516  632  831 1141 1002 1000 1197 1075 1245 1287 1321 1323 1347 1253 1325 1256 1293 1216 1295 1299 1215 1262 1104 1102  956  870  778  677  568  452  451  193   52
 265  128  393  518  395  519  630  920 1138 1073 1194 1198 1319 1318 1344 1341 1345 1322 1362 1326 1329 1351 1302 1300 1106 1163 1034 1217  957  872  779  678  569  453  327  326   53
 129  394  513  514  629  734  919 1072 1242 1246 1139 1001 1136 1196 1343 1195 1359 1346 1368 1349 1350 1294 1263 1328 1038 1218 1164 1033 1035  871  958  781  679  570  196  194   54
 266  263  625  627  515  733  827  828  918 1070 1140 1134 1071 1317 1342 1285 1358 1360 1330 1365 1366 1363 1364 1219 1167 1036 1169 1165  960  873  780  874  571  328  195  329   55
 127  126  392  732  628  830  829  916 1137  996 1283  999 1244 1286 1340 1357 1316 1361 1367 1354 1301 1332 1331 1264 1220 1105 1168  962  959  783  681  680  682  454  330  331   56
 264  391  125  261  626  511  998 1135  917  914 1069 1193 1243 1284 1313 1282 1337 1356 1355 1336 1353 1303 1352 1265 1268 1166 1107  877  875  963  961  574  455  457  572  197   57
 390  124  262  512  731  824  726  913  994 1191 1190 1192 1241 1314 1278 1276 1338 1310 1272 1275 1335 1308 1221 1222 1170 1171 1040 1111 1039  787  786  879  683  456  198  200   58
 260  389  510  509  624  826  822  915 1067  995 1068 1131 1240 1234 1280 1315 1311 1121 1230 1334 1306 1333 1266 1304 1108 1175 1037 1172  964  782  784  575  573  333  199  332   61
 387  724  120  730  508  728  725 1066  997  912 1132 1239 1133 1281 1279 1229 1181 1231 1274 1273 1120 1271 1223 1270 1226 1267 1043 1224 1109  876  880  878  684  458  459   60   59
 123  122  622  385  388  729  993  910  992 1187 1189 1130 1188 1236 1235 1277 1312  981 1178 1309 1177 1307 1176 1174  973 1173 1112 1041  966  687  576  685  460  686  335  334  202
 118  121  258  620  619  825  623  911 1064 1065 1237 1128 1185 1057 1125 1339  982 1183 1233 1054 1051 1227 1228 1116 1110 1269 1225  965  881  691  577  785  578  461  336  201  203
 257  259  386  255  506  621  820  821  991 1063 1129 1186 1238 1123 1182 1124 1122  897 1180 1305 1118 1050 1049 1119  799 1117 1046 1042  882  968  789  788  689  579  338  204   62
 256  253  618  504  727  823  818  909  990  988  905 1060 1059 1127 1126 1184  901 1056  980 1179  894  976  979  889  975  971 1115 1044  967  883  790  580  688  337  205   64   63
 117  384  505  507  502  723  819  907  989 1062  906  811 1061  985  806  898  803 1232 1052 1053  893 1055  800  974  703  700 1114  970 1113  969  791  581  463  464  339   65  206
 116  381  119  254  503  494  722  817  815  721  716  904  984  986  899  900  983  808  702  895  804 1048  977  595  890  891 1047  888  972  884  794  692  468  465  340  462   66
 113  251  382  383  617  371  908  610  816  713  813  902  814  810  603  809  604  599  805  596  892   89  978  701  798  699  796  475  793  792  693  695  342  582  341   70  207
 377  115  247  614  616  379  496  501  719  903  605  366  608  365 1058  711  707  708  896  600  483  594  482  801  704  886  797  887  694 1045  583  690  467  469  466  209  208
 114  380  252  612  611  718  376  240  495  715  987  714  490  235  710  812  485  601  706  597  359  356  705  479  698  590  696  697  586  885  471  351   74  344   68  343   67
 250  112  104  500  249  613  244  609  717  369  367  368  234  491  489  486  709  802  362  228  598  226  480  357  591  795  589  352  592  584  587  348  470  346  210   69   73
 109  111  499  248  498  242  375  372  100  370  236  237   97   96  807  488  484  487  231   90  229  358   86  225   84  474  593  221  473  588  472  349   75   78   72  345   71
 108  497  246  243  720  615  105  241  239  102  238   95  492   94  363  602  364  232  481   91  355  354   87  224   83  476  219  220  218  350   81  215  216  217  585  347  211
 110  106  245  378  373  107  607  374  103  493  101   99   98  233  712  606   93  360  361   92  230  227   88  478   85  477  223  222   82   80  353   79   77   76  214  213  212
