# This puzzle is unsolvable
69
   2    1    3    4    5    6    7    8    9   10   11   12   13   14   15   16   17   18   19   20   21   22   23   24   25   26   27   28   29   30   31   32   33   34   35   36   37   38   39   40   41   42   43   44   45   46   47   48   49   50   51   52   53   54   55   56   57   58   59   60   61   62   63   64   65   66   67  339   68
 272  273  274  275  276  277  278  279  280  281  282  283  284  285  286  287  288  289  290  291  292  293  294  295  296  297  298  299  300  301  302  303  304  305  306  307  308  309  310  311  312  313  314  315  316  317  318  319  320  321  322  323  324  325  326  327  328  329  330  331  332  333  334  335  336  337  338   69   70
 271  536  537  538  539  540  541  542  543  544  545  546  547  548  549  550  551  552  553  554  555  556  557  558  559  560  561  562  563  564  565  566  567  568  569  570  571  572  573  574  575  576  577  578  579  580  581  582  583  584  585  586  587  588  589  590  591  592  593  594  595  596  597  598  599  854  601   71   72
 270  535  792  793  794  795  796  797  798  799  800  801  802  803  804  805  806  807  808  809  810  811  812  813  814  815  816  817  818  819  820  821  822  823  824  825  826  827  828  829  830  831  832  833  834  835  836  837  838  839  840  841  842  843  844  845  846  847  848  849  850  851  852 1100  856  853  340  342   73
 269  534  791 1040 1041 1042 1043 1044 1045 1046 1047 1048 1049 1050 1051 1052 1053 1054 1055 1056 1057 1058 1059 1060 1061 1062 1063 1064 1065 1066 1067 1068 1069 1070 1071 1072 1073 1074 1075 1076 1077 1078 1079 1080 1081 1082 1083 1084 1085 1086 1087 1088 1089 1090 1091 1092 1093 1094 1095 1096 1097 1098 1099 1101  600  855  603  602   74
 268  533  790 1039 1280 1281 1282 1283 1284 1285 1286 1287 1288 1289 1290 1291 1292 1293 1294 1295 1296 1297 1298 1299 1300 1301 1302 1303 1304 1305 1306 1307 1308 1309 1310 1311 1312 1313 1314 1315 1316 1317 1318 1319 1320 1321 1322 1323 1324 1325 1326 1327 1328 1330 1560 1331 1332 1333 1335 1565 1567 1568 1336  605 1339  606  344   75  346
 267  532  789 1038 1279 1512 1513 1514 1515 1516 1517 1518 1519 1520 1521 1522 1523 1524 1525 1526 1527 1528 1529 1530 1531 1532 1533 1534 1535 1536 1537 1538 1539 1540 1541 1542 1543 1544 1545 1546 1547 1548 1549 1550 1551 1552 1553 1554 1555 1556 1557 1996 1559 1329 1562 1784 1563 1564 1334 1566 1790 1337 1570  858  604  857  341  343   77
 266  531  788 1037 1278 1511 1736 1737 1738 1739 1740 1741 1742 1743 1744 1745 1746 1747 1748 1749 1750 1751 1752 1753 1754 1755 1756 1757 1758 1759 1760 1761 1762 1763 1764 1765 1766 1767 1768 1769 1770 1771 1772 1773 1774 1775 1776 1777 1778 1779 1780 1558 1782 1783 1561 1785 1786 1787 2003 1789 1569 1791 1795 1574 1102  859 1340   76   78
 265  530  787 1036 1277 1510 1735 1952 1953 1954 1955 1956 1957 1958 1959 1960 1961 1962 1963 1964 1965 1966 1967 1968 1969 1970 1971 1972 1973 1974 1975 1976 1977 1978 1979 1980 1981 1982 1983 1984 1985 1986 1987 1988 1989 1990 1991 1992 1993 1994 1995 1781 2203 1998 1999 2206 2000 2209 2002 2004 1788 1572 2006 1103  860 1104  345   80 1571
 264  529  786 1035 1276 1509 1734 1951 2160 2161 2162 2163 2164 2165 2166 2167 2168 2169 2170 2171 2172 2173 2174 2175 2176 2177 2178 2179 2180 2181 2182 2184 2383 2185 2186 2187 2188 2189 2190 2191 2192 2193 2194 2195 2196 2197 2198 2199 2200 2201 2202 2403 1997 2204 2205 2597 2001 2407 2210 2211 1792 1344 1338 1793 1341 2005  861 1108  610
 263  528  785 1034 1275 1508 1733 1950 2159 2360 2361 2362 2363 2364 2365 2366 2367 2368 2369 2370 2371 2372 2373 2374 2375 2376 2377 2378 2379 2380 2382 2573 2183 2384 2385 2386 2387 2388 2389 2390 2391 2392 2393 2394 2395 2396 2397 2589 2398 2399 2591 2400 2777 2402 2595 2780 2406 2409 2214 2007 2213 1794 1343 1573 1105  862  609   79  347
 262  527  784 1033 1274 1507 1732 1949 2158 2359 2552 2553 2554 2555 2556 2557 2558 2559 2560 2561 2562 2563 2564 2565 2566 2567 2568 2570 2753 2571 2381 2574 2575 2576 2577 2578 2761 2579 2580 2581 3107 2766 2584 2585 2586 2587 2588 2590 2773 2774 2594 2404 2593 2596 2207 2405 2599 2598 2208 2212 1797 1345 1346 1342  611 1106  348  608   82
 261  526  783 1032 1273 1506 1731 1948 2157 2358 2551 2736 2737 2738 2739 2740 2741 2742 2743 2744 2745 2746 2747 2748 2749 2750 2751 2569 2754 2755 2572 2756 2757 2758 2759 2760 2762 2937 2763 2938 2764 2582 2767 2944 2768 2770 2771 2772 2775 3117 2592 2401 2952 2778 2955 2779 2410 2603 2408 2010 2215 2011 1347   83  612  351 1110  863  349
 260  525  782 1031 1272 1505 1730 1947 2156 2357 2550 2735 2912 2913 2914 2915 2916 2917 2918 2919 2920 2921 2922 2923 2924 2926 2927 2752 2928 2929 2930 2931 2932 2933 2934 2935 3103 3104 2936 3106 2765 2583 2940 2769 3111 2945 2946 2947 3116 2948 2949 3118 2953 3119 3120 2601 2781 2602 2412 2008 1575 1111 1580 2216 1798  352 1350   81  607
 259  524  781 1030 1271 1504 1729 1946 2155 2356 2549 2734 2911 3080 3081 3082 3083 3084 3085 3086 3087 3088 3089 3090 3092 2925 3093 3094 3095 3096 3097 3098 3099 3100 3101 3102 3262 3105 2939 3415 3268 2942 3108 3110 3271 2943 3113 3114 2951 3277 3570 2950 3278 3124 2957 2782 2783 2411 2600 2009 2413 1577  864 1576  866 1107 1112   85  613
 258  523  780 1029 1270 1503 1728 1945 2154 2355 2548 2733 2910 3079 3240 3241 3242 3243 3244 3245 3246 3247 3248 3249 3091 3251 3252 3253 3254 3255 3256 3257 3258 3259 3260 3261 3263 3264 3416 3417 2941 3266 3269 3420 3270 3112 3272 3274 3115 3276 3426 3427 2776 3121 3122 2956 2785 2784 2217 2218 1801 1796 1352 1349  865  350  355 1113  354
 257  522  779 1028 1269 1502 1727 1944 2153 2354 2547 2732 2909 3078 3239 3392 3393 3537 3394 3396 3397 3398 3399 3400 3250 3402 3403 3404 3405 3406 3407 3408 3409 3410 3411 3413 3412 3414 3265 3559 3418 3267 3109 3421 3564 3423 3702 3273 3425 3275 3428 3123 2954 3429 2958 2415 2787 3279 2414 1578 1799 2013 1348  870  867 1109  615  616   84
 256  521  778 1027 1268 1501 1726 1943 2152 2353 2546 2731 2908 3077 3238 3389 3390 3536 3395 3538 3540 3541 3543 3544 3401 3679 3546 3547 3548 3549 3550 3551 3552 3553 3554 3556 3555 3557 3558 3560 3695 3562 3419 3824 3699 3422 3566 3424 3568 3705 3569 3832 3282 3280 2959 3281 2786 2605 2219 2417 2015 1114 1354 2012  869  614  868   87   86
 255  520  777 1026 1267 1500 1725 1942 2151 2352 2545 2730 2907 3076 3237 3534 3391 3672 3673 3539 3675 3676 3542 3678 3680 3545 3682 3809 3683 3684 3685 3686 3687 3688 3689 3690 3691 3692 3820 3693 3696 3561 3698 3563 3700 3565 3828 3567 3703 3831 3571 3431 3430 2960 2961 3125 2606 2420 2604 2014 1579 1804 2416  872  353 1116  617   88  357
 254  519  776 1025 1266 1499 1724 1941 2150 2351 2544 2729 2906 3075 3236 3388 3535 3671 3800 3674 3803 3804 3677 3805 3807 3681 3927 3808 3810 3811 3812 3813 3814 3815 3816 3817 3818 3819 3694 3821 3823 3697 3943 3825 3826 3701 3827 3829 3704 3707 3283 3572 3573 2963 3285 2788 2964 2607 2016 2220 1803 1805 1802 1582 1115  871 1355  356   89
 253  518  775 1024 1265 1498 1723 1940 2149 2350 2543 2728 2905 3074 3235 3387 3533 3919 3801 3921 3802 3922 3923 3924 3806 3925 3926 3928 3929 3930 3931 3932 3933 3934 3935 3936 3937 4049 3938 4052 3822 3941 3942 3944 3945 3946 3947 3948 3830 3706 3709 3574 3284 3129 3127 2791 2418 2789 2221 2017 1581 1800 1351 1583 1117  619  618  358   90
 252  517  774 1023 1264 1497 1722 1939 2148 2349 2542 2727 2904 3073 3234 3532 3669 3799 3798 3920 4032 4033 4034 4035 4036 4037 4038 4039 4040 4041 4042 4043 4044 4045 4046 4047 4151 4048 3939 3940 4155 4053 4054 4055 4056 4057 4058 4059 3949 3708 3575 3432 3434 3126 2790 2419 2610 2792 2421 2608 2019 2223 1584 1353 1118  874  621  620   91
 251  516  773 1022 1263 1496 1721 1938 2147 2348 2541 2726 2903 3072 3233 3531 3668 3670 3797 3918 4031 4136 4137 4138 4139 4140 4141 4142 4143 4144 4145 4146 4147 4148 4149 4150 4152 4247 4249 4051 4154 4156 4157 4158 4159 4160 4161 4060 3950 3951 3833 3576 3436 3435 3433 2422 2612 2224 2020 1806 2018 2609 1587 1356  873 1119  622  360   92
 250  515  772 1021 1262 1495 1720 1937 2146 2347 2540 2725 2902 3071 3232 3386 3530 3385 3667 3917 4030 4135 4232 4233 4234 4235 4236 4237 4238 4239 4240 4241 4242 4243 4244 4245 4246 4248 4153 4050 4250 4251 4252 4253 4254 4255 4162 4061 3952 3834 3710 3577 3286 3288 3131 2965 2611 2962 2225 2021 2222 1807 1585 1586 1121  877 1357  361   93
 248  249  514 1020 1494 1493 1719 1936 2145 2346 2539 2724 2901 3070 3231 3384 3383 3666 3796 3916 4029 4134 4231 4320 4321 4322 4323 4324 4325 4326 4327 4328 4329 4330 4331 4332 4333 4334 4335 4336 4337 4338 4339 4340 4341 4256 4163 4062 3953 3835 3712 3711 3438 3130 3579 3287 2966 2615 2227 2022 1588 1810 2226 1808 1359 1358  875  359  876
 247  513  771 1019 1261 1717 1934 1492 1935 2144 2538 2723 2900 3069 3230 3382 3528 3794 3795 3915 4028 4133 4230 4400 4401 4402 4473 4404 4405 4406 4477 4407 4408 4409 4410 4411 4412 4413 4414 4415 4416 4417 4418 4419 4342 4257 4164 4063 3954 3836 3713 3578 3437 3291 3133 3132 3128 2423 2613 2424 2795 1809 1589 1360 1123 1120  363 1122  623
 512  770  769 1259 1260 1718 1933 2142 2344 2345 2721 2537 3068 3229 3381 3380 3529 3665 3793 3664 3913 4132 4229 4319 4399 4472 4474 4403 4475 4476 4540 4478 4479 4480 4481 4482 4483 4484 4485 4486 4487 4488 4490 4489 4420 4258 4165 4064 3955 3837 3838 3580 3439 3440 2968 3289 2793 3290 2796 2425 2023 1124 2025 1811  880  626  364   96  366
 246  511  510 1018 1491 1716 1489 2143 2343 2536 2722 2898 2899 3067 3228 3526 3527 3524 3914 4027 3792 4131 4228 4318 4398 4471 4536 4537 4538 4539 4595 4541 4542 4543 4544 4545 4546 4547 4548 4549 4550 4551 4421 4345 4343 4259 4166 4065 3956 3839 3714 3581 3441 3134 2967 2797 2427 2428 2430 2426 1590 2230 1362 1361  624  625   95  362  627
 245  506  768  767 1258 1257 1932 1715 2141 2342 2535 2720 2897 3066 3227 3522 3662 3525 3790 3791 4026 4025 4129 4130 4317 4397 4535 4592 4593 4594 4642 4596 4597 4598 4599 4600 4601 4602 4603 4604 4605 4552 4492 4491 4344 4260 4167 4066 3957 3840 3716 3715 3582 3292 2969 3135 2794 2799 2024 2614 1813 1593 1815 1363  878 1127   94  628  367
 766  243  509 1017 1016 1256 1490 1931 2140 2341 2534 2719 2896 3065 3226 3379 3523 3911 3663 3912 4024 4128 4315 4316 4396 4470 4534 4591 4639 4640 4641 4643 4644 4645 4646 4647 4648 4649 4650 4651 4606 4553 4493 4422 4346 4261 4168 4067 3958 3841 3583 3584 3442 3295 3293 2970 2798 2618 2616 2619 2231 2026 1591  881 1126   97  631  365   99
 244  242 1015  508 1255 1488 1714 1713 2139 2340 2533 2718 2895 3064 3225 3378 3661 3659 3660 3789 4023 4226 4227 4225 4314 4469 4533 4589 4590 4679 4681 4682 4683 4684 4685 4686 4687 4688 4689 4652    0 4554 4494 4423 4424 4262 4169 4068 3959 3842 3717 3443 3294 3136 3138 2972 3137 2229 2233 2228 2027 1812 1125  629   98 1128  884  368  100
 241 1254  763 1012  765 1253 1929 1930 2138 2339 2532 2717 2894 3063 3222 3224 3376 3377 3788 3910 4022 4127 4223 4394 4467 4468 4532 4588 4680 4638 4712 4713 4714 4715 4716 4717 4718 4719 4690 4653 4607 4608 4555 4425 4347 4348 4069 4070 3960 3843 3718 3585 3444 3298 3139 3296 2974 2617 1814 2232 1592 1594 1365 1366  882  370  879  630  369
 239 1013  507  764 1011 1712 1928 2137 1710 2338 2531 2715 2893 3220 3221 3223 3521 3658 3908 3909 3907 4224 4313 4312 4395 4392 4466 4531 4637 4678 4711 4736 4737 4738 4739 4740 4741 4720 4691 4654 4609 4556 4495 4426 4349 4264 4263 4071 3961 3844 3719 3587 3586 3140 3141 2800 2971 2973 1816 2234 2235 1597 1364 2029 2028  104  374  372  101
 505 1014  762 1010 1252 1484 1925 1927 1926 2335 2337 2530 2714 2716 3060 3375 3520 3786 3787 4020 4021 4126 4125 4311 4222 4393 4530 4636 4586 4677 4710 4735 4752 4753 4754 4755 4742 4721 4692 4655 4610 4557 4496 4427 4350 4265 4266 4170 3962 3846 3845 3720 3445 3297 3144 3450 2803 2802 2801 2624 1819 2236 1599 2431 1369  883  886  102  632
 504  502  761 1250 1486 1709 1487 2136 1711 2135 2529 2892 2891 3062 3061 3519 3657 3906 3656 4019 4124 4123 4221 4310 4391 4465 4464 4587 4634 4635 4709 4734 4750 4751 4760 4756 4743 4722 4693 4656 4611 4558 4497 4428 4351 4172 4171 4173 3964 3963 3722 3721 3448 3447 2976 2621 2623 2975 1596 1817 2620 1595 2034 1598 1130 1129  633  885  103
 238  237  503 1251 1485 1708 1249 1482 1924 2528 2336 2713 2890 3059 3374 3517 3372 3516 3785 3905 3904 4018 4219 4220 4309 4463 4529 4584 4585 4676 4708 4733 4749 4759 4758 4757 4744 4723 4694 4657 4612 4559 4498 4429 4352 4267 4174 4072 4073 3847 3589 3590 3446 3302 3300 3142 2622 2433 2432 2435 1818 2031 2429 1368 1820 1132 1131  378  371
 240  760 1007 1009 1008 1481 1707 2133 2134 2334 2527 2712 2889 3058 3373 3371 3518 3653 3784 3654 4017 4122 4218 4308 4390 4526 4528 4527 4633 4675 4674 4707 4732 4748 4747 4746 4745 4724 4695 4658 4613 4560 4499 4430 4353 4268 4175 4074 3723 3848 3591 3449 3588 2806 3299 2237 2436 2626 2434 1821 2036 2032 1371  637  636  888  887  634  373
 235  236  759  758 1483 1248 1706 1923 2132 2333 2526 2711 2888 3057 3219 3218 3655 3652 3782 3903 3783 4121 4307 4388 4387 4389 4461 4525 4583 4673 4706 4731 4730 4729 4728 4727 4726 4725 4696 4659 4614 4561 4500 4431 4354 4269 4178 3849 3851 3724 3850 3725 3451 3145 3143 2805 2978 2625 2238 1822 1823 1367 1377 1133 1134 1135  635  890  105
 500  498  501 1247 1005 1480 1705 1922 2131 2332 2525 2710 2887 3056 3217 3370 3515 3781 3902 4015 4016 4120 4217 4304 4306 4462 4460 4581 4632 4631 4705 4704 4703 4702 4701 4700 4699 4698 4697 4660 4615 4562 4501 4432 4356 4177 4075 3965 4176 3852 3592 3301 3593 3147 2982 2977 2979 2437 2627 1603 2030 2239 1601  639  638  375  889  376  109
 234  757 1006  756 1246 1479 1704 1921 2130 2331 2524 2709 2886 3055 3216 3369 3514 3779 3780 3901 4014 4119 4216 4385 4305 4386 4582 4630 4629 4672 4670 4669 4668 4667 4666 4665 4664 4663 4662 4661 4616 4563 4502 4433 4270 4355 4076 3966 3968 3853 3726 3453 3595 3304 2804 2807 2808 2240 2037 2244 2033 2628 1602 1138  892 1136  106  640  107
 232 1004  499 1245 1244 1478 1703 1920 2129 2330 2523 2708 2885 3054 3215 3368 3513 3651 3778 3900 4013 4118 4215 4303 4457 4384 4459 4524 4579 4671 4627 4626 4625 4624 4623 4622 4621 4620 4619 4618 4617 4564 4503 4434 4357 4272 4077 3967 3727 3594 3728 3454 3303 2980 3146 2629 2981 2439 1824 2241 2438 2242 1374 1604 1370 1139  108  891 1137
 497  495  755 1003  754 1477 1702 1919 2128 2329 2522 2707 2884 3053 3214 3367 3512 3650 3649 3899 4012 4117 4214 4458 4456 4522 4523 4580 4578 4628 4577 4575 4574 4573 4572 4571 4570 4569 4568 4567 4566 4565 4504 4359 4273 4271 4179 4078 4079 3969 3970 3729 3305 3452 3148 2630 2810 2809 2440 2035 1140 1375 1373 1826 1379 1372  377  894  110
 496  233  753 1002 1243 1476 1701 1918 2127 2328 2521 2706 2883 3052 3213 3366 3511 3648 3777 3898 4011 4116 4213 4302 4382 4521 4520 4519 4518 4517 4576 4516 4515 4514 4513 4512 4511 4510 4509 4508 4507 4506 4505 4436 4435 4274 4180 4080 3855 4181 3730 3455 3457 3306 3149 2983 2985 2811 2243 2441 2041 2039 1600 1825 1605  642  379  893  111
 231  230  752 1001 1242 1475 1700 1917 2126 2327 2520 2705 2882 3051 3212 3365 3510 3647 3776 3897 4010 4115 4212 4301 4455 4383 4454 4453 4452 4451 4450 4449 4448 4447 4446 4445 4444 4443 4442 4441 4440 4439 4438 4360 4358 4275 4182 4082 4081 3971 3854 3596 3598 3456 3150 2986 2984 2631 2245 2038 1828 1827 1378 1606 1376  895  382  380  112
 229  494  751 1000 1241 1474 1699 1916 2125 2326 2519 2704 2881 3050 3211 3364 3509 3646 3775 3896 4009 4114 4211 4300 4381 4380 4379 4378 4377 4376 4375 4374 4373 4372 4371 4370 4369 4368 4367 4366 4365 4364 4363 4437 4362 4361 4276 4183 3972 3856 3731 3597 3311 3307 3152 2813 2812 2633 2442 2443 2246 1607  644 1380  641 1141  113  381  114
 228  493  750  999 1240 1473 1698 1915 2124 2325 2518 2703 2880 3049 3210 3363 3508 3645 3774 3895 4008 4113 4210 4299 4298 4297 4296 4295 4294 4293 4292 4291 4290 4289 4288 4287 4286 4285 4284 4283 4282 4281 4280 4279 4278 4277 4184 4083 3973 3857 3732 3599 3308 2987 3458 2989 2632 2814 2444 2040 2042 1608 1610 1830 1609  896 1142  384  383
 227  492  749  998 1239 1472 1697 1914 2123 2324 2517 2702 2879 3048 3209 3362 3507 3644 3773 3894 4007 4112 4209 4208 4207 4206 4205 4204 4203 4202 4201 4200 4199 4198 4197 4196 4195 4194 4193 4192 4191 4190 4189 4188 4187 4186 4185 4084 3974 3975 3858 3600 3309 3153 3310 2988 3151 2815 2447 2247 2445 2248 1829  897 1143  643  385  386  115
 226  491  748  997 1238 1471 1696 1913 2122 2323 2516 2701 2878 3047 3208 3361 3506 3643 3772 3893 4006 4111 4110 4109 4108 4107 4106 4105 4104 4103 4102 4101 4100 4099 4098 4097 4096 4095 4094 4093 4092 4091 4090 4089 4088 4087 4086 4085 3859 3860 3733 3601 3459 3460 3154 2990 2816 2635 2044 2634 2249 2043 1832 1382 1144 1381  899  645  116
 225  490  747  996 1237 1470 1695 1912 2121 2322 2515 2700 2877 3046 3207 3360 3505 3642 3771 3892 4005 4004 4003 4002 4001 4000 3999 3998 3997 3996 3995 3994 3993 3992 3991 3990 3989 3988 3987 3986 3985 3984 3983 3982 3981 3980 3979 3978 3976 3735 3734 3602 3461 3312 3155 2991 2817 2636 2446 2250 2046 2045 1831 1145  898  646 1611  117  648
 224  489  746  995 1236 1469 1694 1911 2120 2321 2514 2699 2876 3045 3206 3359 3504 3641 3770 3891 3890 3889 3888 3887 3886 3885 3884 3883 3882 3881 3880 3879 3878 3877 3876 3875 3874 3873 3872 3871 3870 3869 3868 3867 3866 3865 3864 3863 3977 3739 3861 3603 3462 3313 3156 2992 2818 2637 2448 2252 2251 1833 1383 1385 1147 1146  388  387  118
 223  488  745  994 1235 1468 1693 1910 2119 2320 2513 2698 2875 3044 3205 3358 3503 3640 3769 3768 3767 3766 3765 3764 3763 3762 3761 3760 3759 3758 3757 3756 3755 3754 3753 3752 3751 3750 3749 3748 3747 3746 3745 3744 3743 3742 3741 3609 3740 3862 3736 3604 3463 3315 3314 3157 2819 2638 2449 2253 2047 1613 1612 1148 1384  649  900  647  119
 222  487  744  993 1234 1467 1692 1909 2118 2319 2512 2697 2874 3043 3204 3357 3502 3639 3638 3637 3636 3635 3634 3633 3632 3631 3630 3629 3628 3627 3626 3625 3624 3623 3622 3621 3620 3619 3618 3617 3616 3615 3614 3613 3612 3611 3610 3608 3607 3738 3737 3606 3464 3316 3158 2993 2820 2639 2451 2450 2048 1834 1835  903  905  901  390  650  122
 221  486  743  992 1233 1466 1691 1908 2117 2318 2511 2696 2873 3042 3203 3356 3501 3500 3499 3498 3497 3496 3495 3494 3493 3492 3491 3490 3489 3488 3487 3486 3485 3484 3483 3482 3481 3480 3479 3478 3477 3476 3475 3474 3473 3472 3471 3470 3469 3605 3466 3319 3465 3159 2994 2995 2821 2640 2254 2255 2049 1836 1614 1386  902 1150  121  651  389
 220  485  742  991 1232 1465 1690 1907 2116 2317 2510 2695 2872 3041 3202 3355 3354 3353 3352 3351 3350 3349 3348 3347 3346 3345 3344 3343 3342 3341 3340 3339 3338 3337 3336 3335 3334 3333 3332 3331 3330 3329 3328 3327 3326 3325 3324 3323 3167 3467 3320 3321 3163 3318 3317 3160 2822 2641 2452 2050 1837 1616 1615 1387 1149  392  904  120  391
 219  484  741  990 1231 1464 1689 1906 2115 2316 2509 2694 2871 3040 3201 3200 3199 3198 3197 3196 3195 3194 3193 3192 3191 3190 3189 3188 3187 3186 3185 3184 3183 3182 3181 3180 3179 3178 3177 3176 3175 3174 3173 3172 3171 3170 3169 3168 3166 3468 3322 3164 3000 3162 3161 2996 2823 2642 2453 2256 2051 1838 1617 1388 1151  906  652  653  123
 218  483  740  989 1230 1463 1688 1905 2114 2315 2508 2693 2870 3039 3038 3037 3036 3035 3034 3033 3032 3031 3030 3029 3028 3027 3026 3025 3024 3023 3022 3021 3020 3019 3018 3017 3016 3015 3014 3013 3012 3011 3010 3009 3008 3007 3006 3005 3004 3003 3165 3001 2829 2999 2998 2997 2824 2643 2454 2257 2052 1839 1618 1389 1152  907  654  393  124
 217  482  739  988 1229 1462 1687 1904 2113 2314 2507 2692 2869 2868 2867 2866 2865 2864 2863 2862 2861 2860 2859 2858 2857 2856 2855 2854 2853 2852 2851 2850 2849 2848 2847 2846 2845 2844 2843 2842 2841 2840 2839 2838 2837 2836 2835 2834 2833 2832 3002 2831 2830 2828 2827 2826 2825 2644 2455 2258 2053 1840 1619 1390 1153  908  655  394  125
 216  481  738  987 1228 1461 1686 1903 2112 2313 2506 2691 2690 2689 2688 2687 2686 2685 2684 2683 2682 2681 2680 2679 2678 2677 2676 2675 2674 2673 2672 2671 2670 2669 2668 2667 2666 2665 2664 2663 2662 2661 2660 2659 2658 2657 2656 2655 2654 2653 2652 2651 2650 2649 2648 2647 2646 2645 2456 2259 2054 1841 1620 1391 1154  909  656  395  126
 215  480  737  986 1227 1460 1685 1902 2111 2312 2505 2504 2503 2502 2501 2500 2499 2498 2497 2496 2495 2494 2493 2492 2491 2490 2489 2488 2487 2486 2485 2484 2483 2482 2481 2480 2479 2478 2477 2476 2475 2474 2473 2472 2471 2470 2469 2468 2467 2466 2465 2464 2463 2462 2461 2460 2459 2458 2457 2260 2055 1842 1621 1392 1155  910  657  396  127
 214  479  736  985 1226 1459 1684 1901 2110 2311 2310 2309 2308 2307 2306 2305 2304 2303 2302 2301 2300 2299 2298 2297 2296 2295 2294 2293 2292 2291 2290 2289 2288 2287 2286 2285 2284 2283 2282 2281 2280 2279 2278 2277 2276 2275 2274 2273 2272 2271 2270 2269 2268 2267 2266 2265 2264 2263 2262 2261 2056 1843 1622 1393 1156  911  658  397  128
 213  478  735  984 1225 1458 1683 1900 2109 2108 2107 2106 2105 2104 2103 2102 2101 2100 2099 2098 2097 2096 2095 2094 2093 2092 2091 2090 2089 2088 2087 2086 2085 2084 2083 2082 2081 2080 2079 2078 2077 2076 2075 2074 2073 2072 2071 2070 2069 2068 2067 2066 2065 2064 2063 2062 2061 2060 2059 2058 2057 1844 1623 1394 1157  912  659  398  129
 212  477  734  983 1224 1457 1682 1899 1898 1897 1896 1895 1894 1893 1892 1891 1890 1889 1888 1887 1886 1885 1884 1883 1882 1881 1880 1879 1878 1877 1876 1875 1874 1873 1872 1871 1870 1869 1868 1867 1866 1865 1864 1863 1862 1861 1860 1859 1858 1857 1856 1855 1854 1853 1852 1851 1850 1849 1848 1847 1846 1845 1624 1395 1158  913  660  399  130
 211  476  733  982 1223 1456 1681 1680 1679 1678 1677 1676 1675 1674 1673 1672 1671 1670 1669 1668 1667 1666 1665 1664 1663 1662 1661 1660 1659 1658 1657 1656 1655 1654 1653 1652 1651 1650 1649 1648 1647 1646 1645 1644 1643 1642 1641 1640 1639 1638 1637 1636 1635 1634 1633 1632 1631 1630 1629 1628 1627 1626 1625 1396 1159  914  661  400  131
 210  475  732  981 1222 1455 1454 1453 1452 1451 1450 1449 1448 1447 1446 1445 1444 1443 1442 1441 1440 1439 1438 1437 1436 1435 1434 1433 1432 1431 1430 1429 1428 1427 1426 1425 1424 1423 1422 1421 1420 1419 1418 1417 1416 1415 1414 1413 1412 1411 1410 1409 1408 1407 1406 1405 1404 1403 1402 1401 1400 1399 1398 1397 1160  915  662  401  132
 209  474  731  980 1221 1220 1219 1218 1217 1216 1215 1214 1213 1212 1211 1210 1209 1208 1207 1206 1205 1204 1203 1202 1201 1200 1199 1198 1197 1196 1195 1194 1193 1192 1191 1190 1189 1188 1187 1186 1185 1184 1183 1182 1181 1180 1179 1178 1177 1176 1175 1174 1173 1172 1171 1170 1169 1168 1167 1166 1165 1164 1163 1162 1161  916  663  402  133
 208  473  730  979  978  977  976  975  974  973  972  971  970  969  968  967  966  965  964  963  962  961  960  959  958  957  956  955  954  953  952  951  950  949  948  947  946  945  944  943  942  941  940  939  938  937  936  935  934  933  932  931  930  929  928  927  926  925  924  923  922  921  920  919  918  917  664  403  134
 207  472  729  728  727  726  725  724  723  722  721  720  719  718  717  716  715  714  713  712  711  710  709  708  707  706  705  704  703  702  701  700  699  698  697  696  695  694  693  692  691  690  689  688  687  686  685  684  683  682  681  680  679  678  677  676  675  674  673  672  671  670  669  668  667  666  665  404  135
 206  471  470  469  468  467  466  465  464  463  462  461  460  459  458  457  456  455  454  453  452  451  450  449  448  447  446  445  444  443  442  441  440  439  438  437  436  435  434  433  432  431  430  429  428  427  426  425  424  423  422  421  420  419  418  417  416  415  414  413  412  411  410  409  408  407  406  405  136
 205  204  203  202  201  200  199  198  197  196  195  194  193  192  191  190  189  188  187  186  185  184  183  182  181  180  179  178  177  176  175  174  173  172  171  170  169  168  167  166  165  164  163  162  161  160  159  158  157  156  155  154  153  152  151  150  149  148  147  146  145  144  143  142  141  140  139  138  137
