# This puzzle is unsolvable
61
   2    1    3    4    5    6    7    8    9   10   11   12   13   14   15   16   17   18   19   20   21   22   23   24   25   26   27   28   29   30   31   32   33   34   35   36   37   38   39   40   41   42   43   44   45   46   47   48   49   50   51   52   53   54   55   56   57   58   59   60   61
 240  241  242  243  244  245  246  247  248  249  250  251  252  253  254  255  256  257  258  259  260  261  262  263  264  265  266  267  268  269  270  271  272  273  274  275  276  277  278  279  280  281  282  283  284  285  286  287  288  289  290  291  292  293  294  295  296  297  298  299   62
 239  472  473  474  475  476  477  478  479  480  481  482  483  484  485  486  487  488  489  490  491  492  493  494  495  496  497  498  499  500  501  502  503  504  505  506  507  508  509  510  511  512  513  514  515  516  517  518  519  520  521  522  523  524  525  526  527  528  529  300   63
 238  471  696  697  698  699  700  701  702  703  704  705  706  707  708  709  710  711  712  713  714  715  716  717  718  719  720  721  722  723  724  725  726  727  728  729  730  731  732  733  734  735  736  737  738  739  740  741  742  743  744  745  746  747  748  749  750  751  530  301   64
 237  470  695  912  913  914  915  916  917  918  919  920  921  922  923  924  925  926  927  928  929  930  931  932  933  934  935  936  937  938  939  940  941  942  943  944  945  946  947  948  949  950  951  952  953  954  955  956  957  958  959  960  961  962  963  964  965  752  531  302   65
 236  469  694  911 1120 1121 1122 1123 1124 1125 1126 1127 1128 1129 1130 1131 1132 1133 1134 1135 1136 1137 1138 1139 1140 1141 1142 1143 1144 1145 1146 1147 1148 1149 1150 1151 1152 1153 1154 1155 1156 1157 1158 1159 1160 1161 1162 1163 1164 1165 1166 1167 1168 1169 1170 1171  966  753  532  303   66
 235  468  693  910 1119 1320 1321 1322 1323 1324 1325 1326 1327 1328 1329 1330 1331 1332 1333 1334 1335 1336 1337 1338 1339 1340 1341 1342 1343 1344 1345 1346 1347 1348 1349 1350 1351 1352 1353 1354 1355 1356 1357 1358 1359 1360 1361 1362 1363 1364 1365 1366 1367 1368 1369 1172  967  754  533  304   67
 234  467  692  909 1118 1319 1512 1513 1514 1515 1516 1517 1518 1519 1520 1521 1522 1523 1524 1525 1526 1527 1528 1529 1530 1531 1532 1533 1534 1535 1536 1537 1538 1539 1540 1541 1542 1543 1544 1545 1546 1547 1548 1549 1550 1551 1552 1553 1554 1555 1556 1557 1558 1559 1370 1173  968  755  534  305   68
 233  466  691  908 1117 1318 1511 1696 1697 1698 1699 1700 1701 1702 1703 1704 1705 1706 1707 1708 1709 1710 1711 1712 1713 1714 1715 1716 1717 1718 1719 1720 1721 1722 1723 1724 1725 1726 1727 1728 1729 1730 1731 1732 1733 1734 1735 1736 1737 1738 1739 1740 1741 1560 1371 1174  969  756  535  306   69
 232  465  690  907 1116 1317 1510 1695 1872 1873 1874 1875 1876 1877 1878 1879 1880 1881 1882 1883 1884 1885 1886 1887 1888 1889 1890 1891 1892 1893 1894 1895 1896 1897 1898 1899 1900 1901 1902 1903 1904 1905 1906 1907 1908 1909 1910 1911 1912 1913 1914 1915 1742 1561 1372 1175  970  757  536  307   70
 231  464  689  906 1115 1316 1509 1694 1871 2040 2041 2042 2043 2044 2045 2046 2047 2048 2049 2050 2051 2052 2053 2054 2055 2056 2057 2058 2059 2060 2061 2062 2063 2064 2065 2066 2067 2068 2069 2070 2071 2072 2073 2074 2075 2076 2077 2078 2079 2080 2081 1916 1743 1562 1373 1176  971  758  537  308   71
 230  463  688  905 1114 1315 1508 1693 1870 2039 2200 2201 2202 2203 2204 2205 2206 2207 2208 2209 2210 2211 2212 2213 2214 2215 2216 2217 2218 2219 2220 2221 2222 2223 2224 2225 2226 2227 2228 2229 2230 2231 2232 2233 2234 2235 2236 2237 2238 2239 2082 1917 1744 1563 1374 1177  972  759  538  309   72
 229  462  687  904 1113 1314 1507 1692 1869 2038 2199 2352 2353 2354 2355 2356 2357 2358 2359 2360 2361 2362 2363 2364 2365 2366 2367 2368 2369 2370 2371 2372 2373 2374 2375 2376 2377 2378 2379 2380 2381 2382 2383 2384 2385 2386 2387 2388 2389 2240 2083 1918 1745 1564 1375 1178  973  760  539  310   73
 228  686  903  902 1112 1313 1506 1868 1867 2037 2198 2351 2496 2497 2498 2499 2500 2501 2502 2503 2504 2505 2506 2507 2508 2509 2510 2511 2512 2513 2514 2515 2516 2517 2518 2519 2520 2521 2522 2523 2524 2525 2526 2527 2528 2529 2530 2531 2390 2241 2084 1919 1746 1565 1376 1179  974  761  540  311   74
 227  461  685 1111  901 1312 1504 1505 1691 2036 2197 2350 2495 2632 2633 2634 2635 2636 2637 2638 2639 2640 2641 2642 2643 2644 2645 2646 2647 2648 2649 2650 2651 2652 2653 2654 2655 2656 2657 2658 2659 2660 2661 2662 2663 2664 2665 2532 2391 2242 2085 1920 1747 1566 1377 1180  975  762  541  312   75
 225  226  684  460 1110 1311 1503 1690 1689 2035 2196 2349 2494 2631 2760 2761 2762 2763 2764 2765 2766 2767 2768 2769 2770 2771 2772 2773 2774 2775 2776 2777 2778 2779 2780 2781 2782 2783 2784 2785 2786 2787 2788 2789 2790 2791 2666 2533 2392 2243 2086 1921 1748 1567 1378 1181  976  763  542  313   76
 224  458  681  459 1109 1108 1687 1688 2034 2033 2348 2347 2493 2630 2759 2880 2881 2882 2883 2884 2885 2886 2887 2888 2889 2890 2891 2892 2893 2894 2895 2896 2897 2898 2899 2900 2901 2902 2903 2904 2905 2906 2907 2908 2909 2792 2667 2534 2393 2244 2087 1922 1749 1568 1379 1182  977  764  543  314   77
 457  456 1105  900 1309  899 1310 1686 1866 2194 2193 2195 2492 2629 2758 2879 2992 2993 2994 2995 2996 2997 2998 2999 3000 3001 3002 3003 3004 3005 3006 3007 3008 3009 3010 3011 3012 3013 3014 3015 3016 3017 3018 3019 2910 2793 2668 2535 2394 2245 2088 1923 1750 1569 1380 1183  978  765  544  315   78
 223  895  679  683  898 1501 1685 1862 1864 1863 2032 2346 2491 2628 2757 2878 2991 3096 3097 3098 3099 3100 3101 3102 3103 3104 3105 3106 3107 3108 3109 3110 3111 3112 3113 3114 3115 3116 3117 3118 3119 3120 3121 3020 2911 2794 2669 2536 2395 2246 2089 1924 1751 1570 1381 1184  979  766  545  316   79
 222  678  682 1307 1104  896 1502 1499 2031 2030 1865 2345 2490 2627 2756 2877 2990 3095 3192 3193 3194 3195 3196 3197 3198 3199 3200 3201 3202 3203 3204 3205 3206 3207 3208 3209 3210 3211 3212 3213 3214 3215 3122 3021 2912 2795 2670 2537 2396 2247 2090 1925 1752 1571 1382 1185  980  767  546  317   80
 455  453  219  680  454  897 1500 1107 1684 2190 2192 2344 2489 2626 2755 2876 2989 3094 3191 3280 3281 3282 3283 3284 3285 3286 3287 3288 3289 3290 3291 3292 3293 3294 3295 3296 3297 3298 3299 3300 3301 3216 3123 3022 2913 2796 2671 2538 2397 2248 2091 1926 1753 1572 1383 1186  981  768  547  318   81
 220  451  221 1106 1308 1306 1683 1682 1498 1861 2191 2343 2488 2625 2754 2875 2988 3093 3190 3279 3360 3361 3362 3363 3364 3365 3366 3367 3368 3369 3370 3371 3561 3372 3374 3375 3376 3377 3378 3379 3302 3217 3124 3023 2914 2797 2672 2539 2398 2249 2092 1927 1754 1573 1384 1187  982  769  548  319   82
 677  218  676  894 1103 1304 1677 1857 1859 2029 2028 2342 2487 2624 2753 2874 2987 3092 3189 3359 3358 3432 3433 3434 3435 3436 3437 3438 3439 3440 3441 3505 3563 3373 3443 3445 3447 3448 3449 3380 3303 3218 3125 3024 2915 2798 2673 2540 2399 2250 2093 1928 1755 1574 1385 1188  983  770  549  320   83
 452  215  675 1302 1102 1305 1303 1858 1681 2027 2189 2341 2486 2623 2752 2873 2986 3091 3188 3278 3357 3431 3430 3497 3498 3499 3500 3501 3502 3503 3504 3444 3442 3506 3446 3508 3511 3509 3450 3381 3304 3219 3126 3025 2916 2799 2674 2541 2400 2251 2094 1929 1756 1575 1386 1189  984  771  550  321   84
 893  447  450  892 1497 1101 1680 1496 1860 2187 2188 2340 2485 2622 2751 2872 3090 3187 3186 3277 3429 3496 3494 3552 3553 3602 3641 3555 3557 3558 3559 3560 3562 3507 3609 3611 3566 3510 3512 3382 3305 3220 3127 3026 2917 2800 2675 2542 2401 2252 2095 1930 1757 1576 1387 1190  985  772  551  322   85
 217  672  448  673 1100 1099 1494 1495 1855 2026 2185 2186 2484 2621 2750 2871 2985 2984 3275 3276 3495 3356 3493 3551 3600 3554 3640 3556 3604 3605 3606 3607 3608 3564 3565 3567 3610 3513 3451 3383 3306 3222 3221 3128 2918 2801 2676 2543 2402 2253 2096 1931 1758 1577 1388 1191  986  773  552  323   86
 216  449 1300  890 1097  891 1493 1856 1679 2025 1854 2339 2483 2620 2749 2983 2982 3089 3185 3274 3355 3354 3550 3599 3639 3638 3601 3603 3643 3644 3645 3646 3678 3648 3612 3568 3453 3452 3514 3384 3307 3223 3129 3027 3028 2802 2677 2544 2403 2254 2097 1932 1759 1578 1389 1192  987  774  553  324   87
 214  446  674  212 1301 1299 1678 1492 2024 2184 2022 2338 2482 2619 2748 2870 3088 2869 3087 3184 3428 3492 3549 3548 3598 3674 3672 3642 3697 3675 3676 3677 3649 3647 3651 3650 3613 3569 3515 3385 3309 3308 3029 2920 2919 2803 2678 2545 2404 2255 2098 1933 1760 1579 1390 1193  988  775  554  325   88
 671  211  888  889 1096 1098 1298 1676 1853 2182 2021 2337 2183 2618 2747 2868 2981 3183 3272 3273    0 3353 3427 3491 3597 3596 3671 3673 3711 3698 3699 3700 3701 3679 3616 3614 3455 3516 3454 3386 3225 3224 3130 3030 2921 2804 2679 2546 2405 2256 2099 1934 1761 1580 1391 1194  989  776  555  326   89
 445  213 1297 1489  887  886 1491 1490 1852 2023 2181 2336 2481 2617 2746 2867 2980 3086 3085 3182 3270 3426 3425 3595 3668 3635 3637 3670 3669 3720 3713 3715 3702 3680 3681 3652 3570 3457 3388 3310 3132 3226 3131 3031 2922 2805 2680 2547 2406 2257 2100 1935 1762 1581 1392 1195  990  777  556  327   90
 207  670  443  669 1296 1674 1488 1675 1851 2019 2020 2335 2615 2479 2745 2866 2979 3084 3181 3352 3271 3424 3546 3490 3547 3667 3712 3719 3714 3718 3716 3703 3683 3704 3654 3615 3571 3456 3518 3387 3389 3033 3134 3032 2923 2681 2682 2548 2407 2258 2101 1936 1763 1582 1393 1196  991  778  557  328   91
 442  209  884  668 1295 1093 1294 1487 1850 2179 2180 2478 2616 2865 2864 2863 2978 3083 3180 3269 3348 3489 3545 3594 3593 3691 3695 3592 3710 3708 3707 3717 3682 3684 3653 3575 3617 3572 3458 3390 3312 3311 3133 2924 2807 2806 2549 2550 2408 2259 2102 1937 1764 1583 1394 1197  992  779  558  329   92
 210 1095  666  667 1090  885 1293 1849 1673 2334 2480 2332 2614 2477 2742 2744 2977 3179 3268 3267 3351 3423 3488 3544 3634 3636 3694 3630 3693 3696 3688 3706 3705 3618 3622 3655 3573 3517 3520 3519 3459 3313 3035 3228 2925 2808 2683 2551 2409 2260 2103 1938 1765 1584 1395 1198  993  780  559  330   93
 441  208  444  664 1094 1292 1671 1672 1847 2018 2017 2333 2475 2476 2976 3178 3079 3080 3081 3266 3350 3349 3487 3543 3632 3666 3631 3664 3692 3709 3687 3660 3661 3686 3657 3656 3574 3576 3521 3391 3227 3314 3230 3034 2926 2809 2685 2684 2410 2261 2104 1939 1766 1585 1396 1199  994  781  560  331   94
 206  665  883  882 1092 1091 1848 1670 2015 2330 2176 2331 2177 2329 2474 2611 2741 2743 3177 2975 3265 3422 3420 3588 3633 3346 3665 3690 3587 3663 3584 3624 3625 3659 3685 3620 3523 3522 3460 3461 3394 3229 3135 3036 2927 2810 2552 2553 2411 2262 2105 1940 1767 1586 1397 1200  995  782  561  332   95
 440  438  881 1291 1089 1486 1485 1669 2016 1846 2178 2473 2327 2862 2740 2973 3082 2861 3264 3418 3419 3347 3486 3542 3591 3589 3540 3536 3662 3628 3627 3689 3581 3579 3619 3658 3525 3393 3462 3392 3231 3136 3137 3138 2928 2811 2686 2412 2413 2263 2106 1941 1768 1587 1398 1201  996  783  562  333   96
 439  663  662  880 1088 1290 1484 1668 1845 2014 2175 2328 2608 2613 2612 2860 2974 3174 3176 3262 3345 3421 3485 3481 3590 3480 3537 3586 3585 3626 3582 3531 3530 3580 3528 3621 3524 3467 3578 3317 3316 3315 3139 3038 2687 2812 2813 2554 2264 2107 1942 1769 1770 1588 1399 1202  997  784  563  334   97
 205  437  879  661 1087 1289 1483 1482 1667 1844 2013 2971 2325 2739 2472 2858 2737 2972 3078 3417 3482 3344 3541 3484 3538 3535 3478 3629 3474 3409 3533 3583 3403 3529 3469 3468 3577 3526 3463 3464 3318 3232 3140 2929 3037 2932 2931 2814 2415 2414 2265 1945 2108 1943 1771 1203  998  785  564  335   98
 203  204  436  660  878 1288 1481 1666 1843 2012 2326 2174 2173 2610 2607 2609 2738 2970 3077 3173 3263 3483 3416 3412 3338 3336 3413 3407 3534 3532 3405 3470 3471 3473 3623 3327 3399 3527 3465 3395 3319 3233 3234 3039 3144 2692 2688 2690 2689 2556 2109 2110 1590 1589 1400 1204  999  786  565  336   99
 202  435  659  877 1086 1287 1480 1665 1842 2011 2172 2470 2471 2736 2735 2859 3074 3175 3171 3172 3343 3414 3166 3341 3253 3411 3410 3477 3476 3475 3333 3472 3246 3402 3245 3326 3325 3466 3396 3320 3237 3143 3141 3040 3041 2930 2557 2555 2416 2266 1944 1946 1772 1591 1401 1205 1000  787  566  337  100
 433  200  434  876 1085 1286 1479 1664 1841 2010 2171 2324 2604 2469 2606 2856 2969 3076 3261 3260 3339 3258 3257 3415 3539 3342 3161 3251 3408 3248 3331 3330 3328 3157 3243 3400 3241 3322 3238 3398 3397 3146 3235 2935 3142 2691 2815 2417 2268 2267 2111 1947 1773 1592 1402 1403 1001  788  567  338  101
 657  201  432  875 1084 1285 1478 1663 1840 2009 2170 2468 2322 2467 2857 2966 2855 3075 3073 3168 3259 3479 3340 3256 3337 3254 3250 3334 3335 3059 3329 3404 3055 3401 3155 3051 3324 3323 3147 3236 3043 3240 3321 2934 2816 2693 2817 2558 2559 2418 2112 2113 1774 1593 1404 1206 1002  789  568  339  102
 199  198  197  656 1083 1284 1477 1662 2008 2007 2169 2605 2321 2733 2603 3072 2964 2968 3170 3169 3068 3167 3066 3255 3165 3163 3252 3160 3406 3249 3332 3158 2835 3154 3056 2828 3242 3244 3148 3150 3239 3047 2703 2933 3042 2819 2560 2419 2270 2420 2269 1948 1775 1594 1405 1207 1003  790  569  340  103
 430  431  658  874  873 1082 1476 1838 1839 2168 2323 2464 2602 2463 2734 2601 2967 2854 3070 3071 2961 3067 2959 3065 3164 3063 3162 3062 3159 3061 3058 3247 3156 3152 2948 3052 3053 2829 3149 3049 3145 2827 3048 2818 3045 2936 2694 2561 2421 2114 2271 1949 1776 1595 1209 1208 1004  791  570  341  104
 428  655  871  872 1080 1283 1475 1661 2006 2005 2166 2465 2319 2318 2728 2852 2727 2853 2731 3069 2848 2960 2845 3064 2842 2956 2840 2955 2954 3060 2951 2713 3054 3057 2947 3153 2830 3151 3050 2944 3044 2940 2939 2938 2937 2820 2562 2563 2422 2115 2116 1950 1777 1596 1406 1210 1005  792  571  342  105
 654  196  429 1281 1282 1081 1280 1837 1658 2167 2320 2316 2164 2729 2466 2732 2311 2730 2724 2846 2847 2957 2721 2844 2841 2718 2839 2838 2952 2837 2953 2836 2950 2440 2834 2580 2945 2942 2704 2705 2941 3046 2702 2823 2822 2696 2695 2273 2423 2272 1951 1778 1597 1408 1407 1211 1212  793  572  343  106
 195  427  653 1473  869 1474 1079 1836 1657 1660 1835 2003 2317 2851 2598 2849 2965 2963 2726 2962 2725 2722 2590 2719 2958 2446 2587 2717 2716 2715 2581 2712 2833 2831 2708 2709 2707 2573 2832 2572 2826 2574 2824 2701 2569 2821 2566 2697 2275 2274 2117 1952 1779 1598 1409 1007 1006  794  573  344  107
 194  652  650 1078 1279 1472 1471 1659 1834 2002 2004 2599 2165 2314 2596 2459 2457 2850 2455 2594 2723 2589 2843 2720 2449 2302 2447 2585 2583 2582 2444 2949 2442 2579 2578 2710 2943 2576 2706 2287 2946 2131 2434 2571 2699 2565 2698 2564 2425 2424 2118 1953 1780 1599 1410 1213 1008  795  574  345  108
 193  191  867  868 1077 1278 1656 1470 1832 1833 2163 2460 2597 2458 2600 2155 2456 2310 2595 2593 2592 2591 2451 2303 2450 2588 2299 2586 2714 2298 2711 2441 2439 2291 2577 2292 2575 2437 2435 2436 2433 2430 2825 2431 2700 2567 2426 2279 2278 2276 2119 1954 1781 1600 1411 1214 1009  796  575  346  109
 192  425  424  870 1076 1277 1655 1469 2001 2160 2162 2462 2461 1994 1995 2154 2308 1990 2152 2453 2452 1636 2304 2146 2448 2301 2445 2300 2584 2296 2295 2294 2293 2138 2136 2137 2290 2438 2289 2288 2432 2284 1964 2429 2568 2428 2127 2427 2123 2122 2120 1955 1782 1601 1412 1215 1010  797  576  347  110
 190  648  649  651 1075 1276 2000 1653 1830 2161 1999 2158 2315 2312 2313 2157 1992 2153 2309 2150 1989 1814 2149 2148 2145 1982 1981 2143 2297 2141 2443 2140 2139 1975 1971 2135 2134 2132 1970 2130 2133 2570 2286 2283 2128 2280 2282 2277 1960 1959 2121 1956 1783 1602 1413 1216 1011  798  577  348  111
 423  422  647  426 1466 1275 1274 1831 1654 1829 1827 2159 1997 1993 1824 1991 1820 1987 2454 2307 1639 2306 1816 1985 1983 2147 1632 1810 2144 1808 1978 1977 1976 1804 1974 1973 1972 1800 1969 1968 1967 2285 2129 1965 1792 2125 2281 2126 1791 1958 1787 1957 1784 1603 1414 1217 1012  799  578  349  112
 189  646  420  864  866 1468 1465 1467 1651 1652 1828 1998 1826 1996 1825 1822 1455 2156 1817 1818 2151 1986 1815 1637 2305 1812 1445 1979 2142 1629 1807 1806 1805 1803 1802 1623 1622 1434 1799 1798 1797 1796 1966 1616 1963 1612 1961 1962 2124 1789 1788 1786 1785 1604 1415 1218 1013  800  579  350  113
 188  421  645 1072 1074 1272 1273 1650 1463 1649 1648 1647 1646 1645 1821 1642 1819 1057 1640 1451 1258 1988 1449 1635 1813 1811 1630 1443 1980 1809 1628 1627 1626 1625 1624 1436 1801  825 1620 1619 1618 1617 1615 1427 1795 1794 1611 1790 1610 1609 1608 1607 1606 1605 1416 1219 1014  801  580  351  114
 419  186  863  865 1073 1071 1269  856 1268 1464 1461 1460 1459 1643 1644 1458 1454 1260 1259 1641 1638 1448 1254 1051 1447 1634 1444 1249 1631 1442 1441 1440 1439 1438 1437 1241 1037 1435 1621 1234 1431 1428 1233 1614 1793 1613 1425 1424 1423 1422 1421 1420 1419 1418 1417 1220 1015  802  581  352  115
 187  644  862  861 1271 1068  857 1067  634 1462 1265 1264 1263 1457 1823 1456 1453 1055 1257 1056 1450 1050 1253 1252 1048 1984 1251 1250 1248 1247 1246 1245 1244 1243 1242 1038 1240 1238 1239 1034 1432 1237 1430 1429 1029 1232 1230 1229 1228 1227 1226 1225 1224 1223 1222 1221 1016  803  582  353  116
 185  418  643  860 1069 1070  410 1066 1063 1266 1064 1062 1061 1060 1262 1261 1058 1054 1452  624 1255  840  841  839 1446 1633 1047 1046 1045 1044 1043 1042 1041 1040 1039 1036  824  826 1236  822 1235 1032 1031  818 1231 1426 1027 1026 1025 1024 1023 1022 1021 1020 1019 1018 1017  804  583  354  117
 184  417  642  859  638  639  854  851 1267  852  633  632  850  848 1059  847  846  845 1053  842 1256  843 1052  838 1049  837  836  835  834  833  832  831  830  829  828  827 1035 1433  605 1033  604  821  600 1028 1030  817  816  815  814  813  812  811  810  809  808  807  806  805  584  355  118
 183  416  641  640  858  637  855  853  635  407  406  631  630  849  629  627  165  401  844  625  623  622  621  620  619  618  617  616  615  614  613  612  611  610  609  608  607  603  143  823  376  375  601  820  599  598  597  596  595  594  593  592  591  590  589  588  587  586  585  356  119
 182  415  414  413  412  176  411 1270  636 1065  409  405  404  403  402  628  164  626  397  161  396  395  394  393  392  391  390  389  388  387  386  385  384  383  382  381  380  606  378  602  377  374  373  819  372  371  370  369  368  367  366  365  364  363  362  361  360  359  358  357  120
 181  180  179  178  177  173  175  174  408  172  171  170  169  168  167  166  400  163  399  162  398  160  159  158  157  156  155  154  153  152  151  150  149  148  147  146  145  379  144  142  141  140  139  138  137  136  135  134  133  132  131  130  129  128  127  126  125  124  123  122  121
