# This puzzle is unsolvable
34
 134    2    4  137  372  259    5    8    9   10   11  144  143   13  145  146   18  272  150  274   19   22   23  280  157  159  395   30   29   31  286  163   33  165
   1    3  133  135    6    7  138  139  140  141  142  269   15   16   14  148   17  494  149   21  276  275  391  277   28  156  282  281   27  162  161   32   35   34
 256  131  136  257  260  261  262  263  485  264  265  488   12  267  383  147  386  271  495   20  151  387   24  392   25  502   26  500  396  283  284  285  164   36
 132  130  258  373  482  374  377  378  584  379  380  587  266  382  268  270  496  388  152  273  597  278  153  599  154  158  398  508  160  604  401  402  166   37
 253  255  254  371  481  375  376  484  674  583  585  487  381  489  491  385  493  492  843  595  497  596  390  499  394  505  601  397  279  504  287  400  167  288
 129  128  370  480  580  581  483  582  675  676  486  588  679  384  589  764  682  591  683  768  685  602  503  501  393  850  155  399  507  694  168  171  169   38
 127  252  369  479  476  672  673  756  758  677  586  678  680  490  590  763  681  593  684  592  389  687  688  689  693  691  605  775  404  506  291  290  170  172
 126  251  368  576  579  478  671  833  834  757  760  905  761  762  765  840  767  766  770  772  594  912  600  690  598  773  777  608  606  405  509  695  289   41
 125  250  475  477  574  670  577  900  902  759  836  904 1014  839 1015  964  906  845  970  686  846  498  915  916  848  692  774  609  510  607  403   43  511   42
 364  249  578  365  575  669  755  832  960  903  835  962  907  963  837  842  841  965  909  769  911  913  971  972  603  852  851  776  696  406   39   40  292   44
 124  366  367  122  474  668  754  753  831  901  961 1012 1013  966 1017  838 1019  967  844 1065 1021  847  771  974  918  849  917  699  853  700  512  173  294  407
 121  123  248  473  573  667  752  830  899  898 1011 1056  959 1016 1059 1018  968 1062  969 1125 1063  908 1022  973  854  920  778  611  701  513  408  293  175  174
 120  247  245  244  472  666  751  897  829  957  958 1092 1055 1058 1093 1060 1061  910 1020 1099 1126 1100  977  914 1025  855  919  697  782  698  514  295   46   45
 119  363  362  471  572  665  750  828  896  956 1010 1008 1057 1120 1094 1095 1096 1097 1064 1098 1070  975 1066  781  783  980  780  612  409  610  517  410   50   47
 118  361  246  470  571  664  749  827  955  894 1054 1090 1091 1121 1140 1122 1123 1143 1124 1103 1067 1026 1023  979  922  779  614  702  613  298  296  297   49  176
 117  243  360  469  570  663  748  826  825  895 1009 1053 1139 1089 1052 1152 1142 1154 1127 1068 1101  978  921  785 1024  784  856  516  515  412  618  302  179  299
 116  242  359  569  568  662  747  824  893  954 1006 1119 1051 1141 1138 1118 1148 1153 1145 1128 1069 1028  976 1027  858  859  703  518  857  415  411  177   48  300
 241  358  467  468  567  661  746  823  891  892 1004 1007 1087 1117 1136 1149 1151 1104 1144 1106 1105 1102 1029 1030  923  704  786  413  615  519  862  180   51  178
 115  240  357  466  566  660  745  822  953 1005 1050 1086 1113 1088 1137 1150 1116 1134 1146 1107 1129 1071 1072  982  924  926  416  617  616  181  301  303  182   52
 114  239  356  465  565  659  744  821  890  952 1049 1045 1048 1135 1155 1081 1110 1079 1147 1077 1073 1131  981 1031  790  860  787  707  414  706  620  417  305   53
 113  238  355  463  464  819  820  888  950  951 1003 1115 1114 1083  943 1112 1111  992 1038 1039 1076 1074 1034  983  789  621  705  619  521  418  419  184  788  520
 112  237  564  462  743  658  656  889 1002 1047 1001 1084 1085 1044 1082 1040 1132 1133 1033  871  991 1075 1037 1032  984  925  864  708  622  861  710  183   54   55
 110  111  352  563  657  741  742  818  886  949  948  887  998 1043  997 1080 1108 1041 1130 1078  872  933  989 1035  930  985  929  709  791  524  421  308  304   57
 236  234  354  353  562  654  655  740  816  885  947 1000  999  878 1042  727  994  803  937  993  873  935  986 1036  793  792  865  525  713  522  185  523  307   59
 108  109  235  460  561  653  817  734  946  883  942  944  879  996  806  875  995  941  939  876  927 1109  988  931  867  795  711  420  794  623   58  306  863  189
 232  107  461  351  458  560  739  945  813  882  881 1046  880  804  808  547  640  877  934  990  936  932  987  928  718  714  866  624  712  626  186  426  310  187
 233  231  350  349  459  652  738  884  647  812  811  810  730  805  809  724  637  870  799  874  723  720  719    0  797  796  425  798  526  190   56   61   60  192
 106  348  456  457  559  651  737  736  814  648  733  731  643  728  641  807  726  540  634  801  722  632  533  631  716  318  431  422  188  627   71  309  428   62
 105  230  347  557  650  558  649  554  646  815  732  644  548  729  642  444  638  940  800  721  938  869  542  322  434  868  625  429  527  191  528  424  423  311
 104  229  346  455  555  451  449  735  553  550  645  549  446  545  443  639  543  725  541  802  436  636  538  206  630  530  715  628   74   67  529  430  198  317
 103  228  345  454  453  556  452  448  552  551  447  336  334  546  544  441  331  440  635  328  438  633  539  437  321  536   77  535  316  433   69  193   64  312
 102  227  344  223  342  221  340  450  339  337  218  335  215  445  442  212  330  210  329  204  326  208  432  324  717  534  199   72   76  201  532  313  314  194
 101  226  225  343   96  341   94   95  219  216   91   89  333  214  332  211   84   81  439  209  327  435   79  320  537  531  325  319  629  196   70  195  197   66
 100   99   98  224   97  222   93  220  338   92  217   90   88   87  213   86   85   83   82   80  207   78  202  323  203  205  200   75   73  427  315   63   68   65
