# This puzzle is unsolvable
20
  2  77  79 146   5 147  82   4   7   8  11 212  12 216  14  16  91  17  19  20
  1  75   3 206 303 145  80   6  85  10  87  13  88  89  15 217  18  92  94 161
144 143  76 203 200  81 260  84  83 208 214 153 152 266 158  90 159 219  95  21
 73  74 256  78 258 205 211 210 264   9 307 151 157  86 154 218 160  93  22  24
 72 140 204 209 148 149 301 385 304 150 213 265 215 311 156  96 347  98  23 163
199 252 141 142 202 207 340 261 398 335 305 308 310 313 222 343 309 270 223  26
197 257 334 297  70 298 338 299 341 344 371 262 268 155 349 373 162 271  97 168
137 259 362 395 361 329 381 300 365 339 389 337 345 369 269 346 267 273 164  25
247 396 336 249 363 397 296 384 356 326 342 388 386 274 370 263 221 166 100  27
201 251 302 133 255 333 364 380 367 351 238 306 392 377 391 314 220 167 101  28
253  71 292 138 250 293 194 359 393 354 372 387 399 315 374 169 165  99 171 104
353 131  67  63 132 295 322 366 327  68 379 319 285 368 226  29 312 224 103  31
254 139 193 198 383 294 331 323 378 394 179 114 390 348 272 228 275 102  33  30
196 136  66  61 291 360 134 230 237 355 284 117 375 105 173 170 225 115  32 174
248 190 358  69 324 332 191 328 382 235 316 183 320  43 352 231 276 281 277 107
 65 242 188  58 357  49 330  50 287 282 325 119 321 350 178 110 172 106 227  34
 59 245  60 135 192 186 130  53 240 280 181 376 233 232  44 317  46  35 175 108
195  57 127 189 187 244 289 120 288 185 118 124 236 234  47 279 177 176  36 109
128 243  62 126  54  64 318 246 180 182 121  45 286 278 239  39  42   0 112  37
 56 125 290 129  55 184 241  51 123 122  52  41 116 283  48  40 111 229 113  38
