# This puzzle is unsolvable
8
 2 28 13 46 12 38 63 16
41  8 49 37  0 18 21  4
47 27  5 56  7  9 58 26
25 40 54 14 33 34  6 55
10 43 45 53 42  1 35 48
11 51 19 61 17 50 15 22
 3 20 30 44 52 62 59 32
57 23 60 24 29 36 31 39
