# This puzzle is unsolvable
61
   2    1    3    4    5    6    7    8    9   10   11   12   13   14   15   16   17   18   19   20   21   22   23   24   25   26   27   28   29   30   31   32   33   34   35   36   37   38   39   40   41   42   43   44   45   46   47   48   49   50   51   52   53   54   55   56   57   58   59   60   61
 240  241  242  243  244  245  246  247  248  249  250  251  252  253  254  255  256  257  258  259  260  261  262  263  264  265  266  267  268  269  270  271  272  273  274  275  276  277  278  279  280  281  282  283  284  285  286  287  288  289  290  291  292  293  294  295  296  297  298  299   62
 239  472  473  474  475  476  477  478  479  480  481  482  483  484  485  486  487  488  489  490  491  492  493  494  495  496  497  498  499  500  501  502  503  504  505  506  507  508  509  510  511  512  513  514  515  516  517  518  519  520  521  522  523  524  525  526  527  528  529  300   63
 238  471  696  697  698  699  700  701  702  703  704  705  706  707  708  709  710  711  712  713  714  715  716  717  718  719  720  721  722  723  724  725  726  727  728  729  730  731  733  734  949  735  736  737  738  739  740  741  742  743  744  745  746  747  748  749  750  751  530  301   64
 237  470  695  912  913  914  915  916  917  918  919  920  921  922  923  924  925  926  927  928  929  930  931  932  934 1141  935  936  937  938  939  940  941 1151  942  944  945  947  732  948 1156  950  951  952  953  954  955  956  957  958  959  960  961  962  963  964  965  752  531  302   65
 236  469  694  911 1120 1121 1122 1123 1124 1125 1126 1127 1128 1129 1130 1131 1132 1133 1134 1135 1136 1137 1138 1530 1139  933 1142 1143 1144 1145 1146 1147 1347  943 1152 1540 1153  946 1154 1155 1355 1157 1158 1159 1160 1161 1162 1163 1164 1166 1167 1366 1168 1169 1171 1173  966  753  532  303   66
 235  468  693  910 1119 1320 1321 1322 1323 1324 1325 1326 1327 1328 1329 1330 1331 1332 1333 1334 1335 1336 1339 1140 1340 1531 1341 1342 1343 1344 1345 1346 1149 1348 1350 1349 1351 1352 1353 1354 1546 1356 1357 1358 1359 1361 1551 1362 1363 1165 1365 1367 1558 1368 1170  968  967  754  533  304   67
 234  467  692  909 1118 1319 1512 1513 1514 1515 1516 1517 1518 1519 1520 1521 1522 1523 1524 1525 1526 1527 1338 1711 1712 1529 1532 1533 1534 1535 1536 1537 1538 1539 1148 1150 1542 1543 1544 1545 1729 1547 1548 1549 1550 1360 1911 1736 1553 1364 1556 1557 1559 1370 1172 1371  969  755  534  305   68
 233  466  691  908 1117 1318 1511 1696 1697 1698 1699 1700 1701 1702 1703 1704 1705 1706 1707 1708 1709 1710 1337 1528 1714 1888 1715 1716 1718 1893 1719 1895 1720 1721 1899 1723 1722 1726 1727 1728 1904 1730 1731 1732 1733 1735 1552 1737 2078 1555 1738 1740 1741 1560 1369  970 1175 1174  535  306   69
 232  465  690  907 1116 1317 1510 1695 1872 1873 1874 1875 1876 1877 1878 1879 1880 1881 1882 1883 1884 1885 1886 1887 2055 1889 1890 1892 1717 2059 1894 2062 2063 1896 1541 1900 1725 1901 1902 1903 2072 1905 2073 1907 1908 1734 2076 1910 1554 1913 1914 1739 1742 1561 1373 1372  757  756  536  307   70
 231  464  689  906 1115 1316 1509 1694 1871 2040 2041 2042 2043 2044 2045 2046 2047 2048 2049 2050 2051 2052 2053 2213 2056 2216 2057 1891 2370 2218 2219 2061 2373 1897 1898 1724 2067 2066 2068 2069 2071 1906 2232 2074 2233 1909 2079 2237 1912 2238 2081 1915 1916 1743 1562 1177  971  758  537  308   71
 230  463  688  905 1114 1315 1508 1693 1870 2039 2200 2201 2202 2203 2204 2205 2206 2207 2208 2209 2210 2211 2212 2364 2214 2054 2058    0 2217 2372 2060 2374 2223 2517 2375 2065 2226 2227 2228 2070 2230 2382 2231 2234 2075 2235 2077 2388 2239 2080 2082 1917 1744 1563 1176 1374  972  760  538  309   72
 229  462  687  904 1113 1314 1507 1692 1869 2038 2199 2352 2353 2354 2355 2356 2357 2358 2359 2360 2361 2362 2363 2365 2215 2509 1713 2368 2369 2512 2221 2222 2220 2652 2225 2224 2377 2378 2379 2229 2381 2525 2384 2527 2385 2236 2386 2387 2389 2240 2083 1918 1745 1564 1375 1179  759  539  540  310   73
 228  461  686  903 1112 1313 1506 1691 1868 2037 2198 2351 2496 2497 2498 2499 2500 2501 2502 2503 2504 2505 2506 2642 2507 2366 2367 2510 2511 2513 2371 2649 2777 2516 2064 2376 2520 2521 2658 2380 2523 2660 2526 2383 2528 2529 2530 2531 2390 2241 1919 1746 1747 1566 1565  973 1181  974  761   75  312
 227  460  685  902 1111 1312 1505 1690 1867 2036 2197 2350 2495 2632 2633 2634 2635 2636 2637 2638 2639 2640 2641 2769 2643 2644 2646 3003 2648 2895 2773 2776 2514 2519 2655 2653 2656 2902 2522 2657 2524 2659 2661 2662 2663 2664 2665 2391 2242 2085 2084 1920 1748 1567 1377 1178  975 1180  311  541   74
 226  459  684  901 1110 1311 1504 1689 1866 2035 2196 2349 2494 2631 2760 2761 2762 2763 2764 2765 2767 2768 2997 2887 2508 2771 2647 2892 3004 2775 2893 2778 2518 2650 2651 2780 3115 2901 2783 2785 2786 2787 2788 2790 2908 2791 2666 2532 2533 2243 2086 1921 1378 1750  763 1376 1182  762  543  313   76
 225  458  683  900 1109 1310 1503 1688 1865 2034 2195 2348 2493 2630 2759 2880 2881 2882 2883 2884 2766 2885 2888 2999 2770 2772 2890 2645 2515 2894 3108 2896 2897 2898 2779 2654 2903 2782 2784 2904 2905 2906 2907 3019 2789 2909 2667 2534 2392 2393 2244 2087 1568 1751 1183 1379  976 1381  978  314   77
 224  457  682  899 1108 1309 1502 1687 1864 2033 2194 2347 2492 2629 2758 2879 2992 2993 2994 2995 2996 2886 2998 2889 3000 3106 2774 3002 3202 3005 3006 3007 3008 3009 2899 3012 3010 3013 3014 3015 3016 3017 3018 2911 2793 2792 2668 2535 2394 2245 1923 1922 1749 1572  982  764  765  542   81  544   78
 223  456  681  898 1107 1308 1501 1686 1863 2032 2193 2346 2628 2627 2757 2878 2991 3096 3097 3098 3099 3101 3102 3196 3199 3001 2891 3107 3367 3289 3110 3204 3112 3113 3208 2781 3011 3116 3213 3117 3119 3120 3021 3020 3121 2669 2670 2536 2395 2089 2088 1924 1752 1569 1184  983  546  977  980  545   79
 222  455  680  897 1106 1307 1500 1685 1862 2031 2192 2345 2491 2626 2756 2877 2990 3095 3193 3280 3194 3100 3363 3195 3103 3203 3104 3287 3291 3368 3206 3292 3209 3294 2900 3296 3114 3210 3118 3214 3301 3123 3122 2910 2794 2914 2795 2396 2247 2246 2090 1925 1570  979 1380 1571 1753  316   82  766   83
 221  454  679  896 1105 1306 1499 1684 1861 2030 2191 2344 2490 2625 2755 2876 2989 3094 3192 3281 3359 3197 3361 3285 3198 3365 3109 3435 3205 3111 3372 3505 3371 3207 3375 3376 3447 3212 3298 3299 3302 3215 3022 3216 3124 2538 2672 2537 2397 2248 2091 1926 1927 1186 1382 1188  770  315  985  317  549
 220  453  678  895 1104 1305 1498 1683 1860 2029 2342 2189 2343 2489 2754 2875 2986 2988 3191 3190 3282 3432 3360 3284 3364 3288 3437 3105 3200 3441 3366 3293 3373 3295 3211 3377 3563 3297 3378 3300 3379 3125 3024 3218 2912 2540 2796 2671 2539 2249 2092 1928 1755 1573 1754  769 1385  548  767   80  768
 219  452  677  894 1103 1304 1497 1682 1859 2028 2190 2488 2486 2487 2753 2874 2987 3189 3188 3431 3430 3362 3434 3498 3436 3500 3286 3555 3370 3290 3502 3439 3442 3444 3509 3564 3445 3448 3449 3380 3303 3217 3023 3025 2913 2915 2797 2541 2398 2399 2250 2093 1574 1387 1187 1185  318  772  547  551  320
 218  451  676  893 1102 1303 1496 1681 1858 2027 2188 2340 2341 2623 2752 2873 3091 3092 3187 3279 3357 3283 3496 3433 3497 3501 3554 3503 3201 3559 3603 3561 3443 3507 3374 3510 3446 3511 3450 3381 3304 3219 3126 3026 2798 2674 2675 2542 2673 2252 2094 1575 1384 1756 1189  984  319  986  981  321  323
 217  450  675  892 1101 1302 1495 1680 1857 2026 2187 2485 2622 2624 2872 2985 3093 3089 3276 3278 3356 3495 3551 3553 3499 3640 3369 3438 3645 3557 3440 3506 3560 3608 3562 3508 3565 3512 3451 3382 3305 3220 3127 2917 2916 2799 2800 2404 2251 2253 1930 1929 1757 1577 1576 1383  771  322   84  550   86
 216  449  674  891 1100 1301 1494 1679 1856 2025 2186 2339 2484 2621 2751 2750 2984 3185 3090 3358 3277 3186 3429 3550 3552 3598 3605 3601 3604 3556 3504 3643 3607 3609 3610 3611 3566 3513 3452 3383 3306 3221 3128 3027 2918 2801 2543 2677 2400 2254 2095 1931 1758 1578 1386  773 1191   87  552  554   85
 215  448  673  890 1099 1300 1493 1678 1855 2024 2185 2338 2483 2620 2749 2871 2983 3088 3184 3275 3274 3355 3494 3493 3599 3602 3675 3600 3644 3673 3646 3606 3647 3648 3649 3612 3567 3514 3453 3384 3307 3222 3129 3028 2919 2676 2679 2544 2401 2402 2097 1388 1932 1760 1192 1194 1190  553  774  555  324
 214  447  672  889 1098 1299 1492 1677 1854 2023 2184 2337 2482 2619 2748 2870 2869 2980 3086 3273 3352 3428 3427 3492 3639 3638 3642 3696 3672 3558 3699 3677 3678 3650 3651 3613 3515 3454 3455 3385 3308 3223 3130 3029 2920 2802 2803 2545 2547 2096 2256 1933 1390 1391 1580 1389  326  989  325  775   88
 213  446  671  888 1097 1298 1491 1676 1853 2022 2183 2336 2481 2618 2747 2868 2982 2981 3272 3354 3353 3426 3490 3549 3548 3597 3674 3695 3676 3698 3714 3700 3701 3679 3614 3569 3568 3517 3456 3386 3309 3224 3131 3030 2921 2804 2546 2678 2100 2403 1935 1934 2099 1579 1193 1392  990  987  779  556   89
 212  445  670  887 1096 1297 1490 1675 1852 2182 2181 2335 2480 2617 2746 2867 3084 3087 3271 3181 3351 3491 3425 3547 3670 3671 3635 3641 3697 3720 3713 3715 3681 3680 3652 3615 3516 3518 3457 3387 3310 3225 3132 3031 2922 2680 2407 2258 2098 2255 2101 1761 1759 1582 1195 1197  777  988  327   92   90
 211  444  669  886 1095 1296 1489 1674 1851 2021 2334 2479 2616 2865 2744 2745 3085 3182 3183 3269 3350 3424 3489 3593 3596 3669 3637 3694 3711 3712 3718 3716 3702 3682 3653 3616 3570 3459 3571 3388 3311 3226 3133 3032 2923 2805 2681 2548 2405 2406 1763 2102 1762 1581 1393 1196  778  776  558  328  331
 210  443  668  885 1094 1488 1673 1850 2019 2020 2180 2333 2613 2615 2614 2979 2866 3083 2978 3270 3267 3180 3423 3546 3595 3545 3636 3693 3710 3719 3707 3717 3704 3703 3683 3617 3520 3458 3460 3389 3312 3227 3134 3033 2924 2806 2807 2408 2257 2409 1936 1938 1937 1764  991 1394 1395 1198  557  559   91
 209  442  667  884 1093 1295 1487 1672 1849 2018 2179 2332 2478 2477 2742 2743 3178 3268 3081 3179 3347 3422 3488 3487 3543 3594 3634 3692 3690 3709 3688 3708 3705 3684 3654 3618 3391 3522 3574 3313 3228 3229 3135 3034 2925 2683 2682 2549 2260 2259 2103 1765 1766 1584 1583 1200  992  993  780  330  329
 208  441  666  883 1092 1294 1486 1671 1848 2017 2178 2331 2476 2612 2741 2862 3082 3177 3080 3346 3421 3349 3486 3544 3592 3633 3668 3667 3691 3689 3661 3706 3687 3685 3655 3519 3619 3573 3572 3390 3314 3230 3136 3035 2926 2809 2551 2550 2410 2261 2105 1939 1767 1585 1199 1396  994  781  560   94   93
 207  440  665  882 1091 1293 1484 1485 1670 1847 2177 2330 2475 2611 2976 2864 2977 2863 3176 3348 3264 3420 3485 3542 3591 3631 3632 3666 3664 3662 3626 3659 3624 3657 3686 3620 3576 3521 3462 3461 3392 3137 3036 2927 2810 2808 2684 2552 2411 2104 2106 2262 1586 1587 1397 1201  995  782  561  332   95
 206  439  664  881 1090 1292 1483 1669 1846 2016 2176 2329 2474 2740 2739 2861 2975 3079 3078 3266 3345 3265 3419 3541 3590 3630 3629 3665 3663 3627 3625 3581 3623 3656 3622 3658 3621 3575 3523 3393 3315 3231 3316 3037 2928 2811 2685 2553 2412 2263 2107 1940 1941 1768 1399 1398 1202  783  562  333   96
 205  438  663  880 1089 1291 1290 1668 1845 2015 2014 2328 2473 2609 2610 2860 2974 2973 3175 3418 3416 3417 3484 3540 3589 3588 3587 3586 3628 3585 3583 3660 3582 3580 3577 3527 3526 3524 3463 3394 3232 3317 3138 3038 2929 2812 2686 2554 2413 2264 1945 1942 1944 1769 1588 1400  996  564  785  334   97
 204  437  662  879 1088 1289 1482 1844 1843 2013 2175 2470 2326 2472 2738 2859 2972 3077 3344 3263 3262 3343 3483 3539 3538 3537 3536 3535 3534 3584 3533 3471 3530 3528 3579 3468 3525 3464 3465 3395 3233 3139 3140 3039 2930 2688 2687 2415 2416 2414 1943 2266 1770 1589  784 1203  997  786  563  565   98
 203  436  661  878 1087 1288 1481 1667 1841 2012 2174 2471 2327 2608 2737 2858 2971 3076 3174 3173 3342 3481 3482 3480 3479 3478 3410 3477 3476 3474 3405 3531 3529 3470 3401 3327 3578 3466 3396 3319 3318 3234 3141 3040 2931 2813 2689 2555 2267 2108 2265 1772 1771 1590 1591 1205  998 1204  999  336   99
 202  435  660  877 1086 1287 1480 1666 1842 2011 2173 2172 2325 2607 2736 2857 2970 3075 3172 3261 3341 3415 3414 3413 3412 3411 3335 3409 3475 3407 3532 3473 3472 3469 3245 3402 3467 3399 3398 3397 3320 3235 3142 3041 2932 2690 2417 2556 2109 2268 1946 2111 1773 1402 1401 1002  787  567  566  335  100
 201  434  659  876 1085 1285 1479 1665 1664 2010 2171 2324 2469 2606 2735 2856 2969 3074 3171 3259 3260 3340 3339 3338 3337 3336 3334 3159 3408 3332 3331 3406 3154 3403 3244 3328 3400 3324 3321 3239 3146 3236 3143 3042 2933 2814 2815 2557 2558 2418 2112 2110 1774 1206 1000 1001 1403  788  101  337  103
 200  433  658  875 1084 1478 1286 1663 1840 2009 2170 2323 2468 2605 2734 2967 2968 3072 3073 3170 3258 3257 3256 3255 3254 3253 3252 3251 3333 3249 3248 3247 3155 3404 3330 3326 3243 3242 3323 3149 3322 3237 3148 3144 2934 2817 2692 2559 2816 1947 2113 1592 1948 1404 1208 1405 1207  568  569  338  339
 199  432  657  874 1083 1284 1477 1662 1839 2008 2169 2322 2467 2604 2733 2855 2853 3071 3168 3069 3167 3166 3165 3164 3163 3161 3160 3158 3060 3250 3058 3057 2833 3246 3329 3325 3152 3151 3150 3147 3240 3046 3145 2936 2935 2818 2561 2691 2269 2562 2419 1950 1775 1593 1594 1004 1406  570  341  340  102
 198  431  656  873 1082 1283 1476 1661 1838 2007 2168 2466 2320 2732 2731 2966 2965 2728 3070 3169 3068 3067 3066 3065 3064 3162 3063 3061 2838 3059 2949 3157 3153 3055 2948 3052 2945 3048 3241 3047 2943 2940 3043 3045 2819 2694 2695 2560 2693 2420 2270 2271 1949 1778 1597 1211 1003  790  789  792  104
 197  430  655  872 1081 1282 1475 1660 1837 2006 2167 2321 2465 2603 2852 2854 2850 2726 2963 2964 2962 2960 2958 2843 2957 2956 3062 2953 2954 2950 3156 2713 2581 3054 2831 2705 3053 2827 3238 3049 2941 2825 2824 2823 2939 2820 2696 2563 2421 2272 2114 1595 1776 1407 1408 1209 1005 1006  572  107  342
 196  429  654  871 1080 1281 1474 1659 1836 2005 2166 2319 2851 2602 2460 2729 2727 2848 2849 2961 2846 2724 2959 2842 2719 2841 2717 2955 2952 2715 2712 2836 3056 2710 2832 3051 3050 2942 2944 2574 2433 2702 2938 2701 3044 2698 2821 2565 2422 2273 2115 2116 1596 1009 1210 1007 1598  794  791  571  105
 195  428  653  870 1079 1280 1473 1658 1835 2004 2165 2318 2601 2464 2730 2597 2596 2847 2725 2594 2723 2845 2844 2589 2718 2587 2840 2716 2584 2444 2951 2580 2834 2711 2576 2830 2438 2828 2706 2704 2826 2570 2822 2700 2937 2568 2564 2697 2423 2274 1952 1951 1779 1777 1599 1409 1213  793  343  106  108
 194  427  652  869 1078 1279 1472 1657 1834 2003 2164 2317 2600 2462 2459 2599 2457 2456 2454 2593 2722 2590 2721 2588 2720 2448 2586 2835 2839 2837 2714 2442 2582 2709 2292 2947 2946 2708 2575 2436 2434 2285 2571 2699 2432 2566 2280 2424 2425 2118 2117 1953 1780 1410 1411 1212 1008  573  346  344  347
 193  426  651  868 1077 1278 1471 1656 1833 2002 2163 2316 2463 2598 2313 2595 2458 2455 2153 2453 2452 2591 2451 2450 2302 2447 2446 2585 2298 2445 2583 2141 2579 2441 2578 2707 2437 2288 2829 2572 2287 2703 2569 2430 2567 2428 2281 2426 2276 2275 2119 1954 1781 1600 1214  796 1010  574  345  111  110
 192  425  650  867 1076 1277 1470 1655 1832 2001 2162 2315 2314 2157 2461 2311 2154 2309 2308 2592 2152 2307 2149 2304 2303 2449 2301 2300 2299 2297 2443 2295 2293 2137 2440 2577 2290 2291 1969 2435 2131 2286 2431 2283 2429 2282 2427 2279 2278 2277 2120 1955 1782 1601 1412 1215  575  795  797  348  109
 191  424  649  866 1075 1276 1469 1654 1829 1830 1831 2160 1997 2159 2312 2310 1821 1992 2155 1987 2151 2305 2148 1985 2147 2146 1981 2144 2143 2142 2296 2139 2294 1975 2136 2439 2289 2132 2134 1970 2129 2130 2284 1965 2127 1963 2126 2125 1960 2123 2122 1956 1784 1783 1413 1216 1011  798  799  349  576
 190  423  648  865 1074 1275 1653 1467 2000 1649 1999 1826 1996 2158 1994 2156 1993 1819 1989 1991 2306 2150 1986 1814 1984 1982 2145 1980 1809 1979 1977 2140 2138 1804 1974 1971 2133 2135 1798 2573 1968 1967 1795 1966 2128 1962 2124 1790 1961 1959 2121 1958 1957 1602 1414 1217 1013  578  577  112  113
 189  422  647  864 1073 1274 1468 1651 1652 2161 1998 1647 1824 1995 1823 1822 1455 1820 1990 1639 1988 1818 1815 1813 1634 1983 1811 1810 1807 1628 1803 1440 1976 1626 1802 1972 1622 1973 1801 1432 1619 1797 1964 1792 1615 1614 1791 1611 1789 1788 1787 1786 1785 1603 1604 1012 1218  800  579  351  350
 188  421  646  863 1072 1273 1466 1464 1650 1827 1648 1644 1460 1264 1825 1454 1456 1641 1640 1452 1816 1817 1636 1635 1633 1812 1632 1631 1808 1441 1978 1627 1439 1624 1623 1434 1037 1435 1800 1237 1618 1796 1617 1793 1427 1613 1425 1612 1610 1609 1608 1607 1606 1605 1415 1416 1014  801  580  114  115
 187  420  645  862 1071 1272 1465 1463 1462 1828 1461 1645 1646 1061 1643 1261 1263 1642 1453 1638 1637 1451 1449 1448 1447 1446 1445 1444 1630 1629 1806 1442 1625 1805 1436 1242 1239 1621 1235 1799 1236 1431 1794 1233 1428 1426 1230 1424 1423 1422 1421 1420 1419 1418 1417 1219 1220  802  581  116  117
 186  419  644  861 1070 1271 1270 1269 1268 1267 1266 1265  849 1459 1262 1458 1457 1259 1258 1257 1256 1450 1255 1253 1252 1251 1046 1047 1249 1248 1247 1244 1246 1245 1437 1041 1039 1036 1240 1032 1433  821 1430 1616 1232 1231 1229 1228 1025 1227 1226 1225 1224 1223 1222 1221 1015 1016  352  582  354
 185  418  643  860 1069 1068 1067 1066 1065 1064 1063 1062  850 1060 1059 1058 1260 1056 1055 1054 1053 1052 1254 1051 1050 1049 1250  834 1044 1443 1043 1042  830 1438 1040 1241  828 1238 1620 1035 1034  820 1429 1030 1029 1028 1027 1026  814 1024 1023 1022 1021 1020 1019 1018 1017  803  353  583  804
 184  417  642  859  858  857  856  855  854  853  852  851  631  848  629  845 1057  844  843  842  841  622  840  838  619 1048  615 1045  616  833  832  831  829 1243  609  826  825  607 1038 1033  603  375  373  817  600  816  815  594  596  595  812  811  810  809  808  807  360  805  584  119  118
 183  416  641  640  639  638  637  636  635  634  633  632  630  628  847  846  627  626  625  624  396  623  620  839  837  836  614  389  835  387  613  612  611  610  381  382  379  378  605  824 1031  138  822  374  819  818  598  597  370  813  593  592  591  590  589  588  806  587  585  355  356
 182  415  414  413  412  411  410  409  408  407  406  405  404  403  402  401  400  399  398  397  395  394  621  393  392  618  617  390  155  153  386  385  384  383  827  380  606  608  143  142  823  602  601 1234  599  372  136  368  369  367  366  365  364  363  362  361  359  586  358  357  120
 181  180  179  178  177  176  175  174  173  172  171  170  169  168  167  166  165  164  163  162  161  160  159  158  157  391  156  154  152  388  151  150  149  148  147  146  145  377  144  141  376  604  140  139  137  134  135  371  133  132  131  130  129  128  127  126  125  124  123  122  121
