# This puzzle is unsolvable
30
  2   1   3   4   5   6   7   8   9  10  11 128  14 129 130 236  17 132  19  20  21  22  23  24  25  26  27  28  29  30
116 117 118 119 121 228 122 123 124 125 126 127  12  15  16 131 238  18 133 135 136 137 138 140 246 141 142 143 144  31
115 224 225 325 226 326 229 230 231 232 233 234  13 335 235 337 240 241 134 242 243 244 245 139 247 248 249 250 145  32
114 223 324 416 227 419 329 330 331 422 332 424 333 426 237 428 239 339 340 341 343 344 345 346 437 349 347 251 146  33
113 222 323 415 417 120 327 420 421 505 423 507 334 425 336 512 338 430 431 432 342 434 435 436 438 348 252 253 147  34
112 321 220 322 499 500 418 504 328 647 581 506 508 511 427 585 429 513 514 515 433 517 518 519 520 439 351 149 254  35
111 219 414 413 576 575 502 501 578 580 649 648 583 509 510 653 586 588 589 591 516 592 593 594 522 521 440 443 148 350
218 320 221 412 644 573 503 577 579 757 646 650 709 584 652 587 712 809 655 716 658 659 660 595 523 352 150 255  37  36
110 109 319 643 411 498 574 756 706 582 708 758 760 761 651 711 656 654 713 715 657 718 597 664 354 596 353 257 152 151
217 318 410 497 496 572 645 704 702 705 707 800 802 759 710 869 763 807 590 764 767 768 662 661 524 441 442 256 258  38
108 107 216 409 317 495 640 703 754 836 803 838 865 801 762 806 766 714 808 810 843 844 526 525 600 444 356 359 259 153
104 105 316 408 494 570 571 642 755 797 641 798 805 804 866 840 868 667 812 770 720 663 445 721 598 260 528 154  39 355
103 106 215 214 493 407 638 753 752 699 799 864 837 839 887 845 870 813 669 717 765 719 772 771 262 599 527  44 155  40
212 213 492 315 490 701 491 700 835 796 892 863 884 867 888 889 895 886 811 722 872 769 723 601 666 360 261  41 158  42
313 406 312 314 568 637 569 639 698 751 831 834 862 841 896 897 815 842 871 846 847 665 724 450 446 529 264 159  45 156
210 101 565 567 697 403 634 696 832 794 860 861 882 877 885 879 873 874 818 817 849 814 725 448 602 362 357 358 263  48
 99 102 402 404 405 636 564 750 635 795 833 881 856 855 898 899 876 816 776 848 775 773 530 668 447 361 161  43 451 160
310 100 311 211 489 566 695 694 748 830 859 880 883 685 875 894 878 891 850 821 779 452 774 670 533 604 531  47 157  46
207  98  97 401 399 563 746 747 693 793 858 828 857 829 824 854 548 784 851 777 728 603 608 605 778 164 454 535 163 532
 96 307 209 485 561 487 562 632 749 792 791 787 788 827 785 890 852 782 677 733 676 675 541 606 449 610 363 162 268  50
 95 208 488 309 692 308 630 631 745 789 790 741 853 739 620 893 683 822 820 614 613 780 731 607 367 366 364   0 266  49
305 205 633 628 306 484 486 477 629 743 744 740 738 468 732 819 682 823 729 726 537 615 674 265  51 730 169 267 270 609
 94 204 206 396  92 690 478 689 691 476 825 553 624 684 826 737 783 619 735 672 734 463 456 455 373 365 453 370  53 458
395 304 482 398 560 627 400 557 555 626 622 742 686 618 550 469 679 680 671 464 616 542 176 368 536  55 372 459  52 272
483 202 302 303 481 397 558 559 475 556 687 621 551 287 736 382 286 285 678 612  69 379 781 457 540 271  54 534 168 275
 91 203 394 480 392 391 389 387 294 688 623 625 552 470 381 786 547 549 377 681  66  71 611 282 538 269 727 173  58 273
 90  93 300 297 479 390 192 191 295 190 554 293 474 184 288  73 284 179 283 617 376 280 465 371 374 369 673 165 375  64
200 201 199 301 298 194 296  80 388  78 473 472 386 385 380  74 546 183 182 544 462 171 543 539 167 279  67 461  61 166
 88  87 197 393  89 299 193  79  81  77 188 187  70 290 289 383 545 185 467  65 281 175  68 172 178 276 170 277  56  63
198  85 196  86  84 195  83  82 471 189 292  76  75 291 186 384  72 466 180 378 181 174 278  57 274  62 460  60 177  59
