# This puzzle is unsolvable
50
   2    1    3    4    5    6    7    8    9   10   11   12   13   14   15   16   17   18   19   20   21   22   23   24   25   26   27   28   29   30   31   32   34  229   37  232  598   36   39   40   41   42   43  239   44  243   47   49  244   50
 196  197  198  199  200  201  202  203  204  205  206  207  208  209  210  211  212  213  214  215  216  217  218  219  220  221  222  223  224  226  227  413  228  230  418  597   35  233   38  235  236  602  426  237  425   45   46  241  429   48
 195  384  385  386  387  388  389  390  391  392  393  394  395  396  397  398  399  400  401  402  403  404  405  406  407  408  409  410  411  225  412  415  414  595  231  419  420  234  422  421  423  601  424  606  605  238  428  246   54   51
 194  383  564  565  566  567  568  569  570  571  572  573  574  575  576  577  578  579  580  581  582  583  584  585  586  587  760  588  590  591  592   33  594  593  416  768  769  603  600  772  773  774  427  240  777  607  242  431  430  245
 193  382  563  736  737  738  739  740  741  742  743  744  745  746  747  748  749  750  751  752  753  754  755  756  757  758  759  589  762  763  926  764  765  766  417  596  767  599  936 1091 1238  604  937  939  609  608  610  780   53   52
 192  381  562  735  900  901  902  903  904  905  906  907  908  909  910  911  912  913  914  915  916  917  918  919  920  921  922  924  761  925  927 1082 1083  928  930  931  933  932  771  934 1377  776 1093 1094  779  778  432  247   55  433
 191  380  561  734  899 1056 1057 1058 1059 1060 1061 1062 1063 1064 1065 1066 1067 1068 1069 1070 1071 1072 1073 1074 1075 1223 1076  923 1227 1226 1363 1229 1230 1232 1231  770 1233 1236 1235 1375 1090  938  775  942  940  781  611  434  249  248
 190  379  560  733  898 1055 1204 1205 1206 1207 1208 1209 1210 1211 1212 1213 1214 1215 1216 1217 1218 1219 1220 1221 1222 1077 1224 1079 1080 1081 1228 1500 1085 1368  929 1372 1084 1087 1088 1239  935 1240 1241 1096 1097  941  614  435   57   56
 189  378  559  732  897 1054 1203 1344 1345 1346 1347 1348 1349 1350 1351 1352 1353 1354 1355 1356 1357 1358 1359 1360 1361 1362 1225 1078 1364 1497 1365 1366 1370 1505 1504 1234 1086 1506 1374 1089 1508 1237 1098  783 1244  612  613  251  250   58
 188  377  558  731  896 1053 1202 1343 1476 1477 1478 1479 1480 1481 1482 1483 1484 1485 1486 1487 1488 1489 1615 1490 1616 1731 1493 1494 1495 1734 1499 1737 1367 1622 1739 1503 1626 1627 1630 1376 1379 1092 1378 1099 1095  782  784  437  438  252
 187  376  557  730  895 1052 1201 1342 1475 1600 1601 1602 1603 1604 1605 1606 1607 1608 1609 1610 1611 1613 1614 1491 1730 1729 1617 1618 1496 1620 1619 1621 1501 1369 1623 1742 1849 1373 1509 1507 1510 1511 1243 1242 1246  944  615  785  253   59
 186  375  556  729  894 1051 1200 1341 1474 1599 1716 1717 1718 1719 1720 1721 1722 1723 1724 1725 1612 1835 1934 1727 1728 1492 1732 1733 1841 1735 1498 1845 1740 1741 1371 1625 1502 1629 1744 1743 1383 1632 1381  945  618 1382  946  436  254   60
 185  374  555  728  893 1050 1199 1340 1473 1598 1715 1824 1825 1826 1827 1828 1829 1830 1831 1832 1726 1834 2025 2184 1837 1839 1941 1937 1843 2117 1738 1944 1624 1846 1847 1946 1848 1628 1852 1631 1380 1512 1101 1100  786  943  439   61  255   62
 184  373  554  727  892 1196 1049 1198 1339 1472 1714 1823 1924 1925 1926 1927 1928 1929 1930 1931 1833 1933 1836 1935 1936 1838 2028 1938 2031 1939 2035 1736 2034 2119 1945 1947 1948 1851 1746 1633 1850 1745 1102  787 1245  441  617  616  256   63
 183  372  553  725 1048  890 1197 1338 1471 1597 1822 1821 1923 2016 2017 2018 2019 2020 2021 2022 1932 2024 2108 2027 2187 2029 2111 1840 1940 2033 1842 1844 2116 2118 2037 2036 2038 1747 1635 1748 1513 1384  948 1103  789  947  440  443  442  257
 182  371  552  891  726 1047 1195 1470 1713 1596 1820 1711 1922 2015 2100 2101 2102 2103 2104 2023 2105 2182 2026 2110 2107 2185 2109 2113 2032 1943 2114 2192 2258 2194 2120 1951 1950 1949 1634 1516 1385  949 1104  951  788  790  619  620  258   64
 181  370  551  724  889 1046 1336 1337 1469 1595 1712 1819 1921 2014 2099 2176 2244 2179 2177 2246 2247 2248 2309 2253 2186 2189 2112 2115 2260 1942 2191 2318 2193 2121 1952 2039 1853 1857 1636 1637 1514 1249 1248 1387  952  950  621  444  260   65
 180  369  550  723  888 1045 1194 1335 1468 1594 1710 1920 1919 2013 2098 2175 2245 2178 2305 2181 2307 2250 2106 2249 2405 2252 2030 2316 2255 2315 2257 2254 2259 2123 2040 2042 1751 1855 1638 1753 1749 1247 1515 1105 1250  791  446  445   66  259
 179  368  549  722  887 1044 1193 1467 1592 1593 1709 1818 2012 2097 2174 2243 2304 2180 2357 2437 2306 2362 2251 2183 2360 2312 2404 2310 2188 2256 2409 2317 2190 2195 1953 1954 1856 1750 1754 1854 1517 1388 1386 1251  953  792  622  623  261   67
 178  367  548  721 1043 1192 1333 1334 1466 1591 1707 1708 1918 2011 2096 2173 2400 2399 2352 2353 2436 2402 2308 2361 2439 2359 2311 2314 2366 2367 2371 2262 2043 2122 2263 2041 2196 1752 1640 1639 1518 1389 1253 1106  793  624  448  262   70   68
 177  366  546  547  886  720 1191 1332 1465 1590 1706 1817 1816 2010 2094 2354 2303 2356 2242 2358 2461 2401 2438 2363 2408 2406 2364 2313 2442 2365 2368 2198 2124 2261 2197 2044 1955 1858 1641 1390 1252 1519 1254  955  954  794  447  625   69  449
 176  365  545  719  884  885 1042 1190 1464 1589 1705 2009 2008 1917 2172 2095 2355 2300 2435 2464 2434 2495 2403 2463 2445 2407 2370 2410 2470 2320 2369 2319 2321 2199 2125 2045 1956 1859 1755 1520 1391 1108 1107 1109  956  795  265  626   71  263
 175  364  544  718  883 1041 1189 1331 1330 1329 1815 1916 1915 2093 2092 2237 2302 2241 2240 2433 2299 2398 2485 2446 2440 2467 2471 2468 2444 2413 2266 2322 2372 2200 2128 2046 1957 1860 1756 1642 1521 1392 1255 1111 1110  957  450  264   72   73
 174  363  717  882  880 1040 1039 1188 1704 1588 1813 1814 1914 2007 2170 2166 2171 2350 2301 2238 2431 2486 2484 2466 2443 2487 2411 2441 2469 2489 2414 2265 2264 2201 2126 2127 2047 1958 1861 1643 1522 1393 1256  798  627  796  451  266  267   74
 171  542  543  716  715 1034 1035  881 1462 1463 1587 1702 1812 1913 2167 2091 2168 2169 2295 2239 2465 2480 2462 2493 2496 2497 2492 2488 2473 2373 2324 2323 2267 2202 2129 2048 1959 1862 1757 1644 1523 1394 1257 1112  797  628  452  958  268   75
 712  173  361  878 1037 1187 1328 1461 1584 1586 1703 1811 1912 2006 2089 2297 2233 2397 2396 2395 2351 2430 2432 2482 2498 2491 2490 2450 2449 2447 2412 2374 2325 2268 2203 2049 1960 1863 1758 1645 1524 1395 1258  960  959  799  629  454  630  453
 360  362  359  714 1036 1184 1326 1186 1585 1701 1327 1810 2003 2005 2090 2087 2296 2349 2394 2391 2428 2460 2483 2499 2478 2472 2448 2475 2416 2415 2375 2326 2269 2131 2130 2050 1961 1864 1759 1646 1525 1396 1259 1113  961  800  631  270  455   76
 170  539  879 1038  876 1185 1325 1324 1460 1808 1583 1910 2004 1911 2235 2165 2234 2236 2481 2389 2346 2458 2459 2494 2479 2477 2474 2476 2451 2417 2376 2205 2270 2204 2133 2051 1962 1865 1760 1647 1526 1397 1260 1114 1115  801  632  456  271   77
 713  172  541  877 1033 1183 1323 1457 1458 1699 1700 1809 1907 1909 2088 2294 2390 2347 2348 2298 2344 2429 2427 2456 2455 2454 2453 2452 2420 2418 2328 2327 2206 2132 2134 2052 1963 1866 1761 1648 1527 1398 1261  963  962  802  633  457  272   78
 169  538  711  540 1032  875 1182 1322 1459 1456 1582 1806 1807 2002 2085 2164 2393 2083 2163 2392 2289 2426 2457 2425 2423 2384 2422 2421 2378 2419 2377 2271 2272 2207 2053 1964 1867 1762 1649 1650 1528 1263 1262 1116  964  803  634  273  458   79
 358  357  537  710 1031 1180 1181 1455 1580 1581 1698 1697 2001 1908 2162 2086 2231 2230 2232 2293 2341 2388 2387 2386 2337 2385 2382 2381 2380 2333 2379 2329 2273 2208 2135 2054 1965 1868 1763 1529 1530 1264 1399 1117  965  804  635  459  269   81
 168  356  709  535  873  874 1179 1321 1454 1579 1696 1805 1906 1999 2084 2000 2161 2345 2292 2342 2287 2286 2284 2340 2424 2336 2383 2335 2279 2334 2332 2330 2331 2209 2136 2055 1966 1869 1765 1652 1401 1118 1400 1119  966  805  636  460   80  274
 167  536  870  352 1029 1030 1178 1320 1453 1578 1695 1804 1905 1998 2160 2159 2229 2290 2226 2156 2343 2285 2221 2222 2338 2282 2281 2217 2280 2278 2277 2276 2274 2210 2137 2056 1967 1870 1766 1532 1764 1531 1265 1120  967  806  637  275  276   82
 166  706  707  708  354  353  872 1319 1452 1577 1694 1803 1904 1997 2082 2228 2227 2288 2291 2154 2225 2223 2339 2220 2219 2148 2218 2067 2216 2215 2214 2212 2275 2211 2138 2057 1968 1871 1654 1655 1651 1533 1266 1121  968  807  638  461  277   83
 165  164 1027  534 1028  705 1177 1318 1451 1576 1693 1802 1903 1996 2081 2158 2157 2155 2077 2224 2153 2152 1985 2151 2283 2149 2147 2146 2145 2144 2143 2213 2141 2140 2139 2058 1969 1872 1653 1534 1403 1402 1267 1122  969  808  639  462  278   84
 355  704  160  532  529  533 1176 1573 1316 1450 1690 1575 1902 1995 2080 1795 2078 1992 1894 2076 2074 2073 2072 2071 2070 2150 2068 1980 2066 2065 2063 2142 2062 2061 2060 2059 1873 1769 1767 1404 1535 1406 1268 1123  970  809  640  463  279   85
 163  161  162  351  346 1175 1315 1317 1448 1691 1449 1692 1800 1798 1901 1898 2079 1990 1989 1558 1988 1984 1983 1889 1982 2069 1981 1885 1979 1978 2064 1976 1975 1974 1973 1972 1970 1875 1771 1405 1770 1656 1269 1124  971  810  641  464  280   86
 157  530  350  869 1023  871 1024 1174 1173 1574 1796 1801 1686 1994 1993 1684 1991 1896 2075 1895 1789 1986 1786 1891 1888 1887 1783 1886 1884 1883 1977 1778 1881 1879 1878 1877 1874 1971 1657 1768 1659 1270 1271 1125  972  811  642  465   87   88
 703  531  702  349 1026 1022  867 1172 1314 1447 1571 1569 1441 1797 1899 1793 1794 1893 1679 1560 1892 1788 1785 1675 1784 1672 1673 1782 1781 1780 1882 1779 1880 1777 1776 1775 1876 1772 1541 1658 1660 1407 1126 1127  973  812  643  466  281   89
 159  528  868  348  701 1025 1171 1313 1688 1446 1572 1305 1900 1897 1437 1563 1791 1790 1561 1677 1987 1559 1890 1787 1555 1674 1553 1671 1670 1669 1668 1667 1666 1664 1663 1774 1773 1662 1542 1661 1415 1536 1408 1272  974  813  645  644  467   90
 345  347  865  527  866  864 1169 1312 1444 1439 1310 1687 1303 1799 1685 1683 1301 1792 1681 1564 1432 1678 1557 1676 1554 1427 1426 1552 1551 1550 1549 1548 1547 1665 1545 1544 1543 1412 1540 1411 1537 1409 1410 1273  975  814  646  468  282  283
 523  158  700  524 1021  699 1311 1570 1443 1689 1162 1307  685 1009 1682 1435 1436 1680 1438 1562 1433 1431 1556 1429 1428 1292 1290 1425 1424 1423 1421 1287 1420 1546 1283 1417 1138 1414 1413 1538 1277 1539 1129 1128  976  815  647  469  284   91
 342  156  525  526  698  863 1020 1445 1167 1015 1568 1440 1565 1566 1306 1299 1156 1157 1158 1434 1297 1296 1430 1295 1293 1291 1148 1147 1289 1288 1422 1284 1418 1142 1419 1416 1282 1281 1279 1278 1134 1276 1275 1130  977  816  648  470  285   92
 154  343  344  861 1170  862 1168 1166 1164 1309 1567  851 1442 1161 1300 1160 1159  680 1004 1298 1153 1152 1001 1294 1151 1149  998  996 1146 1145 1144 1286 1285  988 1141 1140 1139 1280 1136 1135 1133 1132 1274 1131  978  817  649  471  286   93
 155  153  522 1019  697 1018  857  858 1016 1165 1013 1012 1308 1304 1008  850 1007 1006 1154  843 1155  844 1000 1150  840  999  839  997  995  994  993 1143  992  828  989  832  487 1137  985  984  983  982  981  980  819  650  820  472  287   94
 152  696  341  521  695  860  692 1017  856  513  855 1163  686 1302  852  853  682  849 1005  846  845 1003 1002  841  673  672  837  838  836  835  834  833  991  831  987  830  986  660  827  825  824  823  822  296  979  821    0  473  288   95
 150  340  520  694  693  333  859  691  689  687 1014  854  511  683  508 1010  507  847  679  678  676  842  500  675  498  671  496  670  669  668  492  667  489  665  990  661  829  826  484  482  480  481  655  478  652  651  818  474  289   96
 338  151  519  518  143  516  334  690  515  512  684 1011  510  509  681  323  506  848  321  504  677  502  317  674  499  313  314  495  494  493  308  490  307  488  664  112  663  486  301  658  298  299  654  105  295  653  292  290  291   97
 339  337  146  335  517  144  142  332  514  330  688  137  327  135  132  326  505  131  130  319  503  501  318  316  315  497  312  121  310  309  491  666  116  662  305  304  303  110  300  483  659  297  479  657  656  477  475  476  100   98
 147  149  148  336  145  331  141  139  140  138  328  329  136  134  325  324  133  129  322  320  128  127  126  125  124  123  122  120  311  119  118  117  115  306  114  113  111  302  485  109  108  107  106  104  103  293  294  102  101   99
