# This puzzle is unsolvable
24
  2   1   3   4   5   6   7   8  10  11 102  12 103 188  15  17 108  18  20 195  21 197  22  24
 92  93  94  95  96  97  98  99   9 101 187 185  14 264  13 107 106 334  19 194 113 196  27  23
 91 176 252 177 179 180 181 184 100 256 260 259 104 105 265  16 262 109 191 193  26 112 117  25
 89  90 175 178 253 254 323 182 257 386 327 480 186 330 328 192 395 110 270 269  29 271 198 114
174 173 251 318 320 255 325 321 435 324 385 329 263 261 392 441 332 190 267 111 336 118 272 115
 88  85 319 379 432 322 383 258 382 388 389 387 440 189 444 333 391 335 266 274 116 338 200  28
171  87 172 377 380 433 431 183 478 438 326 390 439 331 483 486 393 485 394 268 204 275 199  30
170  84 250 249 381 474 473 376 572 434 437 543 481 482 436 484 519 340 446 396 445 337 119  31
167 317 430  86 314 378 476 511 384 514 542 515 564 545 517 523 489 487 522 201 203 341 120 121
373 169 243 316 374 369 540 538 513 477 559 574 516 491 399 442 443 488 397 449  35  33 123 400
246 248 244 245 247 375 472 560 555 479 544 561 521 566 562 344 448 492 339 273 202 126  32 124
168 427 429  83 537 428 468 512 475 557 573 541 565 546 490 568 547 447 524 342 398 122 276 209
241  79  80 423 240 510 470 539 507 558 570 569 530 563 553 407 518 128 405 277 278 280  34 279
 82 467 166 471 164 426 506 505 424 535 509 500 548 401 409 549 461 520 451 404 349 205  36  38
421  77 315 239 165 313 508 425 571 556 498 531 355 567 497 406 450 408 575 493 343 207 347  37
307 237 310 422 371 242 311 420 534 496 416 463 552 294 499 526 452 495 456 210 206 345 281  41
 78 161 160 233 305 466 372 312 308 414 532 554 504 455 550 282 529 459 346 127 457 125 131 208
  0 163 370 367 365 419 502 533 465 362 503 225 458 501 413 494 551 525 348 283 402 211  40 130
368  76 306  73  81 418 232 464 536 527 359 415 293 528 412 411 453 351 356 403 291  43 287 132
238 162 234 309  74 154 155 147 364 357 221 462  58 141 145 352 354 142 284 214  45  39 133 134
156  75 159 303  66 366 228 300  65 149 460 296 143 295 358 292 144 220 285 350 216 135  44 212
157 304 153  69  64 151  67 469 363 297 226 224  60 410 222  53 219 139 138 137 140 129 288  42
 71  70 301 235 229 231 417 299  63  62 148 361 298  57  56 223  52 215  51 353 217 289  49  50
 68 236  72 230 158 302 152 150  61 146 227  59 360  55  54 454 286 218 290 136 213  47  46  48
