# This puzzle is unsolvable
10
 33  63  71  51  68   4  66  11  42  43
 69  61   0   1  12  75  38  37  88  67
 30  29  78  39  36  18  31  65   5  45
 62  64  15  14  58  50  89  49  57  19
  3  41  73  46  83  48   8  52  40  74
  2  96  86  44  25  28  92  72  13  55
  9  85  27  84  17  94  79  70  20  21
 87  81  93   7  60  22  98  10  47  99
 54  82  16  32   6  34  56  53  77  24
 91  95  97  59  23  26  80  35  76  90
