# This puzzle is unsolvable
9
25 27  2 43 44 71  0 50 37
60  5 45 21 77  1 66 36 47
48 80 31 23 15 10 32 13 74
40 68 14 29  6 18 19 42  7
 3 78 55 26  4 16 35 11 73
57 59 65 24 12 49 39 20 58
38 79 62 54 41 75 72 64 67
70 33 30  9 53 52  8 22 76
56 28 17 63 34 46 61 69 51
