# This puzzle is unsolvable
39
   2    1    3    4    5    6    7    8    9   10   11   14  165   15  166   16  168   18   19   20   21   22   23   25  319  320  458  178  176   32  180  457  323  328  329  185   36   40   38
 152  153  154  155  156  157  158  159  160  161  162   13  308  307  309   17  167  312  170  314  171  174  175  317  455   27  459   26  184  181   37   30  326  594  186  590  191  189  332
 151  296  297  298  299  300  301  302  304  305  163   12  306  164  443  310  169  445  448  313  172  173  315  699   24  318  321   29  179  705  462  589   33   31  327  335  709   42  592
 150  295  432  433  434  435  436  437  687  439  796  567  566  440  442  444  446  311  577  450  316  449  807  453  580  177  702  583   28  710  704  324  818   34  585  464  333  192  187
 149  294  431  560  561  562  681  565  303  438  688  441  569  800  690  573  693  576  447  697  696  451  452  700  581  703  454  456  325  586  819  588  587  190  188   35  330   45  336
 148  293  430  559  680  792  793  563  682  684  900  686  568  571  803  691  694  572  575  805  910  579  809  578  916  812 1010  322  584  920  921  463  460  183   41  195  193   39  331
 147  291  292  429  558  679  683  564  794  795  798  570  799  902  801  905  802  574  806  695  909 1007  808  810  811 1176  582  918  706  182  468  337  919  711  917  467  466   44  196
 145  146  428  557  678  791  896  897  992  898  995  689 1163  904  903  804  692 1003  906 1004 1006  698 1173  914  913 1098  701  816 1102 1014 1016  821  461  465  591  469  339  334   43
 144  290  427  556  677  790  895  993 1160  899  901  996  997 1085  998  797 1001 1002  907 1093 1092 1005  912 1009 1095 1177  814  815  813 1101 1015  820  713  707   46  925  595  338   49
 143  289  555  554  676  789  894  991 1159  685  994 1081 1000 1299  999 1086 1088 1089  908 1094 1304 1170  911 1172 1097 1249 1178 1248 1013  924  596  822  817  923  597  194   47  197  199
 425  287  288  553  675  788  893 1079    0 1232 1082 1161 1162 1164 1237 1165 1238 1167 1169 1240 1171 1303  915 1008 1246 1311 1011  922  715 1103 1099  823 1018  708  470  712  473   48  471
 142  424  426  552  674  787 1078  990 1158 1231 1233 1080 1083 1354 1298 1234 1087 1241 1357 1358 1305 1242 1174 1243 1308 1312 1182 1100 1309 1019 1012  926  824  598  593  714  474   50  198
 141  285  286  423  673  786  892  891 1157 1077 1297 1296 1084 1236 1301 1168 1239 1091 1302 1090 1409 1360 1364 1175 1411 1366 1363 1179 1105 1180 1017  927  825  716  472  340  203   54   51
 140  422  551  550  672  785  986  989 1230  988 1295 1351 1235 1401 1300 1440 1355 1166 1356 1443 1361 1245 1307 1313 1096 1314 1247 1104 1250 1020 1021  826  827  601  342  202  200  341   52
 138  139  284  421  671  784  889  890 1076 1075 1229 1400 1352 1353 1473 1404 1402 1359 1500 1406 1446 1306 1362 1412 1408 1310 1181 1251 1252 1183  929  829  717  599  600  718  475  201  343
 283  420  547  549  670  783  987  985 1074 1156 1228 1226 1294 1292 1350 1399 1470 1512 1407 1497 1447 1445 1244 1448 1449 1367 1365 1315 1253 1184 1107  928  830  603  480  476  602  344   53
 137  419  669  418  782  886  888 1072 1073 1291 1155 1293 1225 1441 1398 1403 1495 1444 1476 1405 1477 1503 1478 1414 1415 1451 1316 1368 1023 1106 1022  721  932  719  828  345  478  477  204
 282  281  417  548  780  887  984  982 1227 1154 1290 1152 1349 1348 1439 1496 1438 1474 1501 1499 1515 1450 1453 1410 1413 1369 1255 1187 1185 1186 1108 1109  931  479  346  604  347  205   55
 136  135  546  668  781  885  667  884  983 1151 1153 1347 1396 1437 1397 1472 1442 1471 1498 1513 1475 1510 1480 1479 1452 1370 1317 1189 1111 1254 1026 1110  930  831  720  481  605  206   56
 134  280  415  279  545  666  779  981 1071 1070 1224 1289 1346 1435 1394 1436 1469 1494 1502 1514 1511 1516 1481 1482 1416 1318 1256 1188 1112 1190 1025 1024  933  723  722  482  348  207   57
 277  132  278  544  665  778  883  980 1069 1223 1149 1288 1287 1345 1395 1468 1519 1493 1508 1518 1517 1506 1454 1483 1371 1417 1258 1372 1027  934 1028  833  832  724  606  607  349  208   58
 276  131  416  543  664  776  777  979 1150 1067 1222 1390 1068 1393 1341 1467 1492 1490 1520 1487 1505 1485 1484 1455 1504 1257 1259 1261 1113  935 1029  936  834  725  608  483  350   60   59
 133  412  414  413  663  775  882  881  978 1286 1221 1388 1340 1344 1434 1489 1509 1462 1384 1507 1486 1459 1419 1375 1456 1320 1418 1373 1192 1191 1114  835  726  727  609  484  210  209   62
 275  541  542  274  661  774  880 1219 1147 1066 1148 1389 1432 1433 1466 1464 1465 1428 1425 1488 1463 1424 1458 1374 1421 1457 1260 1319 1193 1115 1030  837  937  610  485  486  351   61  211
 128  129  411  130  660  662  977  976 1065 1143 1343 1285 1342 1146 1430 1431 1426 1427 1461 1383 1381 1460 1422 1376 1323 1322 1321 1324 1262 1116 1034 1031  836  728  611  487  352  212   63
 273  538  540  539  773  879  974  973 1062 1218 1220 1145 1392 1391 1337 1277 1429 1385 1491 1382 1380 1331 1423 1420 1379 1377 1325 1264 1194  941 1117  938  939  612  613  488  353  213   64
 127  272  408  659  877  772  876  975  972 1284 1216 1339 1136 1138 1335 1387 1275 1386 1333 1332 1272 1328 1329 1268 1327 1326 1266 1195 1263 1118  940 1032  839  838  355  356  354  214   65
 126  536  407  410  658  771 1061 1064 1063 1215 1283 1217 1281 1214 1336 1338 1276 1334 1207 1274 1273 1271 1270 1378 1269 1267 1199 1265 1196 1120 1035 1119  942  729  730  490  489  215   66
 268  406  409  657  271  535  537  971  875 1144 1280 1282 1055 1211 1278 1212 1279 1208 1132 1048 1205 1204 1330 1203 1202 1201 1200 1197 1122 1121 1033  840  731  732  614  615  358  216   67
 125  123  124  404  656  770  878  970 1060 1140 1057 1056 1139 1213 1054 1137 1210 1133 1206 1131 1130 1129 1128 1127 1126 1125 1198 1123 1039 1036  943  841  734  733  616  618  491  217   68
 266  269  405  533  655  769  768  871  874 1141 1058  965  964  864 1052 1053 1135 1050 1049  957 1047 1046 1045 1044 1043 1042 1124 1040 1038 1037  944  945  842  617  735  357  359  218   69
 122  120  534  654  529  767  873 1059  870  872 1142  866  643  963  962  961 1134 1051  959  958  956  955  855  954  952  951 1041  949  947  849  946  846  843  844  493  492  360  219   70
 401  265  267  766  653  532  969  762  868  967  966  867  865  757  863  861 1209  960  859  752  750  857  748  953  854  853  852  850  948  848  740  847  845  736  619  494  361  220   71
 121  270  402  263  651  531  525  765  258  968  760  759  758  642  756  862  755  860  754  858  751  856  749  747  746  745  950  744  504  741  625  739  738  737  620  495  362  221   72
 119  117  397  527  403  526  394  764  869  523  761  521  640  520  386  517  639  637  753  636  635  634  633  632  630  629  851  742  374  503  626  624  623  622  621  496  363  222   73
 261  262  530  528  396  395  108  648  255  645  644  646  519  389  387  516  514  638  515  513  512  510  239  509  631  508  627  743  507  372  502  501  500  499  498  497  364  223   74
 264  649  400  398  652  650  647  392  110  107  104  101  641  390  102  518  385  383  244  382  381  511  379  377  376  506  236  505  375  373  371  370  369  368  367  366  365  224   75
 118  114  113  260  524  257  109  763  105  252  253  393  249  250  388  246  245  384  243  242  241  380  240   92  378  238  235  628   88  233  232  231  230  229  228  227  226  225   76
 116  115  112  399  259  111  256  254  106  522  251  391  103  248  100  247   99   98   97   96   95   94   93   91   90   89  237   87  234   86   85   84   83   82   81   80   79   78   77
