# This puzzle is unsolvable
36
   2    1    3    4    5  142  145    6    8  147   10   11  152  153   14   16  156   18   19   21  160   22   23   26  165  168  167  169  643  170   30  173   34  303   33   35
 141  273  399  144  276  401    7  279    9  149  400  282   12  283   15   17  154  157  159   20  161  415  162   24  296   27  298   28  423   32   31  172  176  174  305   36
 140  138  272  277  143  275  146  148  404  281   13  151  284  407  285  155  287  288  158  289  290  293  416  163   25  535  295  171  166  420  300  175  302  304   39  426
 139  137  396  397  513  621  403  517  402  278  280  150  405  406  409  286  525  410  411  413  292  531  294  417  164  297   29  538  422  424  301  425  541  427   40   37
 270  271  398  274  620  721  514  723  518  519  627  520  521  730  523  408  524  527  412  635  528  414  529  418  640  641  419  536  537  421  539  306  429  181   38  177
 394  512  393  395  511  720  515  623  724  816  626  725  628  728  522  823  732  526  634  633  735  291  532  739  639  740  642  644  836  645  299  646  540  178  309   41
 136  269  268  510  619  622  722  813  726  815  901  629  625  727  729  821  733  632  734  824  637  530  638  737  533  831  534  916  833  835  428  542  307  543  308   44
 135  134  267  617  509  719  812  814  516  898  973  630  631  904  820  905  979  731  909  907  826  636  829  738  914  830  743  989  837  742  834  745  647  430   42   43
 132  392  614  390  618  718  811  899  624  970  818  900  903  817 1042  822  980  906  908  825  910  736  828  912  913  832  915  741  648  649  544  744  431  179  180   46
 131  133  391  508  616  895  897  896  971 1043  819 1044 1101  976  978 1047 1106  981 1048  982  985  827  986 1054  990  746  838  747  650  653  546  432  312  310   45  184
 265  266  388  716  810  507  717  894  972  974 1041 1102  977 1103 1045 1046  983 1051 1202  984 1110 1052  987  911 1055  993  991  994  652  840  920  545  434  314   47  433
 130  263  386  506  502  809  808  893 1039 1040 1098  975 1105  902 1200 1107 1158 1109 1049 1050 1111 1112 1053  988 1058 1056  917  748  651  548  547  183  182  313  185  311
 129  264  262  615  389  715  806  807  892  969 1100 1150 1153 1104 1233 1155 1157 1201 1159 1160 1161 1162 1163 1113 1164 1115  992  918  749  919  654  750  436  435   48   49
 261  387  612  505  503  714  713  968  967 1034 1038 1099 1195 1154 1234 1156 1199 1108 1264 1203 1204 1205 1206 1165 1116 1114 1062 1057  839  751  549  550  437  315  187  186
 128  385  501  613  384  805  889  891 1036 1151 1094 1196 1197 1152 1228 1261 1232 1236 1283 1295 1265 1167 1238 1239 1118 1207 1060  841  922  997  923  655  438  317   50   51
 260  126  259  504  610  611  710  966  965 1149 1037 1260 1033 1192 1231 1262 1282 1263 1294 1214 1237 1293 1243 1166 1240 1059  924  921  995  842  657  656  439  188  316   52
 124  125  127  500  608  712  963  890 1091 1194 1148 1097 1230 1235 1278 1198 1259 1281 1267 1286 1284 1268 1208 1064 1169  998 1117  996  755  752  753  551  552  190  319  189
 257  383  609  258  709 1093  711  888  884  803 1145 1092 1280 1035 1193 1095 1256 1291 1292 1244 1063 1287 1242 1209  843 1120 1119  927  754  844  659  658  441  318  553   53
 123  381  499  382  607  801  804  802  800  885 1096 1031 1189 1147 1229 1275 1289 1258 1270 1273 1211 1266 1210 1212 1065  999  925 1061  757  845  756  442  554  440  320   54
 122  256  380  498  496  606  887  799 1144  961 1190 1255 1191 1257 1254 1146 1279 1250 1219 1172 1285 1245 1241 1170 1122 1000 1002  926  929  660  555  556  443  193   55  191
 121  255  379  378  605  708  497  705  886  962 1030  964 1277 1227 1136 1290 1253 1252 1288 1249 1271 1168 1213 1121 1171 1124 1003 1123  847  661  928  194  444   57  321   56
 251  254  120  253  604  707  798  883 1032  960 1029 1028 1087 1226 1276 1135 1269 1274 1220 1218 1178 1075 1174 1073 1001 1069 1125 1066  849  759  557  558  662  195  196  323
 119  250  377  495  494  603  706  797  959 1088 1090 1142 1187 1143 1223 1184 1183 1251 1177 1217 1248 1179 1247 1067 1127 1126  930    0  846  760  663  758  192  322   58   59
 252  117  376  493  602  796  704  882  880  958 1086 1188 1089 1225 1221 1182 1222 1134 1180 1272 1246 1175 1130 1173 1070 1068 1004  848  665  564  664  446  325   60  326  197
 374  118  249  492  600  703  702  794 1027 1026 1141 1186 1139 1224 1185 1137 1133 1017 1077 1181 1129 1131 1176 1216 1074 1128 1005 1006  851  762  563  448  445  324   61  198
 116  375  491  599  701  601  881  795  957 1085 1025 1022 1084 1138 1083 1081 1080 1078 1014  946 1076  942 1215  939  940 1072  934  936  850  761  559  932  667  447  327  560
 115  373  372  490  699  793  877  879  953 1024 1140 1023 1021 1020 1082  948 1018  947 1132 1079  943  941 1010 1011 1071  937  931  852  764  763  561  765  666  449  199   62
 114  248  246  598  597  700  955  878  956  952  873  951  950  949 1019  868  866  580 1015 1016  683  863  776  938  675 1009 1007  933  856  562  668  766  451  330   63  201
 245  113  371  489  698  790  792  954  875  787  874  872  871  870  869  583  781  945  865  944  576  678 1013  858  770  771 1008  855  768  669  450  453  670  328  329  202
 247  111  370  487  697  478  488  788  693  692  786  785  689  783  780  867  469  686  682  864  681  575  778  677  859  853  772  769  673  935  452  854  565  331   64   65
 112  369  485  593  236  696  482  791  789  590  691  476  784  688  687  782  779  777  684  466  680  862 1012  465  773  857  671  566  570  457  672  569  567  332  200  203
 242  595  484  483  101  596  591  364  876  230  586  587  474  585  584  472  468  470  581  775  467  577  350  860  774  676  571  674  459  211  458  767  454  333   67   66
 243  244  594  368  360  486  362  695  479  480  690  359  357  227  353  352  354  223  226  579  578  346  861  679  345  572  343  461  340  338   74  456   75  339  334  204
 110  366  104  592  365  237  241  235  361  588  229  231  355  477  228  473  582   88  348  349  347  218  462  574  573  464  463  460  342  214  568   76  336  335   70   68
 106  108  107  240  239  100  694  363  234  358   97   95   96   94  589   89  685  471  351   87  221  220  219  217  344  216  212  341   79  213  209  455  337  206   69  205
 105  103  109  481  367  102  238   99   98  232  475  233  356   92   93   91  225   90  222  224   86   85   84   83   82   81  215   80   77   78   73  210  208  207   72   71
