# This puzzle is unsolvable
73
   2    1    3    4    5    6    7    8    9   10   11   12   13   14   16   17  305   18   20  307   22  310  862  311 1126  594   23 1384   28  317   31   32   33   34   35   36   37   38  326   39   40  329   42   43   44   47  334   48   49   50   52  339  340   53   54   55   57   58   60   61  347   63  630   65  352   66   67   68   69   71   72  359   73
 288  289  290  291  292  293  294  295  296  297  298  299  300  301   15  303  855  306  308  588   21  589  313   24   26  590  314  591   30  593  597  318  320  321  601  322  323  324  325  327   41  328  330  331   45  332  612  335  336  337  338   51  619  341  342   56  343  624  345   59  346   62  350  351   64  353  354  355  357   70  637  358   74
 287  568  569  570  571  572  573  574  575  576  577  578  850  580  302  852  583  585   19  854  586  309 1123  861   25  864 1124  312   29  316  596  319  599  871  600  602  603  604  605  606  607  608  609  610  611   46  333  614  615  887  616  617  890  620  622  623  344  895  625  627  348  628  898  631  902  632  633  635  356  636  361  638   75
 286  567  840  841  842  843  844  845  846 1110  847  848 1113  849  581  851 1118  304  587  584 1120  863 1625  859  315   27  592  867  595 1130  868  598 1132  869  872  873  874  875  876  877  878  879  880  881  882  883  613  884  885  886  888  618  889  891  621  893  894  896 1159  626  349  899 1418  629  900  903  904  634  905  907  360  362   76
 285  566  839 1103 1104 1105 1106 1108 1109 1612 1366 1112 1115 1116  579  582 1621 1117  856 1119  857  860 1626 1627 1381 1382 1129  865  866 1632 1131 1133 1134  870 1135 1136 1137 1138 1139 1140 1141 1142 1143 1144 1145 1146 1147 1148 1149 1150 1151 1152 1153 1154  892 1156 1157 1158 1160  897 1162 1417 1416  901 1164 1667 1165 1167  906  908  639  363   77
 284  565  837  838 1360 1361 1107 1362 1364 1610 1365 1368 1369 1114 1371  853 1619 1375 1374  858 1122 1121 1377 1865 1127 1125 1378 1630 1385 1633 1386 1387 1388 1389 1390 1391 1392 1393 1394 1395 1396 1397 1398 1399 1400 1401 1402 1403 1404 1405 1406 1407 1408 1409 1155 1411 1412 1413 1414 1662 1666 1415 1161 1665 1420 1422 1669 1168 1423 1169  909  640   78
 283  564 1102 1101 1608 1604 1363 1609 1851 1852 1614 1111 1617 1855 1616 2087 1618 1620 2091 1376 1862 1623 1863 1380 2097 1867 1379 1869 1628 1383 1634 1871 1635 1636 1637 1638 1639 1640 1641 1642 1643 1644 1645 1646 1647 1648 1649 1650 1651 1652 1653 1654 1655 1656 1410 1657 1658 1660 1661 1903 1664 1419 1163 1166 1907 1670 1424 1171 1170  641  642  364   79
 282  563  836 1358 1356 1607 1848 1611 2302 1367 2082 1853 2522 2085 1370 1857 1373 1861 1372 1622 1860 2092 2094 2095 1624 1629 1128 2323 2100 2102 1872 2104 1873 1874 1876 1877 1878 1879 1880 1881 1882 1883 1884 1885 1886 1887 1888 1889 1890 1891 1892 1893 1894 1895 1896 1897 1659 1898 1899 2132 1663 1901 1904 1905 1421 1668 1671 1425  910 1172  911  365   80
 281  562 1357 1100 1359 1849 2080 2079 1850 2307 2305 1615 2084 1856 1854 2089 1858 2527 2529 2313 2315 2093 1864 2096 2320 2322 2098 1868 1870 1631 2101 2103 2105 1875 2107 2108 2109 2110 2111 2112 2113 2114 2115 2116 2117 2118 2119 2120 2121 2122 2123 2124 2125 2126 2127 2128 2129 2130 1900 2131 2133 2134 2358 2136 1906 1908 1426 1173 1174  912  643  366   81
 280  561  834 1099 1847 1846 1843 2077 1613 2519 2304 2520 2083 2088 2309 2311 2312 2736 1859 2530 2528 2317 2318 2319 2534 2321 2099 2538 2324 2325 2326 2327 2328 2106 2330 2754 2331 2333 2334 2335 2336 2337 2338 2339 2340 2341 2342 2343 2344 2345 2347 2562 2348 2349 2350 2351 2352 2353 2354 1902 2356 2135 2138 2359 2141 1911 1672 1909 1175  913  644  367   82
 279  560  833  835 1845 1355 1606 2081 2729 2078 2303 2929 2086 2308 2733 2526 2090 2735 2314 2936 2316 2532 2533 2535 2741 2742 2943 2539 2746 2540 2541 2543 2750 2329 2544 2545 2332 2547 2548 2550 2551 2552 2553 2554 2555 2556 2557 2558 2560 2561 2346 2563 2564 2565 2772 2566 2567 2568 2569 2355 2570 2357 2572 2573 2360 1427 2137 1429 1428  914  645  368   83
 278  559  832 1602 1097 1098 1353 2073 2728 1844 2727 2730 2523 2525 3123 2732 2310 2734 2737 2935 2738 2531 2740 1866 2537 2942 2743 2744 2747 2946 2748 2542 2751 2950 2752 2546 2952 2549 2757 2957 2956 2759 2760 2761 2762 2763 2765 2766 2559 2767 2768 2769 2770 2970 2771 2773 2774 2975 2974 2776 2571 2779 2574 2140 2139 1913 1912 1675 1176  646  647   84   85
 277  558  831 1601 2075 1603 1351 1842 2518 2517 2521 2306 2930 2524 3304 3122 2932 2933 2937 3128 2739 2939 3129 2536 2940 3133 2745 2945 3135 3137 2947 2749 2949 3142 3324 2953 3144 2756 2954 3147 2758 2958 2959 2960 2961 2962 2764 2964 2965 2966 2967 2968 2969 2971 2972 2973 2775 3347 2977 2978 2778 2780 2363 2361 2142 1676 1673 1178  915 1910  370  371  369
 276  557  830 2076 1605 1095 2301 2300 2074 2927 2926 2928 3120 2931 2731 3124 2934 3308 3125 3126 3127 2938 3130 3131 2941 3132 3134 2944 3496 3138 3140 2948 3141 2951 2753 3143 2755 3145 2955 3148 3149 3332 3151 3152 3153 3154 2963 3155 3156 3158 3159 3342 3160 3161 3346 3162 3164 3166 2777 3167 2781 2782 2362 2575 2143 1914 1674 1432 1177  916  648   88  372
 275  829  828 1599 1354 1096 1841 2299 2298 2726 2516 2725 3119 3305 3121 3306 3307 3309 3310 3485 3311 3312 3313 3314 3315 3316 3317 3318 3136 3319 3494 3139 3498 3323 3325 3326 3327 3329 3146 3504 3330 3507 3150 3334 3335 3336 3337 3338 3339 3157 3341 3340 3344 3519 3686 3348 3522 3165 3349 2976 3168 2979 2577 2576 2364 1915 1431 1433 1179  917  649   87   86
 555 1093 1094 1352 1600 1349 1840 2296 2072 2515 2724 2925 3118 3303 3480 3481 3482 3650 3483 3484 3486 3487 3488 3489 3490 3491 3659 3492 3495 3320 3322 3497 3665 3499 3500 3668 3501 3502 3505 3506 3331 3674 3333 3509 3510 3511 3512 3513 3514 3516 3518 3343 3517 3685 3163 3520 3521 3523 3169 2980 2783 2784 2578 2365 2144 1916 1678 1180 1430  918  650  374  373
 273  556  270  553 1092 1838 1839 1598 2297 2514 2723 2924 3117 3302 3479 3648 3649 3809 3651 3652 3653 3654 3814 3656 3657 3658 3818 3661 3493 3662 3321 3663 3823 3666 3667 3669 3328 3670 3503 3671 3672 3832 3508 3676 3677 3678 3990 3837 3681 3682 3515 3683 3843 3684 3688 3345 3690 3352 3524 3171 2981 2579 2366 2367 2145 1679 1677 1434 1181  919  651   89   90
 274  272  827 1597  826 2070 1347 1596 2295 2513 2722 2923 3116 3301 3478 3647 3808 3960 3810 3811 3812 3655 3813 3815 3816 3817 3819 3660 3820 3821 3822 3824 3664 3825 3826 3827 3979 3828 3831 3983 3833 3673 3675 3834 3835 4130 3680 3839 3840 3993 3995 4515 3994 3845 3687 3846 3689 3525 3350 3170 3351 2982 2580 2368 2146 1917 1680 1435 1182  920  921  652  375
 552  825  554 1091 1348 1595 1836 1834 2293 2512 2721 2922 3115 3300 3477 3646 3807 3961 4104 3962 3963 3964 3965 3966 3967 3968 3969 3970 3971 3972 3973 4117 3974 3976 3977 3978 4122 3829 3830 3982 4127 4262 3984 3988 4129 3989 3836 3992 4134 3841 4137 3842 4139 3997 3847 3848 3691 3526 3353 3172 2983 2785 2786 2581 2147 1918 1681 1436 1183  922  653  376   91
 822  271  824 1090 2065 2294 1594 1350 2511 2510 2720 2921 3114 3299 3644 3476 3805 3806 3959 4105 4106 4107 4108 4109 4110 4111 4112 4113 4250 4115 4116 3975 4253 4118 4255 4121 3980 4123 3981 4258 4124 3986 3985 4263 4131 3838 3679 3991 4132 4265 4136 3844 4516 3996 3998 3849 3692 3527 3354 3173 2984 2787 2582 2369 2148 1919 1682 1437 1184  923  654  377   92
 269  550 1089  551 1593 2067 1837 2071 2292 2068 2719 2920 3113 3298 3645 3804 3958 3957 4103 4240 4241 4242 4243 4244 4245 4246 4247 4248 4114 4249 4251 4379 4252 4119 4256 4506 4384 4259 4385 4125 4126 4391 4128 3987 4394 4267 4395 4266 4133 4269 4135 4399 4138 4276 3999 3850 3693 3528 3355 3174 2985 2788 2583 2370 2149 1920 1683 1438 1185  924  655  378   93
 268  549 1087 1835 1346  823 1345 2066 2069 2509 2718 2919 3112 3297 3475 3474 3643 4102 4101 4239 4368 4369 4370 4371 4372 4373 4374 4375 4376 4377 4378 4498 4499 4380 4254 4503 4120 4257 4616 4504 4261 4387 4390 4508 4264 4513 4512 4396 4271 4397 4268 4398 4142 4140 4003 4001 4000 3531 3356 2789 2790 2988 2584 2371 2150 1921 1684 1439 1186  925  656  379   94
 267  548  821 1086 1344 1343 1833 1088 2291 2508 2717 2918 3111 3296 3473 3642 3802 3803 3956 4238 4367 4488 4489 4490 4491 4492 4493 4494 4495 4607 4496 4609 4500 4382 4381 4502 4386 4383 4389 4507 4260 4388 4510 4393 4725 4623 4511 4270 4626 4517 4273 4272 4141 4275 3697 3530 3529 3358 3176 2989 2986 3175 2585 2372 2151 1922 1685 1440 1187  926  657  380   95
 266  547  820 1084 1342 1592 2064 1591 2290 2507 2716 2917 3110 3295 3472 3640 3641 3955 4100 4237 4366 4487 4600 4601 4602 4603 4604 4605 4606 4608 4711 4610 4497 4611 4714 4501 4613 4813 4719 4505 4722 4619 4509 4622 4620 4392 4624 4629 4625 4628 4627 4401 4400 4005 4002 3695 3694 3696 3357 3179 2987 2791 2586 2373 2152 1923 1686 1441 1188  927  658  381   96
 264  265  818 1341 1085 1832 1831 2063 2289 2506 2715 2916 3109 3294 3471 3639 3801 3954 4099 4236 4365 4486 4599 4704 4705 4706 4707 4708 4709 4710 4806 4712 4809 4713 4810 4716 4612 4615 4721 4903 4617 4816 4618 4723 4820 4726 4822 4727 4520 4730 4514 4518 4274 4277 3853 3852 3851 3177 3532 3360 3178 2792 2587 2374 2153 1924 1687 1442 1189  928  659  382   97
 545  544 1083  546 1590 1340 1589 1830 2288 2505 2714 2915 3108 3293 3470 3638 3800 3953 4098 4235 4364 4485 4598 4703 4800 4801 4802 4803 4804 4805 4893 4807 4896 4715 4811 4898 4614 4812 4815 5053 5052 4904 4819 4818 4821 4908 4909 4729 4522 4728 4519 4402 4145 4143 3854 4004 3698 3533 3359 3361 2990 2793 2588 2375 2154 1925 1688 1443 1190  929  660  383   98
 263  817  819 1082 1339 1588 1829 2062 2287 2504 2713 2914 3107 3292 3469 3952 3798 4097 4096 4234 4363 4484 4597 4702 4799 4888 4889 4890 4970 4891 4972 4895 4808 4897 4979 4976 4718 4717 4814 4980 4720 4901 4906 4621 4902 4724 4910 4823 4731 4630 4521 4403 4279 4404 4144 3855 3699 3534 3362 3180 2991 2794 2589 2376 2155 1926 1689 1444 1191  930  661  384   99
 262  543  816 1081 1338 1587 1828 2061 2286 2503 2712 2913 3106 3291 3468 3799 3636 3951 4095 4233 4362 4483 4596 4701 4798 4968 5039 5040 4969 4892 4971 4894 4973 5046 4975 5111 4978 4899 4900 4981 4982 5055 4817 4984 4905 4987 4911 4825 4732 4631 4405 4281 4146 4007 4278 3702 3856 3701 3363 3181 2992 2795 2590 2377 2156 1927 1690 1445 1192  931  662  385  100
 261  542  815 1080 1337 1586 1827 2060 2285 2502 2711 2912 3105 3290 3467 3637 3796 3797 3950 4232 4361 4482 4595 4700 4796 4887 4966 5041 5043 5106 5161 5044 4974 5047 5109 4977 5048 5049 5168 5051 5114 4983 5118 4986 4907 4733 5057 4824 4734 4632 4523 4148 4280 4006 4147 3700 3535 3857 3364 3182 2993 2796 2591 2378 2157 1928 1691 1446 1193  932  663  386  101
 260  541  814 1079 1336 1585 1826 2059 2284 2501 2710 2911 3104 3289 3466 3635 3795 3949 4094 4231 4360 4481 4594 4699 4886 4797 4965 5042 4967 5105 5162 5163 5108 5164 5110 5112 5050 5113 5115 5217 5117 5175 5054 5056 5058 4913 5059 4912 4735 4633 4524 4406 4149 4150 4008 3859 3858 3365 3537 3183 2994 2797 2592 2379 2158 1929 1692 1447 1194  933  664  387  102
 259  540  813 1078 1335 1584 1825 2058 2283 2500 2709 2910 3103 3288 3465 3634 3794 3948 4093 4230 4359 4480 4593 4698 4795 4884 5038 5037 5104 5160 5209 5107 5045 5165 5212 5166 5167 5116 5216 5220 4985 5172 5120 5119 4989 4988 4829 4826 4635 4827 4526 4282 4284 4009 3860 3703 3861 3538 3536 3184 2995 2798 2593 2380 2159 1930 1693 1448 1195  934  665  388  103
 258  539  812 1077 1334 1583 1824 2057 2282 2499 2708 2909 3102 3287 3464 3633 3947 4092 4229 4358 4357 4479 4592 4794 4883 4963 4885 5102 5103 5158 5159 5208 5210 5211 5213 5214 5253 5169 5255 5170 5121 5171 5173 5060 4991 4914 4990 4736 4737 4410 4634 4525 4407 4283 4408 4151 3862 3704 3366 3185 2996 2799 2594 2381 2160 1931 1694 1449 1196  935  666  389  104
 257  538  811 1076 1333 1582 1823 2056 2281 2498 2707 2908 3101 3286 3463 3632 3793 3946 4091 4228 4356 4591 4696 4697 4793 4964 4882 5036 5101 5207 5206 5248 5249 5250 5251 5252 5284 5215 5259 5257 5256 5258 5174 5122 5062 4992 4828 4915 4830 4636 4527 4409 4011 4152 4010 3863 3540 3539 3541 3186 2997 2800 2595 2382 2161 1932 1695 1450 1197  936  667  390  105
 256  537  810 1075 1332 1581 1822 2055 2280 2497 2706 2907 3100 3285 3462 3631 3792 3945 4090 4227 4355 4478 4590 4791 4792 4881 4962 5035 5100 5156 5157 5247 5280 5281 5282 5286 5285 5254 5287 5218 5221 5176 5061 5222 5124 4993 4916 4831 4738 4638 4637 4286 4285 4153 4012 3706 3705 3368 3367 3187 2998 2801 2596 2383 2162 1933 1696 1451 1198  937  668  391  106
 255  536  809 1074 1331 1580 1821 2054 2279 2496 2705 2906 3099 3284 3461 3630 3791 3944 4089 4226 4354 4477 4694 4695 4693 4880 4960 4961 5099 5205 5246 5279 5278 5304 5305 5283 5307 5323 5309 5288 5289 5219 5180 5125 5177 4994 4917 4832 4639 4739 4413 4412 4287 4154 4013 3864 3707 3542 3369 3188 2999 2802 2597 2384 2163 1934 1697 1452 1199  938  669  392  107
 254  535  808 1073 1330 1579 1820 2053 2278 2495 2704 2905 3098 3283 3460 3629 3790 3943 4088 4225 4475 4589 4476 4588 4790 4789 4879 5034 5098 5155 5204 5245 5302 5303 5320 5306 5318 5308 5312 5310 5178 5261 5126 5223 5123 4995 4918 4833 4740 4528 4411 4529 4288 4155 4014 3865 3708 3543 3370 3189 3000 2803 2598 2385 2164 1935 1698 1453 1200  939  670  393  108
 253  534  807 1072 1329 1578 1819 2052 2277 2494 2703 2904 3097 3282 3459 3628 3789 3942 4087 4224 4353 4474 4587 4692 4788 4878 4959 5033 5032 5097 5202 5203 5243 5277 5319 5321 5311 5324 5328 5290 5224 5260 5127 5063 4996 4919 4834 4741 4532 4530 4640 4531 4289 4156 4015 3866 3709 3544 3371 3190 3001 2804 2599 2386 2165 1936 1699 1454 1201  940  671  394  109
 252  533  806 1071 1328 1577 1818 2051 2276 2493 2702 2903 3096 3281 3458 3627 3788 3941 4086 4223 4352 4473 4586 4690 4691 4876 4958 5031 5153 5154 5244 5242 5300 5301 5325 5327 5322 5291 5313 5266 5292 5263 5262 5225 5128 5065 4997 4920 4742 4641 4415 4414 4290 4157 4016 3867 3710 3545 3372 3191 3002 2805 2600 2387 2166 1937 1700 1455 1202  941  672  395  110
 251  532  805 1070 1327 1576 1817 2050 2275 2492 2701 2902 3095 3280 3457 3626 3787 3940 4085 4222 4351 4472 4584 4585 4877 4957 4956 5030 5096 5152 5201 5241 5276 5297 5271 5317 5326 5314 5293 5265 5179 5264 5226 5181 5064 4998 4836 4835 4743 4642 4533 4416 4291 4158 4017 3868 3711 3546 3373 3192 3003 2806 2601 2388 2167 1938 1701 1456 1203  942  673  396  111
 250  531  804 1069 1326 1575 1816 2049 2274 2491 2700 2901 3094 3279 3456 3625 3786 3939 4084 4221 4350 4470 4471 4787 4786 4785 4954 4955 5095 5151 5274 5240 5299 5275 5272 5316 5315 5295 5294 5187 5129 5229 5227 5130 4921 4999 4922 4837 4744 4643 4534 4417 4292 4159 4018 3869 3712 3547 3374 3193 3004 2807 2602 2389 2168 1939 1702 1457 1204  943  674  397  112
 249  530  803 1068 1325 1574 1815 2048 2273 2490 2699 2900 3093 3278 3455 3624 3785 3938 4083 4220 4349 4583 4688 4689 4784 4873 4875 5028 5094 5200 5149 5199 5273 5237 5298 5270 5296 5267 5233 5268 5182 5230 5069 5068 5000 5066 4923 4838 4745 4644 4535 4418 4293 4160 4019 3870 3713 3548 3375 3194 3005 2808 2603 2390 2169 1940 1703 1458 1205  944  675  398  113
 248  529  802 1067 1324 1573 1814 2047 2272 2489 2698 2899 3092 3277 3454 3623 3784 3937 4082 4219 4348 4469 4582 4687 4874 4953 5093 5027 5029 5092 5150 5239 5238 5194 5236 5192 5269 5191 5232 5189 5183 5185 5184 5067 5070 5001 4924 4839 4746 4645 4536 4419 4294 4161 4020 3871 3714 3549 3376 3195 3006 2809 2604 2391 2170 1941 1704 1459 1206  945  676  399  114
 247  528  801 1066 1323 1572 1813 2046 2271 2488 2697 2898 3091 3276 3453 3622 3783 3936 4081 4218 4347 4468 4581 4686 4783 4872 5026 5025 5148 5197 5198 5196 5085 5195 5193 5190 5140 5235 5078 5136 5231 5188 5186 5131 5071 5002 4925 4840 4747 4646 4537 4420 4295 4162 4021 3872 3715 3550 3377 3196 3007 2810 2605 2392 2171 1942 1705 1460 1207  946  677  400  115
 246  527  800 1065 1322 1571 1812 2045 2270 2487 2696 2897 3090 3275 3452 3621 3782 3935 4080 4217 4346 4467 4580 4685 4782 4870 4871 5090 5091 5147 5146 5145 5144 5143 5142 5234 5138 5080 5139 5079 5228 5135 5133 5132 5072 5003 4926 4841 4748 4647 4538 4421 4296 4163 4022 3873 3716 3551 3378 3197 3008 2811 2606 2393 2172 1943 1706 1461 1208  947  678  401  116
 245  526  799 1064 1321 1570 1811 2044 2269 2486 2695 2896 3089 3274 3451 3620 3781 3934 4079 4216 4345 4466 4579 4684 4781 4951 5024 4952 5089 5088 5087 5086 5084 5017 5141 4940 5081 5137 5011 5010 5077 5076 5134 5074    0 5073 5004 4749 4750 4648 4539 4422 4297 4164 4023 3874 3717 3552 3379 3198 3009 2812 2607 2394 2173 1944 1707 1462 1209  948  679  402  117
 244  525  798 1063 1320 1569 1810 2043 2268 2485 2694 2895 3088 3273 3450 3619 3780 3933 4078 4215 4344 4465 4578 4683 4780 4869 4950 5023 5022 4946 5021 4945 5018 5082 4858 5083 5015 4937 5014 4936 5009 5075 5008 5007 5006 5005 4927 4928 4842 4649 4540 4423 4298 4165 4024 3875 3718 3553 3380 3199 3010 2813 2608 2395 2174 1945 1708 1463 1210  949  680  403  118
 243  524  797 1062 1319 1568 1809 2042 2267 2484 2693 2894 3087 3272 3449 3618 3779 3932 4077 4214 4343 4464 4577 4682 4779 4868 4949 4948 4947 5019 4862 5020 4860 4943 5016 4941 4939 4855 5012 5013 4852 4934 4933 4932 4931 4930 4929 4843 4751 4650 4541 4424 4299 4166 4025 3876 3719 3554 3381 3200 3011 2814 2609 2396 2175 1946 1709 1464 1211  950  681  404  119
 242  523  796 1061 1318 1567 1808 2041 2266 2483 2692 2893 3086 3271 3448 3617 3778 3931 4076 4213 4342 4463 4576 4681 4778 4867 4866 4865 4864 4863 4770 4771 4861 4942 4767 4857 4938 4856 4854 4935 4761 4851 4850 4849 4848 4847 4846 4844 4752 4651 4542 4425 4300 4167 4026 3877 3720 3555 3382 3201 3012 2815 2610 2397 2176 1947 1710 1465 1212  951  682  405  120
 241  522  795 1060 1317 1566 1807 2040 2265 2482 2691 2892 3085 3270 3447 3616 3777 3930 4075 4212 4341 4462 4575 4680 4777 4776 4775 4774 4773 4772 4672 4944 4769 4859 4768 4766 4765 4764 4763 4853 4762 4760 4759 4758 4757 4756 4655 4845 4753 4652 4543 4426 4301 4168 4027 3878 3721 3556 3383 3202 3013 2816 2611 2398 2177 1948 1711 1466 1213  952  683  406  121
 240  521  794 1059 1316 1565 1806 2039 2264 2481 2690 2891 3084 3269 3446 3615 3776 3929 4074 4211 4340 4461 4574 4679 4678 4677 4676 4675 4674 4566 4673 4670 4563 4669 4667 4666 4665 4664 4557 4663 4662 4661 4660 4659 4658 4657 4754 4755 4654 4653 4544 4427 4302 4169 4028 3879 3722 3557 3384 3203 3014 2817 2612 2399 2178 1949 1712 1467 1214  953  684  407  122
 239  520  793 1058 1315 1564 1805 2038 2263 2480 2689 2890 3083 3268 3445 3614 3775 3928 4073 4210 4339 4460 4573 4572 4571 4570 4569 4568 4567 4449 4671 4325 4448 4668 4323 4560 4559 4558 4442 4556 4555 4554 4553 4552 4551 4550 4656 4549 4548 4546 4545 4428 4303 4170 4029 3880 3723 3558 3385 3204 3015 2818 2613 2400 2179 1950 1713 1468 1215  954  685  408  123
 238  519  792 1057 1314 1563 1804 2037 2262 2479 2688 2889 3082 3267 3444 3613 3774 3927 4072 4209 4338 4459 4458 4457 4456 4455 4454 4453 4452 4451 4564 4327 4562 4561 4445 4321 4444 4443 4441 4440 4184 4438 4317 4439 4437 4434 4433 4179 4547 4308 4430 4429 4304 4171 4030 3881 3724 3559 3386 3205 3016 2819 2614 2401 2180 1951 1714 1469 1216  955  686  409  124
 237  518  791 1056 1313 1562 1803 2036 2261 2478 2687 2888 3081 3266 3443 3612 3773 3926 4071 4208 4337 4336 4335 4334 4333 4332 4331 4330 4196 4197 4326 4057 4565 4446 4447 4191 4320 4189 4188 4318 4185 4045 4316 4436 4312 4435 4311 4310 4431 4432 4307 4306 4305 4172 4031 3882 3725 3560 3387 3206 3017 2820 2615 2402 2181 1952 1715 1470 1217  956  687  410  125
 236  517  790 1055 1312 1561 1802 2035 2260 2477 2686 2887 3080 3265 3442 3611 3772 3925 4070 4207 4206 4205 4203 4202 4063 4201 4200 4199 4329 4450 4328 4194 4324 4193 4322 4192 4052 4050 4319 4186 3744 4314 4315 3899 4313 4181 4180 4039 4309 4177 4176 4175 4174 4173 4032 3883 3726 3561 3388 3207 3018 2821 2616 2403 2182 1953 1716 1471 1218  957  688  411  126
 235  516  789 1054 1311 1560 1801 2034 2259 2476 2685 2886 3079 3264 3441 3610 3771 3924 4069 4068 4067 4066 4204 3918 4064 4062 4060 3914 4198 4059 4056 4195 4055 4053 3907 3751 4190 4051 4049 4046 4048 3743 4043 4183 3896 4042 3894 4041 4178 4038 4037 4036 4035 4034 4033 3884 3727 3562 3389 3208 3019 2822 2617 2404 2183 1954 1717 1472 1219  958  689  412  127
 234  515  788 1053 1310 1559 1800 2033 2258 2475 2684 2885 3078 3263 3440 3609 3770 3923 3922 3921 3920 3919 4065 3762 3917 3916 4061 3913 3912 4058 3911 3910 3908 4054 3906 3905 3902 4187 3583 3745 3746 3900 3897 3742 4044 3740 3895 4040 3893 3892 3891 3889 3888 3887 3886 3885 3728 3563 3390 3209 3020 2823 2618 2405 2184 1955 1718 1473 1220  959  690  413  128
 233  514  787 1052 1309 1558 1799 2032 2257 2474 2683 2884 3077 3262 3439 3608 3769 3768 3767 3766 3765 3764 3763 3761 3760 3597 3915 3595 3758 3756 3755 3909 3588 3753 3590 3749 3748 3586 3903 3412 4047 3901 4182 3580 3409 3741 3739 3738 3737 3736 3890 3735 3733 3732 3731 3730 3729 3564 3391 3210 3021 2824 2619 2406 2185 1956 1719 1474 1221  960  691  414  129
 232  513  786 1051 1308 1557 1798 2031 2256 2473 2682 2883 3076 3261 3438 3607 3606 3605 3604 3603 3602 3601 3600 3599 3598 3596 3759 3757 3594 3591 3592 3754 3418 3752 3589 3750 3904 3414 3587 3585 3582 3898 3581 3578 3407 3577 3576 3575 3574 3573 3572 3734 3570 3569 3568 3567 3566 3565 3392 3211 3022 2825 2620 2407 2186 1957 1720 1475 1222  961  692  415  130
 231  512  785 1050 1307 1556 1797 2030 2255 2472 2681 2882 3075 3260 3437 3436 3435 3434 3433 3432 3431 3430 3429 3428 3427 3426 3425 3424 3593 3420 3241 3242 3240 3239 3417 3048 3416 3236 3584 3747 3410 3231 3408 3579 3406 3227 3405 3404 3403 3402 3221 3571 3400 3399 3397 3396 3395 3394 3393 3212 3023 2826 2621 2408 2187 1958 1721 1476 1223  962  693  416  131
 230  511  784 1049 1306 1555 1796 2029 2254 2471 2680 2881 3074 3259 3258 3257 3256 3255 3254 3253 3252 3251 3250 3249 3248 3247 3246 3245 3423 3057 3419 3054 3421 3052 3238 3415 3050 3413 2851 3233 3411 3046 3230 3229 3228 3226 3039 3225 3224 3223 3222 3401 3219 3398 3218 3217 3216 3215 3214 3213 3024 2827 2622 2409 2188 1959 1722 1477 1224  963  694  417  132
 229  510  783 1048 1305 1554 1795 2028 2253 2470 2679 2880 3073 3072 3071 3070 3069 3068 3067 3066 3065 3064 3063 3062 3061 3060 3059 3058 3243 3244 3055 3053 3422 3051 2854 3237 3234 3047 2853 3232 2850 3045 3044 3043 3041 3040 3038 2843 3037 3036 3034 3220 3033 3032 3031 3030 3029 3028 3027 3026 3025 2828 2623 2410 2189 1960 1723 1478 1225  964  695  418  133
 228  509  782 1047 1304 1553 1794 2027 2252 2469 2678 2879 2878 2877 2876 2875 2874 2873 2872 2871 2870 2869 2868 2867 2866 2865 2864 2863 2862 3056 2657 2859 2858 2857 2653 2856 3049 2650 3235 2649 2852 2849 2848 3042 2846 2642 2845 2844 2841 2840 3035 2839 2838 2837 2836 2835 2834 2833 2832 2831 2830 2829 2624 2411 2190 1961 1724 1479 1226  965  696  419  134
 227  508  781 1046 1303 1552 1793 2026 2251 2468 2677 2676 2675 2674 2673 2672 2671 2670 2669 2668 2667 2666 2665 2664 2663 2662 2661 2660 2659 2861 2860 2658 2656 2655 2654 2855 2651 2648 2439 2647 2436 2646 2645 2847 2432 2643 2641 2640 2842 2638 2637 2636 2635 2634 2633 2632 2631 2630 2629 2628 2627 2626 2625 2412 2191 1962 1725 1480 1227  966  697  420  135
 226  507  780 1045 1302 1551 1792 2025 2250 2467 2466 2465 2464 2463 2462 2461 2460 2459 2458 2457 2456 2455 2454 2453 2452 2451 2450 2449 2448 2447 2446 2445 2444 2442 2441 2220 2221 1995 2438 2218 2437 2435 2434 2644 2433 2431 2430 2429 2639 2427 2426 2425 2424 2423 2422 2421 2420 2419 2418 2417 2416 2415 2414 2413 2192 1963 1726 1481 1228  967  698  421  136
 225  506  779 1044 1301 1550 1791 2024 2249 2248 2247 2246 2245 2244 2243 2242 2241 2240 2239 2238 2237 2236 2235 2234 2233 2232 2231 2230 2229 2228 2227 2226 2225 2443 2223 1996 2440 1993 2219 1991 2217 2216 2215 2214 2212 2211 2210 2209 2428 2208 2207 2206 2205 2204 2203 2202 2201 2200 2199 2198 2197 2196 2195 2194 2193 1964 1727 1482 1229  968  699  422  137
 224  505  778 1043 1300 1549 1790 2023 2022 2021 2020 2019 2018 2017 2016 2015 2014 2013 2012 2011 2010 2009 2008 2007 2006 2005 2004 2003 2002 2001 2000 1999 1998 2224 1997 2222 2652 1994 1992 1756 1990 1989 1987 1986 2213 1985 1984 1983 1982 1981 1980 1979 1978 1977 1976 1975 1974 1973 1972 1971 1970 1969 1968 1967 1966 1965 1728 1483 1230  969  700  423  138
 223  504  777 1042 1299 1548 1789 1788 1787 1786 1785 1784 1783 1782 1781 1780 1779 1778 1777 1776 1775 1774 1773 1772 1771 1770 1769 1768 1767 1766 1765 1764 1763 1762 1761 1760 1759 1758 1755 1514 1754 1511 1988 1753 1751 1750 1749 1748 1747 1746 1745 1744 1743 1742 1741 1740 1739 1738 1737 1736 1735 1734 1733 1732 1731 1730 1729 1484 1231  970  701  424  139
 222  503  776 1041 1298 1547 1546 1545 1544 1543 1542 1541 1540 1539 1538 1537 1536 1535 1534 1533 1532 1531 1530 1529 1528 1527 1526 1525 1524 1523 1522 1521 1520 1519 1518 1517 1516 1515 1757 1513 1512 1510 1259 1752 1508 1507 1506 1505 1504 1503 1502 1501 1500 1499 1498 1497 1496 1495 1494 1493 1492 1491 1490 1489 1488 1487 1486 1485 1232  971  702  425  140
 221  502  775 1040 1297 1296 1295 1294 1293 1292 1291 1290 1289 1288 1287 1286 1285 1284 1283 1282 1281 1280 1279 1278 1277 1276 1275 1274 1273 1272 1271 1270 1269 1268 1267 1266 1265 1264 1262  736 1261 1260 1258 1509 1257 1256 1255 1254 1253 1252 1251 1250 1249 1248 1247 1246 1245 1244 1243 1242 1241 1240 1239 1238 1237 1236 1235 1234 1233  972  703  426  141
 220  501  774 1039 1038 1037 1036 1035 1034 1033 1032 1031 1030 1029 1028 1027 1026 1025 1024 1023 1022 1021 1020 1019 1018 1017 1016 1015 1014 1013 1012 1011 1010 1009 1008 1007 1006 1005 1263 1003 1002 1001 1000  999  998  997  996  995  994  993  992  991  990  989  988  987  986  985  984  983  982  981  980  979  978  977  976  975  974  973  704  427  142
 219  500  773  772  771  770  769  768  767  766  765  764  763  762  761  760  759  758  757  756  755  754  753  752  751  750  749  748  747  746  745  744  743  742  741  740  739  738 1004  462  735  734  733  732  731  730  729  728  727  726  725  724  723  722  721  720  719  718  717  716  715  714  713  712  711  710  709  708  707  706  705  428  143
 218  499  498  497  496  495  494  493  492  491  490  489  488  487  486  485  484  483  482  481  480  479  478  477  476  475  474  473  472  471  470  469  468  467  466  465  464  463  737  178  461  459  458  457  456  455  454  453  452  451  450  449  448  447  446  445  444  443  442  441  440  439  438  437  436  435  434  433  432  431  430  429  144
 217  216  215  214  213  212  211  210  209  208  207  206  205  204  203  202  201  200  199  198  197  196  195  194  193  192  191  190  189  188  187  186  185  184  183  182  181  180  179  177  460  176  175  174  173  172  171  170  169  168  167  166  165  164  163  162  161  160  159  158  157  156  155  154  153  152  151  150  149  148  147  146  145
