# This puzzle is unsolvable
31
122 123   1   7 432 438 236 239   6 240 128  11  10 348 245 608 246 134  20 137  19 140  21 143  25  26 359  29  30 150  31
118 119   4 229 341   5  13 440 127 343 436   9 442  17 130 136  16  18 249 138  22 452  24  23 451 254 257 149 256 148  32
120   3 235 232 233 124 237   8 129 126 131 132 244  12 133 445 349 350 247 353 250 449 453 141 252  27 358  28 362 259 260
116   2 234 339 121 231 518 241 601 607 242 676 344 441  15 847 135 446 682 447 537 251 354 538 540 145  33 154  34 151 361
115 334 338 430 340 335 523 522 603 125 243 439 342 346 683 745 532 351 139 255 450 356 142 541 357 360 253 455 152 147  35
333 228 336 337 437 433 519 434 238 345 526 347 530  14 678 443 685 609 448 352 355 689 687 618 688 144 262 263 258 153  36
113 117 431 332 520 435 738 524 674 604 734 677 444 740 528 531 681 533 802 534 752 614 539 690 457 146 365 364  37  39 156
230 517 114 429 599 600 673 521 602 675 527 606 529 746 612 747 800 248 617 807 686 748 542 536 363 458 456 459 261 366  38
428 427 672 330 331 671 737 669 680 605 794 742 798 799 741 613 611 615 805 850 616 749 806 621 619 620 454 461 155  41  40
112 227 425 224 226 598 670 594 739 525 882 913 879 679 610 744 887 803 917 851 889 535 751 623 692 546 693 265 460 367 264
326 220 327 225 329 516 842 792 840 793 795 841 797 843 743 846 849 801 750 755 919 852 753 691 545 369 462 268 544 157 159
111 109 426 223 595 736 663 731 732 791 790 880 936 912 845 883 804 684 888 891 853 756 694 754 622 463 270 272 266 548  42
422 110 515 424 514 735 597 733 787 596 878 881 796 914 915 844 886 848 942 892 855 808 625 624 549 466 370 543 368 547 158
221 510 512 325 593 667 513 665 729 789 839 838 937 884 952 916 940 941 921 922 920 890 810 759 695 626 371 465 161 163 160
107 108   0 219 511 668 664 837 728 835 909 788 935 910 885 955 918 943 924 923 856 811 809 628 627 629 630 375 267 464  43
423 222 328 592 421 420 509 785 590 877 908 911 875 956 951 950 939 953 946 893 813 757 854 758 697 552 696 273 372 550 269
666 106 730 322 324 419 591 323 834 836 932 933 934 948 958 867 960 954 944 895 857 812 373 631 551 164  46 553 167  51 374
104 105 505 319 507 659 727 418 784 833 874 876 907 902 949 959 938 926 945 858 894 814 699 762 467 470 271  45  47  44 162
103 218 215 589 508 726 662 786 783 873 906 905 901 931 929 947 957 927 928 896 897 859 760 701 761 700 698 276 468  49  48
213 320 217 321 417 586 588 660 724 832 871 870 903 904 824 820 900 899 862 925 860 816 815 469 555 376 556 274 166 377  50
216 214 587 585 503 504 782 661 781 872 831 930 868 774 822 823 865 821 763 818 819 861 707 557 554 379 275 168 165 169 278
100 317 212 415 416 506 657 655 723 725 829 827 869 773 866 713 710 711 769 708 634 706 764 565 703 633 474 472 277 378  53
101 318 102 502 414 654 584 658 830 780 778 828 775 772 825 771 863 712 864 641 768 817 471 702 559 558 704 632 279  52  55
 99  98 211 316 656 779 580 581 721 720 718 777 776 717 715 645 767 643 765 898 390 564 639 766 636 635 382 380 170 381 173
209 412 413 583 582 722 578 579 496 719 651 493 826 649 648 644 570 296 642 484 770 482 185 705 563 560 281 473 383 172  54
313  97 315 411 500 499 497 405 653 652 577 650 574 573 486 571 714 487 488 568 392 393 480 479 387 562 637 476  56 280 171
 95 210 314 408 409 501 498 495 403 494 575 716 399 647 396 646 490 187 485 567 182 640 288 561 709 478 475 283 284 282  57
 96 208 207 410 312 309 407 406 401 304 398 576 492 491 191 299 569 190 295 297 566 292 184 481 388 638 389 385 384 174 175
 94  93 206 310 308 201 307 404 305 303 195 302 400  80  77  78 397 572  73  74 395 289 391  69 477 286 386 287 178  59  58
 92 205 311 204  88 200  85 306 199 197 402  81 194  79 489 189 192 394 186 293 294  70  71 180 183 181  65 285 179 176  60
 91  90  89 202 203  87  86  84 198  83  82 196 193 300 301  76 298  75 188 483  72  68 291  67 290  66  63  62  64 177  61
