# This puzzle is unsolvable
18
  1  68  69 126 178 226  71   8  77  80  11  23   9  83 190 140 191  19
129 180   4  73  70  66 132  10  75  81 134  14  79 135  12 142  85  15
  2 128  78   3 131   7 227  74 187 290 136 189 267 193  17  86  16 192
 61  67 223   6 224 260 186 138 265 144  13 230 233 139  18  82  87  84
182 222 177 183   5 228 259 258 318 188 199 231  76 194 269 268 235  20
127 285  72  65 257 212 315 306 185 229 296 266 133  89 141 294  27  22
 64  63 179 181 125 184 322 320 312 298 299 264 271 313 321 239  21  26
130 317 307 124 261 262 292 295 263 137   0 270 245 272 161 236 195  90
173 221  62 176 305 287 286 323 308 256 282 232 198 314 237 145  88 147
175 218 215 167 220 219 225 234 311 283 309 197 146 293 152 297  93  92
123 122 171 169 213 253 310 280 241 289 291  91 143 238 250  28 148  29
121 174 248 254 108 172 115 118 211 244 288 316 273  31 196  95 275 202
 60 120 119  58 281 164 301 302 284 107 240 206 274 150  96 204 200  24
 57 114 216 113 252 217 251 304 319 277 105 242 100  25 154 103 151  98
303 168  59 170 110 166 214 210  45 276  40  37 249 203 149 243  94  97
117  56  54 106  55  42  44 165 209 157 158 104  32  39  33 201  30  36
116 255  53  48  47  51  46 163 208 102 278 246 160 247 155 153  34 101
 52 112  50  49 111 279 159 300 109 162 205  43 207  41 156  99  38  35
