# This puzzle is unsolvable
46
   5  181  180  182    6  187    9   11  360  359  189  188   12  191  193   13  831  197  370  199   20   22   23   24  204   25  206   27   29   31  381   32  210   35  215   33   37   38   39   40   41   42   44  393  222   46
   1    2  185    3    4  674    8  357  961  823  679  521  192  527   16   14   19  687   17   18  202  200  203  374  376  375  205  207  208   28   30  382  212  383   36  213  217  387  218  219  220  221  227   45  225  223
 351  356  184  352  672  183    7  522  676  526  364  190   10  365  528  194  366  196  832  534   21  535  372  538   26  539  377  378  209  542  544  545  211  384  703  548  216  388  389  390  391  710  394   43   47  556
 354  177  358  512  355  519  821  671  524  525  826  362  363   15  684  530  368  201  198  537  371  533  690  692  693  373  541  844  379  543  699  546  547   34 1244  704  550  551  707  552  856  554  397  392   49  395
 178  179  960  514  520  517 1092  677  825 1098  680  827  361  682  683  195  367  833  531 1105  689  835  536  978  840  694  540  696  842  698  847  700  701  702  214  549  851  386  706  995  555  553  557   48  558   52
 176  353  349  348  513  186  818  824  523  678 1096  966  681  829  529  970  686  973 1107  685  974  838 1108  841  691  982  695 1111  984  380  697  986  988  848  385  705  991  852  708  398  561  224  228   50   51  226
 350  516  174  670  819  817  673  958  675  964  965  828  967  968  834  830 1102  688  975  532  977  837 1109 1232 1113  981  983 1237 1115  845  846  987  989  850 1243  849 1122  853  994  854  993  709  711  563  396   53
 515  511  346  820 1090  669  963 1094 1095 1097 1542 1220 1221 1100  972 1340  971 1104 1228  369  979  839 1110 1231 1230  980  843 1116 1114  985 1117 1240 1119 1121 1120  990 1123 1124  714  992  857  560  562  713  712  399
 175  172  347  173  962  822 1091  518 1440 1333 1219 1443 1444 1099  969 1223 1227 1226 1103 1450  976 1106 1345 1344 1112 1349 1234 1458 1238 1460 1354 1239 1118 1242 1465 1245 1360 1246 1125  996  400  858  401   54  229  231
 171  666  813  667  510  956 1093  959 1218 1332 1217 1334 1546 1337 1101 1445 1545 1224  836 1229 1549 1346 1454 1348 1233 1455 1236 1235 1558 1352 1353 1241 1356 1357 1358 1359 1247 1127 1249  998  717  999  564  232   56  715
 345  668  814  509  344 1215 1214 1088 1331 1222 1633 1335 1541 1543 1338 1336 1548 1723 1636 1448 1341 1553 1637 1347 1554 1646 1456 1648 1350 1459 1461 1355 1463 1563 1464 1466 1361 1126  859 1128  997  860  855  403  402  230
 665  508  663  815  957  955 1087 1216 1330 1439 1442 1329 1717 1339 1634 1342 1861 1719 1449 1550 1724 1225 1452 1644 1552 1555 1351 1731 1557 1649 1560 1462 1561 1562 1564 1467 1362 1248 1129  407  718  234  566  235  236   55
 343  341  342  664  954  507 1211 1089 1212 1213 1438 1540 1716 1441 1794 1446 1447 1720 1551 1544 1451 1343 1640 1726 1453 1647 1457 1556 1650 1559 1651 1652 1653 1654 1565 1468 1251 1254 1131  565  862  559  861   58  405  233
 170  506  812  953  811  816 1210 1326 1327 1632 1537 1538 1539 1631 1792 1635 1795 1862 1800 1641 1643 1639 1725 1645 1803 1802 1730 1732 1807 1733 1734 1735 1736 1655 1566 1130 1363 1000 1252  863  719  716  722  237   57  404
 169  168  505  661  662 1085 1086 1084 1437 1325 1436 1536 1715 1791 1858 1718 1638 1921 1798 1863 1721 1722 1799 1727 1729 1804 1805 1806 1874 1808 1809 1810 1737 1656 1567 1469 1365 1364  721 1001  567 1002  865  239   62  238
 167  340  339  504  810  809  952 1083 1328 1434 1435 1630 1714 1793 1920 1860 1970 1796 1864 1925 1866 1868 1801 1869 1870 1728 1873 1984 1933 1875 1876 1812 1657 1568 1471 1470 1250 1253 1367 1133 1134  406  864   59   60   63
 166  338  503  659  660  949 1209 1082 1208 1535 1534 1626 1628 1713 1547 1919 1922 1972 1797 1926 2019 1642 1867 1929 1980 1871 2024 1872 1930 1934 1877 1738 1811 1659 1658 1569 1366 1472 1132 1003  720  866  723  568  570  569
 165  337  502  808  658  950  951 1207 1324 1431 1711 1533 1629 1971 1857 1859 1924 2018 1865 2054 2020 1976 2055 1928 1931 1982 1932 2026 1985 1935 1878 1815 1813 1739 1571 1473 1368 1256 1255  867 1004  868  571   61  869  408
 164  163  336  501  948  947 1081 1206 1433 1323 1432 1625 1790 1856 1789 1917 1918 2017 1923 2053 1975 2057 1927 1978 1981 1983 2059 1937 2027 1936 1814 1742 1740 1570 1660 1474 1369 1257 1135 1007 1006  726  724  410  240   64
 162  335  657  656  806  807 1080 1205 1322 1430 1710 1624 1627 1712 1787 1973 2016 2015 1974 2079 2078 1979 1977 2023 2085 2086 2025 2028 1986 1880 1879 1741 1743 1661 1572 1475 1370 1258 1008 1005  573  725  411  409  243   65
 161  334  500  655  805  946 1079 1204 1321 1531 1532 1788 1855 1785 1709 1854 2013 2052 2081 2049 2084 2056 2083 2113 2103 2104 2061 2060 1987 1938 1817 1816 1662 1663 1573 1476 1371 1137 1009  872 1136  870  572  242  412  241
 160  333  499  654  804  945 1078 1203 1320 1429 1530 1623 1708 1786 2050 1968 2014 1969 2051 2112 2099 2082 2022 2021 2088 2058 2029 2030 1988 1939 1883 1881 1882 1744 1664 1477 1372 1259 1138  871  727  574  413  244   67   66
 159  332  498  653  803  944 1201 1077 1428 1202 1528 1707 1705 1784 1853 1916 2080 1914 2012 2102 2114 2111 2108 2106 2105 2063 2062 1989 1942 1940 1747 1818 1745 1575 1574 1576 1373 1260 1139 1010  873  728  575  414  245   68
 330  158  497  495  801  802 1318 1076 1317 1529 1527 1622 1783 1781 1915 1912 2010 1966 2077 2047 2109 2098 2095 2092 2115 2087 2064 2089 1990 2031 1991 1819 1665 1479 1577 1478 1374 1261 1140 1011  874  729  576  415  246   69
 156  651  496  652  941  943  942 1198 1200 1426 1526 1706 1621 1704 1852 1967 1913 2076 2011 2100 2096 2101 2094 2090 2070 2093 2065 2034 2032 1992 1820 1885 1746 1666 1480 1375 1262 1263 1141 1012  875  730  577  416  247   70
 331  493  800  799 1074  940 1199 1316 1619 1319 1427 1620 1782 1850 1851 1911 1964 1965 2008 2009 2073 2110 2072 2107 2037 2038 2068 2066 2091 1944 1884 1888 1748 1667 1578 1482 1376 1264 1142 1013  876  731  578  417  248   71
 157  329  492  494  650 1073 1075 1072 1424 1425 1525 1618 1703 1780 1849 1910 1963 2045 2048 2046 2041 2075 2071 2097 1998 2069 1950 1994 1887 1941 1943 1822 1668 1750 1481 1579 1483 1265 1143 1014  877  732  579  418  249   72
 155  154  328  649  798  939 1071 1197 1315 1314 1524 1702 1616 1779 1848 1909 1962 2007 2074 2044 2042 2002 2040 2039 1999 2067 2035 2033 1945 1886 1821 1824 1823 1749 1669 1484 1377 1266 1144 1015  878  733  580  419  250   73
 324  327  326  491  648  797  938 1196 1313 1423 1422 1523 1617 1701 1847 1908 1960 1961 2005 2043 2004 1956 2001 1898 2000 1997 2036 1947 1993 1825 1889 1751 1752 1580 1380 1381 1485 1378 1145 1016  879  734  581  420  251   74
 153  152  490  647  796  937 1070 1195 1312 1421 1521 1615 1699 1778 1777 1846 1907 2006 1958 1957 1901 2003 1955 1953 1952 1951 1949 1946 1996 1890 1828 1826 1671 1670 1379 1581 1382 1267 1146 1017  880  735  582  421  252   75
 151  489  325  646  795  936 1069 1194 1311 1420 1700 1522 1614 1776 1845 1906 1905 1959 1903 1902 1838 1836 1900 1899 1897 1896 1895 1995 1832 1894 1757 1891 1753 1672 1582 1486 1383 1268 1147 1018  881  736  585  583  422   76
 150  323  488  645  794  935 1068 1193 1310 1419 1520 1613 1698 1775 1844 1843 1842 1904 1840 1837 1769 1767 1766 1954 1833 1761 1830 1831 1948 1892 1893 1827 1754 1673 1583 1584 1488 1269 1148 1019  882  584    0  423  253   77
 149  322  487  644  793  934 1067 1192 1309 1418 1519 1612 1697 1774 1773 1772 1771 1841 1770 1839 1768 1686 1599 1765 1834 1764 1762 1682 1760 1758 1829 1756 1675 1755 1585 1487 1270 1149 1020  883  738  737  424  255  254   78
 148  321  486  643  792  933 1066 1191 1308 1417 1518 1611 1696 1695 1694 1693 1692 1691 1690 1689 1688 1687 1401 1835 1763 1684 1681 1680 1759 1679 1677 1676 1674 1588 1489 1490 1384 1271 1150 1021  884  739  586  425  256   79
 147  320  485  642  791  932 1065 1190 1307 1416 1517 1610 1609 1608 1607 1606 1605 1604 1603 1601 1600 1504 1596 1597 1685 1502 1683 1593 1498 1396 1678 1493 1590 1589 1492 1586 1385 1272 1151 1022  885  740  587  426  257   80
 146  319  484  641  790  931 1064 1189 1306 1415 1516 1515 1514 1513 1512 1511 1510 1509 1508 1602 1507 1403 1598 1505 1399 1500 1594 1595 1497 1592 1591 1394 1494 1587 1389 1491 1386 1273 1152 1023  886  741  588  427  258   81
 145  318  483  640  789  930 1063 1188 1305 1414 1413 1412 1411 1410 1409 1408 1407 1406 1405 1404 1290 1506 1400 1501 1503 1398 1499 1397 1284 1395 1496 1495 1390 1279 1388 1387 1276 1274 1153 1024  887  742  589  428  259   82
 144  317  482  639  788  929 1062 1187 1304 1303 1302 1301 1300 1299 1298 1297 1296 1295 1294 1293 1292 1402 1291 1289 1288 1287 1286 1285 1037 1164 1393 1392 1281 1391 1280 1277 1157 1275 1154 1025  888  743  590  429  260   83
 143  316  481  638  787  928 1061 1186 1185 1184 1183 1182 1181 1180 1179 1178 1177 1176 1175 1174 1173 1172 1171 1170 1169 1168 1167 1166 1039 1165 1278 1282 1161 1033 1159 1160 1031 1156 1155 1026  889  744  591  430  261   84
 142  315  480  637  786  927 1060 1059 1058 1057 1056 1055 1054 1053 1052 1051 1050 1049 1048 1047 1046 1045 1044 1043 1042 1041 1040  903 1036 1163 1283 1035 1034  899  897 1158  896 1028  893 1027  890  745  592  431  262   85
 141  314  479  636  785  926  925  924  923  922  921  920  919  918  917  916  915  914  913  912  911  910  909  908  907  906  905 1038  761  902 1162  901  604  755  898 1029 1032 1030  894  892  891  746  593  432  263   86
 140  313  478  635  784  783  782  781  780  779  778  777  776  775  774  773  772  771  770  769  768  767  766  765  764  763  762  904  610  900  760  757  756  754  753  752  895  751  750  749  748  747  594  433  264   87
 139  312  477  634  633  632  631  630  629  628  627  626  625  624  623  622  621  620  619  618  617  616  615  614  613  612  611  451  609  608  758  607  606  605  603  602  601  600  599  598  597  596  595  434  265   88
 138  311  476  475  474  473  472  471  470  469  468  467  466  465  464  463  462  461  460  459  458  457  456  455  454  453  452  284  450  759  448  446  279  445  444  443  442  441  440  439  438  437  436  435  266   89
 137  310  309  308  307  306  305  304  303  302  301  300  299  298  297  296  295  294  293  292  291  290  289  288  287  286  285  109  108  280  447  106  105  278  277  276  275  274  273  272  271  270  269  268  267   90
 136  135  134  133  132  131  130  129  128  127  126  125  124  123  122  121  120  119  118  117  116  115  114  113  112  111  110  107  283  449  281  282  104  103  102  101  100   99   98   97   96   95   94   93   92   91
