# This puzzle is unsolvable
42
   2    1    3    4    5    6    7    8    9  172   10   11  174   14   15  334   16  180   19  183   22  185  343   27  344   25   26  346  190  192  194  195   33  197  497   36   34   37   39  358  359   42
 164  165  166  167  168  169  170  171  327  329   13  175   12  177  178  335   18   17  182   21   20  339  486  341  491   23  345   29  495   31   30  349   32  500  498  502   35   38  199  206   43   40
 163  320  321  322  323  324  473  474  328  173  616  330  176  331  332  333  179  482  483  484  186  340  184   28  189  760   24  632  191  193  494  351  635  196  640  198  201  202  204  203   45   44
 162  319  468  469  470  471  326  325  613  475  476  615  477  478  479  481  621  181  626  338  337  487  881  188  488  187  493  348  887 1110  633  499  893  354  350  200  501  356  361  357  503   41
 161  318  467  608  609  610  472  611  612  614  746  617  748  618  480  620  336  756  624  754  625  485  630  489 1208  628  490  496  347  886  766  638 1005  769 1006  353  504  641   48  355  207  205
 160  317  466  607  740  741  742  743  744  745  747  870  987  751  750  752  874  753  755  877  878  627  342  885  629  761  884  763  762  634  890  352  637 1212  770  642  505  771  508  208   46   47
 159  316  465  606  739  864  865  866  867  868  869  985  872  749  988  619  873  622  991  876  879  758  759  998 1106 1103  492  631  888 1001  636  767 1211 1113  774  892  639  897  209  645  360  362
 158  315  464  605  738  863  980  981  982  983  984 1093  871  986  989  875 1196  992  623  757 1100 1200  996 1203  882  764 1206 1107 1108 1111 1299 1112  775 1007  896  506  772 1115  644   50  210   49
 157  314  463  604  737  862  979 1088 1089 1090 1091 1092 1192 1095 1096 1094 1290  990  880 1204 1098 1102  995  999 1104 1105 1207 1380 1004  768  765  889 1215  891  894  773  647  509  510  363  364  211
 156  313  462  603  736  861  978 1087 1188 1189 1190 1191 1193 1286 1285 1194 1195 1287 1101 1197 1376  997 1205 1296  883 1295 1000 1002 1298 1011 1008 1300 1303 1012 1302 1117  779  646  365  367  507   51
 155  312  461  602  735  860  977 1086 1187 1280 1281 1282 1283 1284 1097 1369 1371 1288 1198 1292  994 1373 1374 1293 1378 1382 1109 1381 1457 1524  900 1305 1210 1114  895 1116  777  778  214  513  643   52
 154  311  460  601  734  859  976 1085 1186 1279 1364 1365 1366 1368 1445 1372 1444 1099 1289  993 1199 1201 1377 1577 1629 1294 1297 1379 1384 1213 1214 1118  898 1010  776 1009  650  899  512  366   53  212
 153  310  459  600  733  858  975 1084 1185 1278 1363 1440 1441 1370 1510 1443 1513 1447 1448 1291 1202 1575 1450 1518 1517 1520 1523 1456 1581 1522 1218 1003 1387  902  901 1217  369  648  515   55  213  368
 152  309  458  599  732  857  974 1083 1184 1277 1362 1439 1508 1367 1567 1569 1446 1512 1573 1515 1514 1452 1375 1449 1632 1519 1453 1454 1459 1383 1389 1460 1458 1119 1120  517  653  516  216  371   54   56
 151  308  457  598  731  856  973 1082 1183 1276 1361 1438 1507 1442 1509 1572 1622 1625 1516 1668 1670 1451 1630 1672 1521 1631 1580 1461 1582 1301 1216 1304 1209 1016 1307  903  511 1013  649  372  217  218
 150  307  456  597  730  855  972 1081 1182 1275 1360 1437 1566 1568 1570 1511 1620 1623 1624 1574 1627 1576 1750 1578 1455 1707 1586 1525 1583 1385 1015 1123 1122  907 1309  780  652  215  220   57   61  783
 149  306  455  596  729  854  971 1080 1181 1274 1359 1436 1506 1505 1619 1571 1665 1667 1666 1702 1703 1626 1708 1705 1673 1676 1674 1633 1310 1386 1462 1306 1124  904 1219  781  514 1014  655  905  219  651
 148  305  454  595  728  853  970 1079 1180 1273 1358 1435 1504 1565 1664 1621 1663 1701 1700 1669 1579 1731 1628 1709 1675 1636 1529 1390 1634 1526 1388 1528 1017 1018  519 1308  787  370  654  222   58  518
 147  304  453  594  727  852  969 1078 1179 1272 1357 1434 1503 1564 1618 1662 1728 1729 1732 1751 1733 1704 1735 1752 1671 1585 1677 1584 1465 1530 1463 1312 1125 1019 1022  657 1223  522  786  782  373  784
 146  303  452  593  726  851  968 1077 1178 1270 1271 1502 1563 1616 1617 1661 1699 1726 1746 1749 1747 1730 1734 1710 1706 1635 1637 1527 1393 1464 1467 1121 1220 1311  656 1020  221  909  908  785  520  375
 145  302  451  592  725  850  967 1076 1177 1356 1432 1433 1501 1562 1615 1660 1727 1698 1763 1697 1761 1753 1762 1736 1711 1678 1588 1679 1587 1466 1392 1225 1391 1222 1128  906 1126  658  374  224   62   59
 144  301  450  591  724  849  966 1075 1176 1269 1355 1354 1500 1561 1614 1659 1696 1725 1759 1748 1757 1756 1754 1737 1713 1712 1638 1589 1531 1532 1533 1313 1315 1221 1024  790 1023  660  791  376  521   63
 143  300  449  590  723  848  965 1074 1175 1268 1353 1431 1499 1560 1613 1658 1695 1724 1745 1758 1718 1742 1740 1738 1680 1639 1591 1534 1590 1397 1395 1394 1129 1127  788  662 1224  378  223   60  523  377
 142  299  448  589  722  847  964 1073 1174 1267 1352 1430 1498 1559 1612 1657 1694 1722 1723 1760 1755 1743 1741 1739 1714 1681 1640 1592 1396 1535 1314 1132 1226  911  914  525  912  659  789   66   64   65
 141  298  447  588  721  846  963 1072 1173 1266 1351 1429 1497 1558 1611 1656 1693 1691 1744 1721 1719 1687 1717 1685 1715 1682 1642 1468 1641 1470 1469 1398 1316  913  910 1130 1021  661  524  380  225  226
 140  297  446  587  720  962 1070  961 1071 1265 1350 1428 1496 1553 1610 1654 1655 1652 1690 1720 1689 1688 1716 1686 1645 1683 1536 1593 1537 1399 1228 1229 1027 1131 1227 1025  663  526  381  382  228  227
 139  296  445  586  719  845  844 1171 1263 1264 1426 1427 1557 1495 1556 1609 1692 1653 1604 1650 1649 1600 1647 1684 1646 1597 1595 1643 1594 1472 1317 1318 1230 1028 1026  793  792  664  527   67  229  379
 138  295  444  585  718  843  960 1172 1069 1170 1349 1348 1425 1494 1607 1554 1606 1651 1549 1603 1602 1648 1601 1599 1644 1543 1596 1538 1473 1471 1400 1401 1320 1133  794 1029  796  795  528  383   69  230
 137  294  443  584  717  842  959 1068 1169 1262 1347 1424 1492 1493 1555 1552 1551 1605 1487 1485 1546 1547 1545 1544 1598 1541 1540 1477 1539 1474 1402 1231 1319 1134  915  916  665  666  385  529   70   68
 136  293  442  583  716  841  958 1067 1168 1261 1346 1423 1491 1608 1419 1488 1417 1416 1550 1486 1548 1413 1483 1481 1480 1542 1479 1406 1476 1404 1403 1321 1232 1135 1030  917  667  530  233  231  384   71
 135  292  441  582  715  840  957 1066 1167 1260 1345 1422 1421 1420 1489 1418 1490 1336 1337 1414 1484 1332 1482 1412 1410 1409 1408 1478 1475 1405 1322 1323 1233 1136 1031  918  797  668  531  232  386   72
 134  291  440  581  714  839  956 1065 1166 1259 1344 1343 1342 1341 1253 1340 1250 1339 1335 1246 1334 1333 1411 1331 1330 1329 1407 1327 1239 1326 1325 1324 1234 1138 1032  919  798  669  532  387  234   73
 133  290  439  580  713  838  955 1064 1165 1258 1257 1256 1255 1254 1158 1252 1155 1247 1415 1248 1153 1152 1245 1244 1243 1241 1328 1240 1143 1040 1238 1237 1137 1236 1033  920  799  670  533  388  235   74
 132  289  438  579  712  837  954 1063 1164 1163 1162 1161 1160 1159 1157 1156 1338 1054 1052 1050 1154 1151 1150 1149 1148 1242 1147 1042 1145 1041 1142 1140 1139 1235 1034  921  800  671  534  389  236   75
 131  288  437  578  711  836  953 1062 1061 1060 1059  947 1058 1057 1056  943 1251  940 1051 1249 1049 1048 1047 1046 1045 1044  814 1043  931  812 1039 1141 1037 1036 1035  922  801  672  535  390  237   76
 130  287  436  577  710  835  952  951  950  949  829  827  948  945  944 1053  941  695  820  821  938  937  936  935  934 1146  933  930 1144  929  927  926  807  925  924  923  802  673  536  391  238   77
 129  286  435  576  709  834  833  832  831  830  828  701  946  826 1055  825  824  559  823  939  557  818  817  816  815  813  932  685  811  810  808 1038  680  806  805  804  803  674  537  392  239   78
 128  285  434  575  708  707  706  705  704  703  702  700  699  698  694  942  561  696  822  819  558  691  689  554  688  687  686  550  404  682  683  928  681  679  678  677  676  675  538  393  240   79
 127  284  433  574  573  572  571  570  569  568  567  566  565  564  563  697  562  693  266  692  560  555  690  412  259  553  407  551  549  809  405  546  545  544  543  542  541  540  539  394  241   80
 126  283  432  431  430  429  428  427  426  425  424  423  422  421  420  419  418  417  415  414    0  556  413  411  261  257  552  255  684  406  547  403  402  401  400  399  398  397  396  395  242   81
 125  282  281  280  279  278  277  276  275  274  273  272  271  270  269  268  267  107  416  264  263  262  100  260  409  408  256  410   97  548  253  252  251  250  249  248  247  246  245  244  243   82
 124  123  122  121  120  119  118  117  116  115  114  113  112  111  110  109  108  106  265  105  104  103  102  101  258   99   98   96  254   95   94   93   92   91   90   89   88   87   86   85   84   83
