# This puzzle is unsolvable
47
 185  181    3  186    4    5    8  191    9   10   12   13   14   15  199  376   19  203   20   17  380  544  384  208  210  382   27   30   29  214   31   32   33   34  395  564  222   39  220   40  223   41   42  400  403  228   46
   1  359  361  363  189    6    7  192  193  194   11  197  196  373  374   18  375   21   24  201   22   23  381   25   26  209  713   28  388  213  555  215  216  392  394  397  217   36   37  720  723  224  402   45   48   47  229
 184  183  187  188  364  365  190  366  367  368  370  195  371   16  539  372  540  545  542  202  204  205  206  547  207  386  387  383  714  390  556  389  391  560  218  871  721  563   35  565  876  227  401   49  569   50  231
 360    2  182  528  531  691  690  533  532  536  369  537  697  538  198  700  200  377  705  858  707  857  706  548  709  710  550  385  212  863  557  715  558  559  219  718   38  872  567  225  226  724   44  727  399   43  230
 357  356  688  362  530  689  842  692  534  535  694  695  848  698  699  541 1132  852  701  546  543  379  702  549  211  862  553  554  711  551  866 1010  712  393  870  396  875  221  562  877  873  566  570  404  233  232   51
 180  358  527  529  686  839  841  844  693  845  846  696 1126  849  992  850  851  853  855  378  703  856  708 1002  860  861 1007 1141  552 1009  716  867  717  561 1014  874  868  719 1017  398  726  728  729  568  405  406   52
 179  355  525  840  526  981  986  843  987  988  989  847  990 1127  991  997 1375  854 1131  704  999 1000 1001 1136 1003 1139  864 1004  865 1008 1271 1146  869 1147 1013 1149 1015 1151  722 1018  725  878  730  572  571  235  234
 177  178  685  837  838  984  985  983 1122 1123 1124 1125 1253 1128  993 1256  994  996 1258  998 1260 1135 1263 1137  859 1138 1267 1005 1142 1006 1145 1272 1012 1275 1011 1274 1276 1016 1153 1020 1279 1019  880  576  236  408   53
 523  353  684  687  982 1119 1248 1121 1249 1250 1251 1252 1372 1254 1129 1130 1378 1376 1377 1134 1259 1261 1262 1264 1265 1498 1268 1497 1387 1143 1390 1391 1273 1148 1505 1506 1150 1277 1396 1397 1152  573 1154  407  409   56   54
 176  682  354  522  836 1117 1120 1118 1247 1369 1370 1371 1373 1374 1255 1257 1487 1490 1379 1489 1380 1381 1382 1383 1384 1266 1140 1386 1499 1144 1269 1392 1270 1393 1508 1395 1394 1280 1023  884 1278  879 1022  731  574  238   57
 521  524  352  683  835  980 1116 1246 1368 1367 1480 1586 1588 1587 1484 1769 1590 1485  995 1593 1491 1595 1492 1494 1495 1385 1600 1389 1604 1500 1603 1502 1503 1607 1608 1611 1609 1509 1281 1155 1021  881  733  732  575  239  237
 173  174  351  681  833  834 1245 1366 1479 1584 1481 1585 1483 1682 1482 1683 1589 1488 1486 1133 1688 1594 1493 1597 1598 1599 1496 1388 1697 1501 1785 1699 1606 1610 1704 1507 1399 1398 1282 1025 1156  882  412  410  413  411   55
 172  175  519  680  979  978 1115 1365 1364 1478 1583 1680 1681 1772 1773 1852 1774 1592 1689 1777 1690 1776 1596 1691 1694 1781 1862 1601 1698 1786 1602 1605 1700 1703 1504 1612 1284 1158 1283 1024  883  734  578   58  577  240   59
 349  518  520  679  832  977 1114 1243 1244 1477 1581 1582 1768 1684 1851 1923 1591 1926 1775 1925 1687 1778 1692 1693 1779 1861 1695 1784 1696 1934 1863 1866 1788 1791 1790 1513 1401 1159  886 1157 1027  736  735  579  414  241  242
 348  350  517  976  831  975 1112 1113 1475 1363 1476 1678 1770 1679 1849 1771 1850 1686 1854 1853 2091 1927 1858 1859 1860 1930 1782 1933 1864 1865 1787 1701 1867 1789 1613 1705 1400 1402 1614 1160  737  887  885  580  415  243   60
 171  347  678  828  677  829 1240 1242 1241 1474 1580 1767 1765 1847 1848 1922 1685 1987 1924 1989 2090 1855 1856 1857 1994 1931 1780 1783 1999 1997 1938 1937 1871 1702 1706 1868 1792 1407 1028 1403 1029 1286  738  581  416   62   61
 169  676  344  516  972 1111  827 1238 1473 1239 1360 1676 1766 1845 1844 1921 1918 2039 2043 1990 2092 1928 1992 2095 1929 2046 1932 1996 1995 1998 1936 1869 1870 1793 1510 1514 1161 1289 1287 1026  888  889  739  582  417  244   63
 170  168  343  515  675  973 1361 1108 1362 1577 1675 1846 1674 1984 1920 2040 1985 1986 1988 2089 2042 1991 2047 2093 1993 2049 2096 2051 2052 1935 2002 1794 1939 1707 1406 1511 1285 1404 1164 1162 1030  890  740  583  418  245   64
 346  512  342  830  513  826 1357 1237 1578 1471 1677 1579 1763 1764 1917 1919 1983 2041 1981 2087 2129 2045 2044 2094 2048 2134 2050 2098 2099 2053 2054 2000 1795 1515 1512 1708 1615 1517 1405 1288 1163 1032  741  585  419  246   65
 166  167  511  825  674 1109 1356  974 1110 1673 1576 1761 1760 1762 1916 1982 1979 2088 2160 2161 2131 2132 2186 2133 2097 2135 2136 2137 2100 2056 1942 2001 1872 1709 1796 1618 1617 1165  891 1166 1031  743  584  742  420  247   66
 165  673  345  510  824 1355  672  969 1107 1472 1358 1575 1759 1843 1915 2035 2127 2037 2038 2085 2130 2185 2163 2202 2164 2165 2167 2138 2101 2003 1941 2055 1940 1797 1710 1410 1616 1409 1516  892 1033  894  744  586  421  248   67
 164  514  339  967  970 1233  971 1359  823 1235 1574 1672 1839 1842 1914 2128 1980 2036 2125 2124 2184 2199 2162 2188 2187 2203 2168 2139 2102 2057 2004 1875 1943 1874 1715 1292 1798 1711 1290 1168 1167 1034  893  423  588  422   68
 341 1106  671  669  509  670 1105 1470 1236 1469 1573 1671 1758 1841 1840 1978    0 2082 2084 2126 2183 2200 2158 2206 2189 2166 2169 2140 2103 2058 2005 1944 1620 1873 1296 1619 1518 1408 1411 1293 1169 1035  746  424  250   70  587
 162  163  340  668  507  966  968 1354 1234 1468 1467 1572 1670 1838 1913 1977 2086 2034 2083 2157 2182 2201 2208 2195 2204 2190 2170 2141 2104 2059 1945 1876 1713 1799 1622 1712 1519 1714 1412 1170  896  589  895  745  253  249  252
 161  160  338  821  822 1103 1104 1232 1466 1570 1571 1669 1668 1757 1912 1976 2033 2121 2123 2159 2181 2122 2177 2207 2205 2191 2171 2142 2061 2105 2006 1946 1877 1800 1413 1523 1291 1521 1297 1294 1295  897  429 1036  428  251  425
 159  337  508  667  820  965 1102 1231 1353 1352 1465 1667 1756 1837 1911 1975 2032 2081 2154 2156 2197 2198 2176 2194 2193 2192 2173 2143 2060 2062 2007 2008 1947 1878 1623 1716 1414 1621 1415 1038 1173  748  591  751  254  426  750
 158  336  506  666  819  964 1101 1230 1351 1464 1569 1666 1755 1836 1910 1974 2031 2080 2179 2153 2180 2196 2152 2150 2148 2144 2174 2145 2108 2106 2009 1948 1879 1624 1626 1522 1520 1172 1171 1300  747  898  749  427   69   71   73
 157  502  505  504  818  963 1100 1229 1350 1463 1568 1665 1754 1835 1909 1908 1973 2079 2120 2151 2155 2178 2115 2149 2112 2172 2147 2109 2107 2063 2010 1949 1880 1801 1717 1524 1802 1525 1298 1039 1037  899  753  594  255   75  257
 156  665  335  501  817  962 1099 1228 1349 1462 1567 1664 1753 1834 1907 2029 2030 2078 2119 2118 2117 2116 2175 2071 2114 2113 2068 2146 2110 2064 2011 1950 1881 1718 1720 1625 1526 1416 1299  593  900   74 1041  256   72  590  596
 155  500  664  663  816  961 1098 1227 1348 1461 1566 1663 1752 1833 1906 1972 2028 2077 2076 2075 2074 2073 2072 2070 2069 2111 2067 1957 2066 2015 2012 1882 1805 1719 1803 1721 1627 1528 1418 1174 1175  430 1040 1042  905  431   77
 154  334  503  332  815  662 1097 1226 1347 1460 1565 1662 1751 1832 1970 1971 2027 2026 2025 2024 2023 2022 2021 2020 2019 2018 2017 1890 2016 2065 2013 1951 1952 1807 1804 1527 1417 1301 1176 1177 1045  595  592  903   76  432  259
 333  330  499  661  814  960 1096 1225 1346 1459 1564 1661 1750 1831 1905 1903 1969 1967 1966 1965 1964 1963 1962 1961 1960 1959 1958 1732 1956 2014 1953 1884 1886 1883 1806 1629 1628 1419 1302 1044 1043  902  598  754   79  258  901
 153  331  660  813  958  959 1095 1224 1345 1458 1563 1660 1749 1830 1902 1904 1968 1901 1899 1898 1897 1896 1895 1894 1893 1892 1816 1891 1813 1954 1955 1888 1809 1808 1722 1725 1529 1421 1178 1046  757  600  597  752  434   78   80
 152  329  498  659  812  957 1094 1223 1344 1457 1562 1659 1748 1829 1828 1827 1825 1900 1824 1823 1822 1821 1820 1818 1817 1734 1815 1889 1814 1887 1811 1727 1726 1723 1630 1724 1422 1531 1306 1420 1048  904  756  755  435  260  261
 151  328  497  658  811  956 1093 1222 1343 1456 1561 1658 1747 1746 1745 1744 1826 1742 1741 1740 1739 1738 1736 1819 1644 1735 1733 1731 1730 1639 1812 1638 1885 1635 1728 1632 1530 1305  906 1047 1304 1180  599  436  433   81   82
 150  327  496  657  810  955 1092 1221 1342 1455 1560 1657 1656 1655 1654 1653 1743 1651 1650 1649 1648 1647 1645 1545 1438 1643 1642 1641 1640 1729 1540 1637 1810 1633 1534 1631 1532 1179 1303 1181  909  907  908  601  263  262   83
 149  326  495  656  809  954 1091 1220 1341 1454 1559 1558 1557 1556 1555 1553 1652 1552 1551 1550 1549 1548 1737 1546 1646 1544 1436 1543 1541 1539 1433 1538 1636 1430 1536 1535 1533 1423 1307 1182 1049  602  758  266  603  437   84
 148  325  494  655  808  953 1090 1219 1340 1453 1452 1451 1450 1449 1448 1554 1446 1445 1444 1443 1442 1441 1440 1547 1439 1322 1437 1435 1542 1434 1065 1315 1634 1537 1427 1426 1425 1424 1308 1185 1183 1051  759  760  605  438  265
 147  324  493  654  807  952 1089 1218 1339 1338 1337 1336 1335 1334 1333 1447 1078 1331 1329 1328 1327 1203 1326 1324 1323 1321 1198 1320 1319 1318 1317 1316 1431 1429 1313 1188 1312 1187 1310 1309  910  604  761  439  267  264   85
 146  323  492  653  806  951 1088 1217 1216 1215 1213 1212 1082 1211 1332 1208 1209 1330 1207 1206 1205 1204 1325 1202 1201 1069 1199 1067 1195 1193 1432 1192 1314 1190  773 1428 1311 1056 1186 1052 1053 1050 1184  912  440  441   87
 145  322  491  652  805  950 1087 1086 1085  798 1214 1084  942 1079 1210  939  940 1077 1076 1074 1073 1072 1071 1070 1068 1200  928 1197 1066 1194  924 1062 1060 1191  920 1059 1189 1057 1055 1054  763  913  911  606  762   86  268
 144  321  490  651  804  949  948  947  946 1083  945  943 1080 1081  941  938  937  936 1075  935  934  933  932  931  930  929  780 1196 1063  778  925  922 1061  921  618 1058  918  917  916  915  914  764  607  271  608   89  269
 143  320  489  650  803  802  801  800  644  944  797  796  640  794  793  792  473  634  791  789  787  786  785  784  783  782  626  781  927  926  923  777  620  775  774  919  616  770  769  768  767  766  765  442  609   88   90
 142  319  488  649  648  647  646  645  643  799  642  478  641  795  639  637  790  635  633  471  788  631  630  629  628  627  625  624 1064  779  622  776  458  619  455  771  617  772  615  614  612  611  610  443  272  444  273
 141  318  487  486  485  484  483  482  481  480  479  477  306  476  638  474  636  470  300  469  632  468  467  466  465  464  463  462  461  623  460  621  459  457  456  454  283  451  280  613  450  448  447  446  270   91   94
 140  317  316  315  314  313  312  311  310  309  308  307  127  305  475  472  304  302  301  299  298  297  296  295  294  293  292  291  290  289  288  287  286  285  284  282  453  281  452  279  449  278  276   96  275   93  445
 139  138  137  136  135  134  133  132  131  130  129  128  126  125  124  303  123  122  121  120  119  118  117  116  115  114  113  112  111  110  109  108  107  106  105  104  103  102  101  100   99  277   98   97  274   95   92
