# This puzzle is unsolvable
57
   2    1    3    4    5    6    7    8    9   10   11   12   13   14   15   16   17   18   19   20   21   22   23   24   25   26   27   28   29   30   31   32   33   34   35   36   37   38   39   40   41   42   43   44   45   46   47   48   49   50   51   52   53   54   55   56   57
 225  223  226  228  443  229  230  231  232  233  234  235  236  237  238  239  240  241  242  243  244  245  246  247  248  249  250  251  252  253  254  255  256  257  258  259  260  261  262  263  264  265  266  267  268  269  270  271  272  273  274  275  276  277  278  279   58
 437  222  441  227  444  651  445  446  447  448  656  449  451  452  453  454  455  456  457  458  459  460  461  462  463  464  465  466  467  468  469  470  471  472  473  474  475  476  477  478  479  480  481  482  483  484  485  486  487  488  489  490  491  492  493  280   59
 224  440  648  442  650  652  851  653  654  655  855  450  657  658  859  660  662  663  664  665  666  667  668  669  670  671  672  673  674  675  676  677  678  679  680  681  682  683  684  685  686  687  688  689  690  691  692  693  694  695  696  697  698  699  494  281   60
 438  439  646  649  647  850  852 1043 1044  853  854 1047  857  659  858  661  860  861  862  864  865  866  867  868  869  870  871  872  873  874  875  876  877  878  879  880  881  882  883  884  885  886  887  888  889  890  891  892  893  894  895  896  897  700  495  282   61
 220  221  645  847  849 1041 1042 1226 1045  856 1229 1046 1048 1049 1050 1051 1052 1053  863 1055 1056 1057 1058 1059 1060 1061 1062 1063 1064 1065 1066 1067 1068 1069 1071 1254 1072 1073 1074 1075 1076 1077 1078 1080 1263 1081 1082 1083 1084 1085 1086 1087  898  701  496  283   62
 218  219  846  848 1040 1400 1225 1401 1227 1228 1404 1230 1231 1232 1233 1234 1236 1237 1054 1412 1239 1240 1241 1242 1243 1244 1245 1246 1247 1248 1249 1250 1251 1252 1070 1429 1255 1256 1257 1258 1259 1260 1261 1079 1264 1265 1440 1266 1267 1268 1269 1088  899  702  497  284   63
 434  436  644  845 1224 1037 1398 1221 1569 1402 1403 1405 1406 1407 1409 1410 1235 1411 1413 1238 1414 1415 1416 1417 1418 1419 1420 1421 1422 1423 1424 1425 1426 1427 1253 1430 1596 1431 1432 1760 1433 1435 1437 1262 1438 1606 1439 1441 1442 1443 1270 1089  900  703  498  285   64
 215  217  435  643 1039 1399 1038 1728 1727 1571 1572 1731 1573 1574 1408 1576 1577 1578 1579 1580 1581 1582 1583 1584 1585 1586 1587 1588 1589 1590 1751 1591 1593 1594 1428 1595 1756 1597 1758 1434 1602 1603 1436 1604 1605 1607 1608 1609 1444 1271 1272 1090  901  704  499  286   65
 214  216  641  844 1036  642 1222 1567 1568 1570 1730 1732 1733 1575 1734 1735 1736 1737 1738 1739 1740 1741 1742 1743 1744 1745 1746 2042 1747 1749 1902 1750 1752 1754 1905 1755 1598 1757 1601 1759 1599 1761 1762 1763 1764 1765 1766 1767 1610 1446 1445 1091  902  705  500  287   66
 433  431  640 1223 1397  842 1219 1566 1565 1729 1880 1882 1883 1884 1886 1887 2030 1888 1889 1890 1891 1892 1893 1894 1896 2038 1897 1748 1900 2043 2304 1592 1903 2047 1904 1906 1907 1909 1910 1911 2054 1600 1913 1914 1915 1916 1917 1768 1611 1447 1273 1092  903  706  501  288   67
 432  430 1034 1035  843  840 1564 1726 1725 1879 2024 2025 2026 2028 1885 2029 2165 2031 2032 2033 2034 2035 2036 2037 2173 1895 2040 2041 1898 2045 1901 1753 2181 2309 2183 2049 2050 1908 2052 2053 2190 1912 2189 2055 2057 2059 1918 1769 1613 1612 1274 1093  904  707  502  289   68
 213  429  841  639  839 1218 1396 1220 1878 1877 1881 2023 2162 2027 2163 2164 2292 2166 2167 2168 2169 2170 2171 2172 2039 2174 2175 2421 1899 2306 2046 2179 2044 2048 2311 2310 2185 2051 2186 2187 2191 2317 2056 2192 2058 2060 1919 1770 1614 1448 1275 1094  905  708  503  290   69
 212  428  838 1032 1216 1394 1563 1395 1724 1876 2022 2160 2159 2289 2288 2290 2291 2293 2294 2295 2296 2297 2298 2299 2300 2301 2422 2302 2303 2177 2424 2305 2307 2308 2184 2544 2431 2313 2432 2188 2315 2316 2319 2194 2193 2195 1772 1771 1615 1449 1276 1095  906  709  504  291   70
 211  427  638 1030 1217 1033 1393 1562 1723 1875 2021 2158 2161 2287 2408 2410 2411 2412 2413 2414 2415 2416 2417 2418 2419 2420 2532 2176 2534 2640 2425 2178 2180 2427 2182 2312 2542 2543 2433 2314 2547 2437 2318 2320 2062 2063 2061 1920 1616 1450 1277 1096  907  710  505  292   71
 426  837  637 1031 1029 1215 1392 1561 1722 1874 2020 2286 2285 2407 2409 2520 2521 2523 2524 2525 2526 2527 2528 2529 2530 2531 2635 2423 2533 2637 2537 2426 2538 2428 2429 2430 2541 2645 2434 2546 2435 2436 2438 2321 2196 1922 1921 1774 1773 1451 1278 1097  908  711  506  293   72
 425  209  635  636  836 1213 1391 1560 1721 2019 2156 2157 2406 2405 2519 2624 2522 2626 2627 2629 2724 2630 2631 2633 2815 2816 2636 2729 2536 2535 2638 2639 2641 2539 2642 2738 2540 2644 2646 2647 2649 2548 2439 2322 2197 2064 1775 1923 1617 1452 1279 1098  909  712  507  294   73
 210  424  634  835 1214 1212 1559 1558 1720 1873 2018 2155 2404 2283 2622 2518 2625 2720 2722 2723 2628 2727 2813 2632 2895 2814 2730 2634 2731 2733 2734 2823 2826 2737 2643 2739 2740 2828 2743 2650 2545 2549 2440 2323 2198 2065 1924 1618 1619 1453 1099 1100  910  713  508  295   74
 208  206  633 1025 1028 1389 1390 1557 1719 1872 2017 2154 2284 2516 2403 2623 2719 2721 2808 2810 2811 2726 2812 2964 2728 2894 2896 2817 2900 2732 2735 2824 2736 2825 2904 2741 2827 2648 2652 2829 2744 2550 2441 2324 2066 2067 1925 1777 1776 1454 1280 1101  911  714  509   75  297
 207  422  423  632  834 1027 1211 1388 1718 1871 2016 2153 2402 2517 2621 2718 2716 2809 2807 2889 2962 2961 2891 2892 2725 2965 2967 2819 2897 2821 2822 2898 2902 2974 2903 2905 2906 2742 2909 2830 2651 2551 2442 2325 2199 2201 1926 1620 1455 1282 1281 1102  912  715  510  296   76
 631  833  421  831 1209 1210 1387 1556 1717 1870 2015 2152 2282 2281 2619 2886 2620 2717 2806 2888 2960 2890 2963 2966 3029 3031 2893 2818 2968 2899 2971 2901 2972 2973 2975 2976 2908 2907 2910 2745 2746 2444 2552 2654 2326 2200 2068 1778 1621 1456 1103 1285  913  716  511  300  298
 203  204  630  832 1024 1026 1386 1555 1716 1869 2014 2151 2280 2401 2515 2399 2617 2805 2959 2958 3024 3025 3026 3027 2820 3028 3030 2969 3087 3032 3034 3035 3036 3037 3038 3039 2977 2979 2748 2653 2747    0 2443 2327 2202 2069 1927 1928 1622 1284 1104  915 1283  717  299   78   79
 420  628  629  830 1023 1207 1385 1554 1715 1868 2013 2150 2513 2511 2514 2618 2715 2804 2884 2885 3023 3080 3081 3082 3083 3084 3085 3086 3033 3089 2970 3136 3091 3092 3093 3040 2833 2978 2655 2831 2446 2553 2554 2445 2203 1929 1780 1779 1623 1457 1105  914  718  512  513   77   80
 201  205  419  829 1208 1022 1384 1553 1714 1867 2012 2149 2400 2397 2278 2713 2512 2887 2714 2957 3022 3079 3128 3129 3130 3131 3132 3133 3134 3175 3135 3090 3138 3139 3094 3041 2980 2981 2834 2750 2832 2329 2447 2556 2204 2070 1930 1781 1624 1461 1458 1108  719 1107  514  515  303
 200  828  202  627 1021 1206 1383 1552 1713 1866 2011 2148 2279 2510 2802 2509 2801 2712 2803 2956 3021 3078 3127 3168 3169 3170 3171 3172 3174 3088 3176 3137 3177 3140 3095 3042 2912 2911 2835 2751 2749 2557 2555 2331 2330 2205 2071 1931 1782 1625 1459 1287  721  916  720  304  301
 418  416  626 1020  827 1205 1382 1551 1712 1865 2010 2147 2277 2276 2398 2616 2883 2882 2881 2955 3077 3126 3125 3167 3200 3201 3202 3203 3173 3205 3206 3207 3178 3141 3096 3043 2982 2913 2656 2836 2659 2658 2328 2559 2206 2207 1932 1783 1460 1288 1286 1784  917 1106  722  302   81
 199  625  417  825 1019 1204 1203 1381 1710 1550 1711 2146 2275 2396 2614 2615 2711 2800 3020 2954 3019 3075 3076 3166 3199 3224 3225 3226 3204 3228 3229 3208 3179 3142 3097 3044 2983 2914 2837 2753 2752 2657 2448 2333 2449 2072 2074 1628 1626 1463 1290 1462  918  517  516   84   82
 198  415  826  623 1018 1202 1549 1862 1864 2008 2009 2007 2274 2395 2508 2613 2710 2799 2880 2952 2953 3018 3124 3165 3198 3223 3240 3227 3244 3242 3230 3209 3180 3143 3098 3045 2984 2915 2838 2660 2450 2558 2332 2451 2076 2073 1933 1936 1629 1627  919 1109  723  726  518   83  305
 197  414  622  624 1017 1378 1380 1548 1709 1863 2006 2145 2273 2394 2507 2506 2709 2798 2878 2879 3017 3074 3123 3164 3197 3222 3247 3239 3241 3243 3231 3210 3181 3144 3099 3046 2985 2916 2839 2754 2661 2561 2560 2212 2075 2208 1934 1935 1464 1939 1289 1291 1110  921  920  306   85
 196  413  823  824 1200 1016 1201 1546 1708 1861 2143 2144 2272 2393 2611 2612 2708 2797 2951 2950 3016 3073 3122 3163 3196 3221 3238 3248 3246 3245 3211 3182 3183 3145 3100 3047 2986 2917 2840 2755 2662 2452 2334 2335 2077 2210 2078 1788 1630 1785 1112  724  923  521  523   86   87
 195  412 1015  822 1014 1377 1379 1707 1547 1860 2005 2142 2271 2392 2505 2610 2707 2796 2877 3015 3072 3121 3162 3161 3220 3217 3237 3235 3234 3233 3213 3212 3185 3102 3146 3048 2987 2918 2841 2756 2663 2562 2211 1789 2209 1938 1786 1633 1787 1292 1465  922 1111  725  309  307   88
 194  411  621  821 1199 1198 1376 1545 1706 1859 2004 2141 2270 2391 2504 2609 2706 2795 2876 2949 3014 3071 3120 3160 3195 3194 3218 3236 3215 3232 3214 3147 3148 3103 3101 3049 3051 2988 2842 2757 2563 2454 2336 2337 2213 1632 2079 1631 1466 1293 1294 1113  519  728  924 1114  520
 193  410  620  619  820 1375 1374 1544 1705 1858 2003 2140 2269 2390 2503 2608 2705 2794 2875 2948 3013 3070 3119 3193 3192 3219 3191 3190 3216 3188 3187 3184 3186 3149 2989 2920 2919 2921 2843 2758 2664 2665 2453 2455 2080 2214 1790 1467 1634 1468 1296  727 1295  925  522  308   90
 192  409  618  819 1013 1012 1197 1543 1704 1857 2002 2139 2268 2389 2502 2607 2704 2793 2874 2947 3012 3069 3118 3159 3158 3157 3156 3154 3189 3153 3152 3151 3150 3106 3104 3052 2990 2844 2845 2759 2565 2456 2564 2338 2339 1940 1937 1791 1635 1469 1118 1115 1116  926  310  730   92
 191  408  617  818 1011 1196 1373 1542 1703 1856 2001 2138 2267 2388 2501 2606 2703 2792 2873 2946 3011 3068 3117 3116 3115 3114 3113 3155 3111 3110 3109 3108 3107 3105 3050 3053 2761 2923 2992 2760 2666 2667 2457 2340 2215 2081 2082 1792 1636 1470 1297 1298 1117  729  313   89   93
 190  407  616  817 1010 1195 1372 1541 1702 1855 2000 2137 2266 2387 2500 2605 2702 2791 2872 2945 3010 3067 3066 3065 3064 3063 3062 3112 3060 3059 3058 3057 3056 3055 3054 2922 2928 2846 2925 2848 2567 2566 2341 2216 2083 1945 1794 1942 1472 1796 1474 1471  732  525  524   91  311
 189  406  615  816 1009 1194 1371 1540 1701 1854 1999 2136 2265 2386 2499 2604 2701 2790 2871 2944 3009 3008 3007 3005 3004 3003 3002 3061 3001 3000 2999 2998 2997 2929 2993 2768 2994 2991 2850 2668 2669 2671 2459 2084 2217 1944 1941 1637 1299 1640  927 1302 1119  526  928  312  314
 188  405  614  815 1008 1193 1370 1539 1700 1853 1998 2135 2264 2385 2498 2603 2700 2789 2870 2943 2942 2941 2940 3006 2938 2937 2936 2935 2934 2933 2932 2931 2930 2854 2996 2851 2924 2926 2847 2763 2762 2568 2569 2462 1943 2461 2218 1638 1797 1475 1121  930  933  527  315  528  529
 187  404  613  814 1007 1192 1369 1538 1699 1852 1997 2134 2263 2384 2497 2602 2699 2788 2869 2868 2867 2866 2865 2939 2864 2862 2861 2860 2859 2858 2857 2856 2855 2771 2995 2853 2927 2767 2849 2765 2764 2570 2458 2343 2088 2085 1946 1795 1793 1799  733 1300  929   95  731  316   94
 186  403  612  813 1006 1191 1368 1537 1698 1851 1996 2133 2262 2383 2496 2601 2698 2787 2786 2785 2693 2784 2783 2690 2781 2779 2778 2776 2775 2684 2774 2773 2770 2681 2680 2852 2578 2677 2766 2670 2672 2571 2460 2342 2344 2086 2087 1639 1473  932 1304  737 1120  734  530  735   96
 185  402  611  812 1005 1190 1367 1536 1697 1850 1995 2132 2261 2382 2494 2495 2600 2696 2695 2694 2593 2691 2780 2590 2863 2688 2687 2777 2685 2686 2683 2682 2582 2772 2581 2769 2357 2676 2576 2675 2673 2347 2465 2220 2345 2091 1949 1947 1641 1123 1303 1301  931  736  531  317   97
 184  401  610  811 1004 1189 1366 1535 1696 1849 1994 2131 2260 2381 2599 2598 2491 2697 2596 2594 2692 2591 2782 2592 2689 2589 2587 2586 2364 2479 2585 2477 2475 2474 2580 2679 2678 2577 2575 2573 2574 2572 2350 2463 2227 2219 2090 2089 1948 1798 1476 1122 1124  738  532  318  319
 183  400  609  810 1003 1188 1365 1534 1695 1848 1993 2130 2259 2380 2492 2490 2597 2489 2488 2595 2486 2371 2370 2367 2484 2368 2588 2366 2363 2481 2583 2361 2476 2358 2473 2579 2355 2674 2359 2468 2467 2229 2466 2346 2221 2349 1305 1800 1801 1125 1642 1306  934  739  533   99   98
 182  399  608  809 1002 1187 1364 1533 1694 1847 1992 2129 2258 2379 2378 2377 2376 2252 2375 2251 2487 2247 2485 2483 2246 2244 2482 2111 2480 2584 2362 2238 2360 2235 2354 2103 2471 2472 2232 2470 2352 2351 2226 2222 2092 2223 1802 1644 1480 1643 1126 1477  935  534  321  320  100
 181  398  607  808 1001 1186 1363 1532 1693 1846 1991 2128 2257 2256 2253 2493 2121 2122 2373 2374 2372 2118 2116 2369 1975 2114 2245 2365 2241 2239 2240 2107 2237 2236 2234 1964 2356 1815 2100 1816 1957 2228 1958 2094 2224 2348 1645 1803 1478 1307 1479  937  936  740  535  322  101
 180  397  606  807 1000 1185 1362 1531 1692 1845 1990 2127 2126 2125 2255 2124 2254 1980 1981 2120 2248 2119 2249 2115 2113 2243 2112 1972 1970 2109 2478 1822 2106 2105 2104 2469 2230 2231 2101 2353 2097 2095 2225 2464 1954 1951 1952 1804 1646 1309 1308 1127  938  741  536  323  102
 179  396  605  806  999 1184 1361 1530 1691 1844 1989 1988 1987 1986 1838 1985 2123 1836 1680 1979 2250 1977 1978 2117 1976 1974 1973 2110 2242 1971 1968 1821 1967 1966 1963 2102 2233 1817 1959 1961 2099 1810 2096 1956 1955 1953 1806 1950 1647 1481 1482 1128  939  742  537  324  103
 178  395  604  805  998 1183 1360 1529 1690 1843 1842 1841 1840 1839 1837 1982 1984 1983 1834 1833 1832 1675 1829 1674 1828 1827 1826 1825 2108 1823 1824 1667 1820 1501 1819 1662 1146 1818 1814 1658 1811 1807 1321 1808 1652 2093 1651 1805 1648 1483 1310 1129  940  743  538  325  104
 177  394  603  804  997 1182 1359 1528 1689 1688 1687 1686 1685 1684 1683 1682 1681 1679 1835 1515 1676 1830 1831 1673 1672 1671 1508 1670 1669 1504 1969 1502 1503 1661 1965 1660  958 1813 1960 1962 1493 1325 1654 1143 1492 1489 1650 1649 1484 1313 1132 1130  941  744  539  326  105
 176  393  602  803  996 1181 1358 1527 1526 1525 1524 1523 1522 1521 1520 1519 1518 1517 1678 1344 1677 1514 1513 1511 1510 1509 1507 1506 1335 1668 1505 1664 1331 1666 1152 1147 1498  957 1812 2098  959 1324 1809 1490 1487 1317 1315 1312 1311  942 1316 1133  943  746  540  327  106
 175  392  601  802  995 1180 1357 1356 1355 1354 1353 1352 1351 1350 1349 1348 1346 1347 1516 1165 1343 1342 1512 1340 1339 1337 1158 1336 1156 1334  967 1332 1328 1500 1665 1663 1497 1145 1323 1659 1326 1656 1655  951 1322 1653 1138  551 1485 1486  948  745 1131  945  541  542  107
 174  391  600  801  994 1179 1178 1177 1176 1175 1174 1173 1172 1171 1170 1169 1345 1167 1166 1164 1163 1162 1341 1161 1159 1338  972 1157  968  965 1333 1153  966 1330 1149 1496 1151 1327 1495 1494 1144 1319  129 1320  954  952  339  953 1488  950  550  947  949  944  329  328  108
 173  390  599  800  993  992  991  990  989  988  987  986  985  984  983  982 1168  981  979  783  978  781  780  974 1160  777  971  970 1155 1154  772  964  963 1329  769  962 1499  961 1148 1657  561  764  558 1142  759  345 1318 1135  124  758  754  751  946  747  543  330  109
 172  389  598  799  798  797  796  795  794  793  792  791  790  789  788  787  786  980  785  784  975  977  578  779  973  575  776  775  969  773  569  354  770  137  564 1150  130  560  346  352 1141  956  557  761 1491  125  554 1136 1139 1134 1314  752  750  748  749  331  110
 171  388  597  596  595  594  593  592  591  590  589  588  587  586  585  584  583  582  581  580  782  976  146  577  365  778  574  573  571  359  570  567  136  355  566  767  960  765  132  763  955  762  128  344  127  552  342  555  755  340  549  547  545  336  544  332  111
 170  387  386  385  384  383  382  381  380  379  378  377  376  375  374  373  372  371  370  369  368  579  367  576  145  364  362  572  142  774  357  135  138  568  768  565  563  133  134  131  559  126  760  347  757  343  120 1137  123  119  338  548  546  335  334  114  112
 169  168  167  166  165  164  163  162  161  160  159  158  157  156  155  154  153  152  151  150  149  148  366  147  363  144  143  360  361  358  141  771  140  139  356  353  766  350  348  562  351  349  553  556  756  341 1140  122  753  121  118  337  117  116  333  115  113
