# This puzzle is unsolvable
16
 59  63  57 157  71  68  10 201 191 244 120  70  72 198  73  13
 60 113  55  67  61   7 225 110 126  11 119 116  19  18  17 166
 56 108 114 158   3   9   1 217 159 164  69 122  20 165 125 123
109 156 193   5  54 167   4 121 195  12  74  78 160  76  15  77
154 239  62  66  64   6 208 162 130 200  14  83 229  81 245  75
 49  58 153 226   2 194 222  22   8 168 211 169 227 124 230 218
220  53 221 219 253 216 161 199 118 242 223  28 209 163  79 173
112 188 155 189 240 243 115 214 236 176 224 252 197  21  16  84
106 151 105  65 248 192 111 205 196 131 249  25 129  86 203  88
184 213 152 147 255 238 117  52 250 210 251 133  24  90 132 174
103 107 190 212 233 102 148 215 246 241 232 170 234 135 254 128
 47  51 104 183 186 235 150 143 187 247 204  94 134  37 202 127
145 181 101  89  93  46 180  92 206  38 178 140 137 175  85  82
 50  97 237  98 142 185 141  95 100 228  33 177  26  35 207  29
 45 149 144  48  99  41 136  39 172 138 139   0  27  32 171  31
 44 146  43 182  40  96  42 231  34  80 179  91  36  30  87  23
