# This puzzle is unsolvable
58
   2    1    3    4    5    6    7    8    9   10   11   12   13   14   15   16   17   18   19   20   22  248   23   24   26  473  254  256   29  477  258  259   34  261   35   36   37   38   39   40   41   42   43   44   45   46   47   48   49   50   51   52   53   54   55   56   57   58
 228  230  448  231  232  233  234  235  236  237  238  239  240  241  242  243  463  245  246  247  467   21  249  470   25  255  253  475   30   32  257  260  479   33  262  263  264  265  266  267  268  269  270  271  272  273  274  275  276  277  278  279  280  281  282  283  284   59
 227  229  449  450  452  453  664  454  455  456  457  458  459  460  461  462  464  244  465  466  468  882  469  250  252  471   27  476  687   28   31  690  688  480  481  482  483  484  485  486  487  488  489  490  491  492  493  494  495  496  497  498  499  500  501  502  285   60
 226  447  661  662  451  866  663  665  666  667  668  669  670  671  672  673  674  675  676 1074 1075  680  884  885  251  681  474  472  685 1272  686 1085  689  691  692  693  694  695  696  697  698  699  700  701  702  703  704  705  706  707  708  709  710  711  712  503  286   61
 225  659  660  864  865  867 1062  868 1251 1065  869  871  873  874 1071  875  878  879  880  881  679  677 1079  678  883  886  684  683  888  889  478  891  893  894  895  896  897  898  899  900  901  902  903  904  905  906  907  908  909  910  911  912  913  914  713  504  287   62
 224  446  445  863 1060 1061 1063 1064  870 1066  872 1067 1068 1069  876 1072 1073 1440 1076 1442 1263 1077 1264 1445 1080 1081  887 1449 1084  890 1086  892 1088 1276 1090 1091 1092 1093 1094 1095 1096 1097 1098 1099 1100 1101 1102 1103 1104 1105 1106 1107 1108  915  714  505  288   63
 444  657  658  862 1059 1248 1250 1430 1252 1253 1254 1255 1434 1256 1070 1259 1612 1438 1439 1441 1617 1444 1265 1266 1267 1447 1268 1270 1271 1273 1452 1087 1089 1274 1277 1278 1279 1280 1281 1282 1462 1283 1284 1286 1287 1288 1289 1290 1291 1292 1293 1294 1109  916  715  506  289   64
 223  222  443  656 1058 1247 1249 1428 1429 1431 1432 1433 1604 1435 1257 1258  877 1610 1261 1260  682 1262 1779 1443 1616 1448 1083 1082 1450 1451 1623 1454 1275 1455 1456 1457 1458 1459 1460 1461 1633 1463 1285 1465 1466 1467 1468 1469 1470 1471 1472 1295 1110  917  716  507  290   65
 221  442  655  861  859 1245 1246 1600 1601 1602 1766 1603 1605 1770 1606 1437 1609 1436 1611 1930 1614 1777 1078 1446 1618    0 1269 1620 1621 1622 1624 1453 1625 1626 1627 1628 1629 1630 1631 1632 1796 1634 1800 1636 1955 1638 1639 1640 1641 1642 1473 1296 1111  918  717  508  291   66
 220  441  654 1057  860 1056 1427 1598 1765 1919 1920 1767 1768 1923 1769 1771 1772 1773 1613 1775 1931 1776 1615 1778 1780 1781 1619 1783 1784 1785 1786 1787 1788 1789 1790 1791 1792 1793 1794 1795 1797 1952 1464 1799 2102 1956 1801 1805 1803 1804 1474 1297 1112  919  718  509  292   67
 219  440  653  858 1055 1244 1599 1426 1763 1764 2068 1921 1922 1608 1925 1927 2074 1928 1774 2077 1929 1933 1934 1935 2082 1936 1782 2084 2086 1938 1940 1942 1943 1944 1945 1946 2094 1947 1949 1951 2098 2097 1798 1637 1635 2104 1802 1958 1644 1643 1806 1298 1113  920  719  510  293   68
 218  439  652  857 1054 1243 1425 1424 1597 1918 2066 2069 2070 1924 1607 1926 2215 2076 2216 2078 2079 1932 2080 2081 2083 1937 2085 1939 2087 2226 1941 2088 2228 2089 2092 2232 2093 1948 2095 2096 1950 2236 1953 2241 1954 2106 1957 1479 1808 1476 1475 1299 1114  921  720  511  294   69
 217  438  651  856 1053 1242 1423 1596 1762 1917 2067 2208 2210 2211 2071 2073 2213 2075 2214 2347 2217 2218 2219 2220 2221 2222 2223 2353 2224 2227 2358 2090 2229 2091 2230 2231 2233 2234 2366 2235 2368 2099 2100 2239 2496 2244 2105 1959 1960 1807 1645 1646  922  923  721  512  295   70
 216  437  650  855 1052 1241 1422 1595 1761 1916 2207 2340 2209 2342 2072 2212 2344 2345 2346 2586 2348 2349 2350 2351 2476 2354 2356 2478 2225 2357 2596 2598 2360 2361 2362 2363 2364 2365 2489 2238 2370 2369 2237 2240 2103 2242 2243 1809 1962 1647 1477 1116 1300  924  722  513  296   71
 215  436  649  854 1051 1240 1421 1594 1760 1759 2065 2206 2339 2341 2463 2343 2467 2466 2468 2469 2693 2473 2474 2588 2352 2591 2475 2593 2701 2477 2480 2483 2705 2482 2707 2485 2487 2488 2490 2367 2606 2714 2371 2373 2101 2372 1961 1810 2108 1963 1115 1478 1118 1117  723  514  297   72
 214  435  648  853 1050 1239 1420 1593 1758 1915 2064 2205 2338 2462 2464 2580 2688 2582 2583 2585 2470 2471 2694 2590 2695 2589 2592 2355 2702 2479 2704 2595 2703 2706 2484 2486 2807 2604 2809 2491 2605 2492 2715 2494 2493 2374 2376 2110 1648 1813 1303 1301 1119  925  724  515  298   73
 213  434  647  852 1049 1238 1419 1592 1757 1914 2063 2204 2337 2579 2465 2689 2581 2690 2584 2691 2692 2792 2472 2696 2697 2888 2799 2802 2699 2594 2481 2359 2804 2597 2600 2708 2602 2603 2711 2811 2375 2607 2609 2812 2245 2495 1965 2107 2109 1649 1480 1302  926  927  725  516  300  299
 212  433  646  851 1048 1237 1418 1591 1756 1913 2062 2203 2336 2461 2578 2687 2787 2788 2789 2587 2793 2967 2794 2887 2797 2890 2798 2972 2894 2892 2893 3051 2803 2599 2806 2709 2601 2900 2810 2902 2712 2713 2608 2814 2246 2247 1964 1484 1651 1811 1812 1481 1304 1120  928  517   76   74
 211  432  645  850 1047 1236 1417 1590 1755 1912 2061 2202 2335 2460 2577 2686 2786 2880 2881 2883 2790 3108 2968 2796 2698 2795 2700 2889 2891 2800 2801 2977 2805 2895 2980 2898 2808 2899 2984 2906 2813 2710 2610 2377 2497 2111 2249 1966 1652 1650 1305 1121 1122  726  728  518  302   75
 210  431  644  849 1046 1235 1416 1589 1754 1911 2060 2201 2334 2458 2459 2576 2685 2879 2964 2791 3040 3041 2885 2884 2886 2970 3046 2971 2973 2974 2976 3119 2978 2896 2981 2897 2982 2901 2983 2904 2716 2903 2717 2613 2498 2248 1967 1653 1308 1483 1482 1306 1123  929  727  301   77   78
 209  430  643  848 1045 1234 1415 1588 1753 1910 2059 2200 2333 2457 2575 2684 2785 2963 3039 3168 3042 2965 3110 3111 2969 3047 3114 3048 3049 2975 3118 3053 3052 3121 3054 3058 3059 2816 2908 2817 2611 2907 2815 2378 2612 2114 2380 1970 1815 1654 1307 1485 1124  729  730  303  304  519
 208  429  642  847 1044 1233 1414 1587 1752 1909 2058 2199 2331 2332 2574 2683 2784 2877 2962 2882 3107 2966 3109 3045 3043 3112 3173 3115 3116 3050 3117 3120 3179 3055 3183 2979 3123 3057 3060 2985 2499 2718 2379 2501 2381 1968 2112 2250 1814 1487 1655 1309  931  930  521  520  305   79
 207  428  641  846 1043 1232 1413 1586 1751 1908 2057 2198 2330 2456 2573 2682 2783 2878 2961 3038 3167 3169 3264 3044 3171 3113 3224 3223 3174 3176 3177 3180 3122 3181 3056 2988 3182 2987 3124 2986 3061 2382 2502 2503 2254 2251 2113 1817 1816 1971 1486 1310 1126 1125  731  522  306   80
 206  427  640  845 1042 1231 1412 1585 1750 1907 2056 2197 2329 2455 2572 2681 2782 2876 2874 3037 3166 3106 3265 3170 3221 3172 3302 3225 3175 3227 3229 3178 3231 3126 3232 3128 3125 3274 2989 2905 2720 2500 2719 2252 2615 1969 2115 2116 1818 1656 1488 1311 1312  932  733  732   81   82
 205  426  639  844 1041 1230 1411 1584 1749 1906 2055 2196 2328 2454 2571 2680 2781 2873 2875 2959 3036 3222 3220 3266 3267 3301 3330 3269 3270 3332 3228 3272 3230 3187 3273 3131 3062 3184 2909 2819 2721 2616 2722 2505 2504 2255 2117 1972 1658 1657 1490 1489 1313  933  935  523  307   83
 204  425  638  843 1040 1229 1410 1583 1748 1905 2054 2195 2453 2452 2570 2679 2780 2958 2960 3035 3105 3165 3219 3263 3300 3327 3328 3268 3226 3271 3305 3306 3307 3311 3186 3063 3127 2821 3064 2991 2617 2723 2614 2818 2387 2118 2383 2253 1820 1819 1491 1127  734 1129  934  524  525  308
 203  424  637  842 1039 1228 1409 1582 1747 1904 2053 2194 2327 2569 2678 2779 2871 2957 2956 3034 3103 3218 3164 3217 3299 3349 3360 3329 3303 3304 3334 3308 3276 3275 3235 3129 3310 3065 2992 2820 2910 2621 2618 2506 2119 2384 2256 1973 1822 1821 1659 1660 1315 1314  735  526  309   84
 202  423  636  841 1038 1227 1408 1581 1746 1903 2052 2193 2326 2451 2568 2677 2872 2778 3033 3102 3104 3163 3261 3262 3298 3347 3348 3350 3331 3351 3281 3280 3336 3277 3309 3233 3234 3130 2990 2822 2724 2728 2120 2257 2385 2508 1975 1974 1823 1661 1492 1316 1128  936  736  527  310   85
 201  422  635  840 1037 1226 1407 1580 1745 1902 2051 2192 2325 2450 2567 2777 2776 2870 2955 3031 3032 3162 3216 3260 3297 3325 3296 3359 3361 3363 3333 3353 3237 3278 3236 3132 3185 2911 2993 2726 2823 2913 2619 2122 2388 2386 2258 2121 1662 1663 1493  938 1130  937  737  528  311   86
 200  421  634  839 1036 1225 1406 1579 1744 1901 2050 2191 2324 2449 2566 2675 2676 2869 2954 3101 3160 3099 3215 3323 3214 3295 3342 3345 3346 3352 3335 3354 3238 3239 3188 3134 3066 3189 2824 2912 2727 2725 2507 2509 2389 2259 1976 1978 1824 1494 1317 1318 1131 1132  738  529  312   87
 199  420  633  838 1035 1224 1405 1578 1900 1899 2049 2323 2322 2448 2563 2673 2775 2868 2953 3030 3100 3159 3257 3212 3258 3326 3290 3355 3362 3356 3313 3337 3312 3133 3246 3068 3067 2994 3069 2914 2620 2622 2623 2510 2390 2260 2123 1825 1977 1664 1495 1133  940  939  941  530  313   88
 198  419  632  837 1034 1223 1404 1577 1743 2048 2189 2190 2447 2564 2562 2565 2674 3027 2867 3029 3259 3161 3098 3213 3292 3324 3343 3357 3339 3338 3319 3285 3240 3279 3282 3191 3190 2996 2995 2915 2826 2624 2729 2825 2511 2261 2124 1979 1826 1665 1496 1319 1134  942  739  531  314   89
 197  418  631  836 1033 1222 1403 1576 1742 1898 2047 2188 2321 2446 2773 2672 2774 2866 2952 2951 3097 3211 3256 3157 3252 3344 3317 3321 3341 3358 3314 3316 3315 3241 3193 3136 3192 3070 2997 2916 2827 2730 2625 2512 2391 2262 2125 1980 1827 1666 1497 1320 1135  741  740  532  315   90
 196  417  630  835 1032 1221 1402 1575 1741 1897 2046 2187 2320 2445 2671 2668 2772 2865 3026 3028 2950 3096 3158 3291 3293 3289 3205 3318 3294 3248 3340 3286 3200 3242 3283 3243 3135 3071 2998 2917 2828 2731 2626 2513 2392 2263 2126 1981 1828 1667 1498 1321 1136  943  742  533  316   91
 195  416  629  834 1031 1220 1400 1401 1740 1739 2045 2186 2319 2444 2670 2559 2771 2864 2949 3025 3095 3156 3210 3255 3253 3322 3320 3250 3202 3288 3287 3199 3284 3244 3197 3194 3072 3073 2999 2918 2829 2732 2627 2514 2393 2264 2127 1982 1829 1668 1499 1322 1137  944  743  534  317   92
 194  415  628  833 1029 1030 1219 1738 1574 1896 2044 1894 2318 2560 2561 2769 2669 2863 2948 3093 3094 3155 3207 3254 3150 3206 3151 3249 3147 3247 3081 3201 3145 3245 3195 3137 3139 3138 3000 2919 2830 2733 2628 2515 2394 2265 2128 1983 1830 1669 1500 1323 1138  945  744  535  318   93
 193  414  627  832 1218 1217 1399 1573 1736 1895 2184 2185 2317 2443 2442 2770 2667 2862 2857 2947 3154 3153 3209 3208 3089 3204 3149 3085 3251 3203 3083 3143 3198 3141 3196 3140 3076 3074 3075 2920 2831 2734 2629 2516 2395 2266 2129 1984 1831 1670 1501 1324 1139  946  745  536  319   94
 192  413  626  831 1028 1398 1397 1572 1737 1893 2043 2042 2183 2316 2558 2767 2768 2861 2855 3024 3023 3091 3090 3152 3016 3087 3017 3086 3148 3082 3146 3079 3142 3008 3078 2927 3005 3002 3001 2921 2832 2735 2630 2517 2396 2267 2130 1985 1832 1671 1502 1325 1140  947  746  537  320   95
 191  412  625  830 1027 1216 1396 1734 1571 1735 2040 2182 2315 2441 2666 2557 2860 2943 2946 2858 3092 3019 3088 2854 3018 2938 3015 3013 2933 3084 3010 3009 2749 3077 2841 3007 3006 3004 3003 2922 2833 2736 2631 2518 2397 2268 2131 1986 1833 1672 1503 1326 1141  948  747  538  321   96
 189  190  411  624 1025 1026 1733 1570 1891 2041 1892 2181 2314 2440 2556 2661 2665 2766 2859 2945 2941 3022 2853 3021 2423 2939 2935 2934 2846 2751 3011 3080 3144 2929 2928 2926 2925 2838 2924 2923 2834 2737 2632 2519 2398 2269 2132 1987 1834 1673 1504 1327 1142  949  748  539  322   97
 410  623  622  829 1215 1213 1214 1568 1569 1889 2039 2180 2313 2555 2662 2438 2664 2660 2765 2759 2944 2761 2760 2851 3020 2850 2849 3014 3012 2753 2844 2930 2748 2750 2746 2745 2743 2837 2742 2836 2835 2738 2633 2520 2399 2270 2133 1988 1835 1674 1505 1328 1143  950  749  540  323   98
 409  408  827 1024  828 1023 1395 1567 1890 1732 2179 2178 2437 2439 2436 2554 2663 2763 2856 2762 2942 2656 2940 2852 2756 2754 2651 2936 2937 2847 2646 2931 2842 2843 2747 2645 2840 2640 2839 2741 2740 2739 2634 2521 2400 2271 2134 1989 1836 1675 1506 1329 1144  951  750  541  324   99
 188  407  621  826  825 1393 1394 1566 1731 1730 2038 2036 2312 2311 2553 2764 2549 2659 2655 2658 2654 2652 2544 2545 2757 2653 2540 2539 2845 2848 2535 2532 2534 2932 2644 2642 2744 2529 2639 2638 2637 2636 2635 2522 2401 2272 2135 1990 1837 1676 1507 1330 1145  952  751  542  325  100
 187  185  824  619 1210 1022 1564 1391 1565 1729 1887 2037 2435 2307 2433 2551 2429 2657 2430 2425 2758 2546 2426 2428 2755 2422 2538 2418 2650 2752 2417 2415 2413 2531 2643 2412 2530 2641 2528 2527 2526 2525 2524 2523 2402 2273 2136 1991 1838 1677 1508 1331 1146  953  752  543  326  101
 186  620  183  822  823 1212 1392 1563 2035 1888 2176 2177 2310 2171 2552 2550 2548 2303 2302 2300 2427 2163 2298 2542 2296 2421 2015 2648 2420 2292 2649 2416 2536 2289 2286 2151 2411 2410 2409 2408 2407 2406 2405 2404 2403 2274 2137 1992 1839 1678 1509 1332 1147  954  753  544  327  102
 404  184  821 1021 1017 1209 1390 1561 1728 1886 2034 2309 2175 2306 2305 2304 2167 2168 2301 2547 2022 2165 2543 2424 2293 2541 2160 2294 2158 2537 2291 2154 2533 2288 2414 2150 2284 2282 2147 2281 2280 2279 2278 2277 2276 2275 2138 1993 1840 1679 1510 1333 1148  955  754  545  328  103
 182  406  617  405 1562 1389 1018 1727 1884 1885 2033 2174 2434 2173 2027 2431 2432 2026 1873 2166 2299 2019 2295 1870 2162 2017 2016 2159 2155 2419 2647 2290 2010 2153 2152 2007 2285 2149 2283 2146 2145 2144 2143 2142 2141 2140 2139 1994 1841 1680 1511 1334 1149  956  755  546  329  104
 180  402  613  618 1207  614 1020 1208 1726 1883 2032 2031 2030 2172 2029 2170 2025 2169 1874 2023 2021 2164 2297 1707 1867 2161 1865 1705 2157 1864 2012 1861 2011 2287 2009 2008 2006 2148 2005 2004 2002 2001 2000 1999 1998 1997 1996 1995 1842 1681 1512 1335 1150  957  756  547  330  105
 615  403  616  819 1211 1388 1019 1560 1725 1882 1881 1880 1879 2308 1878 2028 1716 1875 1714 1712 1871 1710 1869 2020 1709 1704 1708 2156 2013 1862 1702 1860 1859 1858 1857 1856 1855 1854 1852 2003 1851 1850 1849 1848 1847 1846 1845 1844 1843 1682 1513 1336 1151  958  757  548  331  106
 181  179 1015  820 1016 1206 1387 1386 1559 1724 1721 1554 1720 1718 1717 1877 1876 2024 1715 1872 1371 1545 1543 1184 2018 1367 1539 1866 2014 1863 1703 1701 1700 1699 1698 1697 1696 1695 1853 1693 1692 1691 1690 1689 1688 1687 1686 1685 1684 1683 1514 1337 1152  959  758  549  332  107
 178  401  400  612 1013 1204 1205 1385 1558 1723 1722 1553 1552 1719 1551 1550 1549 1189 1372 1547 1713 1544 1541 1542 1706 1868 1365 1538 1537 1536 1535 1358 1532 1357 1531 1530 1528 1353 1694 1526 1525 1524 1523 1522 1521 1520 1519 1518 1517 1516 1515 1338 1153  960  759  550  333  108
 177  611  817  610 1200 1384 1382 1199 1556 1381 1555 1379 1378 1377 1376 1374 1548 1188 1373 1370 1546 1368 1366 1711 1183 1364 1540 1363 1362 1361 1359 1533 1534 1356 1355 1172 1529  978 1527 1351 1350 1349 1348 1347 1346 1345 1344 1343 1342 1341 1340 1339 1154  961  760  551  334  109
 397  175  176  818 1203 1201 1383 1557 1008 1197 1380 1004 1195 1002 1005 1375 1000 1191 1190 1187 1186 1369  994 1185 1182  991 1181 1180 1179 1178 1360 1175 1177 1174 1173  981 1354 1352 1170 1168 1167 1166 1165 1164 1163 1162 1161 1160 1159 1158 1157 1156 1155  962  761  552  335  110
 174 1014  399  816  814 1012 1202  605  809 1006 1198 1196  806 1003 1194 1193  802 1192  998  999  997  796  996  993  793  992  989  790  988  987  986  984 1176  983  982  980 1171 1169  979  977  976  975  974  973  972  971  970  969  968  967  966  965  964  963  762  553  336  111
 173  398  815  396  813 1011  810  604  808 1007 1009  805  598  803 1001  382  801  800  799  798  797  795  588  995  792  791  990  583  789  788  787  985  786  784  783  782  781  778  779  777  776  569  775  774  773  772  771  770  769  768  767  766  765  764  763  554  337  112
 395  608  393  609  812  811  602 1010  387  601  807  160  383  597  596  595  594  593  592  591  590  374  587  794  586  585  584  582  367  581  580  579  785  577  576  575  574  780  571  573  355  570  568  567  566  565  564  563  562  561  560  559  558  557  556  555  338  113
 172  394  607  606  392  167  391  388  603  162  599  600  385  158  159  380  379  378  377  376  375  373  589  372  371  370  146  368  143  365  364  363  578  362  361  359  135  358  572  356  357  354  353  352  351  350  349  348  347  346  345  344  343  342  341  340  339  114
 171  170  169  168  390  166  389  165  163  164  386  161  804  384  381  157  156  155  154  153  152  151  150  149  148  147  145  369  366  144  142  141  140  139  138  360  137  136  134  133  132  131  130  129  128  127  126  125  124  123  122  121  120  119  118  117  116  115
