# This puzzle is unsolvable
21
  4   2   1  81 158 219 222   7  85 225  87  91 161  13 230  16  23 281 170  99  98
 78  82 152 274   6   3   8   9 278 157 159  12  15  17  93  96 163  94 101  22  97
 75  80  79 155  83  84 220  88 160  90 164 396 421  89 169 283   0 286  18  19  21
  5 151 217 153 223 324 224  86 221 364 366 329  92 165 171 287  14 168 397 399 100
 77 215 154 214 272 156 276 325 365 417  10  11 235 334  20 331 167 229  95 231  27
 76 148 320 150 361 275 319 416 322 279 363 419 273 288 172 102 227 233  26 166  25
213 147 270 218 210 216 367 391 162 362 282 326 280 330 332 232 336 284  24 289  28
316 212  73 318 351 317 390 323 277 438 395 327 368 370 423 241  29 103 234 173 104
143 271 209 269 211 393 358 429 431 407 430 372 394 226 285 369 333 290  31 175  32
359  74 315 267 356 321 360 403 440 410 432 240 228 357 371 237 179 339 177 291  30
 72 145 149  68 268 415 411 392 422 424 375 436 398 434 374 239 236 400 176 108 180
 71 144 384 388 354 265 387 414 428 413 382 435 405 340 328 106 404 174 178 105 107
146 258 262 264 412 208 263 418 311 427 344 402 373 338 337 243 341 401 110 293 109
266 308 205 355 139 196 385 352 349 251 437 377 376 425 294 335  33 238 111 292 112
 70  67 313 439  69 353 197 133 348 350 381 386 406 347 188 298 379 242 296  34 113
206 142 312 260 389 314 204 383 131 199 380 295 378 426 247 420 297 181  35 116  36
 65 136 141  58 140  55 257 130 345 299 409 346 408 343 301 244 187 184 115 114 182
 64 202 201  66 310 203  56  53 302 252 193 192 249 248 300 342 191 190 245  37  38
309  61 207 137 198 307 433  52 256 128 194 126 250  49 189 246 183 120 121  39  42
138  59  60 200 261 259 254 132 306 255 127 253 303  50 122  47 186 117 119  41 118
 62  63 135 134  54 195  57 304 129 305  51 123 125 124  48  44  46  45 185  43  40
