# This puzzle is unsolvable
76
   1  300    2  303    7  307    8    9  880   12  311   11  312   13   15   16  316   18   19   20   21   22   23   24   25   26   27   28   29   30   31   32   33   34   35   36   37   38   39   40   41   42   43   44   45   46   47   48   49   50   51   52   53   54   55   56   57   58   59   60   61   62   63   64   65   66   67   68   69   70   71   72   73   74   75   76
 593  592  302  304    3    5  599  598   10  308  602  309  601   14    0  605   17  317  318  319  320  321  322  323  324  325  326  327  328  329  330  331  332  333  334  335  336  337  338  339  340  341  342  344  635  345  346  347  348  349  350  351  352  353  354  355  356  357  358  359  360  361  362  363  364  365  366  367  368  369  370  371  372  373  374   77
 297  299  594  876  597    6  883  878    4  884  600  887  310  604  314  889  315  608  609  610  611  612  613  614  615  616  617  618  619  620  621  622  623  624  625  626  627  628  629  630  631  632  633  343  918  636  637  638  639  640  641  642  643  644  645  646  647  648  649  650  651  652  653  654  655  656  657  658  659  660  661  662  663  664  375   78
 595  301  298  591  596 1420  306  305  882 1160  886  603 1429  313 1163  606  607  890  891  893  894  895  896  897  898  899  900  901  902  903  904  905  906  907  908  909  910  911  912  913  914  915  916  634 1192  919  920  921  922  923  924  925  926  927  928  929  930  931  932  933  934  935  936  937  938  939  940  941  942  943  944  945  946  665  376   79
 590  877 1152 1153 1421  879 1154 1422 1425 1158  885 1159 1688 1162  888 1164 1165 1166  892 1168 1169 1170 1171 1172 1173 1174 1175 1176 1177 1178 1179 1180 1181 1182 1183 1184 1185 1186 1187 1188 1189 1190 1191  917 1193 1194 1195 1196 1197 1198 1199 1200 1201 1202 1203 1204 1205 1206 1207 1208 1209 1210 1211 1212 1213 1214 1215 1216 1217 1218 1219 1220  947  666  377   80
 294  295  296 1150 1151 1680 1155  881 1157 1426 1428 1161 1427 1430 1940 1431 1432 1693 1167 1434 1436 1437 1438 1439 1440 1441 1442 1443 1444 1445 1446 1447 1448 1449 1450 1451 1452 1453 1454 1455 1456 1457 1458 1459 1460 1461 1462 1463 1464 1465 1466 1467 1468 1469 1470 1471 1472 1473 1474 1475 1476 1477 1478 1479 1480 1481 1482 1483 1484 1485 1486 1221  948  667  378   81
 871  589  874  875 1419 1681 1423 1933 1156 1683 1686 1938 1687 1689 1690 1691 1942 1433 1692 1945 1695 1696 1697 1698 1699 1700 1701 1702 1703 1704 1705 1706 1707 1708 1709 1710 1711 1712 1713 1714 1715 1716 1717 1718 1719 1972 1720 1722 1723 1724 1725 1726 1727 1728 1729 1730 1731 1732 1733 1734 1735 1736 1737 1738 1739 1740 1741 1742 1743 1744 1487 1222  949  668  379   82
 293  873  588  872 1149 1932 1678 1424 1682 1684 1935 2180 1936 2186 1939 2419 1941 1694 1435 1944 1946 1947 1948 1949 1950 1951 1952 1953 1954 1955 1956 1957 1958 1959 1960 1961 1962 1963 1964 1965 1966 1967 1968 1969 1970 1721 2214 1973 1974 1975 1976 1977 1978 1979 1980 1981 1982 1983 1984 1985 1986 1987 1988 1989 1990 1991 1992 1993 1994 1745 1488 1223  950  669  380   83
 587  586  870 1148 1418 1677 1679 1931 1934 2177 2178 2179 1937 2182 2183 2185 1943 2184 2187 2188 2189 2190 2191 2192 2193 2194 2195 2196 2197 2198 2199 2200 2201 2202 2203 2204 2205 2206 2207 2208 2209 2210 2211 2212 2213 2679 2215 2217 2451 2218 2219 2220 2221 2222 2223 2224 2225 2226 2227 2228 2229 2230 2231 2232 2233 2234 2235 2236 1995 1746 1489 1224  951  670  381   84
 292  584  585 1147 1417 1416 1930 2176 2412 2413 2414 2415 1685 2181 2416 2645 2866 2423 2421 2422 2424 2425 2426 2427 2428 2429 2430 2431 2432 2433 2434 2435 2436 2437 2438 2439 2440 2441 2442 2443 2444 2445 2446 2447 2448 1971 2677 2678 2216 2453 2454 2455 2456 2457 2458 2459 2460 2461 2462 2463 2464 2465 2466 2467 2468 2469 2470 2237 1996 1747 1490 1225  952  671  382   85
 291  583  869 1415 1675 1929 1928 2175 2174 2640 2641 2642 2643 2420 2864 2644 2865 2647 2648 2649 2651 2652 2653 2654 2655 2656 2657 2658 2659 2660 2661 2662 2663 2664 2665 2666 2667 2668 2669 2670 2671 2672 2673 2674 2675 3108 2450 2449 2895 2680 2681 2682 2683 2684 2685 2686 2687 2688 2689 2690 2691 2692 2693 2694 2695 2696 2471 2238 1997 1748 1491 1226  953  672  383   86
 290  582  868 1145 1676 1146 1927 2173 2411 2410 2860 2861 2862 2863 2418 2417 2646 2867 3079 2650 2870 2871 2872 2873 2874 2875 2876 2877 2878 2879 2880 2882 3093 2883 2884 2885 2886 2887 2888 2889 2891 3305 3101 2893 2894 2676 2896 2897 2452 3110 2899 2901 2902 2903 2904 2905 2906 2907 2908 2909 2910 2911 2912 2913 2914 2697 2472 2239 1998 1749 1492 1227  954  673  384   87
 289  867 1413 1144 1414 1674 2172 2171 2409 2639 2638 2859 3072 3073 3075 3077 3078 3281 2869 2868 3081 3082 3083 3084 3085 3086 3087 3088 3089 3090 3091 2881 3296 3094 3095 3096 3097 3098 3099 3100 2890 2892 3102 3105 3109 3309 3106 3311 3313 2898 2900 3112 3113 3114 3115 3116 3117 3118 3119 3120 3121 3122 3123 3124 2915 2698 2473 2240 1999 1750 1493 1228  955  674  385   88
 288  581  866 1143 1412 1673 1926 2408 2407 2858 3074 3069 3070 3275 3277 3279 3280 3282 3283 3080 3284 3285 3286 3287 3288 3289 3290 3291 3292 3293 3294 3092 3297 3492 3298 3299 3300 3301 3302 3303 3499 3500 3103 3104 3503 3504 3107 3507 3508 3312 3111 3315 3316 3317 3318 3319 3320 3321 3322 3323 3324 3325 3326 3125 2916 2699 2474 2241 2000 1751 1494 1229  956  675  386   89
 287  580  865 1142 1411 1672 1925 2170 2406 2637 2636 3071 3276 3660 3473 3475 3076 3476 3477 3478 3479 3480 3481 3482 3483 3484 3485 3486 3487 3488 3489 3490 3295 3493 3679 3860 3681 3495 3496 3497 3498 3501 3304 3307 3306 3690 3310 3693 3506 3509 3314 3510 3511 3512 3513 3514 3515 3516 3517 3518 3519 3520 3327 3126 2917 2700 2475 2242 2001 1752 1495 1230  957  676  387   90
 286  579  864 1141 1410 1671 1924 2169 2635 2856 3472 2855 3068 3274 3662 3840 3841 3663 3664 3665 3666 3667 3668 3669 3670 3671 3672 3673 3674 3675 3676 3491 3857 3678 3494 3680 3861 3683 3863 3685 3686 3688 3689 3308 4202 3502 3691 3505 3694 3695 3696 3697 3698 3699 3700 3701 3702 3703 3704 3705 3706 3521 3328 3127 2918 2701 2476 2243 2002 1753 1496 1231  958  677  388   91
 285  578 1140 1139 1409 1670 1923 2168 2405 2634 2857 2854 3273 3471 3278 3470 4012 3842 3843 3844 3845 3846 3847 3848 3849 3850 3851 3852 3853 3854 3677 4492 4030 4192 4031 4032 3682 3859 4034 3684 3865 3687 4198 3867 3868 3869 3692 3872 3873 3874 3875 3876 3877 3878 3879 3880 3881 3882 3883 3884 3707 3522 3329 3128 2919 2702 2477 2244 2003 1754 1497 1232  959  678  389   92
 284  577  863 1408 1407 1669 1922 2167 2403 2404 2633 3272 3469 3468 3065 3474 3661 4013 4014 4015 4016 4017 4018 4019 4020 4021 4022 4023 4024 4025 3855 4027 3856 3858 4193 4348 4033 3862 4352 3864 4197 4037 4203 4041 4200 4039 3871 4042 4045 4046 4209 4047 4048 4049 4050 4051 4052 4053 4054 3885 3708 3523 3330 3129 2920 2703 2478 2245 2004 1755 1498 1233  960  679  390   93
 283  576  862  861 1406 1668 1921 2402 2166 3270 2852 3067 2851 3659 3657 3839 3658 4176 4177 4178 4179 4180 4181 4182 4183 4184 4185 4186 4187 4188 4026 4190 4345 4028 4029 4194 4633 4349 4497 4355 4035 3866 4036 4358 4201 4506 4204 4362 4043 4649 4208 4210 4211 4212 4213 4214 4215 4216 4055 3886 3709 3524 3331 3130 2921 2704 2479 2246 2005 1756 1499 1234  961  680  391   94
 282  575 1137 1138 1136 1920 2165 2401 2853 2164 3066 3271 3656 3269 3655 3838 4011 4175 4332 4333 4334 4335 4336 4337 4338 4339 4340 4341 4342 4343 4346 4764 4493 4494 4350 4495 4765 4195 4499 4504 4771 4356 4643 4357 3870 4505 4205 4507 4044 4207 4363 4364 4366 4367 4515 4368 4370 4217 4056 3887 3710 3525 3332 3131 2922 2705 2480 2247 2006 1757 1500 1235  962  681  392   95
 281  574  860  859 1666 1404 1667 1919 2632 2630 2847 3064 3467 3837 3836 4010 4009 4174 4331 4480 4481 4482 4483 4484 4485 4486 4487 4488 4489 4490 4189 4344 4191 4632 4767 4889 5113 4351 4196 4354 4772 4502 4353 4770 4359 4199 4040 4508 4646 4206 4510 4365 4513 4514 4369 4517 4516 4371 4218 3888 3711 3526 3333 3132 2923 2706 2481 2248 2007 1758 1501 1236  963  682  393   96
 280  573  857  858 1405 1664 1665 2400 2163 2850 2631 3063 3465 3654 3466 3835 4008 4172 4173 4620 4478 4621 4622 4623 4624 4625 4626 4627 4628 4629 4491 4763 4635 4496 4347 4890 4766 4640 4769 4501 4500 4774 4773 4503 4038 4360 4777 4509 4361 4648 4650 4511 4512 4653 4652 4654 4219 4373 4057 3889 3713 3712 3334 3133 2924 2707 2482 2249 2008 1759 1502 1237  964  683  394   97
 279  856 1135 1133 1401 1663 2629 1916 2162 2399 2627 3267 3268 3464 3266 3653 4007 4171 4479 4328 4477 4619 4753 4754 4755 4756 4757 4758 4883 4882 4761 4762 5111 4630 4888 4768 4891 5382 5007 5115 5008 4642 5010 4645 4776 4899 4644 4778 4647 4779 4781 4651 4783 4782 4655 4519 4518 4372 4058 4059 4060 3527 3335 3134 2925 2708 2483 2250 2009 1760 1503 1238  965  684  395   98
 277  278  570  855 1918 1917 1132 2160 2628 2161 2849 3062 3060 3463 3833 3834 4005 4330 4329 4476 4618 4752 4876 4877 4878 4879 4880 4881 4997 4998 4760 4885 4886 4638 5000 4892 5002 4636 5005 4894 5116 4641 4897 4895 4898 4900 4901 5016 4903 4780 4904 4905 4906 4784 4785 4656 4374 4220 3891 3890 3714 3528 3529 3135 2926 2709 2484 2251 2010 1761 1504 1239  966  686  685  101
 572  569  571 1402 1661 1134 1915 2398 2846 2625 2845 2848 3061 3651 3830 4006 3831 4170 4327 4475 4617 4751 4750 4992 4993 4994 4995 5104 5103 4884 4759 5107 4887 4631 4999 5110 4639 5301 4498 4637 5004 5118 4896 4775 5011 5014 5015 5017 4902 5018 5019 5020 4907 4786 4657 4520 4375 4221 4222 4061 3715 3530 3336 3532 3136 2710 2485 2252 2011 1762 1505 1240  967   99  100  396
 276  854 1131 1662 1400 1403 1912 2159 2397 2396 3265 2626 3264 3652 3462 3832 3650 4004 4169 4326 4616 4749 4875 4991 5100 5101 5102 4996 5202 5105 5106 5206 5001 5003 4634 5209 5306 5006 5388 5117 5215 5012 5217 5119 5013 5121 5122 5123 5124 5125 5126 5021 4908 4787 4658 4521 4223 4062 3716 3892 3717 3533 3338 3337 3531 2927 2928 2486 2012 1763 1506 1242 1241  968  687  397
 275  568  853 1130 1660 1914 1913 2158 2395 2624 3058 3059 3263 3461 3649 3648 4003 4168 4325 4474 4615 4748 4874 4990 5098 5099 5201 5293 5377 5204 5205 5296 5207 5208 5299 5112 5212 5213 5009 5210 5214 5391 5218 5219 5220 5120 5221 5222 5223 5224 5127 5022 4909 4788 4659 4522 4376 4225 4226 4224 3893 3895 3534 3138 2929 2712 2711 2254 2014 2013 1764 1243  969  688  398  102
 274  567  852 1129 1398 1399 1658 2157 2394 2623 2844 3056 3458 3460 3459 3829 4002 4167 4324 4473 4614 4747 4873 4872 4989 5200 5199 5376 5203 5294 5520 5379 5108 5109 5302 5211 5384 5114 5307 4893 5216 5308 5466 5309 5310 5311 5312 5313 5314 5225 5128 5023 4910 4789 4660 4523 4377 4378 4065 4063 4064 3137 3140 2714 2930 2488 2487 2253 2255 1765 1507 1508  970  689  399  103
 273  566  851 1397 1909 1911 1659 2156 2392 2622 3057 2843 3262 3261 3647 3828 4001 4166 4323 4472 4613 4746 4871 4988 5097 5198 5292 5291 5295 5378 5453 5297 5298 5456 5300 5462 5385 5303 5305 5304 5389 5465 5390 5392 5393 5394 5395 5396 5315 5226 5129 5024 4911 4790 4661 4524 4379 3894 3897 3718 3535 3340 3341 3139 2931 2713 2489 2256 2015 1766 1509 1244  971  690  400  104
 272  850  564 1128 1125 1396 1657 1910 2621 2393 2842 3055 3260 3457 3646 3827 4000 4165 4322 4471 4612 4745 4870 4987 5096 5197 5289 5451 5290 5375 5381 5380 5457 5580 5458 5387 5583 5638 5587 5463 5464 5532 5467 5534 5468 5469 5470 5397 5316 5227 5130 5025 4912 4791 4662 4525 4380 4227 4066 3896 3720 3339 3142 3141 3342 2715 2490 2257 2016 1767 1510 1245  692  973  401  402
 271  563 1394 1127 1126 1395 1656 2154 2155 2620 2841 3054 3259 3456 3645 3826 3999 4164 4321 4470 4611 4744 4869 4986 5095 5196 5288 5374 5521 5450 5523 5454 5632 5522 5383 5460 5527 5529 5637 5461 5531 5533 5535 5536 5594 5471 5472 5398 5317 5228 5131 5026 4913 4792 4663 4526 4381 4228 4067 3898 3719 3537 3536 3344 2932 2716 2491 2258 2017 1768 1511 1246  972  403  691  105
 270  565  848 1124 1393 1655 1908 2153 2391 2390 2619 3053 3258 3455 3644 3825 3998 4163 4320 4469 4610 4743 4868 4985 5094 5195 5373 5519 5449 5452 5579 5524 5455 5526 5584 5586 5386 5590 5639 5588 5591 5530 5592 5593 5537 5538 5399 5400 5318 5229 5132 5027 4914 4793 4664 4527 4382 4229 3901 4070 3343 3899 3143 3345 2933 2717 2492 2259 2018 1769 1512 1247  974  693  404  106
 269  846  562  849 1123 1907 2152 2389 2388 2618 2840 2839 3052 3454 3643 3824 3997 4162 4319 4468 4609 4742 4867 4984 5093 5194 5287 5372 5518 5517 5581 5582 5633 5634 5585 5459 5680 5528 5640 5589 5684 5642 5643 5644 5595 5473 5474 5401 5319 5230 5133 5028 4915 4794 4665 4528 4383 4230 3900 3724 3722 3721 3723 3346 2935 2718 2493 2260 2019 1770 1513 1248  975  694  405  107
 268  847 1122 1121 1392 1654 1653 2151 2387 2617 2838 3051 3257 3453 3642 3823 3996 4161 4318 4467 4608 4741 4866 4983 5092 5193 5286 5371 5448 5578 5631 5676 5675 5678 5635 5525 5636 5717 5682 5683 5688 5685 5686 5645 5596 5540 5539 5402 5320 5231 5134 4916 4795 4796 4666 4529 4384 4231 4068 4071 3541 3538 3144 2934 2937 2719 2494 2261 2020 1771 1249 1250  976  695  111  108
 267  560  845 1120 1389 1905 1906 2150 2616 2837 3050 3255 3256 3452 3641 3822 3995 4160 4317 4466 4607 4740 4865 4982 5091 5192 5285 5370 5447 5516 5577 5628 5630 5677 5713 5679 5714 5719 5681 5718 5641 5722 5721 5687 5646 5597 5475 5321 5322 5232 5135 5029 4917 4668 4797 4385 4386 4232 4069 3902 3725 3347 3539 2936 3145 2720 2495 2262 2021 1772 1514 1251  977  109  110  407
 561  265  559 1391 1651 1652 1904 2149 2386 2615 2836 3049 3254 3451 3640 3821 3994 4159 4316 4465 4606 4739 4864 4981 5090 5191 5284 5369 5446 5515 5673 5576 5674 5711 5739 5742 5740 5715 5716 5746 5723 5720 5648 5647 5598 5541 5476 5403 5323 5233 5136 5030 4918 4667 4532 4530 4388 4073 4233 4072 3726 3540 3146 3147 2938 2721 2496 2263 2022 1773 1515  978  697  696  112  406
 264  266 1390  843 1388 1650 1903 2148 2385 2614 2835 3048 3253 3450 3639 3820 3993 4158 4315 4464 4605 4738 4863 4980 5089 5190 5283 5368 5445 5514 5575 5709 5710 5707 5759 5741 5762 5743 5744 5745 5689 5750 5747 5649 5599 5542 5477 5404 5234 5138 5032 5031 4919 4798 4669 4531 4389 3904 4074 3903 3542 3728 3348 2939 2940 2722 2497 2264 1774 1517 1516 1252  979  698  408  409
 556  263  844  842 1119 1649 1902 2147 2384 2613 2834 3047 3252 3449 3638 3819 3992 4157 4314 4463 4604 4737 4862 4979 5088 5189 5282 5367 5444 5513 5626 5629 5672 5738 5712 5760 5761 5774 5764 5763 5766 5749 5691 5690 5600 5543 5478 5405 5324 5137 5139 5033 4920 4799 4671 4387 4392 4234 3905 3729 3149 3150 3350 3349 3148 2723 2024 2023 1775 1520 1518  980  981  699  410  113
 557  841  558 1118 1387 1648 1901 2146 2383 2612 2833 3046 3251 3448 3637 3818 3991 4156 4313 4462 4603 4736 4861 4978 5087 5188 5281 5366 5443 5511 5627 5574 5708 5671 5737 5757 5765 5773 5770 5748 5751 5767 5650 5601 5602 5544 5479 5406 5325 5235 5236 5034 4921 4800 4533 4535 4236 4670 3906 3730 3727 3543 3351 2941 2724 2499 2265 2266 2025 1776 1253 1256  982  700  411  114
 262  555  840 1117 1386 1647 1900 2145 2382 2611 2832 3045 3250 3447 3636 3817 3990 4155 4312 4461 4602 4735 4860 4977 5086 5187 5280 5365 5442 5573 5512 5625 5670 5706 5736 5758 5772 5755 5768 5729 5752 5692 5724 5726 5604 5480 5481 5407 5326 5237 5140 5035 4922 4801 4672 4391 4536 4235 4075 3908 3352 3544 3546 3151 2942 2727 2498 2267 2026 1254 1519 1521 1255  701  412  115
 261  554  839 1116 1385 1646 1899 2144 2381 2610 2831 3044 3249 3446 3635 3816 3989 4154 4311 4460 4601 4734 4859 4976 5085 5186 5279 5364 5441 5510 5572 5571 5624 5668 5705 5769 5775 5771 5753 5694 5728 5725 5603 5651 5605 5545 5408 5409 5327 5238 5036 5037 4923 4802 4673 4390 4238 3907 4077 4078 3545 3732 3152 2728 2945 2500 2725 2028 2501 1777 1778 1257  983  702  413  116
 260  553  838 1115 1384 1645 1898 2143 2380 2609 2830 3043 3248 3445 3634 3815 3988 4153 4310 4459 4600 4733 4858 4975 5084 5185 5278 5363 5440 5509 5570 5623 5669 5704 5733 5735 5756 5732 5754 5731 5730 5653 5693 5652 5606 5546 5482 5410 5328 5484 5141 4924 4925 4674 4675 4537 4239 4534 4076 4079 3733 3731 3547 3153 2943 2944 2726 2502 2027 1780 2268 1522  984  703  414  117
 259  552  837 1114 1383 1644 1897 2142 2379 2608 2829 3042 3247 3444 3633 3814 3987 4152 4309 4458 4599 4732 4857 4974 5083 5184 5277 5362 5439 5508 5569 5622 5667 5703 5734 5702 5701 5700 5658 5698 5727 5696 5695 5654 5548 5547 5483 5329 5241 5142 5038 4927 4926 4803 4676 4394 4240 4237 4080 3909 3911 3154 3353 3156 3354 2729 2503 2271 1779 1523 1524 1258  985  704  415  118
 258  551  836 1113 1382 1643 1896 2141 2378 2607 2828 3041 3246 3443 3632 3813 3986 4151 4308 4457 4598 4731 4856 4973 5082 5183 5276 5361 5438 5507 5568 5621 5666 5665 5664 5663 5662 5661 5699 5660 5697 5657 5656 5655 5607 5549 5485 5411 5240 5143 5239 5145 5041 4805 4677 4393 4539 4241 4081 3735 3910 3734 3549 3548 2947 3155 2504 2270 2269 1781 1259 1525  705  706  416  119
 257  550  835 1112 1381 1642 1895 2140 2377 2606 2827 3040 3245 3442 3631 3812 3985 4150 4307 4456 4597 4730 4855 4972 5081 5182 5275 5360 5437 5506 5567 5620 5619 5618 5617 5616 5615 5614 5613 5659 5612 5611 5610 5609 5608 5550 5486 5412 5330 5144 5331 5040 4804 5039 4540 4396 4538 4395 4242 3912 3550 3355 3551 3158 3356 2731 2505 2272 2032 2029 1782 1260  987  986  417  120
 256  549  834 1111 1380 1641 1894 2139 2376 2605 2826 3039 3244 3441 3630 3811 3984 4149 4306 4455 4596 4729 4854 4971 5080 5181 5274 5359 5436 5505 5566 5565 5564 5563 5562 5561 5560 5559 5558 5557 5556 5555 5554 5490 5552 5551 5413 5414 5243 5146 5147 5242 4807 4806 4678 4541 4397 4243 4082 3913 3736 2946 3357 3157 2730 2506 2033 2276 2031 1526 1784 1261 1527  707  418  121
 255  548  833 1110 1379 1640 1893 2138 2375 2604 2825 3038 3243 3440 3629 3810 3983 4148 4305 4454 4595 4728 4853 4970 5079 5180 5273 5358 5435 5504 5503 5502 5501 5500 5499 5498 5497 5496 5495 5494 5493 5492 5553 5420 5418 5487 5416 5333 5332 5244 4928 5043 4929 4808 4810 4543 4542 4244 3738 4084 3552 3553 3358 3359 3159 2949 2948 2034 1783 2030 1263  988  708  991  419  122
 254  547  832 1109 1378 1639 1892 2137 2374 2603 2824 3037 3242 3439 3628 3809 3982 4147 4304 4453 4594 4727 4852 4969 5078 5179 5272 5357 5434 5433 5432 5431 5430 5429 5428 5427 5426 5425 5424 5423 5421 5342 5341 5491 5488 5419 5337 5415 5245 5148 5149 5044 4680 4679 4930 4398 4399 4248 4083 3914 3737 3916 3360 2951 2732 2507 2273 2035 2275 1785 1528 1262  990  989  709  420
 253  546  831 1108 1377 1638 1891 2136 2373 2602 2823 3036 3241 3438 3627 3808 3981 4146 4303 4452 4593 4726 4851 4968 5077 5178 5271 5356 5355 5354 5353 5352 5351 5350 5349 5348 5347 5346 5345 5344 5422 5256 5254 5489 5339 5417 5250 5336 5334 5248 5246 5045 5042 4681 4809 4544 4245 4247 3556 4086 3363 3915 3554 3160 2510 2734 2950 2733 2511 1787 1529 1264  992  710  712  123
 252  545  830 1107 1376 1637 1890 2135 2372 2601 2822 3035 3240 3437 3626 3807 3980 4145 4302 4451 4592 4725 4850 4967 5076 5177 5270 5269 5268 5267 5266 5265 5264 5263 5262 5261 5260 5259 5258 5257 5343 5255 5159 5340 5252 5338 5156 5249 5153 5335 5247 4931 4811 4932 4682 4545 4400 4401 4246 4087 2952 3739 3162 2735 2953 2274 2277 1786 1788 2036 1530 1531  711  421  126  422
 251  544  829 1106 1375 1636 1889 2134 2371 2600 2821 3034 3239 3436 3625 3806 3979 4144 4301 4450 4591 4724 4849 4966 5075 5176 5175 5174 5173 5172 5171 5170 5169 5168 5167 5166 5165 5164 5163 5162 5161 5160 5158 5253 5157 5251 5054 5155 5154 5152 5151 5150 4933 4813 4812 4683 4402 4249 3918 4085 3362 3919 3361 3161 3555 2508 2736 2509 2279 1789 1267  993 1265  124 1266  125
 250  543  828 1105 1374 1635 1888 2133 2370 2599 2820 3033 3238 3435 3624 3805 3978 4143 4300 4449 4590 4723 4848 4965 5074 5073 5072 5071 5070 5069 5068 5067 5066 5065 5064 5063 5062 5061 5060 5059 5058 5057 5056 5055 4942 4943 5052 5051 5050 5049 5048 5046 5047 4934 4684 4546 4547 4403 4250 3917 3740 3920 3365 3558 3163 2954 2737 2038 2037 2039 1532  994  713  424  423  127
 249  542  827 1104 1373 1634 1887 2132 2369 2598 2819 3032 3237 3434 3623 3804 3977 4142 4299 4448 4589 4722 4847 4964 4963 4962 4961 4960 4959 4958 4957 4956 4955 4954 4953 4952 4951 4950 4949 4948 4947 4946 4945 4944 4824 5053 4941 4940 4939 4938 4937 4936 4935 4814 4685 4548 4090 4251 4089 3741 3742 3364 3367 3366 2955 2738 2278 2513 2280 1534 1791 1533 1268  995  714  128
 248  541  826 1103 1372 1633 1886 2131 2368 2597 2818 3031 3236 3433 3622 3803 3976 4141 4298 4447 4588 4721 4846 4845 4844 4843 4842 4841 4840 4839 4838 4837 4836 4835 4834 4833 4832 4831 4830 4829 4828 4827 4826 4825 4823 4696 4822 4821 4820 4819 4818 4817 4816 4815 4686 4550 4549 4405 3921 3743 3744 3557 3165 3164 2957 2739 2514 2512 2516 2041 1790 1269  997  996  715  129
 247  540  825 1102 1371 1632 1885 2130 2367 2596 2817 3030 3235 3432 3621 3802 3975 4140 4297 4446 4587 4720 4719 4718 4717 4716 4715 4714 4713 4712 4711 4710 4709 4708 4707 4706 4705 4704 4703 4702 4701 4700 4699 4698 4697 4561 4695 4694 4692 4557 4691 4690 4689 4688 4687 4406 3925 4404 4088 3745 3559 3368 3561 2956 2740 2282 2517 2281 1792 2040 1535 1270  716  426  130  425
 246  539  824 1101 1370 1631 1884 2129 2366 2595 2816 3029 3234 3431 3620 3801 3974 4139 4296 4445 4586 4585 4584 4583 4582 4581 4580 4579 4578 4577 4576 4575 4574 4573 4572 4571 4570 4569 4568 4567 4566 4565 4564 4563 4562 4560 4417 4559 4693 4414 4556 4555 4554 4553 4552 4551 4253 4091 4092 3926 3922 3169 3167 3166 2958 2741 2518 2283 2042 1537 1536  998 1272  717  132  131
 245  538  823 1100 1369 1630 1883 2128 2365 2594 2815 3028 3233 3430 3619 3800 3973 4138 4295 4444 4443 4442 4441 4440 4439 4438 4437 4436 4435 4434 4433 4432 4431 4430 4429 4428 4427 4426 4425 4424 4423 4422 4421 4420 4419 4418 4416 4415 4264 4558 4413 4412 4411 4410 4408 4407 4252 4093 3747 3923 3748 3563 3560 3562 2960 2515 2959 2284 1793 2043 1538 1271  999  429  427  428
 244  537  822 1099 1368 1629 1882 2127 2364 2593 2814 3027 3232 3429 3618 3799 3972 4137 4294 4293 4292 4291 4290 4289 4288 4287 4286 4285 4284 4283 4282 4281 4280 4279 4278 4277 4276 4275 4274 4273 4272 4271 4270 4269 4268 4267 4266 4105 4263 4104 4262 4261 4259 4258 4409 4257 4256 3924 4254 3746 3749 3371 3370 3168 2743 2519 2742 2044 1795 1794 1539 1273 1000  718  719  133
 243  536  821 1098 1367 1628 1881 2126 2363 2592 2813 3026 3231 3428 3617 3798 3971 4136 4135 4134 4133 4132 4131 4130 4129 4128 4127 4126 4125 4124 4123 4122 4121 4120 4119 4118 4117 4116 4115 4114 4113 4112 4111 4110 4109 4108 4107 4265 4106 4103 4102 4101 4260 4100 4098 3756 4096 4094 3929 4095 3928 3564 3372 3369 3170 2745 2286 2285 2045 1796 1274 1001  720  431  430  134
 242  535  820 1097 1366 1627 1880 2125 2362 2591 2812 3025 3230 3427 3616 3797 3970 3969 3968 3967 3966 3965 3964 3963 3962 3961 3960 3959 3958 3957 3956 3955 3954 3953 3952 3951 3950 3949 3948 3947 3946 3945 3944 3943 3942 3941 3940 3939 3938 3937 3936 3935 3934 3933 4099 3757 3931 3930 4097 4255 3750 3565 3172 3171 2744 2961 2520 2287 2046 1797 1540 1275 1002  721  432  135
 241  534  819 1096 1365 1626 1879 2124 2361 2590 2811 3024 3229 3426 3615 3796 3795 3794 3793 3792 3791 3790 3789 3788 3787 3786 3785 3784 3783 3782 3781 3780 3779 3778 3777 3776 3775 3774 3773 3772 3771 3770 3769 3768 3767 3766 3765 3764 3763 3762 3761 3760 3759 3758 3932 3755 3572 3754 3753 3927 3751 3566 3373 2963 2962 2746 2521 2288 2047 1798 1541 1276 1003  722  433  136
 240  533  818 1095 1364 1625 1878 2123 2360 2589 2810 3023 3228 3425 3614 3613 3612 3611 3610 3609 3608 3607 3606 3605 3604 3603 3602 3601 3600 3599 3598 3597 3596 3595 3594 3593 3592 3591 3590 3589 3588 3587 3586 3585 3584 3583 3582 3581 3580 3579 3578 3577 3576 3575 3574 3573 3571 3569 3570 3752 3568 3567 3374 3173 2964 2747 2522 2289 2048 1799 1542 1277 1004  723  434  137
 239  532  817 1094 1363 1624 1877 2122 2359 2588 2809 3022 3227 3424 3423 3422 3421 3420 3419 3418 3417 3416 3415 3414 3413 3412 3411 3410 3409 3408 3407 3406 3405 3404 3403 3402 3401 3400 3399 3398 3397 3396 3395 3394 3393 3392 3391 3390 3389 3388 3387 3386 3385 3384 3383 3382 3381 3380 3181 3378 3377 3376 3375 3174 2965 2748 2523 2290 2049 1800 1543 1278 1005  724  435  138
 238  531  816 1093 1362 1623 1876 2121 2358 2587 2808 3021 3226 3225 3224 3223 3222 3221 3220 3219 3218 3217 3216 3215 3214 3213 3212 3211 3210 3209 3208 3207 3206 3205 3204 3203 3202 3201 3200 3199 3198 3197 3196 3195 3194 3193 3192 3191 3190 3189 3188 3187 3186 3185 3184 3183 3182 2974 3379 3179 3178 3177 3176 3175 2966 2749 2524 2291 2050 1801 1544 1279 1006  725  436  139
 237  530  815 1092 1361 1622 1875 2120 2357 2586 2807 3020 3019 3018 3017 3016 3015 3014 3013 3012 3011 3010 3009 3008 3007 3006 3005 3004 3003 3002 3001 3000 2999 2998 2997 2996 2995 2994 2993 2992 2991 2990 2989 2988 2987 2986 2985 2984 2983 2982 2981 2980 2979 2978 2977 2976 2760 2973 3180 2972 2971 2970 2969 2968 2967 2750 2525 2292 2051 1802 1545 1280 1007  726  437  140
 236  529  814 1091 1360 1621 1874 2119 2356 2585 2806 2805 2804 2803 2802 2801 2800 2799 2798 2797 2796 2795 2794 2793 2792 2791 2790 2789 2788 2787 2786 2785 2784 2783 2782 2781 2780 2779 2778 2777 2776 2775 2774 2773 2772 2771 2770 2769 2768 2767 2766 2765 2764 2763 2762 2761 2759 2975 2758 2757 2756 2755 2754 2753 2752 2751 2526 2293 2052 1803 1546 1281 1008  727  438  141
 235  528  813 1090 1359 1620 1873 2118 2355 2584 2583 2582 2581 2580 2579 2578 2577 2576 2575 2574 2573 2572 2571 2570 2569 2568 2567 2566 2565 2564 2563 2562 2561 2560 2559 2558 2557 2556 2555 2554 2553 2552 2551 2550 2549 2548 2547 2546 2545 2544 2543 2542 2541 2540 2539 2538 2537 2536 2535 2534 2533 2532 2531 2530 2529 2528 2527 2294 2053 1804 1547 1282 1009  728  439  142
 234  527  812 1089 1358 1619 1872 2117 2354 2353 2352 2351 2350 2349 2348 2347 2346 2345 2344 2343 2342 2341 2340 2339 2338 2337 2336 2335 2334 2333 2332 2331 2330 2329 2328 2327 2326 2325 2324 2323 2322 2321 2320 2319 2318 2317 2316 2315 2314 2313 2312 2311 2310 2309 2308 2307 2306 2305 2304 2303 2302 2301 2300 2299 2298 2297 2296 2295 2054 1805 1548 1283 1010  729  440  143
 233  526  811 1088 1357 1618 1871 2116 2115 2114 2113 2112 2111 2110 2109 2108 2107 2106 2105 2104 2103 2102 2101 2100 2099 2098 2097 2096 2095 2094 2093 2092 2091 2090 2089 2088 2087 2086 2085 2084 2083 2082 2081 2080 2079 2078 2077 2076 2075 2074 2073 2072 2071 2070 2069 2068 2067 2066 2065 2064 2063 2062 2061 2060 2059 2058 2057 2056 2055 1806 1549 1284 1011  730  441  144
 232  525  810 1087 1356 1617 1870 1869 1868 1867 1866 1865 1864 1863 1862 1861 1860 1859 1858 1857 1856 1855 1854 1853 1852 1851 1850 1849 1848 1847 1846 1845 1844 1843 1842 1841 1840 1839 1838 1837 1836 1835 1834 1833 1832 1831 1830 1829 1828 1827 1826 1825 1824 1823 1822 1821 1820 1819 1818 1817 1816 1815 1814 1813 1812 1811 1810 1809 1808 1807 1550 1285 1012  731  442  145
 231  524  809 1086 1355 1616 1615 1614 1613 1612 1611 1610 1609 1608 1607 1606 1605 1604 1603 1602 1601 1600 1599 1598 1597 1596 1595 1594 1593 1592 1591 1590 1589 1588 1587 1586 1585 1584 1583 1582 1581 1580 1579 1578 1577 1576 1575 1574 1573 1572 1571 1570 1569 1568 1567 1566 1565 1564 1563 1562 1561 1560 1559 1558 1557 1556 1555 1554 1553 1552 1551 1286 1013  732  443  146
 230  523  808 1085 1354 1353 1352 1351 1350 1349 1348 1347 1346 1345 1344 1343 1342 1341 1340 1339 1338 1337 1336 1335 1334 1333 1332 1331 1330 1329 1328 1327 1326 1325 1324 1323 1322 1321 1320 1319 1318 1317 1316 1315 1314 1313 1312 1311 1310 1309 1308 1307 1306 1305 1304 1303 1302 1301 1300 1299 1298 1297 1296 1295 1294 1293 1292 1291 1290 1289 1288 1287 1014  733  444  147
 229  522  807 1084 1083 1082 1081 1080 1079 1078 1077 1076 1075 1074 1073 1072 1071 1070 1069 1068 1067 1066 1065 1064 1063 1062 1061 1060 1059 1058 1057 1056 1055 1054 1053 1052 1051 1050 1049 1048 1047 1046 1045 1044 1043 1042 1041 1040 1039 1038 1037 1036 1035 1034 1033 1032 1031 1030 1029 1028 1027 1026 1025 1024 1023 1022 1021 1020 1019 1018 1017 1016 1015  734  445  148
 228  521  806  805  804  803  802  801  800  799  798  797  796  795  794  793  792  791  790  789  788  787  786  785  784  783  782  781  780  779  778  777  776  775  774  773  772  771  770  769  768  767  766  765  764  763  762  761  760  759  758  757  756  755  754  753  752  751  750  749  748  747  746  745  744  743  742  741  740  739  738  737  736  735  446  149
 227  520  519  518  517  516  515  514  513  512  511  510  509  508  507  506  505  504  503  502  501  500  499  498  497  496  495  494  493  492  491  490  489  488  487  486  485  484  483  482  481  480  479  478  477  476  475  474  473  472  471  470  469  468  467  466  465  464  463  462  461  460  459  458  457  456  455  454  453  452  451  450  449  448  447  150
 226  225  224  223  222  221  220  219  218  217  216  215  214  213  212  211  210  209  208  207  206  205  204  203  202  201  200  199  198  197  196  195  194  193  192  191  190  189  188  187  186  185  184  183  182  181  180  179  178  177  176  175  174  173  172  171  170  169  168  167  166  165  164  163  162  161  160  159  158  157  156  155  154  153  152  151
