# This puzzle is unsolvable
19
  4   1   5 140  70 138   8   9   7  79  10  82 201  85  15 152  21  20  19
137 192  75 141 241  74   6  77  81  12 146  83  11  13  92  16  17  24  23
275  63 195  71  73 197 149  80 142  14 200 151 316 150 205 204 206  87  22
135   2 279  72 244 139  78  76 311 145 144 198 285  84 148 154  88  18  90
189 191 240 180 133  68 196 199 242 278 147 318 286 251 250 202 156 153 207
 64 129 309 239 193 280 339 283 235 282 143 288 248 342  86  26  94  91  25
131 273  69 313   3 245 243 336 315 317 247 354 353 249 290 203 289 296  93
190 334 134 183 136 335 329 287 314 348 307 340  89 208 291 209  27  96 155
  0 308  65 194 277 238 359 319 246 355 344 258 322 321 252  97  98  31 102
 66 188 276 281 312 274 306 360 284 310 337 302 338 262 294  99 210  28 211
128 236 132 358 350 187 328 351 268 300 261 222 323 256 295  95 214 159 157
237 182  62  67 332 356 303  49 327 352 293 163 264 212 220 213 257 253 254
232 123 231 127 126 272 331 305 170 320 171 266 357 326 158 161 259 260  29
125 234 184 181 271  61 292 227 346 343 221 347 325 341 263 255 215 160 100
 56  55 270  57 130 122 333 349 223 174 108 324 267  46 162 168  32  30 106
230 229 186 124 176 185 269 224 330 225 297  48 110 218  39 101  33 105 104
 58  50 179  52 113 226 112 345 118 173 298  45  44 167 216 164 107  36  35
119  59 228 178  60 233 120 304 114 299 172 115 301 219 166  34 165  38  37
121  54  51 117 116  53 169 265 177 175  43  47 111 103 109  42  41  40 217
