# This puzzle is unsolvable
45
   2    1    3    4    5    6    7    8    9   10   11   12   13   14   15   16   17   18   19   20   21   22   23   24   25   26   27   28   29   30   31   32   33   34   35   36   37   38   39   40   41   42   43   44   45
 176  177  178  179  180  181  182  183  184  185  186  187  188  189  190  191  192  193  194  195  196  197  198  199  200  201  202  203  204  205  206  207  208  209  210  211  212  213  214  215  216  217  218  219   46
 175  344  345  346  347  348  349  350  351  352  353  354  355  356  357  358  359  360  361  362  363  364  365  366  367  368  369  370  371  372  373  374  375  376  377  378  379  380  381  382  383  384  385  220   47
 174  343  504  505  506  507  508  509  510  511  512  513  514  515  516  517  518  519  520  521  522  523  524  525  526  527  528  529  530  531  532  533  534  535  536  537  538  539  540  541  542  543  386  221   48
 173  342  503  656  657  658  659  660  661  662  663  664  665  666  810  667  668  670  671  672  673  674  675  676  677  678  679  680  681  682  683  684  685  686  687  688  689  690  691  692  693  544  387  222   49
 172  341  502  655  800  801  802  803  804  805  806  807  943  808  809  811  669  813  814  815  816  817  818  819  820  821  822  823  824  825  826  827  828  829  830  831  832  833  834  835  694  545  388  223   50
 171  340  501  654  799  936  937  938 1066  939  940  941  942  944  945  946  812  948  949  950  951  952  953  954  955  956  957  958  959  960  961  962  963  964  965  966  967  968  969  836  695  546  389  224   51
 170  339  500  653  798  935 1064 1065 1186 1185 1068 1069 1070 1071 1072 1073  947 1075 1076 1077 1078 1079 1080 1081 1082 1083 1084 1085 1086 1087 1088 1089 1090 1091 1092 1093 1094 1095  970  837  696  547  390  225   52
 169  338  499  652  797  934 1063 1184 1067 1187 1298 1188 1189 1190 1191 1192 1074 1193 1194 1195 1197 1198 1199 1200 1201 1202 1203 1204 1205 1206 1207 1208 1209 1210 1211 1212 1213 1096  971  838  697  548  391  226   53
 168  337  498  651  796  933 1062 1183 1296 1297 1402 1299 1300 1301 1302 1303 1304 1305 1306 1196 1307 1308 1309 1310 1311 1313 1314 1315 1316 1317 1318 1319 1320 1321 1322 1323 1214 1097  972  839  698  549  392  227   54
 167  336  497  650  795  932 1061 1181 1400 1399 1401 1497 1404 1499 1405 1406 1407 1408 1409 1410 1411 1412 1413 1415 1312 1416 1417 1418 1419 1420 1421 1422 1423 1424 1425 1324 1215 1098  973  840  699  550  393  228   55
 166  335  496  649  794  931 1060 1295 1182 1496 1495 1584 1403 1500 1587 1501 1502 1503 1504 1505 1506 1507 1508 1414 1509 1511 1512 1513 1514 1515 1516 1517 1518 1519 1426 1325 1216 1099  974  841  700  551  394  229   56
 165  334  495  648  793  930 1059 1180 1294 1398 1293 1585 1498 1586 1588 1589 1590 1591 1670 1593 1672 1594 1595 1596 1510 1598 1599 1600 1601 1602 1603 1604 1605 1520 1427 1326 1217 1100  975  842  701  552  395  230   57
 164  333  494  792  791  929 1179 1178 1292 1397 1494 1583 1664 1665 1666 1738 1667 1669 1741 1592 1743 1673 1674 1676 1597 1677 1678 1679 1680 1681 1682 1683 1606 1521 1428 1327 1218 1101  976  843  702  553  396  231   58
 163  332  493  647  790  928 1058 1177 1291 1396 1493 1582 1663 1736 1800 1737 1668 1739 1740 1671 1861 1744 1745 1675 1747 1748 1749 1750 1751 1752 1753 1684 1607 1522 1429 1328 1219 1102  977  844  703  554  397  232   59
 162  331  492  645  646  927 1057 1290 1286 1394 1395 1581 1662 1856 1858 1742 1803 1804 1859 1805 1860 1808 1863 1746 1810 1811 1812 1813 1814 1815 1754 1685 1608 1523 1430 1329 1220 1103  978  845  704  555  398  233   60
 161  491  789  489  926 1055 1056 1176 1492 1491 1490 1580 1734 1801 1735 1802 1857 1904 1906 1806 1862 1807 1910 1809 1865 1866 1867 1868 1869 1816 1755 1686 1609 1524 1431 1331 1330 1104  979  846  705  556  399  234   61
 160  330  644  490  643  787  925 1288 1579 1289 1661 1578 1733 1799 1798 1797 1855 1905 1854 1976 1908 1909 1911 1864 1912 1913 1915 1916 1870 1817 1756 1687 1610 1525 1432 1332 1221 1105  980  847  706  557  400  235   62
 328  329  488  642  924  788 1054 1285 1392 1175 1489 1659 1660 1658 1732 1902 1945 1975 1946 1907 1947 1948 1949 1950 1951 1952 1914 1918 1917 1818 1757 1688 1611 1526 1433 1222 1223  981 1108  848  707  558  401  236   63
 159  158  487  784  923 1052 1390  785 1287 1391 1488 1577 1657 1795 1796 1794 1903 1943 2001 1978 2016 1979 1980 1981 1982 1983 1954 1953 1871 1819 1758 1689 1612 1527 1528 1434  982 1106  983  849  709  559  402  237   64
 157  326  327  786  641 1173 1053 1174 1171 1393 1575 1487 1730 1851 1853 1944 1901 1942 1977 2000 2024 2002 2003 2007 1984 1957 1955 1873 1872 1820 1759 1690 1613 1529 1335 1435 1224 1334 1109  708  710  560  405  238   65
 156  486  640  639  483  921 1051  922 1172 1389 1486 1576 1731 1729 1852 1900 1899 1941 1974 1999 1973 2017 2022 2005 2008 1956 1985 1919 1874 1821 1760 1692 1530 1691 1226 1333 1107 1225  984  561  711  404  850  403   66
 155  325  485  638  917 1281 1170 1050 1169  920 1284 1485 1574 1727 1728 1793 1898 1940 2013 1939 1998 2015 1986 2020 2006 2004 1920 1921 1875 1822 1762 1615 1616 1614 1436 1438 1227  985  852  851   68  562  239   69  240
 323  324  322  637  783  918 1283 1048 1388 1386 1387 1656 1654 1792 1652 1850 1848 1970 1938 2018 1992 2023 2019 2010 2011 2021 1958 1987 1823 1824 1693 1617 1761 1437 1532 1110 1337 1230  714 1112  986  712  409  407   67
 154  321  916  635  919  782 1047 1167 1282 1572 1484 1483 1573 1650 1725 1726 1849 1897 1972 1995 1996 1997 2014 1928 2009 1963 1877 1988 1763 1765 1764 1694 1533 1531 1439 1338 1340  987  856 1111  853  564  243  406   70
 153  320  484  636  632 1045 1049 1166 1482 1168 1571 1570 1655 1653 1790 1791 1847 1936 1968 1969 1994 2012 1990 1991 1959 1962 1960 1925 1923 1876 1825 1695 1440 1336 1534 1229 1115 1228  241  713  854  408  565   71  244
 152  481  482  781  634  780 1046  913 1385 1383 1384 1651 1786 1846 1842 1789 1937 1971 1894 1934 1967 1966 1965 1993 1826 1961 1989 1879 1827 1830 1696 1621 1618 1442 1339 1341 1232 1114  563  857  855  567  246  245   72
 151  319  480  779  777  915  633 1280 1380 1279 1278 1569 1895 1788 1649 1844 1891 1893 1892 1933 1932 1931 1887 1964 1929 1884 1878 1828 1880 1922 1769 1697 1619 1441 1536 1342  989 1231  988  859 1113  566  715  242  411
 150  318  478  479 1044  778 1164 1382 1165 1381 1477 1722 1787 1643 1785 1724 1783 1781 1935 1838 1889 1930 1778 1886 1835 1885 1924 1926 1767 1628 1768 1766 1620 1345 1234 1344 1444  991  990  718  717  716    0  247   73
 149  316  317  631  776 1043 1041 1042 1275 1276 1568 1480 1718 1839 1716 1896 1843 1712 1782 1780 1779 1837 1888 1836 1775 1834 1927 1833 1881 1829 1705 1701 1535  993 1623 1233 1346 1116 1117  719  410  858   74   75   76
 148  147  475  477  629  911 1038 1481 1379 1277 1565 1723 1478 1648 1841 1845 1719 1715 1890 1635 1777 1709 1710 1776 1707 1631 1882 1831 1700 1622 1703 1542 1698 1443 1537 1235 1118 1343  992  860  248  568  412  569  249
 313  145  315  775  773 1161  630  914 1162 1163 1476 1647 1717 1567 1784 1566 1720 1642 1640 1711 1557 1636 1634 1359 1883 1773 1832 1774 1770 1772 1445 1699 1624 1446 1447 1236 1348 1538 1119  994  861  570  413  571  414
 146  772  476  628  771  912 1040 1159 1274 1160 1273 1479 1646 1721 1840 1561 1465 1639 1638 1714 1713 1553 1554 1708 1632 1633 1550 1771 1706 1629 1702 1545 1540 1704 1625 1347  995 1120  996  721  862  572  415  250   78
 314  144  474  627 1039  774 1037 1271  910 1475 1374 1645 1564 1560 1378 1562 1372 1370 1463 1364 1366 1360 1363 1458 1549 1252 1551 1630 1546 1454 1627 1626 1539 1453 1243 1448 1237 1121  997  863  720  722  416   77  251
 143  312  473  626  908  770 1036 1158 1272 1377 1474 1472 1471 1264 1644 1263 1261 1641 1466 1461 1462 1558 1257 1361 1357 1548 1547 1457 1247 1249 1244 1352 1240 1349 1544 1122 1238 1239  864  865  723  573  417  252   79
 142  311  472  625  907  906  909 1375 1268 1270 1373 1473 1563 1470 1467 1559 1469 1262 1556 1367 1020 1552 1637 1459 1255 1256 1456 1355 1455 1354 1541 1351 1451 1543 1246 1128 1241 1123  998  866  725  574  418  253   80
 141  310  471  624  769  905 1156 1157 1269 1267 1376 1152 1151 1468 1028 1369 1144 1148 1260 1464 1555 1258 1362 1142 1140 1358 1251 1013 1136 1248 1133 1450 1242 1449  872 1126  734 1002 1124 1001  726  724  576  419   81
 140  309  470  623  768 1034 1035 1155 1154 1153 1266 1147 1149 1150 1371 1026  752 1145 1259 1143 1460 1365  886 1017 1254 1253  882 1137 1011 1132 1356 1350 1353 1130 1129  729 1245 1003  732 1000  867  575  577  256  420
 139  308  469  622  767  904 1033 1032 1031 1030 1029  610 1265  897  757  891 1146 1022 1021  748 1139  888  884 1138 1014 1134  881  883 1012 1135 1009 1008 1131 1452 1127  586  433 1125 1004  731  583  868  727  254  255
 138  307  468  621  766  903  902  901  900  899  896  607  609 1025 1024 1023  755 1368  892  890 1019  285  600 1018  444  599 1250  745  592 1010  740  879 1007  874 1006  873  871  430  580  423  259  728  578   83   82
 137  306  467  620  765  764  763  762  761  760  758  898  894 1027  893  608  606  751  287  749  889  887  746  885  109 1016  595  440  741  275  742  591  736  877  735 1005  431  267  584  579  999  870  869  257   85
 136  305  466  619  618  617  616  615  614  613  612  756  456  452  611  116  750  603  447  449  448  602  597  744 1015  596  743  105  739  878  590  274  589  738  875  876  587  585  581  426  422  424  421   92   87
 135  304  465  464  463  462  461  460  459  294  457  759  454  291  121  118  753  754  451  284 1141  601  747  282  280  598  442  277  106  104  880  103  101  435  432   97  428  429  427  582  730  262  260   91   84
 134  303  302  301  300  299  298  297  296  458  455  122  123  120  290  895  453  117  286  283  115  445  114  281  108  278  279  441  593  438  434  737  436  100  733  269  588   96  268  265  264  263   88   89  258
 133  132  131  130  129  128  127  126  125  295  293  124  292  119  289  450  605  604  288  113  446  112  111  443  110  107  439  276  594  273  437  102  271  270  272   99   98   95  266   93   94  261  425   90   86
