# This puzzle is unsolvable
43
   3  168  169  330    5  171  173  335  174   10   12  178   11  180   14   16  182   20   19   21  348   22  189   25  191   26   27   28   29   30   31   32   33   34   35   36   37  206   38   39   41   42   43
 329    4  170    2  483    6  332  333    7  334    9  179  338  339   15  493  343  185   17  186  499   24  188  351  192  193  194  195  196  197  198  199  200  201  202  364  204  205  207  208  367  209   44
   1  328  624  327  625  172  763  761    8  487  175  337  490   13  181  342  344   18  187  346  641  190   23  502  352  503  353  354  355  356  357  359  509  361  362  203  657  363   40  366  368  210   45
 167  481  626  623  331  888  627  484  177  766  336  632  489  340  341  769  492  184  345  496  347  497  501  350  643  504  647  650  505  507  508  358  360  512  656  513  658  515  365  517  211  212   46
 166  480  326  324  482  762  485 1009  630  488  634 1124  895  898  636  491  495  637  494  901  183  500  349  642  908  781  646  506  651  785  912  654  510  511  655  791  514  516  659  518  369  213   47
 163  164  479  889 1008  890  628  176  631  486  768  894  633 1017  635  770  899  773  498  772  640  776  779  778  644  645  780  784 1030  649  787  914  652  788  789  790  792  793  661  520  519  370   48
 475  165  160  325  759  758  764  892  629 1012  765  767 1014  896 1128  900 1018  775  638  904  903 1020  777  910  907 1136  782  648 1031  913  786 1033  653  916  920 1147  918  795  921  660  371  214   49
 477  478  476  622  757  887 1007 1010  891 1120 1013  893 1015  771  897 1019 1130  902 1021 1132  639  905 1023  906 1028  783 1139 1242 1141 1142 1144 1032 1034 1035 1036  917  919  794  522  521  372  215   50
 760  162  620  621  474  886 1121 1321 1225 1011 1122 1228 1125 1126 1127 1129 1131  774 1233 1234 1022 1238 1024 1134 1026 1029  909 1339 1027 1143 1246  915 1247 1146 1038 1037  796  663  664  662  373  216   51
 158  323  321  322  619  756  885  884 1118 1117 1224 1123 1323 1229 1016 1230 1231 1328 1330 1236 1237 1133 1025 1137 1239 1240  911 1138 1244 1140 1248 1507 1145 1249 1148 1039  922  798  797  523  374  217   52
 161  159  317  472  320  883  753 1223 1006 1222 1322 1227 1489 1324 1325 1326 1232 1329 1235 1495 1331 1135 1333 1334 1422 1335 1241 1243 1245 1340 1343 1429 1251 1250 1149 1040  923  799  665  524  375  218   53
 319  157  473  755 1000  618 1004 1119 1320 1408 1226 1410 1409 1412 1491 1413 1327 1415 1414 1417 1419 1332 1420 1501 1423 1336 1424 1337 1338 1508 1505 1342 1345 1151 1152 1041  800  925  666  525  376  219   54
 318  471  156  617  616 1115  882 1005 1002 1116 1318 1407 1488 1490 1411 1492 1494 1416 1567 1497 1418 1496 1499 1572 1689 1573 1576 1425 1428 1426 1427 1341 1509 1253 1150 1252 1042  924  667  526  377  220   55
 470  154  152  880  752  881  999 1114 1317 1319 1316 1406 1560 1561 1624 1563 1493 1628 1565 1498 1566 1569 1631 1421 1635 1503 1502 1504 1575 1579 1510 1506 1346 1431 1430 1043  926  801  668  527  378  221   56
 153  316  611  469  754  879 1113 1220 1221 1486 1404 1487 1558 1559 1562 1626 1564 1627 1629 1630 1568 1633 1571 1500 1634 1636 1737 1692 1577 1578 1434 1432 1344 1154 1044 1045  927  802  669  528  379  222   57
 155  466  615  878  750 1001 1112 1111 1003 1218 1315 1405 1485 1680 1625 1682 1730 1683 1684 1685 1686 1632 1570 1688 1691 1739 1574 1637 1638 1349 1580 1433 1347 1256 1254  928  929  803  670  530  529  224   58
 314  612  467  751  748  877 1215  998 1219 1314 1403 1482 1484 1623 1726 1679 1727 1769 1731 1732 1772 1687 1775 1735 1776 1690 1740 1694 1695 1640 1693 1435 1255 1156 1348 1046  804  805  671  223  382  380  381
 315  311  463  610  876  468  747  997 1311 1483 1313 1481 1557    0 1622 1681 1728 1729 1770 1771 1773 1774 1736 1734 1806 1777 1738 1641 1581 1511 1639 1350 1436 1257 1153 1155 1047  930  672  673  383   59  225
 313  151  464  614  746  745 1110 1399 1217 1109 1312 1555 1556 1621 1620 1678 1768 1800 1801 1802 1804 1733 1805 1828 1778 1779 1741 1642 1696 1582 1583 1515 1512 1258 1158 1157 1048  806  807  533  531  226   60
 312  310  309  609  874  465  995  749 1209 1401 1310 1402 1618 1479 1677 1767 1766 1799 1824 1825 1803 1826 1843 1807 1808 1743 1702 1742 1697 1643 1513 1352 1351 1353 1260  932 1050  931  808  532  675   62  227
 150  147  607  872  613  875  996 1108 1553 1216 1400 1550 1551 1725 1554 1674 1676 1765 1798 1823 1839 1840 1827 1830 1744 1780 1700 1698 1645 1514 1584 1438 1259 1261 1160 1159 1049  933  385  534   61  384  228
 149  148  606  744  608  993 1214 1480  994 1213 1107 1397 1619 1675 1615 1724 1797 1837 1796 1822 1841 1831 1809 1810 1829 1784 1811 1781 1699 1585 1516 1439 1437 1262 1354 1051  676  809  387  674  536  386   63
 146  308  461  462  740  743  873 1106 1212 1477 1552 1548 1721 1673 1764 1722 1723 1795 1820 1763 1844 1847 1834 1848 1832 1749 1782 1745 1644 1586 1517 1440 1355 1161 1162  935  934  936  535  388   64   67  230
 307  460  602  458  742  605 1307 1105  992 1393 1398 1395 1475 1549 1614 1720 1761 1762 1821 1838 1842 1835 1845 1751 1812 1783 1701 1646 1587 1649 1518 1441 1356 1053 1263 1052  678  677  679  389  229   65   68
 145  305  306  739  871  459  991  990 1100 1211 1309 1308 1670 1617 1478 1672 1794 1819 1818 1846 1836 1789 1816 1833 1706 1814 1746 1648 1647 1588 1519 1357 1442 1443 1265 1164  810  811  537  538  539  231  234
 144  604  457  989  869 1208 1101  866 1210 1104 1616 1394 1719 1547 1671 1718 1760 1793 1792 1791 1817 1755 1790 1788 1785 1652 1748 1651 1650 1521 1445 1266 1165 1264 1163  939  938  812  813  680  390   66  233
 143  303  741  304 1102  738  988  870 1306 1304 1396 1611 1546 1612 1669 1717 1759 1758 1757 1756 1754 1753 1787 1705 1752 1704 1813 1747 1590 1589 1520 1359 1267 1361 1056  941 1054  937  814  540   69  235  232
 142  456  603  867  868  987 1305 1098 1303 1207 1476 1613 1545 1610 1668 1666 1716 1715 1714 1713 1711 1660 1815 1710 1786 1750 1707 1653 1524 1703 1522 1444 1358 1268 1058 1055  815  940  681  391  236  393   70
 141  302  601  736  865  599 1206  985 1205 1392 1473 1474 1472 1540 1541 1608 1665 1605 1664 1662 1712 1659 1708 1598 1658 1454 1657 1592 1591 1523 1446 1360 1363 1362 1057 1060  682  684  818  541  392   72  237
 140  301  598  986  600  737 1103 1204 1389 1390 1301 1543 1470 1667 1609 1465 1463 1606 1663 1603 1661 1602 1600 1709 1656 1655 1597 1595 1529 1527 1594 1593 1269 1270 1166 1169 1059  683  942  542  543  394   71
 139  454  455  453  735 1099  864 1203 1299 1302 1471 1467 1295 1466 1383 1381 1542 1538 1604 1536 1533 1601 1376 1531 1599 1457 1654 1596 1528 1525 1450 1448 1364 1170 1167  816  943  817  685  544  395  238   73
 138  300  452  863  597  984 1097 1202 1469 1298 1300 1391 1293 1384 1464 1382 1537 1539 1461 1378 1535 1460 1534 1532 1455 1530 1371 1453 1277 1452 1449 1447 1365 1271 1272 1171 1061  819  686  545  397  239   74
 137  299  451  732  596  861 1095  862 1201  983 1388 1294 1386 1544 1385 1289 1607 1462 1379 1377 1375 1374 1459 1456 1283 1373 1370 1372 1181 1526 1367 1366 1273 1063 1168 1172  944  820  687  396  240  241   75
 136  298  450  595  734  733  859  981 1200 1297 1197 1296 1195 1468 1192 1191 1290 1085 1190 1288 1287 1285 1284 1458 1281 1074 1278 1072 1369 1451 1368 1275 1274 1174  946 1062  945  821  688  546  398  242   76
 296  134  133  449  980  729  860 1096 1094 1387 1089 1196 1087 1292  970 1194 1193 1088 1082 1186 1286 1080 1185 1282 1183 1279  959 1179 1178 1177 1276 1176 1175 1067 1173 1064  947  822  689  547  548  399   77
 297  135  594  731  858  730  727  982 1090  852  975  974  851  973  849 1291 1380  969 1189 1187  965 1078 1184 1076  962 1073  960 1075 1071 1180 1070 1069 1068  952 1066 1065  948  823  690  549  400  243   78
 295  446  448  593  591  978  979 1199 1198  856  582  976  846 1086  717 1083  845  967  966 1188  964 1079  963 1077  961 1182  834  704 1280  833  955  954  951  830  828  950  949  824  691  550  401  244   79
 130  592  293  445  444  724  725 1093 1091  855  584  853 1084  847  971  432  715  844  843 1081  712  842  841  840  839  838  836  705  835  956  701  832  953  698  829  826  825  694  692  551  402  245   80
 291  287  447  728  857  726  589  585 1092  722  721  977  276  719  718  968  577  578  714  713  711  710  709  708  707  958  837  565  703  702  957  699  560  697  696  827  695  555  693  552  403  246   81
 131  132  294  590  587  440  586  438  854  723  434  972  278  720  850  848  428  716  574  573  572  571  570  569  568  419  706  564  417  418  416  700  559  831  558  557  556  408  554  553  404  247   82
 289  443  290  129  441  285  439  283  282  583  581  435  279  580  576  429  274  273  575  426  425  424  423  422  421  567  566  263  415  563  562  258  561  414  412  411  410  253  407  406  405  248   83
 127  128  292  288  123  286  284  437  281  436  116  277  431  430  113  579  112  275  427  271  270  269  268  267  266  265  420  264  262   99  261  260  413  257  256  255  409  254   90  251  250  249   84
 126  125  442  588  124  122  121  120  119  280  118  117  115  114  433  111  110  109  272  108  107  106  105  104  103  102  101  100   98   97   96  259   95   94   93   92   91   89  252   88   87   86   85
