# This puzzle is unsolvable
15
104 101   1 103  59   6 204  65  60  70 181  13  15  21  69
 57   2 139  64 145  11   5   4  14   8 178  68  10  18 114
107  58 146 109 198 147 106  63   9  62 112  71 183 116 151
 98  56 105   7 173   3 197  66  67 182  12   0 118 153  73
 54 141 213 143 174 142 108 218 200 111  72 180  77 113  74
179 172 216 199 223 144 102 157 201 110 208 150  20 115  16
 55  94 219 140 224 177 207 220  83 154 148 117  17  82  75
138  48  45 155 100 162 167 206 203 123 191  22 186 187 189
 46  50 136 193 221 195 129 202 168 185 159  76 149  23 156
176  51  61  52 215  49 209 175  87 217 125  19 184  32  80
166 134  43  95  40 130 205 122 152 210 121 124 160 192 158
 47  99 196 171  53  92  41  86 163  38 188 222  79  78 119
 97 135 137 164  89  37 133  39 131 161  30 211  24 169 120
 90  44  93 132  88 194 165 170  34 128 190  28  29  31  27
 85  91  42 214  96  84 212  35  36 127  81 126  33  26  25
