# This puzzle is unsolvable
18
128   3  74 135  71  68  76  73  72  75  12 236   7 138 143  13 142  20
180  61   2   5 265   6 137 129 190  11 227  78 193  14  79  83  21  84
131 253   1 226 179   0 126 186   9 259 192  91  15 269  10 194  88  18
130  65 311 127 182  77 132 139 231 188   4 148 140  80  17  24  23  89
 67 260 224  70 261  64 225 257 181   8 234  19 299  86 144 310  82 235
177 136 173  69  63 124 289 183 290 141 306 233 312 189 196  87 146  90
258  62 133 125 185 308 288 292 266 268 232 187 295  85  25 294 197  16
263 120 256 122 184 221 222 300 291 229 191 309 145  81 273  27 238  22
 66  59 282 285  60 262 134 322 319 228 245 178 239 307 195 270  26 271
121  58 123 264 318 317 323 316 315 293 303 313  96 156 151 150  94 147
223 220 170 118 176 172 280 320 304 246 152 267 241 275 163  29  28  93
216 287 219 218  50 281 175 278 314 230 105 277  38 297 205 298 198  30
116  57 119 213 171 217 113 301 276 302 108 296 274 201 204  92 153 149
115 252 255 286 168 249 247 107  40 160 321 279 243 242  41  31 237 199
215 305  56 109 254 248 174 251 165 159 104 208 272 203 157 103  43  97
 55 167 210 283 112 250 166 284  45  46 209 101  39 240 244 200  98  95
169 212  53 114 111 214 110 161  44 164 162 207  35 206 202  33  99  34
 54 117  51  47  52 211  48  49  42 106 158 100 102  37 155  36  32 154
