# This puzzle is unsolvable
68
   2    1    3    4    5    6    7    8    9   10   11   12   13   14   15   16   17   18   19   20   21   22   23   24   25   26   27   28   29   30   31   32   33   34   35   36   37   38   39   40   41   42   43   44   45   46   47   48   49   50   51   52   53   54   55   56   57   58   59   60   61   62   63   64   65   66   67   68
 268  269  270  271  272  273  274  275  276  277  278  279  280  281  282  283  284  285  286  287  288  289  290  291  292  293  294  295  296  297  298  299  300  301  302  303  304  305  306  307  308  309  310  311  312  313  314  315  316  317  318  319  320  321  322  323  324  325  326  327  328  329  330  331  332  333  334   69
 267  528  529  530  531  532  533  534  535  536  537  538  539  540  541  542  543  544  545  546  547  548  549  550  551  552  553  554  555  556  557  558  559  560  561  562  563  564  565  566  567  568  569  570  571  572  573  574  575  576  577  578  579  580  581  582  583  584  585  586  587  588  589  590  591  592  335   70
 266  527  780  781  782  783  784  785  786  787  788  789  790  791  792  793  794  795  796  797  798  799  800  801  802  803  804  805  806  807  808  809  810  811  812  813  814  815  816  817  818  819  820  821  822  823  824  825  826  827  828  829  830  831  832  833  834  835  836  837  838  839  840  841  842  593  336   71
 265  526  779 1024 1025 1026 1027 1028 1029 1030 1031 1032 1033 1034 1035 1036 1037 1038 1039 1040 1041 1042 1043 1044 1045 1046 1047 1048 1049 1050 1051 1052 1053 1054 1055 1056 1057 1058 1059 1060 1061 1062 1063 1064 1065 1066 1067 1068 1069 1070 1071 1072 1073 1074 1075 1076 1077 1078 1079 1080 1081 1082 1083 1084  843  594  337   72
 264  525  778 1023 1260 1261 1262 1263 1264 1265 1266 1267 1268 1269 1270 1271 1272 1273 1274 1275 1276 1277 1278 1279 1280 1281 1282 1283 1284 1285 1286 1287 1288 1289 1290 1291 1292 1293 1294 1295 1296 1297 1298 1299 1300 1301 1302 1303 1304 1305 1306 1307 1308 1309 1310 1311 1312 1313 1314 1315 1316 1317 1318 1085  844  595  338   73
 263  524  777 1022 1259 1488 1489 1490 1491 1492 1493 1494 1495 1496 1497 1498 1499 1500 1501 1502 1503 1504 1505 1506 1507 1508 1509 1510 1511 1512 1513 1514 1515 1516 1517 1518 1519 1520 1521 1522 1523 1524 1525 1526 1527 1528 1529 1530 1531 1532 1533 1534 1535 1536 1537 1538 1539 1540 1541 1542 1543 1544 1319 1086  845  596  339   74
 262  523  776 1021 1258 1487 1708 1709 1710 1711 1712 1713 1714 1715 1716 1717 1718 1719 1720 1721 1722 1723 1724 1725 1726 1727 1728 1729 1730 1731 1732 1733 1734 1735 1736 1737 1738 1739 1740 1741 1742 1743 1744 1745 1746 1747 1748 1749 1750 1751 1752 1753 1754 1755 1756 1757 1758 1759 1760 1761 1762 1545 1320 1087  846  597  340   75
 261  522  775 1020 1257 1486 1707 1920 1921 1922 1923 1924 1925 1926 1927 1928 1929 1930 1931 1932 1933 1934 1935 1936 1937 1938 1939 1940 1941 1942 1943 1944 1945 1946 1947 1948 1949 1950 1951 1952 1953 1954 1955 1956 1957 1958 1959 1960 1961 1962 1963 1964 1965 1966 1967 1968 1969 1970 1971 1972 1763 1546 1321 1088  847  598  341   76
 260  521  774 1019 1256 1485 1706 1919 2124 2125 2126 2127 2128 2129 2130 2131 2132 2133 2134 2135 2136 2137 2138 2139 2140 2141 2142 2143 2144 2145 2146 2147 2148 2149 2150 2151 2152 2153 2154 2155 2156 2157 2158 2159 2160 2161 2162 2163 2164 2165 2166 2167 2168 2169 2170 2171 2172 2173 2174 1973 1764 1547 1322 1089  848  599  342   77
 259  520  773 1018 1255 1484 1705 1918 2123 2320 2321 2322 2323 2324 2325 2326 2327 2328 2329 2330 2331 2332 2333 2334 2335 2336 2337 2338 2339 2340 2341 2342 2343 2344 2345 2346 2347 2348 2349 2350 2351 2352 2353 2354 2355 2356 2357 2358 2359 2360 2361 2362 2363 2364 2365 2366 2367 2368 2175 1974 1765 1548 1323 1090  849  600  343   78
 258  519  772 1017 1254 1483 1704 1917 2122 2319 2508 2509 2510 2511 2512 2513 2514 2515 2516 2517 2518 2519 2520 2521 2522 2523 2524 2525 2526 2527 2528 2529 2530 2531 2532 2533 2534 2535 2536 2537 2538 2539 2540 2541 2542 2543 2544 2545 2546 2547 2548 2549 2550 2551 2552 2553 2554 2369 2176 1975 1766 1549 1324 1091  850  601  344   79
 257  518  771 1016 1253 1482 1703 1916 2121 2318 2507 2688 2689 2690 2691 2692 2693 2694 2695 2696 2697 2698 2699 2700 2701 2702 2703 2704 2705 2706 2707 2708 2709 2710 2711 2712 2713 2714 2715 2716 2717 2718 2719 2720 2721 2722 2723 2724 2725 2726 2727 2728 2729 2730 2731 2732 2555 2370 2177 1976 1767 1550 1325 1092  851  602  345   80
 256  517  770 1015 1252 1481 1702 1915 2120 2317 2506 2687 2860 2861 2862 2863 2864 2865 2866 2867 2868 2869 2870 2871 2872 2873 2874 2875 2876 2877 2878 2879 2880 2881 2882 2883 2884 2885 2886 2887 2888 2889 2890 2891 2892 2893 2894 2895 2896 2897 2898 2899 2900 2901 2902 2733 2556 2371 2178 1977 1768 1551 1326 1093  852  603  346   81
 255  516  769 1014 1251 1480 1701 1914 2119 2316 2505 2686 2859 3024 3025 3026 3027 3028 3029 3030 3031 3032 3033 3034 3035 3036 3037 3038 3039 3040 3041 3042 3043 3044 3045 3046 3047 3048 3049 3050 3051 3052 3053 3054 3055 3056 3057 3058 3059 3060 3061 3062 3063 3064 2903 2734 2557 2372 2179 1978 1769 1552 1327 1094  853  604  347   82
 254  515  768 1013 1250 1479 1700 1913 2118 2315 2504 2685 2858 3023 3180 3181 3182 3183 3184 3185 3186 3187 3188 3189 3190 3191 3192 3193 3194 3195 3196 3197 3198 3199 3200 3201 3202 3203 3204 3205 3206 3207 3208 3209 3210 3211 3212 3213 3214 3215 3216 3217 3218 3065 2904 2735 2558 2373 2180 1979 1770 1553 1328 1095  854  605  348   83
 253  514  767 1012 1249 1478 1699 1912 2117 2314 2503 2684 2857 3022 3179 3328 3329 3330 3331 3332 3333 3334 3335 3336 3337 3338 3339 3340 3341 3342 3343 3344 3345 3346 3347 3348 3349 3350 3351 3352 3353 3354 3355 3356 3357 3358 3359 3360 3361 3362 3363 3364 3219 3066 2905 2736 2559 2374 2181 1980 1771 1554 1329 1096  855  606  349   84
 252  513  766 1011 1248 1477 1698 1911 2116 2313 2502 2683 2856 3021 3178 3327 3468 3469 3470 3471 3472 3473 3474 3475 3476 3477 3478 3479 3480 3481 3482 3483 3484 3485 3486 3487 3488 3489 3490 3491 3492 3493 3625 3494 3496 3497 3630 3498 3499 3501 3502 3365 3220 3067 2906 2737 2375 2182 2183 1982 1981 1555 1330 1097  856  607  350   85
 251  512  765 1010 1247 1476 1697 1910 2115 2312 2501 2682 2855 3020 3177 3326 3467 3600 3601 3602 3603 3604 3605 3606 3607 3608 3609 3610 3611 3612 3613 3614 3615 3616 3617 3618 3619 3620 3621 3623 3745 3747 3626 3624 3628 3629 3751 3753 3754 3500 3503 3366 3221 3068 2907 2561 2560 2376 2184 1774 1772 1556 1331 1098  857  608  351   86
 250  511  764 1009 1246 1475 1696 1909 2114 2311 2500 2681 2854 3019 3176 3325 3466 3599 3724 3725 3726 3727 3728 3729 3730 3731 3732 3733 3734 3735 3736 3737 3738 3739 3740 3741 3742 3743 3744 3622 3746 3748 3495 3864 3749 3750 3756 3868 3633 3631 3504 3367 3222 3069 2739 2738 2562 2185 2377 1983 1773 1557 1332 1099  858  609  352   87
 249  510  763 1008 1245 1474 1695 1908 2113 2310 2499 2680 2853 3018 3175 3324 3465 3598 3723 3840 3841 3842 3843 3844 3845 3846 3847 3848 3849 3850 3851 3852 3853 3854 3855 3856 3857 3858 3859 3860 3861 3862 3863 3627 3972 3865 3866 3634 3635 3632 3505 3368 3223 3070 2908 2563 2741 2378 2186 1985 1984 1558 1333 1100  859  610  353   88
 248  509  762 1007 1244 1473 1694 1907 2112 2309 2498 2679 2852 3017 3174 3323 3464 3597 3722 3839 3948 3949 3950 3951 3952 3953 3954 3955 3956 3957 3958 3959 3960 3961 3962 3963 3964 3965 3966 3967 3968 3969 3970 3971 4071 4072 3752 3867 3755 3869 3506 3369 3224 3071 2909 2740 2379 2565 1986 1987 1775 1776 1334 1101  860  611  354   89
 247  508  761 1006 1243 1472 1693 1906 2111 2308 2497 2678 2851 3016 3173 3322 3463 3596 3721 3838 3947 4048 4049 4050 4051 4052 4053 4054 4055 4056 4057 4058 4059 4060 4061 4062 4063 4064 4065 4066 4067 4068 4069 4161 4070 3974 3973 3975 3758 3636 3507 3370 3225 3072 2910 2742 2564 2380 2187 1560 1779 1559 1335 1102  861  612  355   90
 246  507  760 1005 1242 1471 1692 1905 2110 2307 2496 2677 2850 3015 3172 3321 3462 3595 3720 3837 3946 4047 4140 4141 4142 4143 4144 4145 4146 4147 4148 4149 4150 4151 4152 4153 4154 4155 4156 4157 4158 4159 4160 4244 4162 4073 3976 3757 3870 3759 3371 3374 3226 3074 2911 2566 2567 2382 2381 1777 2188 1778 1337 1103  614  862  356   91
 245  506  759 1004 1241 1470 1691 1904 2109 2306 2495 2676 2849 3014 3171 3320 3461 3594 3719 3836 3945 4046 4139 4224 4225 4226 4227 4228 4229 4230 4231 4232 4233 4234 4235 4236 4237 4238 4239 4240 4241 4242 4243 4245 4164 3977 3978 3871 3509 3508 3227 3228 2913 3073 2912 2744 2568 2743 2189 1780 1988 1336 1561 1106 1105 1104  613  357
 244  758  757 1003 1240 1469 1690 1903 2108 2304 2305 2494 2675 3013 3170 3319 3460 3593 3718 3835 3944 4045 4138 4223 4300 4301 4302 4303 4304 4305 4306 4307 4308 4309 4310 4311 4312 4313 4314 4315 4316 4317 4318 4246 4074 4163 3979 3872 3761 3638 3372 3637 3373 3075 2914 2746 2745 2383 2190 1989 1563 1562  864 1564  615  358  359   92
 243  505  242 1002 1239 1468 1902 2107 2303 2493 2674 2673 2848 2847 3317 3169 3459 3592 3717 3833 3834 3943 4044 4137 4222 4368 4369 4370 4371 4432 4372 4374 4375 4376 4377 4378 4379 4380 4381 4441 4382 4320 4384 4165 4076 4075 3760 3874 3640 3873 3762 3639 3229 3076 2916 2915 2569 2384 2191 1992 1781 1991 1338  863  865   93  616  360
 241  504 1001 1238 1466 1467 1689 1901 2104 2105 2491 2492 2846 3012 3011 3318 3458 3591 3716 3942 3941 4043 4136 4221 4299 4367 4428 4429 4431 4482 4373 4433 4434 4435 4436 4437 4438 4439 4440 4443 4492 4319 4247 4167 4248 4077 3981 3980 3876 3512 3511 3510 3230 3077 2747 2570 2571 2385 2192 1990 1784 1565 1340 1339  618   95   94   96
 503  502  756  754 1000 1237 1688 1687 2301 1899 2302 2672 2845 3010 3168 3316 3457 3590 3715 3940 3831 4042 4135 4220 4298 4296 4478 4479 4430 4561 4483 4484 4485 4486 4487 4488 4489 4490 4491 4383 4385 4442 4386 4166 4078 4079 3877 3982 3643 3641 3513 3375 3231 3078 2917 2749 2748 2386 1993 2194 1782 1783 1341 1107 1109  361  868  362
 240  501  999  755 1236 1465 1686 1900 2106 2300 2490 2671 2844 3166 3167 3315 3456 3589 3714 3832 3939 4041 4134 4297 4427 4365 4366 4295 4425 4480 4562 4527 4528 4529 4530 4531 4532 4533 4534 4493 4444 4387 4321 4249 4168 4080 3983 3765 3875 3377 3763 3376 3232 3079 2918 2572 2573 2387 2193 1566 1342 1786 1570  869 1108  617  363  365
 239  500  753  998 1235 1464 1685 1898 2103 2299 2489 2670 2843 3009 3165 3314 3455 3588 3713 3829 3937 4040 4133 4219 4362 4363 4364 4477 4481 4526 4525 4563 4590 4564 4565 4566 4567 4568 4535 4494 4445 4388 4322 4250 4169 4081 3878 3879 3764 3642 3644 3378 3233 3080 2919 2750 2574 2388 1567 1994 1787 1997 1344  866  364  619   98  620
 238  499  752  997 1234 1463 1684 1896 1897 2102 2298 2669 3006 3008 3007 3164 3454 3586 3587 3828 3938 4039 4132 4218 4217 4294 4424 4426 4522 4560 4524 4588 4589 4591 4592 4593 4594 4569 4536 4495 4446 4389 4323 4324 4082 3985 3766 3880 3767 3645 3514 3379 3234 3081 2920 2751 2197 1996 2195 1995 2389 1785 1568  867 1110  870  101  368
 237  498  751 1233 1462 1232 1683 2101 2100 2487 2488 2668 2842 2841 3163 3313 3452 3453 3712 3711 4038 3830 4131 4216 4361 4292 4475 4559 4523 4558 4557 4608 4609 4610 4611 4612 4595 4570 4537 4496 4447 4390 4325 4251 4170 3987 3984 3768 3646 3516 3515 3380 3235 3082 2921 2752 2576 2196 2391 2575 1789 1345 1569 1112  622  621   99   97
 236  497  750  996  995 1461 1682 1894 1895 2297 2486 2667 3004 3005 3162 3312 3585 3710 3934 3826 3936 3827 4130 4214 4215 4293 4423 4422 4476 4586 4587 4607 4620 4621 4622 4613 4596 4571 4538 4497 4448 4391 4326 4252 4171 4083 4173 3986 3881 3769 3517 3381 3236 3083 2922 2753 2577 2390 1788 1572 1346 1111 1114 1343  871  623  366  367
 235  496  749  994 1231 1460 1681 1893 2296 2295 2485 2666 2840 2839 3161 3311 3310 3584 3709 3825 3935 4037 4129 4213 4360 4359 4421 4474 4521 4520 4556 4585 4618 4623 4616 4614 4597 4572 4539 4498 4449 4392 4327 4253 4254 4172 4084 3882 3519 3647 3518 3382 3237 3084 2923 2755 2754 2392 2198 2200 1573 1998 1347 1113  100  624  872  102
 234  495  748  993 1230 1459 1680 2098 2099 2294 2484 2665 2838 3003 3160 3309 3451 3450 3583 3708 3933 4036 4127 4291 4290 4419 4554 4519 4517 4555 4584 4619 4617 4602 4615 4600 4598 4573 4540 4499 4450 4393 4328 4255 4174 4085 3988 3883 3770 3648 3649 3520 3383 2924 2926 2756 2578 2199 1999 1790 1571 1576 1349  875 1348  874  625  103
 233  494  747  992 1229 1458 1679 1892 2097 2293 2483 2664 2837 3002 3159 3308 3449 3582 3707 3823 3824 4035 4126 4128 4289 4358 4473 4518 4420 4606 4604 4605 4581 4601 4599 4574 4575 4544 4541 4500 4451 4394 4329 4256 4175 4086 3989 3884 3771 3650 3521 3384 3238 3085 2925 2579 2580 2393 2201 2000 1791 1350 1574 1116  626  877 1115  370
 232  493  746  991 1228 1457 1678 1891 2096 2482 2481 2663 3001 3000 3158 3307 3448 3581 3706 3822 3932 4034 4033 4212 4288 4357 4418 4472 4471 4553 4551 4583 4582 4579 4578 4577 4543 4542 4501 4452 4453 4395 4330 4257 4087 3991 4088 3886 3772 3523 3651 3385 3087 3239 3086 2757 2395 2394 2202 1792 1793 1575  876 1117  879  104  629  369
 231  492  745  990 1227 1456 1677 1890 2095 2292 2662 2835 2836 2999 3157 3306 3704 3447 3705 3931 4031 4032 4125 4211 4287 4356 4417 4470 4516 4515 4552 4511 4550 4549 4546 4508 4576 4506 4504 4502 4454 4333 4398 4396 4258 4176 3992 3990 3652 3522 3386 3241 3240 3088 3089 2581 2396 2203 2002 2003 2001 1577 1352 1119 1351  627  873  105
 230  491  744  989 1226 1455 1676 1889 2094 2291 2479 2661 2834 3303 2830 3155 3446 3580 3819 3930 4123 4124 4030 4210 4286 4355 4416 4469 4514 4465 4603 4466 4512 4547 4580 4509 4460 4458 4505 4397 4399 4400 4332 4331 4177 4089 3774 3773 3885 3887 3387 3242 3090 2928 2758 2927 2582 2397 2206 2205 1794 1578  878  628  371  106  372  373
 229  490  743  988 1225 1454 1675 1888 2093 2480 2290 2660 2833 2998 3154 3302 3156 3304 3579 3703 4122 3820 3929 4209 4285 4354 4415 4468 4467 4411 4513 4464 4510 4463 4462 4461 4545 4457 4402 4503 4455 4335 4259 4178 4179 4090 3993 3888 3775 3653 3388 3526 3524 2759 2929 2760 2583 2399 2398 2204 1795 1120 1118 1122  630  374  108  107
 228  489  742  987 1224 1453 1674 1887 2092 2289 2478 2659 2832 2997 3445 3305 3444 3578 3821 3928 4029 4121 4207 4208 4284 4353 4414 4350 4413 4412 4410 4409 4408 4548 4406 4405 4507 4404 4339 4401 4334 4456 4336 4263 4260 4180 3994 3656 3891 3389 3655 3525 3244 3243 3091 2762 2761 2584 2005 2004 1796 1579 1353 1355 1121  880  109  110
 227  488  741  986 1223 1452 1673 1886 2288 2090 2477 2831 3152 3151 3301 3153 3441 3577 3702 3818 3927 4028 4206 4205 4283 4352 4351 4349 4278 4348 4347 4346 4345 4407 4344 4342 4459 4269 4403 4340 4337 4262 4261 4182 4091 4092 3890 3889 3529 3527 3390 3245 3093 2931 2586 2763 2585 2400 2587 2006 1797 1580 1356 1354 1123  631  375  111
 226  487  740  985 1222 1451 1672 1885 2091 2476 2657 2658 2995 2996 3443 3576 3575 3700 3699 3817 3926 4027 4119 4120 4282 4281 4280 4279 4277 4276 4197 4274 4195 4273 4343 4271 4341 4270 4267 4268 4266 4265 4184 4099 4181 3996 3777 3997 3654 3776 3391 3246 3392 3092 2932 2930 2401 2402 2207 2007 1798 1581 1357 1124  881  632  633  377
 225  486  739  984 1221 1450 1671 1884 2089 2287 2474 2656 2829 2994 3300 3701 3442 3574 3698 3816 3925 4026 4204 4117 4203 4202 4201 4200 4199 4198 4275 4194 4193 4106 4272 4191 4103 4190 4338 4187 4188 4100 4186 4264 4093 4183 4094 3892 3778 3995 3657 3528 3094 3247 2934 2764 2935 2209 2211 1799 2008 1584 1582  883  882  634  112  376
 224  485  738  983 1220 1449 1670 1883 2088 2475 2655 2473 2828 2991 3150 3298 3299 3573 3697 3815 3924 4024 4025 4118 4116 4115 4114 4113 4112 4111 4109 4014 4108 4012 4107 4104 4008 4102 4189 4006 4101 4098 4185 4097 4096 4095 3998 3893 3779 3780 3530 3394 3250 3095 3096 2403 2933 2210 2208 2009 1583 1800 1358 1125  884  635  378  113
 223  484  737  982 1219 1448 1669 1882 2087 2286 2285 2284 2827 2992 2993 3149 3440 3572 3696 3814 3923 3921 4023 4022 4021 4020 4019 4018 4017 3913 4110 4196 3909 3910 4011 4192 4105 4010 4007 3792 3902 4005 4003 3899 4001 3999 3894 3895 3781 3658 3532 3393 2936 3248 2765 2767 2588 2405 2012 2011 2213 2010 1359 1126  885  636  379  114
 222  483  736  981 1218 1447 1668 1881 2086 2283 2471 2654 2472 2825 3147 3148 3297 3437 3571 3813 3922 3810 3920 3919 3918 3917 3916 3915 3914 4015 4016 3912 4013 3908 3907 3796 4009 3906 3793 3903 3791 4002 3901 4004 3787 4000 3896 3662 3782 3531 3660 3395 3533 3097 2766 2591 2589 2404 2406 2212 1360 1804 1586 1127  886  637  380  115
 221  482  735  980 1217 1446 1667 1880 2282 2084 2652 2650 2826 2989 3295 3296 3438 3439 3695 3569 3811 3809 3689 3690 3807 3806 3805 3804 3803 3802 3800 3911 3799 3798 3797 3794 3904 3676 3905 3673 3900 3669 3543 3671 3898 3897 3786 3785 3665 3661 3534 3396 3249 3659 2937 2768 2592 2590 1803 2014 1802 1801 1585 1128  887  638  381  116
 220  481  734  979 1216 1445 1666 1879 2085 2469 2470 2824 2990 2653 3145 3294 3568 3570 3694 3812 3565 3692 3564 3808 3560 3427 3686 3685 3557 3684 3801 3681 3680 3679 3678 3677 3795 3675 3674 3672 3789 3790 3670 3668 3788 3667 3666 3783 3784 3663 3535 3397 3252 3251 3098 2770 2938 2214 2015 2013 1806 1588 1361 1131  888  639  382  117
 219  480  733  978 1215 1444 1878 1877 2083 2281 2651 2468 2823 2987 3146 2988 3144 3433 3567 3693 3430 3563 3691 3561 3426 3688 3687 3559 3558 3683 3555 3552 3551 3550 3415 3416 3414 3549 3548 3411 3546 3409 3544 3407 3542 3541 3538 3537 3664 3536 3400 3398 3399 3099 3100 2408 2769 2409 2215 2216 1362 1589 1363 1129  889  640  383  118
 218  479  732  977 1214 1664 1665 2082 2280 2467 2648 2649 2278 2822 3435 3292 3436 3434 3432 3566 3431 3429 3562 3428 3283 3425 3424 3422 3279 3556 3420 3682 3276 3418 3417 3273 3412 3269 3413 3268 3545 3410 3408 3406 3263 3261 3540 3539 3402 3258 3401 3254 3257 3253 2771 3101 2407 2940 2218 1805 1807 1367 1130 1133  890  641  384  119
 217  478  731  976 1213 1443 1663 1876 2081 2466 2646 2986 2821 2984 3140 3143 3291 3290 3289 3288 3287 3286 3285 3133 3284 3282 3280 3423 3278 3421 2966 3553 2965 3275 3274 3272 3271 3547 3119 3116 3117 3267 3265 3114 3264 3111 3262 3405 3403 3259 3103 3256 3104 3255 2939 2772 2411 2593 2412 2016 2018 2017 1587 1365  891  642  385  120
 216  477  730  975 1441 1442 1662 1875 2080 2279 2465 2645 2647 2820 3142 3293 2981 3139 3138 3137 3136 3135 3134 2974 3132 3131 3281 3129 3128 3554 3419 3127 3124 2964 3123 3121 3120 3270 2794 3118 3115 3266 2957 3112 3110 3404 2608 3260 2949 3108 3106 2945 2946 2942 2594 2941 2595 2410 2219 2217    0 1591 1132  892  644  387  386  121
 215  476  729  974 1212 1440 1661 1874 2079 2277 2275 2464 2985 2816 2819 3141 2813 2982 2980 2978 2977 2976 2975 2807 2972 3130 2804 2971 2803 2969 2800 3126 2799 2798 2963 2962 2961 2959 2791 2958 2790 2612 2954 2955 2956 2786 2952 2950 2784 3107 2948 3105 2778 2944 3102 2773 2775 2596 2597 1592 2020 1590  893 1364 1135  643  645  122
 214  475  728 1210 1211 1439 1660 1873 2078 2276 2644 2463 2983 2818 2817 2815 2814 2812 2979 2811 2810 2809 2808 2806 2973 2805 2629 2970 2801 2802 2968 3277 2624 2439 3122 2795 2960 2619 2617 2793 2792 3113 2789 2613 3109 2610 2953 2425 2609 2782 2780 2947 2604 2777 2776 2598 2943 2774 2222 2019 1369 1366 1808 1810 1593  894  388  123
 213  474  727  973 1209 1437 1438 1871 2077 2274 2462 2643 2460 2642 2458 2640 2265 2639 2637 2453 2636 2451 2632 2450 2449 2631 2630 2445 2967 2444 2626 3125 2625 2622 2797 2621 2436 2434 2616 2041 2433 2614 2240 2788 2951 2787 2783 2427 2606 2781 2605 2420 2779 2602 2601 2413 2220 2021 2022 2221 1134 1809 1594 1136  896  389  895  124
 212  473  726  972  971 1208 1659 1658 2076 1872 2271 2461 2459 2457 2267 2641 2456 2638 2454 2262 2635 2452 2259 2633 2256 2257 2447 2446 2054 2628 2627 2441 2623 2440 2796 2620 2437 2244 2618 2435 2615 2241 2432 2611 2038 2785 2426 2424 2607 2423 2422 2603 2421 2418 2599 2417 2414 2415 1811 1595 1370 1814  650 1368 1137  897  125  391
 211  472  725  970 1207 1436 1657 1870 2272 2273 2072 2270 2269 2069 2268 2266 2264 2455 2263 2062 2261 2260 2258 2448 2634 2056 2254 2253 2053 2251 2250 2442 2248 2247 2438 2246 2245 1623 2243 2040 2431 1833 2042 2430 2039 2428 2235 2036 2234 2232 2231 2230 2229 2419 2227 2600 2416 2224 2025 1812 1372 1596 1138 1813 1373  648  390  126
 210  471  724  969 1206 1435 1656 2074 2075 2073 1865 2071 1647 1863 2068 2067 2066 2065 1856 2064 2061 1853 1854 2059 2058 2057 2055 2255 2252 2443 2052 2051 2249 2050 2048 2047 2046 1839 2045 2242 1834 2239 1832 2429 2238 2236 2035 2233 1827 2033 2031 2030 2029 2228 2028 2225 2226 2026 2223 1816 1815 1597 1371  649  128  651  646  393
 209  470  723  968 1205 1434 1655 1869 1868 1867 1651 1864 2070 1861 1860 1859 1858 1643 1857 1855 1638 2060 1851 1850 1413 1635 1849 1848 1847 1846 1845 1406 1842 2049 1841 1840 1625 1624 2044 1836 1620 1835 1619 1831 1616 2237 2037 1829 2034 1825 2032 1609 1824 1822 1821 2027 1819 1818 2023 2024 1599 1141 1598  900  647 1139  394  127
 208  469  722  967 1204 1433 1654 1653 1652 1428 1866 1649 1862 1648 1646 1645 1644 1420 1641 2063 1637 1639 1415 1852 1412 1636 1633 1632 1631 1409 1176 1843 1844 1627 1403 1402 1626 1169 1838 2043 1621 1622 1396 1618 1615 1830 1828 1612 1611 1826 1388 1823 1607 1384 1606 1820 1605 1817 1603 1602 1600 1376 1140  898  899  398  652  395
 207  468  721  966 1203 1432 1431 1430 1429 1427 1650 1426 1425 1424 1423 1422 1421 1419 1418 1186 1640 1416 1185 1414 1182 1181 1634 1410 1177 1408  936 1175 1628 1405 1404 1171 1401  931 1399 1400 1165 1398 1395 1617  923 1393 1163 1614 1392 1387  916 1608  915 1153 1154 1382 1604 1379 1148 1601 1147 1374  905 1143 1142  133  653  132
 206  467  720  965 1202 1201 1200 1199  959 1197 1195  956 1194 1193 1192 1191 1189 1187  949 1417  700 1183 1184  944 1180  943 1411  937 1178 1179 1629 1630  688 1174 1172 1168  930  685 1837  927 1166 1397 1164 1394  922 1161 1613  920  673 1390 1610  917 1386 1383 1151 1150 1149 1381 1378 1380 1146  130 1375  906  903  654  129  392
 205  466  719  964  963  962  961  960  958 1198  957 1196  955  954  953  952 1190 1642  703 1188  948  947  945  697  696  694  940  941  939  938  690  172  934  686 1173  932 1167  929  429  928  926  424  679  420 1162  155 1159 1157 1156 1155  918  913  914 1385  411  912  410  665  909  406 1377 1144 1145  901  655  401  396  397
 204  465  718  717  716  715  714  713  712  711  710  709  708  707  706  705  704  951  950  702  701  946  699  442  440  942  439  693  175 1407  434  170  689  433  933  165 1170  426  160  681  425  925  422  677  674  675 1158 1389  921  672  415  669  414 1152  666  409  664  662  911  907  908  660  405  657  656  904  131  902
 203  464  463  462  461  460  459  458  457  456  455  454  453  452  451  450  449  448  447  446  445  444  698  180  443  695  438  437  692  691  935  435  168  167  684  682  432  427  164  423  680  421  157  156  419  417  154  416  919 1391  153  668  670  412  667  147  910  143  408  144  659  141  658  402  138  400  135  134
 202  201  200  199  198  197  196  195  194  193  192  191  190  189  188  187  186  185  184  183  182  181  179  178  441  177  176  174  173  436  171  169  431  166  687  428  430  683  163  162  161  159  158  924  676  678 1160  418  152  671  151  150  413  149  148  146  663  145  407  661  142  404  403  140  139  137  399  136
