# This puzzle is unsolvable
76
 593    2    3    4    5  305    9  309   11  310   13 1164  313  603   14  889  607  887   17   18   21   22  322   23   24   27   28   29   30  620   31   32   33   34   35   36   37   38   39   40   41   42   43   44   45   46   47   48   49   50   51   52   53   54   55   56   57   58   59   60   61   62   63   64   65   66   67   68   69   70   71   72   73   74   75   76
   1  302  301  303  304    7    6   10  598  599   12  308  314  604  317   15  312  316  610  318   19   20  320   25  324   26  617  326  329  330  621  331  332  333  334  335  336  337  338  339  340  341  342  343  344  345  346  347  348  349  350  351  352  353  354  355  356  357  358  359  360  361  362  363  364  365  366  367  368  369  370  371  372  373  374   77
 299  300  594  595  878  596 1154    8  307 1157  885  315  311  606  890   16  608 1940  319  612  896  321  611  614  323  325  619  327  903  328  904  622  623  624  625  626  627  628  629  630  631  632  633  634  635  636  637  638  639  640  641  642  643  644  645  646  647  648  649  650  651  652  653  654  655  656  657  658  659  660  661  662  663  664  375   78
 876  592  591  877  879  880  306  597  883  881 1159 1163  605 1427  886 1430 1432 1692  895  609 1694  615 1172  898  897 1442  899  900 1175  616 1178  905  906  907  908  909  910  911  912  913  914  915  916  917  918  919  920  921  922  923  924  925  926  927  928  929  930  931  932  933  934  935  936  937  938  939  940  941  942  943  944  945  946  665  376   79
 589  298  875  297 1152 1153 1155 1156 1935  600 1691  601 1160 1162 2643 2420  892  888 1167 1169 1437 1170 1171 1440  613  901 1702 1176  618 1177 1179 1180 1181 1182 1183 1184 1185 1186 1187 1188 1189 1190 1191 1192 1193 1194 1195 1196 1197 1198 1199 1200 1201 1202 1203 1204 1205 1206 1207 1208 1209 1210 1211 1212 1213 1214 1215 1216 1217 1218 1219 1220  947  666  377   80
 590  295  588  874 1151 1422 1681 1424  882 1684 2180  602  884 1161 1431 1165  891  893 1942 1435 1168 1438 1439 1950 1173 1174 1443 1954 1444  902 1446 1447 1448 1449 1450 1451 1452 1453 1454 1455 1456 1457 1458 1459 1460 1461 1462 1463 1464 1465 1466 1467 1468 1469 1470 1471 1472 1473 1474 1475 1476 1477 1478 1479 1480 1481 1482 1483 1484 1485 1486 1221  948  667  378   81
 587  873 1149 1419 1420 1680 1421 1423 2415 1683 1687 1685 1939 1429 1166 2421 1693 1941  894 1690 1436 1696 1697 2195 1952 2428 1700 1703 1955 1445 1705 1706 1707 1708 1709 1710 1711 1712 1713 1714 1715 1716 1717 1718 1719 1720 1721 1722 1723 1724 1725 1726 1727 1728 1729 1730 1731 1732 1733 1734 1735 1736 1737 1738 1739 1740 1741 1742 1743 1744 1487 1222  949  668  379   82
 296  871  872 1150 1679 1932 1931 1682 1936 2174 1934 1426 1686 1943 1428 1689 1688 2419 1434 1945 2189 1947 1948 1699 1698 2194 1441 1953 1704 2198 1956 1957 1958 1959 1960 1961 1962 1963 1964 1965 1966 1967 1968 1969 1970 1971 1972 1973 1974 1975 1976 1977 1978 1979 1980 1981 1982 1983 1984 1985 1986 1987 1988 1989 1990 1991 1992 1993 1994 1745 1488 1223  950  669  380   83
 586  585 1417 1416 1930 1678 1677 2412 1933 2414 2861 2179 2181 1433 2183 2648 2645 2647 2187 1946 2651 2190 2191 1949 2427 2430 2193 2196 2197 2199 2434 2200 2201 2202 2665 2203 2205 2206 2207 2208 2209 2210 2211 2212 2213 2214 2215 2216 2217 2218 2219 2220 2221 2222 2223 2224 2225 2226 2227 2228 2229 2230 2231 2232 2233 2234 2235 2236 1995 1746 1489 1224  951  670  381   84
 294  293 1148 1146 1418 1675 2409 2176 2177 2639 1937 2411 1158 2184 1938 2185 2418 2188 1695 2649 1944 2425 2426 2192 2429 1951 1701 2431 2432 2435 2436 2437 2664 2438 2666 2204 2440 2441 2442 2443 2444 2445 2446 2447 2448 2449 2450 2451 2452 2453 2454 2455 2456 2457 2458 2459 2460 2461 2462 2463 2464 2465 2466 2467 2468 2469 2470 2237 1996 1747 1490 1225  952  671  382   85
 291  583 1147  584 1415 1674 2171 2410 2413 2862 1425 2864 2416 2178 2646 2186 2422 2867 2869 2423 2650 2652 2653 2654 2874 2655 2656 2877 2659 2433 2660 2662 2881 2663 2883 2439 2667 2668 2669 2670 2671 2672 2673 2674 2675 2676 2677 2678 2679 2680 2681 2682 2683 2684 2685 2686 2687 2688 2689 2690 2691 2692 2693 2694 2695 2696 2471 2238 1997 1748 1491 1226  953  672  383   86
 290 1142 1145  870  868 1929 2175 1676 2406 2638 2859 3073 2417 2182 2642 3279 2865 3077 2424 2868 2870 2871 2872 2873 3085 2657 2876 3088 2658 2879 2661 2880 3093 2882 2884 2885 2886 2887 2888 2889 2890 2891 2892 2893 2894 2895 2896 2897 2898 2899 2900 2901 2902 2903 2904 2905 2906 2907 2908 2909 2910 2911 2912 2913 2914 2697 2472 2239 1998 1749 1492 1227  954  673  384   87
 867  869  292 1144 1414 1413 1928 1924 2860 2641 2637 2644 3276 3072 3075 3076 3078 2866 3079 3080 3081 3082 3083 3084 3288 2875 3086 3089 2878 3090 3091 3092 3296 3094 3095 3096 3097 3098 3099 3100 3101 3102 3103 3104 3105 3106 3107 3108 3109 3110 3111 3112 3113 3114 3115 3116 3117 3118 3119 3120 3121 3122 3123 3124 2915 2698 2473 2240 1999 1750 1493 1228  955  674  385   88
 289  582 1143  865 1412 1673 2170 3070 2173 2636 2408 3275 3277 2863 3278 3474 3280 3281 3282 3283 3284 3285 3286 3287 3483 3289 3087 3292 3673 3293 3294 3490 3295 3297 3298 3299 3300 3301 3302 3303 3304 3305 3306 3307 3308 3309 3310 3311 3312 3313 3314 3315 3316 3317 3318 3319 3320 3321 3322 3323 3324 3325 3326 3125 2916 2699 2474 2241 2000 1751 1494 1229  956  675  386   89
 288  579  287 1411 1671 1926 2407 1927 2635 2172 2640 2858 3069 3074 3472 3473 3475 3476 3477 3478 3479 3480 3668 3482 3481 3485 3290 3486 3291 3487 3488 3489 3491 3492 3493 3494 3495 3496 3497 3498 3499 3500 3501 3502 3503 3504 3505 3506 3507 3508 3509 3510 3511 3512 3513 3514 3515 3516 3517 3518 3519 3520 3327 3126 2917 2700 2475 2242 2001 1752 1495 1230  957  676  387   90
 578  580  581 1672  866 1141 1923 2169 2405 2857 2856 3274 3071 3471 3660 3661 3662 3663 3664 3665 3666 3846 3667 3669 3670 3484 3672 3674 3676 3675 3677 3856 3679 3680 3681 3682 3861 3683 3684 3685 3686 3687 3688 3689 3690 3691 3692 3693 3694 3695 3696 3697 3698 3699 3700 3701 3702 3703 3704 3705 3706 3521 3328 3127 2918 2701 2476 2243 2002 1753 1496 1231  958  677  388   91
 284  286  864 1925 1410 1409 1670 2168 2634 3067 2855 3068 3273 3470 3659 3840 3841 3842 3843 3844 3845 3847 4018 3849 3850 3671 3851 3852 3853 3854 3855 4027 3678 3858 3859 3860 4032 3862 3863 3864 3865 3866 3867 3868 3869 3870 3871 3872 3873 3874 3875 3876 3877 3878 3879 3880 3881 3882 3883 3884 3707 3522 3329 3128 2919 2702 2477 2244 2003 1754 1497 1232  959  678  389   92
 863  576  862 1140 1408 1669 1922 2167 2404 2630 2633 3269 3272 3469 3658 3839 4012 4013 4014 4178 4015 4017 4019 4182 3848 4021 4023 4185 4022 4025 4189 4345 4026 4029 4193 4030 4033 4351 4196 4034 4036 4037 4038 4039 4040 4041 4042 4043 4044 4045 4046 4047 4048 4049 4050 4051 4052 4053 4054 3885 3708 3523 3330 3129 2920 2703 2478 2245 2004 1755 1498 1233  960  679  390   93
 285  282  577 1139 1138 1407 1921 2166 2403 2854 2165 3066 3271 3468 3657 3838 4011 4332 4176 4333 4016 4334 4336 4181 4338 4183 4488 4187 4024 4188 4190 4346 3857 4028 4496 4031 4195 4352 4198 4035 4199 4200 4201 4202 4203 4204 4205 4206 4207 4208 4209 4210 4211 4212 4213 4214 4215 4216 4055 3886 3709 3524 3331 3130 2921 2704 2479 2246 2005 1756 1499 1234  961  680  391   94
 283  860  861  859 1406 1668 1919 1920 2164 2632 2631 2853 3065 3467 3656 3837 4010 4175 4177 4480 4180 4179 4335 4020 4337 4184 4339 4186 4341 4343 4344 4492 4191 4192 4347 4194 4350 4197 4499 4353 4354 4355 4356 4357 4359 4506 4360 4362 4648 4363 4364 4365 4366 4367 4368 4369 4370 4217 4056 3887 3710 3525 3332 3131 2922 2705 2480 2247 2006 1757 1500 1235  962  681  392   95
 281  575 1137  858 1405 1667 1666 2163 2400 2852 2850 2851 3270 3466 3655 3836 4008 4009 4174 4331 4481 4482 4483 4484 4485 4486 4340 4627 4489 4490 4342 4491 4494 4495 4632 4348 4636 4498 4500 4639 4501 4502 4503 4505 4643 4646 4358 4645 4510 4649 4511 4512 4513 4514 4515 4516 4371 4218 4057 3888 3711 3526 3333 3132 2923 2706 2481 2248 2007 1758 1501 1236  963  682  393   96
 279  574 1136 1134 1135 1665 2402 1918 2399 2401 2849 3064 3268 3465 3654 3835 4007 4173 4330 4479 4620 4621 4622 4623 4624 4625 4487 4626 4759 4628 4761 4633 4493 4634 4349 4497 4767 4637 4638 4640 4894 4772 4897 4504 4776 4647 4361 4507 4509 4508 4650 4651 4652 4653 4654 4517 4372 4219 4058 3889 3712 3527 3334 3133 2924 2707 2482 2249 2008 1759 1502 1237  964  683  394   97
 573  280  572  857 1404 1664 1917 2162 2628 2629 2848 3063 3267 3464 3653 3834 4006 4172 4329 4477 4478 4752 4754 4755 4877 4756 4757 4758 4881 4629 4760 4762 4630 4885 4763 4635 4766 4768 4769 4770 4641 4773 4898 4896 4642 4777 4778 4902 4779 4780 4781 4782 4783 4784 4655 4518 4373 4220 4059 3890 3713 3528 3335 3134 2925 2708 2483 2250 2009 1760 1503 1238  965  684  395   98
 278  571  856 1133 1403 1402 1663 2161 2398 2627 3062 3266 3463 3652 3651 3833 4170 4005 4171 4328 4619 4751 4753 4876 4993 4880 4996 4995 4883 4884 4887 4631 4765 5109 4764 4889 4890 4891 4892 4893 4771 5011 5010 4899 4644 4775 4901 5016 4903 5020 5019 4905 4906 4785 4656 4519 4374 4221 4060 3891 3530 3714 3336 3135 2926 2709 2484 2251 2010 1761 1504 1239  966  685  396   99
 276  277  855 1132 1662 1915 1916 2160 2397 2626 3060 3061 3265 3059 3462 3832 4004 4327 4326 4476 4618 4617 4875 4992 4879 4878 4994 4882 4997 4998 4999 4886 5002 4888 5003 5004 5005 5006 5007 5008 4895 5118 5012 5013 5120 4900 5223 5221 5017 5125 4904 5021 4907 4786 4657 4520 4375 4222 3894 4061 3892 3529 3337 3136 2927 2710 2485 2252 2011 1763 1762 1240  967  686  397  100
 570  569  854 1131 1401 1400 1913 2159 2396 2395 2625 2847 3058 3461 3650 3831 4003 4169 4475 4749 4615 4750 4874 5100 5200 5101 5102 5103 5104 5105 5106 5000 5107 5208 5108 5110 5112 5113 5114 5115 5117 5009 5119 4774 5123 5122 5124 5015 5018 5225 5127 5126 4908 4787 4658 4521 4376 4062 3893 3718 3715 3531 3338 3137 2928 2711 2486 2253 2012 1764 1505 1506  968  687  398  101
 275  567  568  853 1399 1914 1661 2158 2394 2621 2846 3264 3262 3263 3649 3830 4168 4167 4322 4324 4614 4747 4748 4991 4989 4990 5099 5204 5202 5203 5296 5206 5001 5209 5299 5111 5211 5303 5213 5116 5390 5216 5307 5218 5219 5014 5313 5315 5222 5314 5224 5022 4909 4788 4659 4522 4063 4223 4064 3716 3340 3717 3339 3138 2929 2712 2487 2254 1765 2014 1242 1241  969  688  399  102
 274  566 1130 1129 1398 1660 1659 1912 2157 2624 2844 2845 3057 3460 3459 3648 4472 4323 4474 4325 4616 4746 4873 4988 5098 5199 5201 5292 5378 5205 5380 5298 5381 5207 5300 5210 5212 5214 5387 5215 5308 5389 5217 5309 5468 5310 5121 5220 5395 5226 5128 4910 4789 4660 4523 4378 4377 4224 3895 3896 3532 3341 3139 2930 2931 2488 2255 2015 1508 2256 1509  971 1243  689  400  103
 565  851  852 1128 1656 1396 1911 1658 2393 2392 2843 3056 3261 3457 3458 3829 3647 4002 3828 4473 4612 4744 4872 4871 5097 5198 5376 5293 5377 5294 5295 5297 5379 5382 5383 5301 5302 5385 5305 5304 5306 5464 5391 5467 5469 5312 5397 5396 5394 5129 5024 5023 4911 4790 4661 4524 4225 4226 4065 3897 3533 3719 3534 3140 2714 2713 2489 1766 2257 2013 1244  970  691  401  104  105
 273  564 1127 1395 1397 1909 1910 2156 2623 2841 2622 3055 3260 3456 3827 3999 4000 4001 4613 4471 4745 4743 4870 4987 5096 5197 5291 5290 5375 5453 5454 5455 5456 5457 5458 5459 5384 5460 5461 5529 5388 5463 5465 5392 5393 5536 5311 5470 5316 5227 5130 5025 4912 4791 4662 4525 4379 4380 4066 3898 3720 3535 3342 3141 2932 2715 2490 2258 1767 1768 1510 1245  690  972  402  106
 272  850  848  849 1126 1657 2154 2391 2620 2619 2842 3054 3259 3455 3646 3645 3826 4165 4166 4321 4611 4742 4869 5095 5196 5194 5289 5451 5452 5520 5521 5522 5523 5524 5525 5526 5527 5386 5528 5462 5531 5532 5533 5534 5466 5535 5471 5398 5317 5228 5131 5026 4913 4792 4663 4526 4381 4227 4067 3899 3721 3536 3343 3143 3142 2933 2491 2018 2016 2017 1507  973  974  692  404  403
 271  563  847 1125 1394 1655 2152 1907 2155 2153 2389 3258 3051 3644 3255 3825 3824 4319 4470 4320 4468 4610 4985 4868 5195 5093 5373 5374 5450 5519 5580 5581 5582 5583 5584 5680 5586 5637 5587 5589 5640 5590 5592 5593 5594 5537 5472 5399 5318 5229 5132 5027 4914 4793 4664 4527 4382 4228 4229 4068 3722 3537 3346 3344 2934 2716 2717 2260 2259 1769 1512 1511  976  693  405  107
 270  562  561 1124 1393 1653 1654 2840 2390 2618 3052 2839 3454 3641 3642 3643 3998 4162 4163 4469 4608 4609 4867 5094 5193 5192 5288 5372 5449 5518 5579 5632 5633 5634 5635 5679 5636 5639 5588 5641 5530 5591 5643 5644 5595 5538 5473 5400 5320 5319 5133 5028 4915 4794 4665 4528 4383 4384 4230 3900 3724 3723 3145 3144 2935 2718 2492 2493 2019 1513 1771 1246 1248  975  694  108
 269  846  560 1123 1392 1652 1906 1908 2388 2617 2836 3053 3254 2837 3638 3453 4164 4160 4318 4466 4740 4741 4986 4984 5286 4983 5287 5371 5448 5578 5631 5630 5676 5711 5677 5585 5681 5638 5682 5683 5684 5642 5686 5647 5646 5596 5474 5402 5401 5230 5231 5029 4916 4795 4666 4530 4529 4231 4069 3902 3538 3540 3539 3345 2936 2719 2494 2261 2020 1770 1514 1249 1247  696  406  109
 268  559  267  845 1391 1905 2150 2151 2387 3049 2838 3256 3257 3993 3823 4159 3997 4317 4467 4464 4465 4607 4866 4982 5092 5285 5370 5369 5447 5516 5517 5674 5577 5740 5712 5714 5715 5716 5717 5719 5746 5685 5687 5645 5597 5539 5476 5475 5321 5232 5134 5030 4917 4796 4667 4385 4386 4232 4070 3901 3903 3541 3347 3146 2937 2720 2495 2262 2021 1772 1515 1250  695  978  407  110
 265  266  844 1122 1390 1651 1904 2149 2386 2616 2615 3449 3048 3050 4161 3995 3819 3996 4316 4739 4606 4865 4864 5091 5191 5446 5515 5284 5444 5573 5576 5575 5673 5675 5737 5713 5742 5743 5744 5718 5688 5720 5648 5721 5598 5540 5403 5233 5322 5136 5135 5031 4918 4797 4668 4531 4387 4071 4072 3904 3725 3542 3348 3147 2938 2721 2496 2263 2022 1773 1516  979  697  977  408  111
 557  264 1121 1120 1389 1650 1903 2148 2385 2614 2835 3451 3253 3821 3822 3640 3820 4158 4315 4605 4738 4737 4981 5090 5089 5190 5445 5368 5443 5514 5628 5629 5739 5678 5741 5710 5759 5762 5763 5764 5745 5747 5689 5649 5541 5723 5477 5404 5405 5234 5137 5032 4919 4798 4669 4236 4233 4388 4235 3726 3729 3727 3349 3148 2939 2722 2497 2264 2023 1774 1517 1251 1252  980  409  112
 842  843  558 1119 1388 1649 1902 2147 2384 2613 3046 3047 3252 3452 3450 3992 3639 4157 4314 4463 4604 4862 4863 4980 4979 5189 5282 5283 5512 5281 5513 5574 5672 5738 5736 5761 5760 5773 5774 5766 5765 5748 5690 5722 5599 5542 5478 5324 5323 5235 5033 4920 4799 4670 4535 4533 4532 4234 4073 3906 3728 3543 3350 3149 2940 2723 2498 2265 2024 1775 1518 1253  981  698  410  113
 263  556  841 1118 1387 1648 1901 2146 2383 2612 2834 2833 3251 3448 3637 3818 3994 4156 4312 4313 4462 4603 4736 4861 4978 5088 5087 5367 5442 5366 5627 5572 5626 5709 5708 5770 5772 5771 5768 5775 5749 5724 5651 5691 5600 5543 5544 5406 5236 5139 5138 5034 4922 4921 4389 4534 4390 4074 4076 4075 3905 3544 3351 3150 2941 2724 2499 2266 2025 1776 1519 1254  700  699  411  114
 262  555  840 1117 1386 1647 1900 2145 2382 2611 2832 3045 3250 3447 3636 3817 3991 4155 4461 4602 4601 4735 4860 4977 5086 5187 5365 5279 5280 5624 5511 5669 5671 5625 5735 5757 5732 5753 5755 5767 5750 5725 5692 5652 5601 5545 5480 5408 5325 5326 5141 5035 4923 4800 4801 4671 4672 4238 4237 3907 3730 3545 3352 3151 2942 2725 2500 2267 2026 1777 1520 1255  982  701  412  115
 261  554  839 1116 1385 1646 1899 2144 2381 2610 2831 3044 3249 3446 3635 3816 3990 3989 4311 4460 4600 4734 4859 4976 5085 5186 5188 5364 5441 5510 5571 5623 5707 5670 5756 5758 5706 5754 5769 5729 5752 5751 5726 5650 5602 5546 5479 5482 5327 5238 5140 5036 5037 4802 4673 4536 4391 4240 4239 3908 3731 3546 3353 3152 2943 2726 2501 2268 2027 1778 1521 1256  983  702  413  116
 260  553  838 1115 1384 1645 1898 2143 2380 2609 2830 3043 3248 3445 3634 3815 3988 4154 4153 4459 4599 4733 4858 4975 5084 5185 5278 5363 5440 5509 5570 5622 5668 5705 5704 5734 5702 5733 5730 5728 5727 5695 5693 5603 5694 5547 5481 5409 5328 5239 5237 5040 4925 4924 4803 4537 4392 4078 4077 3909 3732 3547 3354 3153 2944 2727 2502 2269 2028 1779 1522 1257  984  703  414  117
 259  552  837 1114 1383 1644 1897 2142 2379 2608 2829 3042 3247 3444 3633 3814 3987 4152 4310 4458 4598 4732 4857 4974 5083 5184 5277 5362 5507 5438 5508 5569 5621 5667 5664 5701 5700 5731 5699 5698 5697 5654 5656 5653 5548 5407 5604 5412 5484 5330 5240 5142 5038 4675 4674 4538 4393 4079 4080 3910 3548 3355 3154 3155 2945 2728 2503 2270 2029 1780 1523 1258  985  704  415  118
 258  551  836 1113 1382 1643 1896 2141 2378 2607 2828 3041 3246 3443 3632 3813 3986 4151 4309 4308 4457 4731 4856 4973 5082 5183 5276 5361 5439 5506 5568 5620 5666 5703 5617 5663 5662 5661 5660 5659 5657 5696 5550 5605 5483 5549 5244 5411 5410 5329 5242 5145 5143 4676 4804 4539 4394 3911 4242 3734 3733 3549 3357 3356 2946 2729 2504 2271 2030 1781 1524 1259  986  705  416  119
 257  550  835 1112 1381 1642 1895 2140 2377 2606 2827 3040 3245 3442 3631 3812 3985 4150 4307 4456 4597 4730 4855 4972 5081 5182 5275 5360 5437 5505 5567 5619 5564 5665 5562 5616 5615 5614 5613 5612 5658 5610 5609 5655 5606 5607 5488 5332 5487 5144 4927 4806 4805 4926 4677 4807 4395 4540 4241 4081 3735 3550 3358 3156 2730 2949 2505 2272 2031 1782 1525 1260  987  706  417  120
 256  549  834 1111 1380 1641 1894 2139 2376 2605 2826 3039 3244 3441 3630 3811 3984 4149 4306 4455 4596 4729 4854 4971 5080 5181 5274 5359 5436 5566 5503 5565 5563 5618 5561 5560 5559 5558 5495 5556 5611 5492 5553 5608 5418 5413 5486 5333 5485 5331 5243 5241 5042 4928 4678 4541 4396 4244 4243 3912 3736 3551 3359 2948 3157 2731 2506 2273 2032 1783 1526 1261  988  707  418  121
 255  548  833 1110 1379 1640 1893 2138 2375 2604 2825 3038 3243 3440 3629 3810 3983 4148 4305 4454 4595 4728 4853 4970 5079 5180 5273 5358 5435 5504 5432 5502 5501 5500 5499 5498 5497 5425 5496 5555 5557 5491 5554 5490 5551 5552 5339 5415 5245 5043 5146 5039 5041 4929 4679 4543 4246 4397 4082 3913 3737 3552 3360 2947 3158 2732 2507 2274 2033 1784 1527 1262  989  708  419  122
 254  547  832 1109 1378 1639 1892 2137 2374 2603 2824 3037 3242 3439 3628 3809 3982 4147 4304 4453 4594 4727 4852 4969 5078 5179 5272 5357 5434 5433 5353 5431 5430 5429 5428 5427 5426 5345 5258 5494 5493 5421 5420 5252 5340 5336 5337 5414 5334 5147 5246 4932 4930 4808 4809 4398 4083 3915    0 3914 3553 3159 3554 2951 3160 2733 2508 2275 2034 1785 1528 1263  990  709  420  123
 253  546  831 1108 1377 1638 1891 2136 2373 2602 2823 3036 3241 3438 3627 3808 3981 4146 4303 4452 4593 4726 4851 4968 5077 5178 5271 5356 5355 5354 5352 5265 5351 5350 5349 5348 5423 5260 5257 5424 5343 5342 5254 5341 5417 5419 5250 5338 5248 5335 5148 4931 4680 4810 4245 4682 4399 4084 4085 3916 3738 3739 3362 3361 2950 2734 2509 2276 2035 1786 1529 1264  991  710  421  124
 252  545  830 1107 1376 1637 1890 2135 2372 2601 2822 3035 3240 3437 3626 3807 3980 4145 4302 4451 4592 4725 4850 4967 5076 5177 5270 5269 5268 5267 5266 5264 5169 5263 5262 5261 5165 5346 5259 5344 5422 5256 5255 5253 5251 5489 5416 5249 5247 5152 5149 5044 4681 4542 4811 4400 4544 4247 4086 3917 3740 3555 3161 2952 2953 2735 2510 2277 2036 1787 1530 1265  992  711  422  125
 251  544  829 1106 1375 1636 1889 2134 2371 2600 2821 3034 3239 3436 3625 3806 3979 4144 4301 4450 4591 4724 4849 4966 5075 5176 5175 5174 5173 5172 5171 5170 5168 5065 5167 5063 5166 5347 5163 5162 5161 5160 5159 5158 5157 5156 5155 5154 5151 5150 5046 5045 4933 4812 4546 4545 4401 4248 4087 3918 3741 3556 3363 3163 3162 2736 2511 2278 2037 1788 1531 1266  993  712  423  126
 250  543  828 1105 1374 1635 1888 2133 2370 2599 2820 3033 3238 3435 3624 3805 3978 4143 4300 4449 4590 4723 4848 4965 5074 5073 5072 5071 5070 5069 5068 5067 5066 4954 5064 5061 4951 5164 4949 5059 5058 5057 5056 5055 5054 5053 5052 5051 5153 5049 5048 5047 4547 4813 4683 4548 4402 4249 4088 3919 3742 3557 3364 3164 2954 2737 2512 2279 2038 1789 1532 1267  713  424  425  127
 249  542  827 1104 1373 1634 1887 2132 2369 2598 2819 3032 3237 3434 3623 3804 3977 4142 4299 4448 4589 4722 4847 4964 4963 4962 4961 4960 4840 4959 4957 4955 4837 4835 4833 5062 4832 5060 4950 4948 4947 4946 4944 4943 4824 4941 4940 4939 5050 4938 4937 4936 4934 4684 4687 4685 4403 4250 4089 3922 3920 3743 3365 3366 2955 2738 2513 2280 2039 1790 1533  995  994  714  426  128
 248  541  826 1103 1372 1633 1886 2131 2368 2597 2818 3031 3236 3433 3622 3803 3976 4141 4298 4447 4588 4721 4846 4845 4844 4843 4842 4841 4713 4958 4839 4956 4836 4834 4952 4953 4705 4831 4829 4702 4827 4945 4826 4562 4697 4942 4823 4821 4820 4819 4818 4817 4690 4935 4814 4686 4549 4251 4091 4252 3560 3921 3165 3558 2956 2739 2514 2281 2041 2040 1534 1268  996  716  715  129
 247  540  825 1102 1371 1632 1885 2130 2367 2596 2817 3030 3235 3432 3621 3802 3975 4140 4297 4446 4587 4720 4719 4718 4717 4716 4715 4714 4712 4711 4710 4838 4709 4708 4707 4706 4570 4568 4704 4830 4566 4828 4825 4696 4561 4695 4822 4694 4693 4692 4691 4689 4815 4816 4553 4550 4404 4090 4253 3923 3745 3367 3559 3744 3166 2957 2740 2515 2282 1791 1535 1269 1270  717  427  130
 246  539  824 1101 1370 1631 1884 2129 2366 2595 2816 3029 3234 3431 3620 3801 3974 4139 4296 4445 4586 4585 4584 4583 4582 4581 4580 4579 4578 4577 4576 4575 4574 4573 4572 4571 4569 4426 4424 4421 4422 4701 4700 4698 4419 4418 4560 4559 4558 4557 4556 4555 4554 4410 4688 4551 4405 4093 4254 4092 3924 3561 3368 3167 2958 2741 2516 2283 2042 1792 1271 1272  998  997  428  131
 245  538  823 1100 1369 1630 1883 2128 2365 2594 2815 3028 3233 3430 3619 3800 3973 4138 4295 4444 4443 4442 4441 4440 4439 4438 4437 4436 4435 4434 4433 4432 4431 4430 4429 4428 4427 4567 4703 4425 4565 4564 4699 4563 4420 4267 4417 4416 4415 4414 4413 4261 4412 4411 4552 4409 4408 4406 4407 3747 3746 3562 3369 3168 2959 2742 2517 2284 2043 1536 1793 1537  999  718  429  132
 244  537  822 1099 1368 1629 1882 2127 2364 2593 2814 3027 3232 3429 3618 3799 3972 4137 4294 4293 4292 4291 4290 4289 4288 4287 4286 4285 4284 4283 4282 4281 4280 4279 4278 4277 4276 4275 4274 4423 4273 4272 4271 4270 4269 4268 4266 4265 4264 4263 4103 4262 4259 4100 4258 4257 4256 4255 4094 3925 3748 3563 3370 3169 2960 2743 2285 2044 1795 1794 1538 1273 1000  719  430  133
 243  536  821 1098 1367 1628 1881 2126 2363 2592 2813 3026 3231 3428 3617 3798 3971 4136 4135 4134 4133 4132 4131 4130 4129 4128 4127 4126 4125 4124 4123 4122 4121 4120 4119 4118 4117 4116 4115 4114 4113 4112 4111 4110 4109 4108 4107 4106 4105 3937 4102 4101 4260 4099 4098 3931 4097 4096 4095 3926 3749 3564 3371 3170 2961 2744 2518 2286 2045 1796 1539 1274 1001  720  431  134
 242  535  820 1097 1366 1627 1880 2125 2362 2591 2812 3025 3230 3427 3616 3797 3970 3969 3968 3967 3966 3965 3964 3963 3962 3961 3960 3959 3958 3957 3956 3955 3954 3953 3952 3951 3950 3949 3948 3947 3946 3945 3944 3943 3942 3941 3940 3939 3938 3762 4104 3935 3934 3933 3757 3932 3930 3929 3928 3927 3750 3565 3372 3171 2962 2745 2519 2287 2046 1797 1540 1275 1002  721  432  135
 241  534  819 1096 1365 1626 1879 2124 2361 2590 2811 3024 3229 3426 3615 3796 3795 3794 3793 3792 3791 3790 3789 3788 3787 3786 3785 3784 3783 3782 3781 3780 3779 3778 3777 3776 3775 3774 3773 3772 3771 3770 3769 3768 3767 3766 3765 3764 3763 3761 3936 3760 3759 3575 3758 3756 3755 3754 3753 3752 3751 3566 3373 3172 2963 2746 2520 2521 2047 1798 1541 1276 1003  722  433  136
 240  533  818 1095 1364 1625 1878 2123 2360 2589 2810 3023 3228 3425 3614 3613 3612 3611 3610 3609 3608 3607 3606 3605 3604 3603 3602 3601 3600 3599 3598 3597 3596 3595 3594 3593 3592 3591 3590 3589 3588 3587 3586 3585 3584 3583 3582 3581 3580 3579 3578 3577 3576 3574 3573 3572 3381 3571 3570 3569 3568 3567 3374 3173 2964 2747 2522 2288 2289 1799 1542 1277 1004  723  434  137
 239  532  817 1094 1363 1624 1877 2122 2359 2588 2809 3022 3227 3424 3423 3422 3421 3420 3419 3418 3417 3416 3415 3414 3413 3412 3411 3410 3409 3408 3407 3406 3405 3404 3403 3402 3401 3400 3399 3398 3397 3396 3395 3394 3393 3392 3391 3390 3389 3388 3387 3386 3385 3384 3383 3382 3182 3380 3379 3378 3377 3376 3375 3174 2966 2965 2748 2290 2048 2049 1800 1278 1005  724  435  138
 238  531  816 1093 1362 1623 1876 2121 2358 2587 2808 3021 3226 3225 3224 3223 3222 3221 3220 3219 3218 3217 3216 3215 3214 3213 3212 3211 3210 3209 3208 3207 3206 3205 3204 3203 3202 3201 3200 3199 3198 3197 3196 3195 3194 3193 3192 3191 3190 3189 3188 3187 3186 3185 3184 2976 3183 3181 3180 3179 3178 3177 3176 3175 2967 2749 2523 2292 2050 1544 1543 1279 1006  725  436  139
 237  530  815 1092 1361 1622 1875 2120 2357 2586 2807 3020 3019 3018 3017 3016 3015 3014 3013 3012 3011 3010 3009 3008 3007 3006 3005 3004 3003 3002 3001 3000 2999 2998 2997 2996 2995 2994 2993 2992 2991 2990 2989 2988 2987 2986 2985 2984 2983 2982 2981 2980 2979 2978 2977 2975 2760 2974 2973 2972 2971 2755 2970 2969 2752 2525 2291 2052 2524 1801 1545 1280 1007  726  437  140
 236  529  814 1091 1360 1621 1874 2119 2356 2585 2806 2805 2804 2803 2802 2801 2800 2799 2798 2797 2796 2795 2794 2793 2792 2791 2790 2789 2788 2787 2786 2785 2784 2783 2782 2781 2780 2779 2778 2777 2776 2775 2774 2773 2772 2771 2770 2769 2768 2767 2766 2765 2764 2763 2762 2761 2759 2758 2535 2757 2756 2531 2754 2968 2753 2526 2293 2294 2051 1802 1546 1281 1008  727  438  141
 235  528  813 1090 1359 1620 1873 2118 2355 2584 2583 2582 2581 2580 2579 2578 2577 2576 2575 2574 2573 2572 2571 2570 2569 2568 2567 2566 2565 2564 2563 2562 2561 2560 2559 2558 2557 2556 2555 2554 2553 2552 2551 2550 2549 2548 2547 2546 2545 2544 2543 2542 2541 2540 2539 2538 2537 2536 2304 2533 2532 2530 2529 2528 2751 2750 2527 2053 1804 1803 1547 1282 1009  728  439  142
 234  527  812 1089 1358 1619 1872 2117 2354 2353 2352 2351 2350 2349 2348 2347 2346 2345 2344 2343 2342 2341 2340 2339 2338 2337 2336 2335 2334 2333 2332 2331 2330 2329 2328 2327 2326 2325 2324 2323 2322 2321 2320 2319 2318 2317 2316 2315 2314 2313 2312 2311 2310 2309 2308 2307 2306 2305 2303 2534 2302 2301 2300 2299 2298 2297 2296 2295 2054 1805 1548 1283 1010  729  440  143
 233  526  811 1088 1357 1618 1871 2116 2115 2114 2113 2112 2111 2110 2109 2108 2107 2106 2105 2104 2103 2102 2101 2100 2099 2098 2097 2096 2095 2094 2093 2092 2091 2090 2089 2088 2087 2086 2085 2084 2083 2082 2081 2080 2079 2078 2077 2076 2075 2074 2073 2072 2071 2070 2069 2068 2067 2066 2065 2064 2063 2062 2061 2060 2059 2058 2057 2056 2055 1806 1549 1284 1011  730  441  144
 232  525  810 1087 1356 1617 1870 1869 1868 1867 1866 1865 1864 1863 1862 1861 1860 1859 1858 1857 1856 1855 1854 1853 1852 1851 1850 1849 1848 1847 1846 1845 1844 1843 1842 1841 1840 1839 1838 1837 1836 1835 1834 1833 1832 1831 1830 1829 1828 1827 1826 1825 1824 1823 1822 1821 1820 1819 1818 1817 1816 1815 1814 1813 1812 1811 1810 1809 1808 1807 1550 1285 1012  731  442  145
 231  524  809 1086 1355 1616 1615 1614 1613 1612 1611 1610 1609 1608 1607 1606 1605 1604 1603 1602 1601 1600 1599 1598 1597 1596 1595 1594 1593 1592 1591 1590 1589 1588 1587 1586 1585 1584 1583 1582 1581 1580 1579 1578 1577 1576 1575 1574 1573 1572 1571 1570 1569 1568 1567 1566 1565 1564 1563 1562 1561 1560 1559 1558 1557 1556 1555 1554 1553 1552 1551 1286 1013  732  443  146
 230  523  808 1085 1354 1353 1352 1351 1350 1349 1348 1347 1346 1345 1344 1343 1342 1341 1340 1339 1338 1337 1336 1335 1334 1333 1332 1331 1330 1329 1328 1327 1326 1325 1324 1323 1322 1321 1320 1319 1318 1317 1316 1315 1314 1313 1312 1311 1310 1309 1308 1307 1306 1305 1304 1303 1302 1301 1300 1299 1298 1297 1296 1295 1294 1293 1292 1291 1290 1289 1288 1287 1014  733  444  147
 229  522  807 1084 1083 1082 1081 1080 1079 1078 1077 1076 1075 1074 1073 1072 1071 1070 1069 1068 1067 1066 1065 1064 1063 1062 1061 1060 1059 1058 1057 1056 1055 1054 1053 1052 1051 1050 1049 1048 1047 1046 1045 1044 1043 1042 1041 1040 1039 1038 1037 1036 1035 1034 1033 1032 1031 1030 1029 1028 1027 1026 1025 1024 1023 1022 1021 1020 1019 1018 1017 1016 1015  734  445  148
 228  521  806  805  804  803  802  801  800  799  798  797  796  795  794  793  792  791  790  789  788  787  786  785  784  783  782  781  780  779  778  777  776  775  774  773  772  771  770  769  768  767  766  765  764  763  762  761  760  759  758  757  756  755  754  753  752  751  750  749  748  747  746  745  744  743  742  741  740  739  738  737  736  735  446  149
 227  520  519  518  517  516  515  514  513  512  511  510  509  508  507  506  505  504  503  502  501  500  499  498  497  496  495  494  493  492  491  490  489  488  487  486  485  484  483  482  481  480  479  478  477  476  475  474  473  472  471  470  469  468  467  466  465  464  463  462  461  460  459  458  457  456  455  454  453  452  451  450  449  448  447  150
 226  225  224  223  222  221  220  219  218  217  216  215  214  213  212  211  210  209  208  207  206  205  204  203  202  201  200  199  198  197  196  195  194  193  192  191  190  189  188  187  186  185  184  183  182  181  180  179  178  177  176  175  174  173  172  171  170  169  168  167  166  165  164  163  162  161  160  159  158  157  156  155  154  153  152  151
