# This puzzle is unsolvable
49
   2    1    3    4    5    6    7    8    9   10   11   12   13   14   15   16   17   18   19   21   22   24  216   26   27  217   28   29  220   31  405   32  408   34   35   36   37   38   39   40   41   42   43   44   45   46   47   48   49
 192  193  194  195  196  197  198  199  200  201  202  203  204  205  206  207  208  392  209   20  212  213  215  399   25  400  218  219  578  221   30  223  224  225   33  226  410  227  230  231  232  233  234  235  236  237  238  239   50
 191  376  377  378  379  555  380  382  558  383  384  385  386  387  388  389  566  567  211  210  394  395   23  743  398  397 1052  401  580  404  406  222  407  409  228  412  584  229  413  414  415  416  417  418  419  420  421  240   51
 375  552  551  553  554  381  556  557  884  559  561  729  728  730  564  391  390  568  393  570  736  396  214  573  899  576  402  744 1334  403 1336  581  582  583  749  911  585  589  914  590  757  591  592  593  594  595  422  241   52
 190  374  720  719  721  722  723  724  886  726  725  885  563  562  731  565  733  894  735  893  895 1192  572  898  738  740  742  746  745  577 1057  908  905  750  751  411  586  587  913  588 1067  758  918  759  761  596  423  242   53
 189  373  550  880  879  881  882 1034  883 1036  887  560  888  889 1041  732  892  734 1188 1046 1049  737  571 1050  574  903  741 1196  904  902  906 1200  579  748  752 1465  915  912  755  756 1064  916 1069  760  762  597  424  243   54
 188  372  549  718  877 1032 1033 1177 1035 1037  727 1038 1039  890 1040  891 1043 1044 1189  897 1048 1047  739  569  900 1194 1195 1054 1198  907  747 1203 1058 1062 1063  754  753 1206 1343 1065 1066  917 1068 1070  763  598  425  244   55
 371  548  546  717  716  878 1031 1312 1180 1178 1314 1181 1182 1183 1184 1042 1186 1187 1045 1324 1191 1193  901 1197 1330 1458  575 1055 1333 1691 1201 1060  909 1466 1204 1202 1207 1061 1339 1209 1210 1211  920  919  764  599  426  245   56
 187  370  369  715  547 1030 1176 1175 1179 1442 1313 1316 1444 1445 1319 1185 1448 1321 1322 1323  896 1453 1327 1454 1789 1325 1326 1056 1199 1463 1582 1335 1059 1338  910 1894 1340 1468 1208 1342 1345 1212 1071  921  765  600  427  246   57
 186  185  714  876 1029 1174 1173 1311 1440 1441 1315 1317 1318 1567 1446 1320 1565 1449 1569 1450 1190 1787 1051 1575 1791 1885 1577 1689 1053 1690 1581 1695 1462 1205 1697 1801 1341 1587 1471 1344 1346 1213 1072  922  766  601  428  247   58
 368  183  184  545  875 1028 1172 1310 1439 1559 1560 1561 1443 1563 1564 1447 1566 1568 1680 1571 1452 1572 1455 1573 1461 1328 1688 1576 1457 1459 1580 1694 1585 1584 1337 1699 1469 1588 1470 1472 1347 1214  924  923  767  602  429  248   59
 182  367  544  713  874 1027 1309 1308 1438 1558 1673 1562 1674 1675 1676 1677 1678 1679 1570 1681 1451 1682 1686 1329 1687 1788 1332 1578 2055 1460 1890 1692 1464 1586 1467 1590 1589 1591 1473 1475 1348 1074 1073  925  768  603  430  249   60
 181  366  543  712  873 1026 1171 1437 1436 1672 1671 1872 1776 1778 1779 1780 1781 1782 1783 1786 1881 1969 1790 1685 1456 1331 1684 1889 1793 1579 1796 1797 1693 1696 1583 1980 1803 1701 1474 1349 1351 1215 1075  926  769  604  431  250   61
 180  365  542  711  872 1025 1170 1307 1435 1557 1670 1777 1871 1873 1874 1875 1876 1878 1785 1784 2048 1882 1574 1970 2185 1884 1792 2053 1974 2057 2126 1893 1799 1977 1800 1891 1703 1700 1592 1350 1216 1218 1076  927  770  605  432  251   62
 179  364  541  710  870  871 1024 1305 1306 1556 1669 1775 1870 1960 1961 1962 1963 1877 1965 1966 1879 1683 1968 2124 2049 1883 1972 2242 1795 1975 1979 1794 2129 1798 1804 1895 1805 1702 1802 1593 1217 1077  928  929  771  606  433  252   63
 178  362  363  540  709 1023 1169 1304 1434 1668 1667 1773 1774 1959 2040 2041 2042 1964 2044 2046 1967 1880 2047 1973 2120 2050 1886 2052 1888 1978 1976 1897 2125 1892 1698 1595 1981 1704 1594 1477 1476 1352 1220 1078  772  607  434  253   64
 176  177  539  708  869 1021 1168 1432 1554 1555 1666 1772 1869 1958 2039 2112 2113 2043 2178 2045 2116 2119 2182 2051 2184 2121 2122 1887 2189 2054 2190 2191 2192 2058 1983 1900 1898 1806 1598 1478 1353 1079 1219  930  773  608  435  254   65
 361  360  538  707  868 1167 1022 1302 1433 1303 1553 1771 1868 1957 2038 2111 2176 2114 2180 2115 2236 2117 2181 2355 2183 2123 2187 2288 2188 2056 2245 2128 2059 1982 1899 1984 1896 1596 1705 1354 1221 1080 1082  931  774  609  436  255   66
 175  359  537  706  867 1165 1020 1301 1431 1552 1769 1665 1956 2037 2110 2175 2232 2177 2233 2179 2234 2285 2286 2235 1971 2241 2240 2328 2247 2246 2062 2061 2063 2060 1902 1807 1809 1708 1479 1597 1480 1081 1222  932  775  438  610  256  257
 174  536  535  705  866 1166 1163 1164 1551 1550 1770 1866 1867 1955 2036 2109 2174 2231 2280 2320 2283 2118 2237 2354 2239 2357 2287 2238 2290 2243 2127 2131 1985 1986 2134 1808 1901 1707 1481 1357 1083  933  934  776  611  612  258  260  437
 173  358  704  703  865 1019 1300 1162 1430 1663 1664 1768 1865 1954 2035 2108 2173 2230 2278 2281 2284 2319 2350 2378 2356 2325 2186 2359 2329 2291 2248 2130 2064 2193 1903 2132 1600 1709 1706 1599 1224 1482 1085  777  935  440  442   69   67
 172  357  533  534  702  864 1161 1428 1429 1549 1662 1767 1864 1953 2034 2107 2172 2229 2279 2318 2282 2322 2324 2380 2326 2358 2289 2327 2292 2244 2249 2195 2194 2133 2065 1987 1810 1711 1483 1355 1484 1358 1223 1225  613  938  439  259   68
 171  356 1012 1017 1018 1159 1016 1299 1427 1548 1661 1766 1863 1952 2033 2106 2171 2228 2168 2277 2351 2376 2353 2388 2379 2394 2381 2360 2293 2330 2250 2196 2135 2067 1988 2066 1811 1812 1601 1710 1356 1359  778  779  614  937  441   70   71
 170  355  701  862  861 1015  529 1298 1426 1547 1660 1765 1862 1951 2032 2104 2170 2315 2317 2349 2352 2227 2321 2377 2392 2395 2382 2332 2333 2331 2295 2197 2136 1989 1905 1904 1906 1603 1485 1226 1490 1084 1360 1227 1086  939  263   72   73
 169  354  532 1014  859 1297 1160 1296 1425 1546 1659 1764 1861 2029 1950 2103 2105 2374 2275 2316 2373 2323 2400 2399 2396 2383 2362 2397 2297 2294 2336 2198 2137 2068 1990 1813 1712 1602 1486 1488  781 1361 1228  780  616  617  264  444  443
 168  353  531  863  699  696  860 1294 1295 1545 1658 1763 1860 2226 1949 2031 2102 2165 2223 2276 2274 2390 2375 2393 2398 2367 2363 2361 2296 2253 2252 2138 2201 1991 2139 1814 1908 1713 1487  936 1716  782 1232  618  783  615  261   75   74
 167  352  530  527  858 1013  700 1423 1158 1544 1657 1762 1859 2030 2028 2225 2169 2167 2224 2272 2346 2348 2372 2386 2306 2369 2384 2298 2251 2254 2255 2202 2199 2141 2069 2070 1992 1909 1605 1489 1362 1087 1229  941 1090 1363  619  445  262
 351  697  528  855  698 1157 1011 1422 1293 1543 1656 1761 1947 1948 2099 2101 2166 2221 2347 2371 2370 2391 2343 2265 2341 2340 2339 2365 2364 2200 2256 2300 2140 2071 1994 1817 1816 1815 1604 1715 1088 1231 1092  942  784  446  447  620   76
 166  350  526  857  856 1155 1292 1008 1424 1541 1542 1857 1858 1946 2027 2164 2098 2314 2313 2389 2273 2344 2368 2387 2342 2260 2335 2303 2337 2334 2299 2072 2142 1995 1911 1818 1912 1993 1230 1492 1608 1091 1364  785  268  448  265   77   78
 165  164  525  854 1009 1010 1156 1291 1421 1420 1759 1760 1856 1945 2026 2100 2097 2220 2222 2312 2267 2310 2155 2263 2338 2305 2307 2301 2210 2366 2258 2257 2073 1996 1910 1717 1907 1819 1493 1367 1714 1089  943 1365  786  621  267    0   80
 163  349  348  694  693 1290 1154 1289 1419 1540 1655 1654 1758 1855 1944 2024 2163 2269 2345 2216 2214 2308 2266 2213 2211 2262 2261 2385 2207 2259 2148 2208 2204 2143 2074 1999 1914 1998 1718 1606 1235  940 1093 1094 1234  944  622  270  266
 161  162  524 1007  523 1151  695 1418 1539 1652 1653 1757 1854 1943 2162 2025 2160 2311 2271 2159 2268 2217 2309 2264 2152 2212 2304 2209 2302 2149 2082 2203 2146 2205 1997 1722 2075 1609 1607 1238 1611 1233 1491  946  787  945  450  271  269
 160  347  346  853 1152 1006 1153 1288 1417 1538 1651 1756 1853 1942 2023 2095 2219 2161 2158 2270 2091 2090 2088 2087 2154 2153 2151 2150 2206 2081 2147 2078 2145 2144 1610 1821 1495 1720 1721 1370 1494 1236  947  789  788  623  449   81   79
 344  345  522  692  852 1005 1150 1287 1416 1537 1650 1755 1852 1941 2022 2094 2019 2093 2092 2215 2218 2157 2156 2089 2086 2085 2084 2083 2007 2004 2005 2079 2080 2000 2001 2002 1820 1823 1719 1237 1096 1366 1239  790  626  453  627  452   82
 159  520  690  691 1004 1003 1149 1286 1415 1536 1649 1754 1851 1940 2020 2096 1936 2018 2017 2016 2015 2014 2013 2012 2011 2010 2009 1925 2008 2006 2003 1830 2077 2076 1918 1822 1913 1613 1615 1612 1097 1369 1368  624  791  625  451  454   83
 158  157  521  689  850  851 1148 1285 1414 1535 1648 1753 1850 1939 2021 1938 1845 1935 1934 1933 1932 1931 1930 1929 1928 1927 1926 1924 1833 1923 1921 1732 1920 1828 1826 1915 1917 1723 1497 1496 1372 1095  948 1240  456  792  273  274  272
 341  343  519  688  849 1002 1147 1284 1413 1534 1647 1752 1849 1848 1847 1937 1846 1745 1843 1842 1841 1840 1839 1838 1837 1836 1835 1735 1834 1832 1831 1919 1729 1728 1825 1727 1916 1824 1724 1373 1241 1371 1098  950  949  793  628   84   86
 342  156  518  687  848 1001 1146 1283 1412 1533 1646 1751 1750 1749 1748 1747 1844 1746 1744 1743 1742 1741 1740 1739 1738 1737 1736 1628 1734 1626 1509 1730 1506 1508 1829 1505 1617 1618 1499 1498 1374 1100 1099  951  794  629  455  275   87
 155  340  517  686  847 1000 1145 1282 1411 1532 1645 1644 1643 1642 1641 1640 1639 1638 1637 1636 1635 1634 1633 1632 1631 1630 1629 1513 1922 1512 1510 1733 1624 1827 1621 1620 1385 1619 1614 1501 1375 1242 1101  952  795  630  457   85  276
 154  339  516  685  846  999 1144 1281 1410 1531 1530 1529 1528 1527 1526 1525 1524 1523 1522 1521 1520 1519 1518 1517 1516 1515 1391 1731 1627 1255 1388 1387 1625 1622 1507 1726 1725 1503 1502 1616 1376 1243 1102  953  796  631  458  277   88
 153  338  515  684  845  998 1143 1280 1409 1408 1407 1406 1405 1404 1403 1402 1401 1400 1399 1398 1397 1396 1395 1394 1393 1392 1390 1514 1258 1389 1511 1257 1623 1384 1383 1381 1504 1380 1378 1500 1377 1244 1103  954  797  632  459  278   89
 152  337  514  683  844  997 1142 1279 1278 1277 1276 1275 1274 1273 1272 1271 1270 1269 1268 1267 1266 1265 1264 1263 1262 1261 1260 1119 1120 1386 1256 1253 1254 1252 1382 1251 1250 1249 1379 1248 1246 1245 1104  955  798  633  460  279   90
 151  336  513  682  843  996 1141 1140 1139 1138 1137 1136 1135 1134 1133 1132 1131 1130 1129 1128 1127 1126 1125 1124 1123 1122 1121 1259  972 1118 1117 1116 1115 1114 1113 1112 1111 1110 1109 1247 1107 1106 1105  956  799  634  461  280   91
 150  335  512  681  842  995  994  993  992  991  990  989  988  987  986  985  984  983  982  981  980  979  978  977  976  975  974  973  817  971  970  969  968  967  966  965  964  962  961 1108  960  959  958  957  800  635  462  281   92
 149  334  511  680  841  840  839  838  837  836  835  834  833  832  831  830  829  828  827  826  825  824  823  822  821  820  819  818  654  816  815  814  813  812  811  810  808  963  807  806  805  804  803  802  801  636  463  282   93
 148  333  510  679  678  677  676  675  674  673  672  671  670  669  668  667  666  665  664  663  662  661  660  659  658  657  656  655  653  482  652  651  650  649  648  647  809  645  644  643  642  641  640  639  638  637  464  283   94
 147  332  509  508  507  506  505  504  503  502  501  500  499  498  497  496  495  494  493  492  491  490  489  488  487  486  485  484  483  481  302  480  478  477  476  475  646  474  473  472  471  470  469  468  467  466  465  284   95
 146  331  330  329  328  327  326  325  324  323  322  321  320  319  318  317  316  315  314  313  312  311  310  309  308  307  306  305  304  303  115  301  479  300  298  297  296  295  294  293  292  291  290  289  288  287  286  285   96
 145  144  143  142  141  140  139  138  137  136  135  134  133  132  131  130  129  128  127  126  125  124  123  122  121  120  119  118  117  116  114  113  112  299  111  110  109  108  107  106  105  104  103  102  101  100   99   98   97
