# This puzzle is unsolvable
24
  2   1   4  93   5 180   7  10 384 100  12 187 102  15 105  16 110 193  21  18  22 113 270  25
 92 176   3 174 256 179  99 325 257   8  13 188  14 106 109 330  17 108  19  23 195  24  26  28
380  96 177 258   6 181  98 255 432   9 101 103  11 189 104 107 191 190 111  20 112 120 117 196
 91 175  95  97 476 182 383 254 513 183 261 185 387 262 332 266 265 269 268 115 340 335 194 197
 90 318  94 250 321 178 322 433 386 184 326 482 437 264 263 192 267 395 337 394 201 198  27 114
 89  88 253 251 379 320 382 259 186 260 327 329 439 574 389 333 334 342 275 393 341 336 272 199
 87 173 172 252 323 542 431 385 435 390 572 546 522 388 392 440 490 441 444 118 200 202 116  29
 86 171 317 319 249 381 434 478 479 324 483 328 484 397 488 331 391 442 343 547 203 274 271  30
 85 169 248 376 378 430 477 560 438 436 514 515 562 518 459 563 339 443 489 493 398 273  34 206
247 245 316 246 474 377 475 512 540 573 529 517 571 566 550 486 453 481 552 564 487  31  33 119
 82 170 314 315 375 429 473 511 561 541 543 570 525 519 545   0 521 485 491 448 211  39 276 338
168  84 167 243 374 427 428 472 539 538 569 548 520 549 401 544 553 445 344 346 125 396 205 121
 83 373 244 242 426 471 507 470 510 508 575 565 567 480 127 524 347 400 207 278  32 204 449 123
309 313 166 306 368 371 425 558 509 557 461 551 531 516 555 559 446 402 450 403  35 447 214 128
 79  81  80 372 469 424 370 556 535 418 532 568 537 554 497 523 399  41 404 209 277  40  36 345
 78 239 164 310 311 422 312 505 534 533 462 463 530 411 412 458 527 283 210 208 212  38 280 282
162 163 165 366 241 468 506 423 504 419 502 460 501 528 526 498 492 408 130 287 279 124 133  43
 77  76 240 302 367 369 466 303 465 414 464 499 359 413 409 494 356 348  54 126 349 281 213 452
160 467 161 159 234 232 301 363 415 360 410 496 407 148 500 406 454 289  37 139 141 286 131 284
158 235 308 236 231 421 503 307 536  61 297 357 226 354 220 285 218 456 222 132 122 216  44  42
 75  74 233 238  73 364 305 299 230 417 228 416 358 361 137 296 355  53 142 219 288 451 129  45
 67 156 237  68 304 150 420 151 362  59 295 221 145 153  57 294 140 350 457 495  51 351 291 352
 72  71 365 155  66  62 149 298  60 225 146 227 224 293 144  52 217 136 134  49 405 290 455  47
 69  70 154 157  65 152 147  64 229 300  63 143 223  58  56  50 138 292  55 353  46  48 215 135
