# This puzzle is unsolvable
66
   2    1    3    4    5    6    7    8    9   10   11   12   13   14   15   16   17   18   19   20   21   22   23   24   25   26   27   28   29   30   31   32   33   34   35   36   37   38   39   40   41   42   43   44   45   46   47   48   49   50   51   52   53   54   55   56   57   58   59   60   61   62   63   64   65   66
 260  261  262  263  264  265  266  268  519  269  270  271  272  273  274  275  276  277  278  279  280  281  282  283  285  536  286  287  288  289  290  291  292  293  294  295  296  297  298  299  300  301  302  303  304  305  306  307  308  309  310  311  312  313  314  315  316  317  318  319  320  321  322  323  324   67
 259  512  513  514  515  516  517  267  762  520  521  522  523  524  525  526  527  528  529  530  531  532  533  534  535  284  537  538  540  783  541  542  543  544  545  546  547  548  549  550  551  552  553  554  555  556  557  558  559  560  561  562  563  564  565  566  567  568  569  570  571  572  573  574  325   68
 258  511  756  757  758  759  761  518  997  763  764  765  766  767  768  769  770  771  772  773  774  775  776  777  778  779  780  782 1017  784  785 1020  786  787  788  789  790  791  792  793  794  795  796  797  798  799  800  801  802  803  804  805  806  807  808  809  810  811  812  813  814  815  816  575  326   69
 257  510  755  992  993  994  995  996 1224  998  999 1000 1001 1002 1003 1004 1005 1006 1007 1235 1008 1238 1010 1012 1013 1241 1016  781 1018  539 1019 1021 1022 1023 1024 1251 1025 1026 1027 1028 1030 1031 1032 1259 1033 1034 1035 1482 1263 1038 1039 1040 1041 1042 1043 1044 1045 1046 1047 1048 1049 1050  817  576   71  327
 256  509  754  991 1221 1219  760 1442 1223 1225 1226 1227 1228 1229 1230 1231 1232 1233 1234 1454 1009 1236 1011 1239 1240 1015 1014 1462 1244 1245 1246 1247 1248 1249 1250 1252 1253 1473 1255 1256 1029 1257 1258 1478 1479 1260 1262 1481 1036 1265 1266 1267 1268 1269 1270 1271 1272 1273 1274 1275 1276 1051  818  577   70  329
 255  508  753  990 1220 1222 1652 1441 1443 1444 1445 1446 1448 1449 1863 1450 1451 1453 1666 1664 1456 1237 1457 1458 1459 1461 1242 1674 1243 1464 1465 1466 1467 1468 1469 1470 1471 1254 1472 1474 1475 1476 1477 2087 1690 1261 1480 1693 1037 1483 1485 1486 1487 1488 1489 1490 1491 1492 1493 1494 1277 1052  819  578   72   73
 254  507  752  989 1218 1440 1653 1654 1655 1656 1859 1657 1447 1659 1660 2058 1864 1663 1452 1870 1667 1669 1668 1670 1671 1672 1874 1463 1877 1675 1676 1677 1678 1679 1680 1681 1682 1683 1684 1685 1686 1687 1688 2453 2088 1893 2089 1694 1264 1484 1898 1697 1698 1699 1700 1701 1702 1906 1703 1495 1278 1053  579  330  328  332
 253  506  751  988 1217 1439 1651 1856 2052 1858 2053 2056 2243 1658 1862 1662 1661 2061 1665 1867 1455 1869 1871 1872 1873 1460 1876 1673 2072 1878 1879 1880 1881 1882 1883 1884 1885 1886 1887 1888 1889 1890 1689 2274 1692 1691 1895 2091 1897 1696 1695 1900 1901 1902 1903 1904 1905 1704 1705 1496 1279 1054  820  580  331   74
 252  505  750  987 1216 1438 1437 1650 2241 2050 1857 1861 2057 2245 2247 2059 1866 2060 2249 2062 1868 2065 2066 2067 2068 2069 1875 2070 2071 2073 2074 2075 2076 2077 2078 2079 2080 2081 2082 2083 2084 2085 1891 2275 1892 2456 1896 2458 2280 2281 1899 2095 2096 2097 2098 2099 2100 1907 1706 1497 1280  822  821  581   75   76
 251  504  749 1213 1435 1854 2051 1855 2239 2055 2242 1860 2421 2244 2594 2426 2427 1865 2429 2063 2064 2252 2253 2254 2255 2256 2257 2258 2259 2260 2261 2262 2263 2264 2265 2266 2267 2268 2269 2270 2271 2272 2086 2452 2276 1894 2279 2278 2092 2459 2093 2282 2283 2284 2285 2101 1908 1707 1498 1282 1056 1055  583  824  582   77
 250  503  748  986 1649 1214 1436 1852 2049 2240 2419 2420 2593 2422 2595 2246 2425 2248 2428 2250 2764 2251 2431 2433 2434 2435 2436 2437 2438 2439 2440 2441 2442 2443 2444 2445 2447 2448 2449 2621 2450 2451 2623 2273 2454 2626 2090 2455 2094 2457 2460 2461 2462 2463 2464 2286 2102 1708 1499 1281 1284 1057  823  333   79  334
 249  502  747 1215  984 1647 1646 1853 1648 2418 2237 2054 2592 2759 2913 2424 2597 2599 2761 2600 2765 2602 2432 2603 2605 2606 2607 2608 2609 2610 2611 2612 2613 2614 2615 2616 2446 2618 2782 2619 2622 2624 2787 2625 2788 2627 2277 2628 2629 2631 2632 2633 2634 2636 2465 2287 2103 1910 1911 1909 1283 1058  825  584  335   78
 248  501  746  985  983 1434 1432 1851 2048 2046 2236 2911 2423 2756 2757 2596 2760 3063 2430 3336 2763 2919 2766 2604 2923 2769 2770 2771 2772 2773 2774 2775 2776 2777 2778 2780 2617 2781 2620 2939 2941 2784 3087 2786 2943 2789 2790 2791 2792 2949 2630 2794 2797 2795 2635 2288 2104 1912 1709 1710 1500 1059  826  585  336   80
 247  500  745  982 1212 1211 1849 1433 2047 2235 2591 2590 2755 2912 2758 2914 2916 2762 2598 2920 3067 2601 2922 2768 2767 2924 3071 2926 2927 2928 2929 2930 2931 2932 2933 2779 2934 3222 2937 2938 2783 2940 2785 3089 2942 2944 2945 2946 2948 2793 2950 2952 2951 2466 2467 2796 2105 1711 1712 1501 1285 1060  827  587  586   81
 246  499  744  981 1210 1431 1850 1846 2045 2234 2587 2238 2416 3060 3200 3062 2915 3202 3064 2918 3205 3068 2921 3208 3069 3072 2925 3073 3074 3075 3076 3077 3217 3078 3080 2936 3220 3084 3223 3085 3086 3226 3088 3090 3229 3091 3092 3094 2947 3095 3096 2798 2468 2639 2291 2289 2106 1913 1503 1502 1286 1061  828  340  338   82
 245  498  743  980 1209 1430 1645 1847 1848 2044 2415 2588 2589 2910 3057 3199 3201 3334 3455 3204 3459 3203 3066 3335 3070 3210 3211 3212 3214 3468 3346 3215 3216 3079 3218 3083 3081 3082 2935 3353 3224 3225 3227 3228 3231 3362 3232 3093 3233 3097 3098 2954 2800 2469 2292 2290 2107 1914 1713 1504 1287 1062  588  589  830  337
 244  497  742  979 1208 1429 1643 1644 2043 2233 2413 2417 2909 3058 2752 2753 3061 3329 2917 3333 3065 3207 3337 3209 3463 3341 3342 3343 3344 3213 3345 3347 3348 3349 3350 3219 3351 3221 3352 3479 3356 3357 3358 3359 3230 3485 3486 3361 3364 3234 3099 2953 2640 2799 2470 2293 2108 1915 1916 1714 1289 1063  829 1505  339  341
 243  496  741  978 1207 1428 1639 1642 2042 2232 2586 2414 2750 2751 3198 3331 3059 3330 3332 3457 3574 3206 3338 3339 3577 3579 3464 3581 3469 3584 3470 3585 3471 3472 3473 3475 3476 3477 3354 3355 3478 3480 3481 3597 3482 3360 3483 3484 3365 3235 3236 3237 2638 2637 2472 2471 2109 2110 1507 1715 1288 1064  832  831   84   83
 242  495  740  977 1206 1426 1427 1641 1845 2231 2412 2585 2908 2754 2907 3056 3453 3570 3456 3458 3681 3576 3461 3340 3462 3578 3465 3467 3466 3582 3583 3692 3586 3587 3589 3474 3590 3591 3592 3593 3594 3595 3596 3598 3363 3706 3488 3602 3366 3367 3100 2641 2803 2473 2643 2801 2294 2295 1919 1918 1917 1290 1065  590  591   85
 241  494  739  975  976 1844 1640 2041 2229 2230 2411 2584 2749 2906 3055 3197 3195 3196 3573 3569 3680 3575 3460 3682 3685 3686 3580 3687 3688 3689 3690 3792 3791 3695 3588 3696 3697 3698 3699 3700 3701 3702 3703 3600 3707 3599 3705 3370 3487 3238 2802 2957 2955 2644 2642 2474 2112 2111 1506 1716 1291  833  592  343  342   86
 240  493  738 1204 1425 1205 1424 1638 2040 2039 2410 2583 2748 2905 3194 3051 3567 3454 3572 3678 3780 3872 3782 3683 3785 3876 3786 3787 3788 3789 3691 3790 3693 3694 3793 3795 3796 3797 3798 3799 3800 3801 3802 3704 3893 3804 3601 3239 3241 3369 2956 3103 2804 2299 2298 2296 2297 2113 1717 1508 1509 1066 1067  593  344   87
 239  492  737  974 1203 1637 1842 1843 2228    0 2409 2747 2904 3053 3054 3326 3327 3571 3679 3677 3871 3781 3783 3684 3874 3784 3877 3878 3879 3880 3881 3882 3883 3884 3794 3886 3887 3889 3973 3890 3891 4049 3976 3805 3803 3604 3711 3603 3709 3102 3490 3101 2959 2807 2805 2645 1921 1720 1718 1719 1292 1068 1293  835  345   88
 238  491  736  973 1202 1423 1636 1841 2038 2227 2226 2582 2746 3193 3328 3452 3450 3566 3451 3568 3957 3778 3873 4032 3958 3959 3960 3961 3962 3963 3964 3965 3966 3885 4046 3968 3970 4044 3888 3974 3972 3892 3894 3895 3806 3808 3605 3371 3106 3105 3368 3240 2806 2475 2476 2114 1920 1511 1721 1510 1294 1069  834  594  346   89
 237  490  735  972 1201 1422 1635 1840 2037 2407 2408 2581 2580 3052 3049 3050 3676 3675 3776 3868 3779 3954 3870 3875 4033 4035 4036 4161 4037 4038 4039 4040 4108 4041 4109 3969 4110 4045 4047 3971 4048 4050 3975 3977 3897 3807 3708 3493 3491 3104 3242 2960 2958 2646 2647 2300 2115 1922 1512 1513 1295  836  595  596  347   90
 236  489  734  971 1200 1421 1634 1839 2036 2225 2406 2579 2903 2745 3192 3189 3324 3565 2902 3564 3867 3777 3869 4031 4101 4034 4102 4163 4103 4105 4106 4107 3967 4042 4218 4043 4112 4113 4114 4115 4116 4051 3898 3979 3896 3712 3492 3606 3489 3372 3107 2961 2808 2649 2477 2301 2117 1722 1924 1514 1071 1070  837  838  348   91
 235  488  733  970 1199 1420 1633 1837 1838 2035 2224 2578 2744 2743 3325 2901 3323 3448 3563 3956 3953 3775 4030 4099 4100 4097 4160 4212 4104 4214 4216 4166 4167 4111 4168 4169 4170 4172 4173 4174 4117 4053 4052 3978 3899 3811 3608 3607 3374 3243 3108 2648 2479 2809 2478 2302 1923 1925 1723 1515 1296 1297  839  597  599   93
 234  487  732  969 1198 1419 1632 2034 2223 2405 2577 3191 2898 3190 3048 3188 2899 3321 3447 3774 3772 3674 4029 4098 4028 4159 4158 4215 4164 4295 4165 4292 4261 4219 4220 4264 4221 4224 4176 4225 4119 3980 3810 3900 3809 3714 3494 3713 3496 3373 3110 2963 2964 2810 2480 2303 2116 2118 1725 1724 1073 1072  840   92  598  349
 233  486  731  968 1197 1418 1631 1836 2033 2222 2404 2742 2576 2900 3046 3186 3322 3449 3446 3672 3952 3955 3865 4026 4162 4157 4251 4256 4257 4291 4293 4321 4217 4263 4266 4265 4171 4223 4222 4175 4054 4120 3981 3901 3812 3609 3495 3245 3710 3109 3246 2962 2812 2650 2481 2304 2119 1928 1516 1299 1298 1074  842  841  600   94
 232  485  730  967 1196 1417 1630 1835 2032 2402 2403 2574 2741 3047 2740 2897 3444 3187 3673 3864 3445 3773 3951 4155 4210 4093 4027 4209 4294 4260 4258 4322 4262 4324 4297 4299 4301 4329 4178 4177 4122 4118 3982 3813 3716 3715 3610 3497 3244 3375 2811 2966 2965 2651 1927 2120 2305 1926 2307 1076 1300 1077 1075  352  350   95
 231  484  729  966 1195 1416 1629 1834 2031 2221 2400 2401 2738 2575 2739 3045 3320 3671 3562 3866 3771 3670 3863 4094 4152 4096 4213 4255 4211 4340 4259 4323 4296 4343 4298 4300 4268 4326 4227 4121 4179 4056 4055 3902 3814 3717 3611 3498 3376 3248 3247 3249 2652 2814 2121 1726 1727 1519 1518 1517 1301  844  843  353  601   96
 230  483  728  965 1194 1415 1628 1833 2030 2220 2399 2573 2737 3043 2896 3185 3319 3443 3560 3561 3770 3950 3948 4024 4095 4253 4207 4254 4290 4252 4351 4339 4342 4325 4346 4327 4303 4267 4226 4269 4228 4057 3983 3984 3903 3718 3612 3250 3381 3111 2967 2485 2813 2653 2306 2482 1931 1302 1929  845 1728 1078  604  354  351   97
 229  482  727  964 1193 1414 1627 1832 2029 2218 2572 2736 3044 2895 3042 3184 3318 3442 3559 3667 3769 3669 3949 4025 4153 4156 4208 4206 4287 4320 4353 4341 4354 4345 4344 4328 4302 4230 4270 4229 4180 4058 3985 3904 3815 3613 3377 3379 3252 3499 2815 2971 3112 2817 2483 2308 2127 2123 1303 1729 1305  605  602  603  355   98
 228  481  726  963 1192 1413 1626 2028 2217 2219 2027 2216 2735 2894 3183 3182 3317 3441 3668 3558 3862 3861 3947 4022 3946 4154 4204 4319 4286 4318 4288 4317 4335 4352 4355 4304 4272 4330 4181 4124 4123 4059 3986 3905 3816 3719 3500 3251 3501 3378 2816 3113 2484 2654 2310 2309 2122 2124 1730 1520 1306 1079  846  606  356   99
 227  480  725  962 1191 1412 1625 1831 1830 2569 2398 2571 2397 2893 2892 3041 3316 3315 3557 3666 4020 3768 4087 4092 4021 4249 4151 4314 4313 4316 4338 4349 4334 4348 4347 4306 4307 4271 4231 4182 4125 4060 3987 3906 3817 3720 3614 3502 3114 3380 2969 2968 3116 2655 2487 2486 2125 1930 1932 1521 1523 1080  847  607  357  100
 226  479  724  961 1190 1411 1624 1829 2026 2396 2215 2734 2570 2891 3040 3181 3314 3440 3556 3665 3767 4023 3860 3942 4089 4088 4289 4250 4285 4315 4337 4336 4311 4310 4331 4332 4305 4274 4273 4183 4126 4061 3988 3907 3818 3721 3615 3616 3254 3382 3117 3115 2970 2656 2821 2311 2312 1732 1522 1308 1304 1081  848  608  358  101
 225  478  723  960 1189 1410 1623 1828 2025 2214 2395 2568 2733 2890 3039 3180 3313 3439 3555 3664 3765 3859 3766 4091 3945 4090 4248 4205 4284 4282 4350 4281 4278 4333 4240 4308 4275 4233 4232 4184 4127 4062 3908 3819 3722 3617 3618 3503 3504 3253 3118 2819 2818 2488 2658 2657 2126 1933 1731 1934 1524 1082  612  609  359  102
 224  477  722  959 1188 1409 1622 1827 2024 2213 2394 2567 2732 2889 3038 3179 3312 3438 3437 3554 3764 3857 3858 3941 3943 4150 4018 4203 4247 4244 4283 4280 4279 4312 4277 4238 4276 4234 4235 4185 4128 4063 3989 3909 3820 3723 3505 3506 3383 3384 2973 2820 2974 2972 2659 2313 1935 2315 2128 1733 1307  849  850 1309  103  104
 223  476  721  958 1187 1408 1621 1826 2023 2212 2393 2566 2731 2888 3037 3178 3311 3436 3553 3663 3662 3763 3944 4017 4148 4149 4202 4201 4246 4197 4243 4242 4195 4239 4309 4192 4237 4236 4186 4129 4130 4064 3990 3910 3821 3724 3619 3507 3385 3255 3120 3119 2492 2490 2489 2314 1936 2130 1735 1734 1525 1736 1083  610  611  105
 222  475  720  957 1186 1407 1620 1825 2022 2211 2392 2565 2730 2887 3036 3177 3310 3435 3552 3661 3762 3855 3856 4086 4019 4146 4200 4199 4245 4198 4196 4241 4139 4194 4002 4193 4191 4134 4188 4132 4187 3993 3991 3911 3822 3725 3620 3508 3386 3256 3257 2975 2822 2491 2660 2131 2316 1938 1937  852 1311  851 1084  853  360  361
 221  474  719  956 1185 1406 1619 1824 2021 2210 2391 2564 2729 2886 3035 3176 3309 3434 3551 3660 3761 3854 3940 4016 4147 4085 4145 4144 4143 4142 4077 4078 4137 4138 4073 4136 4135 4189 4133 4069 4066 3992 4065 3912 3913 3726 3621 3387 3388 3258 2976 2977 2823 2661 2662 2317 1527 2129 1310 1941 1940 1737 1528 1086  364  106
 220  473  718  955 1184 1405 1618 1823 2020 2209 2390 2563 2728 2885 3034 3175 3308 3433 3550 3659 3760 3852 3939 3938 4012 4084 4015 4081 4080 4008 4079 4076 4140 4003 4004 4001 4190 4071 4070 4068 4131 4067 3994 3824 3823 3727 3622 3509 3259 3122 3121 2978 2824 2663 2493 2318 2132 1942 1738 1526  855 1089  613  363  362  107
 219  472  717  954 1183 1404 1617 1822 2019 2208 2389 2562 2727 2884 3033 3174 3307 3432 3549 3658 3759 3937 3853 4014 4013 4083 4082 4011 4009 4007 3929 4141 4075 3926 4074 4072 4000 3921 3999 3998 3997 3996 3995 3914 3825 3728 3623 3510 3389 3260 3123 2826 2664 2496 2494 2133 1740 1739 1939 1530 1312 1085 1087 1088  365  108
 218  471  716  953 1182 1403 1616 1821 2018 2207 2388 2561 2726 2883 3032 3173 3306 3431 3548 3657 3758 3851 3848 3935 3934 3933 3932 4010 3930 3842 3927 4006 3839 3925 3924 3923 3922 3834 3920 3919 3918 3917 3916 3915 3826 3729 3624 3511 3390 3262 3261 3124 2825 2495 2665 2319 2134 1531 1532 1529 1313  616  857  366  854  109
 217  470  715  952 1181 1402 1615 1820 2017 2206 2387 2560 2725 2882 3031 3172 3305 3430 3547 3656 3757 3850 3936 3849 3847 3846 3844 3931 3748 3841 3744 4005 3928 3745 3837 3836 3835 3833 3832 3831 3736 3830 3829 3828 3827 3730 3625 3512 3391 3125 2980 2981 2827 2979 2497 2135 1943 1945 1944 1314 1533 1091  614  856  368  110
 216  469  714  951 1180 1401 1614 1819 2016 2205 2386 2559 2724 2881 3030 3171 3304 3429 3546 3655 3756 3755 3754 3753 3752 3751 3845 3843 3645 3747 3746 3840 3743 3838 3742 3741 3740 3636 3739 3738 3737 3734 3631 3733 3732 3731 3626 3513 3392 3263 3126 2828 2667 2666 2498 2320 2136 1741 1316 1090 1092  858  615  367  617  111
 215  468  713  950 1179 1400 1613 1818 2015 2204 2385 2558 2723 2880 3029 3170 3303 3428 3545 3654 3653 3652 3651 3650 3649 3648 3750 3749 3646 3644 3643 3642 3641 3640 3639 3638 3637 3525 3635 3634 3633 3632 3735 3630 3629 3628 3627 3514 3393 3264 3127 2982 2829 2668 2499 2321 2322 1315 1743 1742 1534 1317  859  618  369  112
 214  467  712  949 1178 1399 1612 1817 2014 2203 2384 2557 2722 2879 3028 3169 3302 3427 3544 3543 3542 3541 3540 3539 3538 3537 3647 3535 3534 3533 3532 3531 3530 3529 3528 3527 3526 3406 3524 3522 3521 3520 3401 3519 3518 3517 3516 3515 3394 3265 3128 2983 2830 2669 2500 2323 2137 2138 1745 1536 1318 1093  860  619  370  113
 213  466  711  948 1177 1398 1611 1816 2013 2202 2383 2556 2721 2878 3027 3168 3301 3426 3425 3424 3423 3422 3421 3420 3419 3418 3536 3416 3415 3414 3413 3412 3411 3410 3409 3408 3280 3405 3144 3404 3523 3403 3274 3400 3399 3398 3397 3396 3395 3266 3129 2984 2831 2670 2501 2324 2139 1535 1946 1744 1319 1094  861  620  371  114
 212  465  710  947 1176 1397 1610 1815 2012 2201 2382 2555 2720 2877 3026 3167 3300 3299 3298 3297 3296 3295 3294 3292 3291 3290 3417 3289 3288 3287 3286 3285 3284 3283 3282 3281 3279 3407 3142 3278 3277 3402 3139 3273 3272 3271 3270 3269 3268 3267 3130 2985 2832 2671 2502 2325 2140 1947 1746 1537 1320 1095  862  621  372  115
 211  464  709  946 1175 1396 1609 1814 2011 2200 2381 2554 2719 2876 3025 3166 3165 3164 3163 3161 3160 3017 3158 3293 3157 3156 3155 3154 3153 3152 3151 3150 3149 3148 3147 3146 3145 3143 3000 3141 3276 3275 2996 3138 3137 3136 3135 3134 3133 3132 3131 2986 2833 2672 2503 2326 2141 1948 1747 1538 1321 1096  863  622  373  116
 210  463  708  945 1174 1395 1608 1813 2010 2199 2380 2553 2718 2875 3024 3023 3022 3021 3019 3162 3018 3016 3159 3015 3014 3013 3012 3011 3010 3009 3008 3007 3006 3005 3004 3003 3002 3001 2999 2848 2998 3140 2997 2995 2994 2993 2992 2991 2990 2989 2988 2987 2834 2673 2504 2327 2142 1949 1748 1539 1322 1097  864  623  374  117
 209  462  707  944 1173 1394 1607 1812 2009 2198 2379 2552 2717 2874 2873 2872 2871 2870 3020 2868 2867 2866 2865 2864 2863 2862 2861 2860 2859 2858 2857 2856 2855 2854 2853 2852 2851 2850 2849 2688 2689 2846 2845 2844 2843 2842 2841 2840 2839 2838 2837 2836 2835 2674 2505 2328 2143 1950 1749 1540 1323 1098  865  624  375  118
 208  461  706  943 1172 1393 1606 1811 2008 2197 2378 2551 2716 2715 2714 2713 2712 2711 2869 2709 2708 2707 2706 2705 2704 2703 2702 2701 2700 2699 2698 2697 2696 2695 2694 2693 2692 2691 2690 2522 2847 2687 2686 2685 2684 2683 2682 2681 2680 2679 2678 2677 2676 2675 2506 2329 2144 1951 1750 1541 1324 1099  866  625  376  119
 207  460  705  942 1171 1392 1605 1810 2007 2196 2377 2374 2549 2547 2546 1998 2545 2543 2710 2542 2541 2540 2539 2538 2537 2536 2535 2534 2533 2532 2531 2530 2529 2528 2527 2526 2525 2524 2523 2347 2521 2520 2519 2518 2517 2516 2515 2514 2513 2512 2511 2510 2509 2508 2507 2330 2145 1952 1751 1542 1325 1100  867  626  377  120
 206  459  704  941 1170 1391 1604 1809 2006 2195 2376 2191 2375 2373 2372 2188 2370 2544 2368 2367 2366 2365 2364 2363 2362 2361 2360 2359 2358 2357 2356 2355 2354 1979 2353 2352 2351 2168 2348 2345 2346 2344 2161 2343 2342 2341 2340 2339 2338 2337 2336 2335 2334 2333 2332 2331 2146 1953 1752 1543 1326 1101  868  627  378  121
 205  458  703  940 1169 1390 1603 1808 2005 2194 2550 2193 2548 2190 2371 2189 1997 2369 2187 2184 2183 2182 2181 2180 2179 2178 2177 2176 2175 2174 2172 2171 2170 1978 1778 2350 2169 2349 2166 2163 2164 1971 2162 2160 2159 2158 2157 2156 2155 2154 2153 2152 2151 2150 2149 2148 2147 1954 1753 1544 1327 1102  869  628  379  122
 204  457  702  939 1168 1389 1602 1807 2004 2003 2002 1802 2001 1800 1999 1797 2186 1996 2185 1993 1992 1991 1990 1989 1988 1987 1986 1985 1984 1983 2173 1982 1981 1977 1572 2167 1975 1776 2165 1973 1972 1970 1771 1969 1968 1967 1966 1965 1964 1963 1962 1961 1960 1959 1958 1957 1956 1955 1754 1545 1328 1103  870  629  380  123
 203  456  701  938 1167 1388 1601 1806 1805 1804 2192 1803 2000 1801 1799 1590 1798 1795 1994 1794 1586 1793 1792 1790 1582 1789 1787 1785 1578 1783 1576 1135 1782 1980 1780 1779 1976 1775 1974 1774 1773 1772 1562 1563 1769 1768 1767 1766 1765 1764 1763 1762 1761 1760 1759 1758 1757 1756 1755 1546 1329 1104  871  630  381  124
 202  455  700  937 1166 1387 1600 1599 1598 1597 1596 1595 1594 1593 1592 1591 1796 1995 1589 1588 1587 1585 1791 1584 1144 1788 1581 1786 1577 1362 1784 1575 1781 1358 1357 1573 1571 1570 1568 1354 1566 1565 1770 1564 1561 1346 1560 1559 1558 1557 1556 1555 1554 1553 1552 1551 1550 1333 1549 1547 1330  872  631  632  382  125
 201  454  699  936 1165 1386 1385 1384 1383 1382 1381 1380 1379 1378 1377 1376 1375 1374 1150 1149 1371 1370 1369 1583 1368 1580 1579 1365 1364 1363 1361 1360 1574 1359 1355 1356 1777 1569 1353 1567 1352 1128 1349 1348 1347 1123 1345 1344 1343 1342 1341 1340 1339 1338 1337 1336 1335 1334 1548 1109 1332 1105  873 1106  383  126
 200  453  698  935 1164 1163 1162 1161 1160 1159 1158 1157 1156 1155 1154 1153 1152 1373 1372 1151 1148 1147  915 1145  913 1367  912 1366 1141 1139 1138 1137 1136 1134 1133  902 1132 1131 1130 1129 1350 1351 1127 1126 1124 1122 1121  890  888 1118  886 1117 1116  884 1115 1113 1112  880 1111 1110 1331 1108 1107  633  384  127
 199  452  697  934  933  932  931  930  929  928  927  926  925  924  923  922  921  920  919  918  917  916  675 1146  914 1142 1143  672 1140  908  907  906  905  904  903  663  901  900  899  898  897  896  895 1125  655  653  892  889  403 1119  649  146  646  885 1114  883  882  641  879  878  877  875  874  634  385  128
 198  451  696  695  694  693  692  691  690  689  688  687  686  685  684  683  682  681  680  679  678  677  676  674  911  673  169  671  909  669  668  667  666  665  664  416  662  661  660  659  658  657  408  893  894  654  891  404  651 1120  402  887  648  399  644  643  881  139  640  639  637  876  636  635  386  129
 197  450  449  448  447  446  445  444  443  442  441  440  439  438  437  436  435  434  433  432  431  430  429  428  427  426  910  425  670  423  422  421  420  163  418  417  415  414  413  412  411  410  656  409  407  406  652  149  401  147  650  400  398  645  397  396  642  394  137  393  391  390  389  388  387  130
 196  195  194  193  192  191  190  189  188  187  186  185  184  183  182  181  180  179  178  177  176  175  174  173  172  171  170  168  424  167  166  165  419  164  162  161  160  159  158  157  156  155  154  153  152  151  405  150  148  145  647  144  143  142  141  140  395  138  392  638  136  135  134  133  132  131
