# This puzzle is unsolvable
62
   2  244  247    4    5  250  485    7    9  489   10  253   12   13   15   16   17   18   19   20   21   22   23   24   25   26   27   28   29   30   31   32   33   34   35   36   37   38   39   40   41   42   43   44   45   46   47   48   49   50   51   52   53   54   55   56   57   58   59   60   61   62
 480    1    3  482  248    6  484    8  251   11  255  256  491   14  258  259  260  261  262  263  264  265  266  267  268  269  270  271  272  273  274  275  276  277  278  279  280  281  282  283  284  285  286  287  288  289  290  291  292  293  294  295  296  297  298  299  300  301  302  303  304   63
 245  243  478  481  483  249  712  486  487  252  715  490  717  257  493  494  495  496  497  498  499  500  501  502  503  504  505  506  507  508  509  510  511  512  513  514  515  516  517  518  519  520  521  522  523  524  525  526  527  528  529  530  531  532  533  534  535  536  537  538  305   64
 242  708  246  709  710  711  931  713  714  254  718  937  492  719  720  721  722  943  723  725  726  727  728  729  730  731  732  733  734  735  736  737  738  739  740  741  742  743  744  745  746  747  748  749  750  751  752  753  754  755  756  757  758  759  760  761  762  763  764  539  306   65
 240  476  479  707  929  930 1142  932  934  716  935  488  936 1148  939  940  941  942  724  944  945  946  947  948  949  950  951  952  953  954  955  956  957  958  959  960  961  962  963  964  965  966  967  968  969  970  971  972  973  974  975  976  977  978  979  980  981  982  765  540  307   66
 477  705  241  928 1140 1345 1346 1344 1144  933 1145 1351 1149  938 1150 1152 1355 1154 1358 1359 1357 1157 1158 1159 1160 1161 1162 1163 1164 1165 1166 1167 1168 1169 1170 1171 1172 1173 1174 1175 1176 1177 1178 1179 1180 1181 1182 1183 1184 1185 1186 1187 1188 1189 1190 1191 1192  983  766  541  308   67
 238  239  927  926 1139 1141 1143 1347 1729 1348 1350 1544 1349 1147 1548 1151 1550 1153 1155 1156 1554 1360 1361 1362 1363 1364 1365 1366 1367 1368 1369 1370 1371 1372 1373 1374 1375 1376 1377 1378 1379 1380 1381 1382 1383 1384 1385 1386 1387 1388 1389 1390 1391 1392 1393 1394 1193  984  767  542  309   68
 475  703  706  925 1138 1343 1540 1541 1909 1542 1146 1545 1546 1547 1354 1352 1551 1356 1552 1741 1740 1555 1556 1557 1558 1559 1560 1561 1562 1563 1564 1565 1566 1567 1568 1569 1570 1571 1572 1573 1574 1575 1576 1577 1578 1579 1580 1581 1582 1583 1584 1585 1586 1587 1588 1395 1194  985  768  543  310   69
 237  702  704  924 1137 1342 1539 1728 1730 1543 1731 1733 1734 1735 1353 1549 1736 1737 1738 1918 1553 1742 1743 1744 1745 1746 1747 1748 1749 1750 1751 1752 1753 1754 1755 1756 1757 1758 1759 1760 1761 1762 1763 1764 1765 1766 1767 1768 1769 1770 1771 1772 1773 1774 1589 1396 1195  986  769  544  311   70
 474  236  473  923 1136 1341 1726 1538 1727 2081 1910 1912 1913 2085 2084 1915 1916 1917 1739 1920 2090 1921 1922 1923 1924 1925 1926 1927 1928 1929 1930 1931 1932 1933 1934 1935 1936 1937 1938 1939 1940 1941 1942 1943 1944 1945 1946 1947 1948 1949 1950 1951 1952 1775 1590 1397 1196  987  770  545  312   71
 235  472  701  922 1135 1338 1340 1908 1906 1907 2080 2245 1732 2247 2086 2249 2087 2088 2089 1919 2409 2254 2091 2093 2095 2096 2097 2098 2099 2100 2101 2102 2103 2104 2105 2106 2107 2108 2109 2110 2111 2112 2113 2114 2115 2116 2117 2118 2119 2120 2121 2122 1953 1776 1591 1398 1197  988  771  546  313   72
 234  471  700  921 1535 1133 1339 1725 1724 2082 1911 2244 1914 2083 2248 2250 2251 2252 2407 2253 2256 2255 2092 2094 2257 2259 2260 2261 2262 2263 2264 2265 2266 2267 2268 2269 2270 2271 2272 2273 2274 2275 2276 2277 2278 2279 2280 2281 2282 2283 2284 2123 1954 1777 1592 1399 1198  989  772  547  314   73
 231  232  698  699 1134 1534 1537 1723 2079 1905 2243 2400 2547 2402 2403 2404 2405 2553 2554 2406 2411 2412 2413 2258 2560 2414 2416 2563 2417 2418 2419 2420 2421 2422 2423 2424 2425 2426 2427 2428 2429 2430 2431 2432 2433 2434 2435 2436 2437 2438 2285 2124 1955 1778 1593 1400 1199  990  773  548  315   74
 468  233  697  919  920 1722 1536 1721 1533 2077 2078 2399 2401 2549 2550 2690 2692 2551 2693 2408 2410 2697 2558 2557 2559 2562 2415 2702 2565 2566 2705 2567 2568 2569 2570 2571 2572 2573 2574 2575 2576 2577 2578 2579 2580 2581 2582 2583 2584 2439 2286 2125 1956 1779 1594 1401 1200  991  774  549  316   75
 230  470  469  467  918 1132 1337 1903 2076 2241 2242 2548 2546 2246 2688 2552 2823 2555 2826 2694 2948 2695 2698 2699 2700 2561 2832 2701 2564 2704 2836 2706 2707 2708 2709 2710 2711 2712 2713 2714 2715 2716 2717 2718 2719 2720 2721 2722 2585 2440 2287 2126 1957 1780 1595 1402 1201  992  775  550  317   76
 229  696  916  917 1130 1335 1336 1904 2240 2239 2397 2398 2544 2687 2689 2821 2944 2825 2947 2827 2556 2949 2951 2829 2830 2831 2833 2834 2703 2958 2959 2837 2838 2839 2840 2841 2842 2843 2844 2845 2846 2847 2848 2849 2850 2851 2852 2723 2586 2441 2288 2127 1958 1781 1596 1403 1202  993  776  551  318   77
 228  466 1129  915 1131 1531 1532 1900 1902 2075 2073 2396 2686 2819 2545 2820 2945 2822 2946 2696 2828 3063 2950 2952 2953 2954 2955 2956 2835 3073 2960 2961 3076 2962 2963 2964 2965 2966 2967 2968 2969 2970 2971 2972 2973 2974 2853 2724 2587 2442 2289 2128 1959 1782 1597 1404 1203  994  777  552  319   78
 227  694  695 1128 1333 1334 1530 1716 1719 1901 2237 2238 2395 2684 2817 2824 2685 2691 3061 3062 3064 3169 3066 3067 3068 3069 3070 3071 2957 3180 3074 3075 3183 3077 3078 3079 3080 3081 3082 3083 3084 3085 3086 3087 3088 2975 2854 2725 2588 2443 2290 2129 1960 1783 1598 1405 1204  995  778  553  320   79
 464  465  693  692 1126 1332 1718 1720 1899 2074 2072 2393 2394 2682 2543 2818 2816 3059 3269 3168 3171 3363 3065 3172 3175 3176 3177 3178 3072 3179 3181 3182 3282 3184 3185 3186 3187 3188 3189 3190 3191 3192 3193 3194 3089 2976 2855 2726 2589 2444 2291 2130 1961 1784 1599 1406 1205  996  779  554  321   80
 226  463  913 1127 1331 1330 1529 1898 1717 2070 2235 2683 2539 2681 2943 3058 3060 2942 2941 3170 3444 3272 3173 3174 3274 3275 3276 3277 3278 3279 3280 3372 3281 3283 3284 3285 3286 3287 3288 3289 3290 3291 3292 3195 3090 2977 2856 2727 2590 2445 2292 2131 1962 1785 1600 1407 1206  997  780  555  322   81
 225  462  691  914  911  912 1528 1897 1715 2069 2071 2232 3057 2540 2815 3167 3056 3268 3267 3271 3360 3270 3362 3273 3364 3366 3367 3368 3369 3370 3371 3455 3373 3374 3375 3376 3377 3378 3379 3380 3381 3382 3293 3196 3091 2978 2857 2728 2591 2446 2293 2132 1963 1786 1601 1408 1207  998  781  556  323   82
 224  461  690 1125 1124 1329 1527 1714 1525 1895 2391 2236 2392 2233 2390 2940 2680 3166 3266 3361 3359 3445 3446 3447 3365 3449 3450 3451 3452 3453 3454 3456 3531 3458 3533 3459 3460 3461 3462 3463 3464 3383 3294 3197 3092 2979 2858 2729 2592 2447 2294 2133 1964 1787 1602 1409 1208  999  782  557  324   83
 223  460  689  910 1123 1328 2234 1526 1894 1896 2679 2542 2812 2814 2938 2939 2937 3165 3164 3358 3443 3520 3521 3522 3448 3523 3524 3526 3527 3529 3596 3530 3598 3457 3600 3534 3535 3536 3537 3538 3465 3384 3295 3198 3093 2980 2859 2730 2593 2448 2295 2134 1965 1788 1603 1410 1209 1000  783  558  325   84
 221  688  907  909  459 1122 1524 1713 1893 2066 2068 2541 2538 2813 3054 3055 3162 3163 3265 3357 3519 3518 3588 3589 3590 3591 3525 3651 3592 3594 3706 3657 3597 3658 3659 3601 3602 3603 3604 3539 3466 3385 3296 3199 3094 2981 2860 2731 2594 2449 2296 2135 1966 1789 1604 1411 1210 1001  784  559  326   85
 687  222  457 1121  908 1327 1326 2067 1523 1712 2230 2536 2388 2678 2811 2936 3053 3263 3264 3442 3440 3441 3587 3648 3649 3650 3652 3654 3593 3528 3595 3655 3656 3709 3532 3660 3661 3662 3605 3540 3467 3386 3297 3200 3095 2982 2861 2732 2595 2450 2297 2136 1967 1790 1605 1412 1211 1002  785  560  327   86
 220  458 1119  456 1120 1325 1519 1892 2231 2064 2389 2063 2387 2537 2809 2935 3052 3161 3262 3356 3355 3517 3586 3647 3700 3701 3702 3703 3653 3704 3705 3599 3707 3750 3710 3711 3712 3663 3606 3541 3468 3387 3298 3201 3096 2983 2862 2733 2596 2451 2298 2137 1968 1791 1606 1413 1212 1003  786  561  328   87
 685  218  686  905 1521  683 1324 1323 1891 2065 2534 2386 2535 2810 2677 2934 3051 3160 3261 3354 3439 3516 3585 3646 3699 3744 3745 3746 3747 3748 3749 3751 3708 3752 3753 3754 3713 3664 3607 3542 3469 3388 3299 3202 3097 2984 2863 2734 2597 2452 2299 2138 1969 1792 1607 1414 1213 1004  787  562  329   88
 219  455  904  906 1117 1520 1522 1709 1711 1890 2228 2385 2675 2676 2808 2933 3050 3159 3260 3353 3438 3515 3584 3645 3698 3743 3780 3781 3782 3783 3784 3785 3786 3787 3788 3755 3714 3665 3608 3543 3470 3389 3300 3203 3098 2985 2864 2735 2598 2453 2300 2139 1970 1793 1608 1415 1214 1005  788  563  330   89
 217  454  684 1322 1888 1118 1708 1710 2062 2227 2225 2229 2533 2673 2932 2805 3049 3158 3259 3352 3437 3514 3583 3644 3697 3742 3778 3779 3809 3810 3812 3833 3813 3814 3789 3756 3715 3666 3609 3544 3471 3390 3301 3204 3099 2986 2865 2736 2599 2454 2301 2140 1971 1794 1609 1416 1215 1006  789  564  331   90
 451  216  452  902  903 1321 1518 1887 2384 2061 1889 2383 2807 2931 2674 2930 3048 3157 3258 3351 3436 3513 3582 3641 3642 3696 3808 3806 3807 3828 3829 3811 3832 3815 3790 3757 3716 3667 3610 3545 3472 3391 3302 3205 3100 2987 2866 2737 2600 2455 2302 2141 1972 1795 1610 1417 1216 1007  790  565  332   91
 215  453  681 1114 1116 1320 1706 1707 2060 2059 2226 2382 2532 2530 2806 2804 3047 3156 3257 3346 3350 3512 3581 3580 3643 3741 3776 3740 3839 3830 3842 3843 3840 3817 3791 3758 3717 3668 3611 3546 3473 3394 3392 3206 3101 2988 2867 2738 2601 2456 2303 2142 1973 1796 1611 1418 1217 1008  791  566  333   92
 214  682  679  680 1115  901 1319 1705 1885 2224 2223 2381 2672 2531 2803 2929 3045 3046 3256 3435 3509 3432 3433 3510 3695 3694 3739 3827 3826 3841 3831 3835 3834 3818 3792 3719 3759 3718 3612 3547 3393 3305 3303 3304 3207 2989 2868 2739 2602 2457 2304 2143 1974 1797 1612 1419 1218 1009  792  567  334   93
 213  449  450  900 1318 1703 1517 1515 1886 1704 1884 2380 2529 2669 2670 2928 3044 3154 3155 3349 3254 3347 3434 3693 3736 3775 3777 3738 3825 3838 3837 3816 3836 3793 3760 3761 3670 3613 3548 3475 3474 3306 3209 3103 3102 2990 2869 2740 2603 2458 2305 2144 1975 1798 1613 1420 1219 1010  793  568  335   94
 212  678  677  898 1113 1317 1516 1513 1883 2058 2379 2221 2668 2671 2526 2802 2926 2927 3253 3348 3430 3579 3511 3638 3692 3737 3804 3805 3803 3824 3823 3821 3820 3819 3794 3720 3671 3669 3614 3549 3476 3395 3307 3208 3104 2991 2870 2741 2604 2459 2306 2145 1976 1799 1614 1421 1220 1011  794  569  336   95
 211  448  676 1109  899 1111 1316 1514 2057 2222 2220 2378 2527 2800 2924 2925 2528 3153 3041 3255 3345 3576 3639 3508 3640 3774 3735 3802 3801 3800 3822 3798 3797 3796 3795 3762 3721 3672 3615 3550 3478 3477 3396 3210 3105 2992 2871 2742 2605 2460 2307 2146 1977 1800 1615 1422 1221 1012  795  570  337   96
 210  447  675 1110 1112 1315 1702 1512 1701 1882 2055 2377 2525 2667 2801 3151 3250 3043 3249 3152 3429 3507 3578 3690 3773 3685 3772 3771 3770 3769 3799 3768 3766 3765 3764 3763 3722 3674 3673 3616 3551 3397 3308 3211 3106 2993 2872 2743 2606 2461 2308 2147 1978 1801 1616 1423 1222 1013  796  571  338   97
 209  446  896  897  894 1314 1511 2056 1881 2054 2219 2376 2524 2666 2923 3150 2922 2799 3344 3431 3343 3734 3577 3691 3636 3733 3687 3732 3731 3730 3729 3767 3728 3727 3725 3724 3676 3723 3617 3552 3479 3398 3309 3212 3107 2994 2873 2744 2607 2462 2309 2148 1979 1802 1617 1424 1223 1014  797  572  339   98
 208  445  895  893 1108 1313 1510 1700 2053 2218 2375 2374 2798 2664 2797 3039 3251 3573 3042 3148 3428 3506 3689 3505 3635 3688 3686 3684 3683 3682 3681 3680 3679 3726 3678 3622 3677 3675 3618 3553 3480 3399 3310 3213 3108 2995 2874 2745 2608 2463 2310 2149 1980 1803 1618 1425 1224 1015  798  573  340   99
 444  673  443  674 1107 1509 1695 1699 1880 2052 2217 2795 2523 2665 2796 3040 3149 3252 3147 3341 3427 3572 3637 3634 3633 3632 3631 3630 3629 3628 3627 3626 3625 3624 3560 3558 3623 3620 3619 3554 3481 3400 3311 3214 3109 2996 2875 2746 2609 2464 2311 2150 1981 1804 1619 1426 1225 1016  799  574  341  100
 207  206  672 1106 1696 1312 1878 1698 1879 2216 2049 2215 2660 2918 2921 2662 3146 3248 3340 3575 3426 3504 3574 3502 3571 3570 3568 3567 3566 3565 3493 3564 3490 3563 3489 3561 3621 3557 3556 3555 3482 3401 3312 3215 3110 2997 2876 2747 2610 2465 2312 2151 1982 1805 1620 1427 1226 1017  800  575  342  101
 205  442  892 1105 1311 1310 1697 1507 1307 2050 2521 2663 2522 2372 2661 3038 2794 3144 3425 3342 3338 3503 3335 3499 3498 3569 3497 3496 3495 3494 3413 3414 3411 3562 3410 3559 3488 3486 3485 3484 3483 3402 3313 3216 3111 2998 2877 2748 2611 2466 2313 2152 1983 1806 1621 1428 1227 1018  801  576  343  102
 204  441  671  890 1104 1508 1505 1309 2373 2051 2214 2519 2048 2920 2658 3036 3143 3247 3145 3423 3336 3500 3501 3422 3420 3419 3418 3330 3417 3416 3415 3492 3491 3412 3409 3487 3407 3320 3406 3405 3404 3403 3314 3217 3112 2999 2878 2749 2612 2467 2314 2153 1984 1807 1622 1429 1228 1019  802  577  344  103
 203  440  670  669 1506 1103 1694 1876 1692 1877 2212 2368 2371 2792 2213 2793 2919 3035 2910 3246 3140 3337 3240 3333 3334 3332 3331 3329 3234 3232 3233 3327 3325 3324 3323 3228 3322 3408 3319 3318 3317 3316 3315 3218 3113 3000 2879 2750 2613 2468 2315 2154 1985 1808 1623 1430 1229 1020  803  578  345  104
 202  439  668 1102 1308  891 1504 1693 1875 2045 2518 2047 2210 2520 2517 2659 3037 3245 3244 3243 3424 3241 3421 3024 3238 3236 3134 3235 3131 3130 3328 3017 3231 3230 3229 3125 3321 3225 3224 3223 3222 3221 3220 3219 3114 3001 2880 2751 2614 2469 2316 2155 1986 1809 1624 1431 1230 1021  804  579  346  105
 201  438  667  889  888 1101 1306 1872 1691    0 2046 2370 2367 2915 2657 2369 3032 3142 3339 3034 3139 3242 3239 2905 3136 3237 3022 3133 3132 3129 3128 3016 3126 3014 3326 3226 3227 3122 3121 3120 3119 3118 3117 3116 3115 3002 2881 2752 2615 2470 2317 2156 1987 1810 1625 1432 1231 1022  805  580  347  106
 200  437  666  887 1100 1305 1503 1690 1873 2211 1874 2366 2516 2917 2791 2916 3031 3029 3141 3030 3028 3026 3138 2781 2904 3135 2902 3021 3020 3019 3018 2898 2899 2769 3123 3012 2893 3011 3010 3009 3008 3007 3006 3005 3004 3003 2882 2753 2616 2471 2318 2157 1988 1811 1626 1433 1232 1023  806  581  348  107
 199  436  665  886 1099 1304 1502 1501 1871 2208 2044 2515 2790 2656 2913 3033 2788 2912 2784 2783 2908 3025 3027 2780 2500 2501 2776 2775 2640 2901 2771 2900 3127 2895 3015 3124 2766 2892 2891 2890 2889 2888 2887 2885 2886 2759 2883 2754 2617 2472 2319 2158 1989 1812 1627 1434 1233 1024  807  582  349  108
 198  435  664  885 1098 1303 1500 1689 1870 2207 2365 2513 2654 2655 2914 2787 2789 2786 2911 2909 2782 1849 3137 2644 2903 3023 2641 2639 2774 2495 2770 2897 2896 2768 3013 2894 2765 2629 2763 2484 2762 2761 2760 2624 2622 2884 2756 2755 2618 2473 2320 2159 1990 1813 1628 1435 1234 1025  808  583  350  109
 197  434  663  884 1097 1302 1499 1688 1869 2209 2514 2041 2364 2512 2652 2650 2651 2649 2506 2505 2648 2906 2352 2024 2777 2779 2643 2187 2496 2636 2772 2341 2344 2493 2767 2632 2334 2630 2631 2332 2628 2627 2626 2758 2757 2479 2621 2477 2619 2474 2321 2160 1991 1814 1629 1436 1235 1026  809  584  351  110
 196  433  662  883 1096 1301 1498 1687 1868 2043 2205 2206 2042 2510 2509 2508 2653 2355 2785 2647 2503 2646 1851 2907 2778 2642 2192 2345 2497 2494 2492 2773 2343 2491 2634 2633 2485 2490 2764 2486 2006 2483 2625 2482 2328 2623 2620 2327 2476 2475 2322 2161 1992 1815 1630 1437 1236 1027  810  585  352  111
 195  432  661  882 1095 1300 1497 1686 1867 2040 2363 2202 2511 2034 2200 2359 2357 2507 2356 2354 2502 2193 1275 1848 2498 2645 2499 2348 2638 2185 2342 2183 2637 2338 2339 2340 2178 2335 2488 2008 2173 2333 2481 2480 2169 2002 2326 2478 1998 2166 2323 2162 1993 1816 1631 1438 1237 1028  811  586  353  112
 194  431  660  881 1094 1299 1496 1685 1866 2039 2204 2360 2362 2033 2201 2199 2358 2197 2195 2194 2028 1850 2351 2350 2349 2190 2191 2346 2186 2184 2016 2182 2180 2635 1838 2012 2487 2489 2336 2176 1831 1828 2005 1829 2004 2168 2325 2165 2000 2324 2164 2163 1994 1817 1632 1439 1238 1029  812  587  354  113
 193  430  659  880 1093 1298 1495 1684 1865 2037 1862 2203 2361 2035 1675 2031 2198 1855 2030 2196 2029 2026 1666 2025 2022 2189 2347 2020 2188 2019 2018 2015 1840 2181 2177 1837 2014 2010 1833 2009 2329 2175 2174 2171 2331 2170 2001 1825 2167 1999 1997 1996 1995 1818 1633 1440 1239 1030  813  588  355  114
 192  429  658  879 1092 1297 1494 1683 1864 2038 1861 2036 1860 1859 1858 1674 1857 1854 1853 1479 1670 2504 2353 1668 1847 1846 1845 2021 1470 1272 1660 1841 1839 1656 1466 2179 2337 1834 2011 1832 2003  836 1647 2172 1645 1827 1826 1642 1824 1823 1822 1821 1820 1819 1634 1441 1240 1031  814  589  356  115
 191  428  657  878 1091 1296 1493 1682 1680 1863 1679 1487 1678 1677 1484 1856 2032 1672 1480 1671 2027 1852 1669 2023 1476 1664 1662 1663 1842 1844 1661 1843 1263 1465 2013 1655 1836 1265 1652 1650 1830 2007 1646 2330 1454 1644 1643 1641 1450 1640 1639 1638 1637 1636 1635 1442 1241 1032  815  590  357  116
 190  427  656  877 1090 1295 1492 1491 1681 1490 1489 1488 1486 1676 1485 1483 1673 1482 1481 1278  854 1477 1478 1667 1665 1273 1066  850 1471 1065 2017 1467 1657 1062 1261  387 1654  621 1835 1459 1456 1457 1649 1048 1049 1453 1047 1254 1451 1449 1448 1447 1446 1445 1444 1443 1242 1033  816  591  358  117
 189  426  655  876 1089 1294 1293 1292 1291 1290 1289 1288 1287 1286 1285 1284 1283 1282 1281 1280 1279 1277 1475 1474 1274 1472 1063 1469 1269 1468 1060 1658 1271 1058 1266 1460 1462 1461 1651 1260 1259 1257 1648 1258 1255 1253 1046 1251 1044 1250 1249 1248 1247 1246 1245 1244 1243 1034  817  592  359  118
 188  425  654  875 1088 1087 1086 1085 1084 1083 1082 1081 1080 1079 1078 1077 1076 1075 1074 1073 1072 1276 1070 1069 1068 1473 1067  626 1268  625  847 1057  619  840 1463 1059  152  841 1054  837  616 1053 1051  834 1455  833 1452 1252  830 1043 1042 1041 1040 1039 1038 1037 1036 1035  818  593  360  119
 187  424  653  874  873  872  871  870  869  868  867  866  865  864  863  862  861  860  859  858  857  856  630  853  632  852  628 1064 1270  156 1061 1464  846  848 1267 1264 1056  839 1653  151 1052 1458  143  383 1050  832 1045  135  375  829  828  826  825  824  823  822  821  820  819  594  361  120
 186  423  652  651  650  649  648  647  646  645  644  643  642  641  640  639  638  637  636  635  634 1071  633  855  631  629  158  851  397  155 1659  391  623  389  388  148 1262  615 1055  838  382  835  612  610 1256  379  608  831  605  136  827  603  602  601  600  599  598  597  596  595  362  121
 185  422  421  420  419  418  417  416  415  414  413  412  411  410  409  408  407  406  405  404  403  402  401  400  399  398  627  394  624  622  393  845  390  844  386  149  146  842  618  614  145  142  380  611  378  609  377  138  607  373  604  372  371  370  369  368  367  366  365  364  363  122
 184  183  182  181  180  179  178  177  176  175  174  173  172  171  170  169  168  167  166  165  164  163  162  161  160  159  157  849  396  395  154  392  153  843  150  620  147  617  613  385  384  144  381  141  140  139  606  376  137  374  134  133  132  131  130  129  128  127  126  125  124  123
