# This puzzle is unsolvable
51
   2    1    3    4    5    6    7    8    9   10   11  211   12  213   14   15   17   18   19   20   21   22   23   24   25   26   27   28   29   30   31   32   33   34   35   36   37   38  238   39   41   42   43   44   45   46   47   48   49   50   51
 200  201  202  203  204  205  206  207  208  209  210   13  403  212  214   16  216  217  218  219  220  221  222  223  224  225  226  227  228  229  230  231  232  233  234  235  236  428  237   40  240  241  242  243  435  244  246  247  249   52  251
 199  392  393  394  395  396  397  398  399  400  401  402  405  587  406  215  590  408  409  410  411  412  413  414  415  416  417  418  419  420  421  422  423  424  425  609  426  427  429  239  430  432  433  434  245  436  438  253  248  439  441
 198  391  576  577  578  579  580  581  582  583  584  586  760  763  404  588  932  591  592  593  594  595  596  597  598  599  600  601  602  603  604  605  606  607  784  953  611  787  612  614  431  615  616  617  618  619  437  440  252   53   54
 197  390  575  752  753  754  755  756  757  758  759  928  762  761 1089  589  407  766  767  769 1095  770  771  772  773  774  775  776  777  778  779  780  781  782  608  951  950  786  785  613  788  790  791  792  793  794  795  622  621  443   55
 196  389  574  751  920  921  922  924  926 1085 1088 1087 1086  585  929  764  931  765  934  768  936  937  938  939  940  941  942  943  944  945  946  947  948  949  783 1109  610 1113  954 1265  789  956 1118  958  961 1120  962  623  250  620  254
 195  388  573  919 1080 1081 1082  923  925 1236 1237 1239 1381  927 1384  930 1091  933 1092  935 1094 1096 1097 1098 1099 1100 1101 1102 1103 1104 1105 1106 1107 1108 1110  952 1111 1112 1262 1264  955  957 1268  959 1119  960  625  445  624   57  442
 193  194  750  918  749 1079 1232 1233 1377 1083 1235 1378 1380 1090 1383 1240 1242 1651 1093 1243 1523 1246 1247 1249 1250 1251 1252 1253 1254 1255 1256 1257 1258 1259 1260 1261 1405 1115 1114 1407 1267 1117 1116 1270 1411  796  444   58   59   56   60
 192  571  572  570 1078 1077 1231 1376 1512 1234 1379 1515 1516 1238 1518 1241 1385 1386 1245 1389 1387 1390 1248 1528 1394 1395 1530 1396 1397 1398 1399 1400 1401 1402 1403 1404 1667 1542 1263 1409 1545 1410 1269  965  963  799  964  797  626  255  258
 191  386  387  747  748  917 1230 1374 1375 1084 1513 1642 1644 1382 1645 1519 1520 1522 1244 1524 1388 1526 1392 1393 1527 1656 1529 1531 1532 1533 1534 1535 1536 1537 1538 1539 1541 1406 1668 1543 1671 1266 1412 1544 1271 1121  798  627  446  256  257
 383  190  569  746  916  915 1229 1373 1511 1640 1514 1641 1517 1643 1764 1646 1648 1521 1649 1650 1525 1652 1391 1653 1654 1775 1657 1658 1659 1660 1661 1663 1782 1664 1665 1666 1786 1408 1540 1670 1547 1414 1273 1122 1123  966  628  801  259  448   62
 384  385  568  745  914 1076 1227 1228 1510 1639 1760 1761 1762 1763 1765 1876 1647 1767 1768 1769 1770 1771 1772 1773 1655 1774 1776 1777 1778 1780 1781 1662 1783 1894 1784 1896 1897 1785 1788 1669 1789 1548 1413 1274  802  800  803  629  260  447   61
 189  382  567  744  913 1075 1074 1372 1509 1638 1759 1872 1873 1874 1979 1877 1766 1878 1879 1880 1881 1882 1883 1884 1885 1990 1991 1886 1992 1779 1891 1892 1893 1997 1895 1999 2095 2001 1787 1790 1673 1549 1415 1272 1275  968 1124  804  967  449  261
 187  381  564  912 1073 1226 1225 1371 1508 1637 1758 1871 1976 1977 1875 1978 1980 1981 1982 1983 1984 1985 1986 1987 1988 1989 1887 1889 1888 1890 1993 1995 1996 2092 1998 2000 1898 1792 2002 1672 1791 1416 1546 1126 1125  805  631  630  450   65   63
 380  188  743  566  563 1072 1370 1507 1506 1636 1757 1870 1975 2072 2073 2074 2075 2076 2077 2079 2244 2080 2082 2169 2170 2083 2084 2086 2087 2090 1994 2091 2178 2179 2093 2094 2096 1900 1794 1793 1899 1674 1417 1276  970 1127  969  632  451   66   64
 186  565  379  741  742  910 1224 1369 1635 1634 1756 1869 1974 2071 2160 2161 2162 2163 2165 2078 2166 2168 2247 2249 2081 2172 2085 2173 2174 2089 2088 2175 2176 2180 2182 2097 2004 1903 2003 1675 1551 1550 1418 1277 1128  971  806  452  454  264  262
 185  378  376  740  911  906 1069 1223 1368 1633 1755 1868 1973 2070 2159 2240 2241 2242 2164 2245 2316 2167 2248 2319 2250 2171 2251 2252 2253 2254 2255 2177 2257 2329 2258 2259 2181 1901 1904 1902 1676 1552 1419 1278  972  634  807  633  453  263   67
 184  562  908  909 1070 1366 1071 1367 1505 1504 1754 1867 1972 2069 2158 2239 2312 2313 2243 2314 2317 2246 2318 2320 2383 2321 2322 2323 2324 2325 2326 2256 2327 2330 2260 2183 2098 2006 2005 1795 1677 1678 1553 1279 1129  974  973  808  455  265   68
 183  377  738  736  907  905 1068 1222 1503 1632 1753 1866 1971 2068 2157 2238 2311 2376 2432 2377 2315 2378 2382 2437 2438 2384 2385 2386 2387 2388 2390 2392 2328 2391 2261 2184 2099 2007 1905 1796 1679 1554 1420 1280 1130 1131  810  635  636  266   69
 182  375  561 1067  739 1221 1065 1219 1502 1631 1752 1865 1970 2067 2156 2237 2310 2375 2435 2380 2480 2379 2436 2484 2381 2485 2440 2441 2442 2443 2389 2446 2445 2331 2262 2185 2100 1906 1907 1797 1555 1422 1421 1281 1132  975  811  809  456  267   70
 181  374  735  737 1220 1365 1066 1217 1501 1630 1751 1969 1968 2066 2155 2236 2309 2374 2431 2433 2434 2521 2483 2486 2524 2439 2487 2488 2489 2490 2444 2491 2393 2332 2263 2186 2101 2008 1798 1799 1680 1681 1423 1282 1133  976  638  637  457  268   71
 180  903  560  557  904 1218 1364 1500 1362 1750 1863 1864 2065 2153 2234 2154 2308 2373 2478 2481 2519 2520 2553 2522 2523 2525 2526 2527 2528 2529 2492 2447 2394 2333 2264 2187 2102 2009 1908 1800 1682 1556 1424 1283 1134  977  812  639  458  269   72
 179  373  558  559  734 1064 1363 1216 1361 1629 1749 1862 2064 2063 2235 2232 2233 2372 2479 2477 2430 2482 2552 2578 2555 2556 2557 2558 2559 2530 2493 2448 2395 2334 2265 2188 2103 2010 1910 1909 1683 1557 1425 1284  978  813  814  640  459  270   73
 178  372  555  556  733  902 1063 1499 1498 1628 1861 1859 1966 1967 2152 2307 2306 2428 2427 2429 2518 2551 2576 2554 2577 2579 2580 2581 2560 2531 2494 2449 2396 2335 2266 2189 2104 2012 2011 1684 1685 1426 1427 1287 1135 1137  979  641  460  271   74
 177  371  370  732  901 1062 1215 1497 1495 1627 1626 1747 1860 2062 2151 2305 2304 2370 2371 2476 2517 2550 2575 2592 2593 2594 2595 2582 2561 2532 2495 2450 2397 2336 2267 2190 2105 1911 1802 1801 1560 1559 1286 1558 1136  815  816  642  461  272   75
 176  369  554  731  900 1214 1359 1360 1625 1746 1748 1963 1965 2150 2149 2231 2303 2369 2426 2475 2516 2549 2574 2591 2600 2596 2597 2583 2562 2533 2496 2451 2398 2337 2268 2191 2106 2013 1912 1803 1686 1561 1428 1138 1285  980  643  644  462   76  274
 175  368  553  730  899 1061 1213 1496 1358 1624 1745 1858 1964 2061 2229 2230 2302 2368 2425 2474 2515 2548 2573 2590 2599 2598 2584 2585 2563 2534 2497 2452 2399 2338 2269 2192 2107 2014 1913 1804 1687 1562 1429 1288  981  817  983 1139  463  273   77
 174  367  552  729  898 1060 1059 1212 1494 1623 1743 1744 1961 1962 2060 2059 2148 2367 2424 2473 2514 2547 2572 2589 2588 2587 2586 2566 2564 2535 2498 2453 2400 2339 2270 2193 2108 2015 1914 1805 1688 1563 1430 1289  984    0  982  645  464  275   78
 173  366  728  727 1058 1355 1210 1357 1493 1622 1742 1741 1856 1960 2147 2146 2228 2301 2423 2472 2513 2546 2571 2570 2542 2569 2541 2567 2565 2536 2499 2454 2401 2340 2271 2194 2109 2016 1915 1806 1689 1564 1431 1141 1140  985  820  647  818  277  278
 365  364  550  551 1057  897 1211 1356 1491 1492 1621 1854 1959 2058 2145 2227 2300 2366 2422 2471 2512 2545 2544 2543 2540 2506 2568 2539 2504 2537 2500 2455 2341 2342 2272 2195 2110 2017 1916 1807 1690 1565 1432 1290 1143 1142  819  646  468   80  465
 171  172  549  896  895 1206 1209 1208 1490 1857 1351 1853 1855 2056 2144 2226 2225 2365 2420 2470 2511 2510 2509 2508 2507 2463 2503 2461 2538 2501 2456 2403 2402 2343 2273 2196 2111 2018 1917 1808 1691 1567 1292 1291 1144  987  648  649   81  276  466
 170  548  547  723  726 1056 1055 1354 1618 1619 1620 1740 2054 2057 2055 2298 2299 2363 2364 2469 2468 2467 2466 2465 2464 2462 2505 2460 2459 2502 2408 2457 2404 2344 2197 2199 2112 2019 1918 1809 1692 1434 1293  986 1433  470   85   82  469   83   79
 168  363  724 1054  894  892 1353 1350 1488 1852 1850 1851 2053 1958 2143 2224 2362 2421 2419 2418 2417 2416 2415 2414 2413 2412 2411 2410 2409 2348 2458 2346 2275 2198 2274 2113 2021 2020 1919 1810 1435 1294 1436  823 1566  824 1145  279  988  821   86
 166  546  359  360  891 1053 1052 1489  893 1738 1739 1957 1956 2142 2223 2296 2297 2361 2360 2359 2358 2357 2356 2355 2354 2353 2352 2351 2350 2407 2349 2345 2406 2277 2278 2276 2115 2022 1920 1693 1568 1147 1295 1297  990  989  650  822  280   84  467
 545  169  889 1207  887  725  888 1616 1205 1737 1615 1736 1954 2052 2141 2222 2295 2294 2293 2292 2291 2290 2289 2288 2287 2286 2285 2284 2283 2281 2207 2405 2279 2122 2202 2114 2200 1921 1812 1694 1695 1569 1437 1146  651  652  281  825  472  283  654
 361  362  722  890 1050 1049 1613 1203 1486 1485 1849 1955 1617 2051 2140 2221 2220 2219 2218 2217 2216 2215 2214 2213 2212 2211 2210 2209 2208 2282 2205 2347 2120 2203 2201 2119 2116 2023 1922 1811 1696 1570 1571 1296 1148  991  826   87  282  285   88
 165  358  167  720 1348  721 1204 1051 1734 1347 1735 1614 1953 2050 2139 2048 2138 2136 2135 2134 2133 2132 2131 2130 2129 2128 2127 2126 2125 2124 2121 2204 2280 2028 2030 2117 2026 2024 1815 1814 1572 1439 1438 1298 1150 1149  992  827  471  284   89
 164  543  715  356 1048 1349 1202 1487 1352 1847 1733 1848 1951 1949 1950 2047 2137 2045 2044 1944 2041 1941 2040 2039 1939 2038 2037 2035 2033 2123 2206 2032 2031 2029 2027 2118 1928 1816 1923 1813 1697 1698 1573 1300 1299  994  655  653  475   92   91
 542  541  719  544  540 1346 1345 1484 1483 1846 1732 1844 1605 1842 2049 1475 2046 1945 2043 1943 2042 1719 1834 1940 1937 1938 2036 1935 2034 1827 1932 1931 1824 1709 1930 1926 1819 2025 1817 1925 1924 1442 1575 1440  828  993  657  995  656   90  286
 163  162  357  539 1047  717 1482 1481 1611 1612 1607 1952 1843 1728 1474 1840 1946 1839 1837 1724 1835 1942 1594 1833 1718 1832 1829 1936 1828 1933 1825 1826 1588 1710 1583 1927 1823 1818 1704 1700 1574 1699 1441 1301  831 1153  832  287  473  474  477
 355  352  353  883  882 1343 1201 1480 1344 1610 1477 1729 1473 1603 1726 1948 1947 1841 1471 1836 1467 1599 1720 1831 1717 1714 1830 1716 1713 1712 1934 1586 1587 1708 1820 1706 1821 1585 1703 1702 1579 1576 1443 1151 1152 1577  996  658  476  478  288
 714  160  158 1046  716  885  886 1342 1730 1731 1478 1608 1336 1606 1845 1186 1725 1602 1723 1468 1721 1722 1598 1595 1463 1593 1462 1591 1318 1589 1711 1458 1822  848 1929 1450 1705 1449 1581 1580 1578 1701 1444 1302 1303  830  833  829  290   93   94
 538  350  713  159  884 1198 1200 1199 1197 1609 1337 1338 1334 1189 1604 1838 1470 1601 1469 1600 1329 1466 1465 1597 1592 1324 1715 1177 1459 1590 1456 1319 1171 1315 1451 1454 1448 1312 1452 1162 1447 1446 1305 1445 1304 1154  660  661  479  659  289
 161  351  537  718  881 1196 1042 1043 1193  872 1192  523 1335 1036 1035 1185 1332 1727 1331 1330 1027 1327 1179 1596 1326 1325 1464 1323 1460 1014 1015 1172 1455 1453 1582 1707 1584 1165  844 1311 1163 1309 1308 1159 1155  997  834  836  480  481  664
 347  535  348  534  536  878 1044 1340 1195 1479 1039 1476 1191 1034 1190  696 1472  868 1184 1182 1328 1181 1025 1178 1174  857 1020 1017 1175 1457  852 1320 1317 1314 1166 1012 1007 1010 1161 1164 1160 1307 1306  999  998 1156 1158  663   95  291  292
 157  354  711 1045  880  877 1037 1194 1341 1339  700  870  704 1333 1187 1030 1183  865 1028 1029  693 1180 1023  859 1021 1322  858 1019 1018 1321 1016 1316 1013 1168 1169 1170  311 1313 1310  673  846 1005 1004 1003 1157  662  666 1001   96  482  295
 156  712  530  533  879  876 1041 1040  524 1038 1188  141  873 1032 1033  869  866  695  864  514  863 1026 1024  689 1022  856  686 1176 1173  854  682  853  851  850  679 1167 1008 1011  845  674 1006  843  842  841  839  838  837  835 1000  483  293
 349  155  346  532  710  706  528  705  525  874  703  522  520  871  697  516  518  694  328  692  510  690  860  323  688  687  685 1461  855  683  503  681  677  849  847  498  675 1009  113  672  671  670  840  669 1002  489  665  484   98  297  294
 154  344  709  342  708  148  149  875  336  339  338  702  142  517  698  332  867  515  513  327  862  861  129  324  509  507  506  505  684  317  504  502  680  500  501  676  497  496  495  112  494  492  304  301  667  105  486  485  487   97   99
 153  152  531  150  341  529  707  527  521  340  140  701  699 1031  519  334  330  133  329  132  512  326  691  321  128  508  320  319  318  122  316  119  314  313  678  310  309  308  307  110  306  305  109  490  491  106  488  104  296  298  100
 151  345  343  146  147  145  144  526  337  143  335  139  138  137  333  331  136  135  134  131  130  511  325  322  127  126  125  124  123  121  120  315  118  117  499  116  312  115  114  493  111  108  302  303  107  668  299  300  103  102  101
