# This puzzle is unsolvable
49
   2    1    3    4    5    6    7    8    9   10   11   12   13  205  206   14   16   17   18   19   21   22   23   24   25   26   27   28   29   30   31   32   33   34   35   36   37   38   39   40   41   42   43   44   45   46   47   48   49
 192  193  194  195  196  197  198  199  200  201  202  203  204  388  390  207   15  209  210   20  211  212  213  214  215  217  218  219  220  221  222  223  224  225  226  227  228  229  230  231  232  233  234  235  236  237  238  239   50
 191  376  377  378  379  380  381  382  383  384  385  386  387  730  389  208  563  392  393  394  395  396  397  398  216  399  400  401  403  404  405  406  407  408  409  410  411  412  413  414  415  416  417  418  419  420  421  240   51
 190  375  552  553  554  555  556  557  558  559  560  561  562  564  731  566  391  567  568  569  570  571  572  573  574  575  402  744  577  579  580  581  582  583  584  585  586  587  588  589  590  591  592  593  594  595  422  241   52
 189  374  551  720  721  722  723  724  725  726  727  728  729 1040  889  565  733  734  735  736  737  738  739  740  741  742  576 1054  578  746  747  748  750  751  910  752  753  754  755  756  757  758  759  760  761  596  423  242   53
 188  373  550  719  880  881  882  883  885 1036  886 1038  887 1041  888  732  892  893  894  895  896  897  898  899 1051  900  902  743  745  906 1057  907  749 1060  909 1061  911  913  914  915  916  917  918  919  762  597  424  243   54
 187  372  549  718  879 1032 1175 1033 1035 1314  884 1180 1037  890 1042  891 1043 1044 1045 1046 1047 1049 1192 1050 1194  901 1052 1053  903  904 1055 1058  908 1204 1062  912 1063 1064 1065 1066 1067 1068 1069  920  763  598  425  244   56
 186  371  548  717  877  878 1176 1034 1177 1560 1179 1181 1039 1182 1183 1185 1186 1187 1188 1327 1189 1190 1048 1193 1330 1196 1198 1332 1056 1200  905 1335 1462 1201 1205 1341 1342 1343 1469 1208 1210 1211 1070  921  764  599  245  426   57
 185  370  547  716 1031 1312 1029 1313 1441 1442 1317 1561 1445 1319 1447 1321 1184 1322 1326 1569 1454 1324 1453 1456 1195 1197 1686 1333 1334 1199 1581 1336 1059 1202 1203 1339 1340 1207 1209 1345 1346 1212 1071  922  600  601   55   58   59
 184  546  715  714  876 1173 1030 1558 1440 1673 1315 1778 1559 1316 1320 1674 1565 1323 1450 1325 1191 1452 1684 1329 1573 1574 1575 1458 1690 1578 1461 1463 1584 1338 1585 1206 1586 1468 1470 1344 1472 1213 1072  766  765  428  427  246  248
 183  369  545  713  875 1309 1174 1438 1439 1562 1443 1318 1444 1446 1449 1781 1567 1328 1451 1683 1572 1785 1681 1786 1331 1688 1577 1579 1689 1459 1464 1465 1583 1466 1697 1695 1467 1588 1589 1471 1347 1214  924  923  767  602  429  247   60
 182  368  544  874 1028  870 1024 1311 1171 1178 1774 1671 1872 1564 1677 1448 1879 1568 1881 1965 1679 1571 1685 1883 1885 1576 1789 1691 1460 1793 1692 1580 1795 1696 1337 1800 1587 1699 1590 1473 1348 1215 1073 1074  925  604  430  249   61
 181  367  712  873 1170 1026 1169 1776 1557 1172 1672 1563 1670 1676 1779 1963 1678 1878 1566 1968 1455 2050 1687 1787 1790 2048 2054 1976 1975 1693 1891 1582 1890 1694 1798 1698 1802 1700 1591 1474 1349 1216 1075  926  603  768  432  431  250
 180  366  543  711  871 1025 1307 1668 1437 1310 1871 1436 1675 1873 1962 1780 1783 1782 1882 1969 1784 1880 1886 1971 2051 1792 1457 1970 2120 1978 1977 1796 1893 1980 1799 1895 1894 1701 1592 1475 1350 1217 1076  927  769  605  251  252   62
 179  365  542  541  872 1306 1308 1027 1305 1435 1556 1775 1777 1960 1875 2041 2042 1876 2044 1680 1570 2116 1682 2118 2187 1788 1791 1974 2127 1888 2053 1892 2058 2059 1801 1804 1803 1593 1476 1351 1353 1077 1078  928  771  770  606  433   63
 539  362  540  707 1023  710 1166 1304 1434 1667 1555 1870 1958 1874 1961 1959 2176 1964 1877 2045 2047 2119 1884 2049 1972 2122 1973 2242 1794 1887 2055 2189 1797 1979 1981 1896 1702 1703 1594 1477 1218 1352 1079  929  772  607  434  253   64
 178  538  709  869  705 1168 1433 1432 1303 1554 1553 1772 1957 2112 2043 2038 2040 2113 2177 1966 2179 2046 2181 2355 2123 2121 2188 2125 2052 2245 2128 1889 2057 1982 1984 1983 1897 1706 1478 1597 1220 1219 1080  930  773  608  435  254   65
 177  364  536 1021  867 1017 1167 1165 1431 1666 1302 1869 2039 1868 2111 2036 2114 2232 2178 2115 2117 2235 2239 2237 2286 2287 2185 2184 2126 2130 2244 2056 2191 2190 1985 1705 1805 1479 1595 1354 1356 1221  931  932  774  609  436  255   66
 360  358  363  708  173 1022 1020 1019 1430 1551 1669 1771 1867 1956 2035 2037 2109 2175 2233 2282 2320 1967 2236 2183 2240 2124 2288 2243 2192 2291 2246 2132 2060 2129 1900 1899 1807 1901 1707 1704 1599 1355 1082 1081  775  610  437  256   67
 170  361  175  704  865  868  866 1164 1300 1665 1552 1773 1770 1769 1955 2174 2110 2231 2281 2279 2352 2182 2390 2285 2326 2241 2324 2289 2329 2247 2195 2194 2061 2131 1808 1987 1898 1903 1600 1596 1357 1222 1223  933  776  611  438  257   68
 535  531  176  359  174 1163 1301 1661 1162 1429 1664 1865 1866 1954 2034 2108 2230 2228 2229 2277 2321 2180 2238 2284 2325 2354 2290 2186 2330 2358 2292 2064 2193 2134 2062 1812 1809 1481 1709 1480 1224 1083  934  935  777  612  439  258   69
 706  355  533  356  537 1018  864 1299 1426 1427 1768 1550 1952 2107 1953 2172 2173 2171 2278 2280 2234 2323 2391 2353 2356 2381 2328 2327 2293    0 2249 1986 2063 1902 1904 1708 2065 1806 1483 1482 1358 1225 1084  936  778  613  440  259   70
 703  172  702  861  171 1160 1297 1864 1428 1298 1663 1546 1861 1862 1765 2033 2170 2283 2319 2351 2376 2375 2317 2377 2394 2379 2395 2359 2331 2248 2135 2066 2196 2133 1811 1712 1989 1710 1810 1359 1484 1226 1360 1085  779  615  442  260   71
 169  530  863  862  357 1296  534 1161 1549 1547 1659 1767 1766 1951 2104 2106 2032 2226 2318 2227 2350 2349 2357 2378 2393 2396 2360 2332 2333 2294 2250 2197 2137 2067 2136 1905 1598 1603 1711 1601 1485 1486 1086  937  938  780  614  261   72
 532  354  699  700 1015 1014 1295 1157 1425 1764 1662 1158 2031 2030 1548 2105 2169 2225 2316 2276 2274 2322 2399 2380 2384 2383 2382 2362 2296 2295 2251 2198 2068 1992 1990 1988 1906 1813 1602 1361 1228 1227 1087  781  444  617  441  262   73
 168  353  351  701  698  859 1293 1012 1420 1544 1763 1860 1424 1859 1947 2103 2168 2224 2275 2314 2372 2388 2398 2400 2389 2397 2361 2363 2334 2297 2252 2199 2070 1991 2069 1907 1814 1713 1604 1487 1362 1229 1088  939  616  782  443  263   74
 860  349  167  696 1013 1159 1016 1294  858 1545 1657 1950 1660 1948 2029 1858 2166 2167 2273 2346 2371 2370 2348 2373 2387 2386 2385 2364 2335 2298 2254 2253 2138 2139 1993 1908 1815 1714 1605 1488 1363 1230 1089  940  783  618  445  264   75
 350  694  348  697 1156 1009 1423 1292 1658 1656 1761 1863 1762 1857 1949 2102 2099 2223 2272 2347 2315 2392 2312 2369 2368 2367 2366 2365 2336 2299 2201 2140 2200 2071 1994 1909 1816 1715 1606 1489 1364 1231 1090  941  784  619  446  265   76
 166  529  528  526  857 1011 1154 1291 1542 1543 1655 1760 1855 1856 2028 2101 1946 2222 2271 2345 2374 2313 2343 2342 2341 2340 2339 2338 2337 2300 2255 2202 2141 2072 1995 1910 1817 1716 1607 1490 1365 1232 1091  942  785  620  447  266   77
 164  352  524  695 1155 1152  692 1421  855 1419 1654 1759 2027 1944 2165 2100 2221 2270 2311 2310 2267 2344 2308 2307 2306 2305 2304 2303 2302 2301 2256 2203 2142 2073 1996 1911 1818 1717 1608 1491 1366 1233 1092  943  786  621  448  267   78
 165  523  163  527 1007 1010 1541 1422 1287 1540 1539 1758 1854 2026 2024 2098 2164 2220 2269 2268 2215 2309 2265 2264 2263 2262 2261 2260 2259 2258 2257 2204 2143 2074 1997 1912 1819 1718 1609 1492 1367 1234 1093  944  787  622  449  268   79
 346 1151  162  160  693  856 1538 1005 1289 1652 1653 2025 1756 1943 2162 1945 2163 2219 2218 2217 2266 2156 2214 2213 2212 2211 2210 2209 2208 2207 2206 2205 2144 2075 1998 1913 1820 1719 1610 1493 1368 1235 1094  945  788  623  450  269   80
 161  525  345  854  852  853 1290 1153 1416 1417 1651 1757 1853 1942 2023 2097 2161 2160 2092 2090 2216 2159 2157 2155 2153 2152 2151 2150 2149 2148 2147 2146 2145 2076 1999 1914 1821 1720 1611 1494 1369 1236 1095  946  789  624  451  270   81
 521  522  159  690  851 1008 1418 1147 1150 1537 1650 1755 1852 1941 2022 2094 2093 2096 2091 2016 2089 2088 2087 2154 2086 2085 2084 2083 2082 2081 2080 2079 2078 2077 2000 1915 1822 1721 1612 1495 1370 1237 1096  947  790  625  452  271   82
 347  344  343  688 1004 1006 1285 1148 1288 1536 1754 1752 1851 1940 2020 2095 2019 2018 2017 2015 2158 2014 2013 2012 2011 2010 2009 2008 2007 2006 2005 2004 2003 2002 2001 1916 1823 1722 1613 1496 1371 1238 1097  948  791  626  453  272   83
 156  157  520  691  689 1149 1286 1414 1648 1646 1649 1850 1939 1938 2021 1937 1936 1935 1934 1933 1932 1931 1930 1929 1928 1927 1926 1925 1924 1923 1922 1921 1920 1919 1918 1917 1824 1723 1614 1497 1372 1239 1098  949  792  627  454  273   84
 158  518 1000  519  687 1003 1284 1415 1532 1645 1753 1647 1849 1848 1847 1846 1845 1844 1843 1842 1841 1840 1839 1838 1837 1836 1835 1834 1833 1832 1831 1830 1829 1828 1827 1826 1825 1724 1615 1498 1373 1240 1099  950  793  628  455  274   85
 342  517  339  850  847 1146 1411 1413 1409 1412 1534 1751 1750 1749 1748 1747 1746 1745 1744 1743 1742 1741 1740 1739 1738 1737 1736 1735 1734 1733 1732 1731 1730 1729 1728 1727 1726 1725 1616 1499 1374 1241 1100  951  794  629  456  275   86
 516  341  685  848  686  849 1281 1001 1535 1533 1275 1644 1643 1642 1641 1640 1639 1638 1637 1636 1635 1634 1633 1632 1631 1630 1629 1628 1627 1626 1625 1624 1623 1622 1621 1620 1619 1618 1617 1500 1375 1242 1101  952  795  630  457  276   87
 155  154  340  846  845 1002 1143 1140 1283 1531 1529 1406 1528 1527 1526 1525 1524 1523 1522 1521 1520 1519 1518 1517 1516 1515 1514 1513 1512 1511 1510 1509 1508 1507 1506 1505 1504 1503 1502 1501 1376 1243 1102  953  796  631  458  277   88
 338  153  515  684  997 1279 1282 1410 1407 1408 1530 1137 1405 1404 1403 1402 1401 1400 1399 1398 1397 1396 1395 1394 1393 1392 1391 1390 1389 1388 1387 1386 1385 1384 1383 1382 1381 1380 1379 1378 1377 1244 1103  954  797  632  459  278   89
 512  152  513  514 1280  998 1278  999 1144 1277 1276 1274 1273 1134 1272 1271 1270 1269 1268 1267 1266 1265 1264 1263 1262 1261 1260 1259 1258 1257 1256 1255 1254 1253 1252 1251 1250 1249 1248 1247 1246 1245 1104  955  798  633  460  279   90
 151  337  336  683  996 1145  993 1139  501  837 1138 1135  988  987 1133 1132 1131 1130 1129 1128 1127 1126 1125 1124 1123 1122 1121 1120 1119 1118 1117 1116 1115 1114 1113 1112 1111 1110 1109 1108 1107 1106 1105  956  799  634  461  280   91
 150  335  681  682  842 1141 1142  839  838  676  992 1136  833  832  986  829  985  983  982  981  980  979  977  976  658  975  974  973  972  971  970  969  968  967  966  965  964  963  962  961  960  959  958  957  800  635  462  281   92
 333  148  334  149  678  844  994  675  674  990  991  989  671  669  831  984  666  826  494  825  313  824  660  978  822  821  820  819  818  817  816  814  813  812  811  810  809  808  807  806  805  804  803  802  801  636  463  282   93
 147  510  841  511  840  680  843  677  673  836  834  670  499  668  830  317  665  493  663  828  661  823  492  659  486  657  656  655  654  653  815  651  650  649  648  647  646  645  644  643  642  641  640  639  638  637  464  283   94
 509  146  330  679  508  507  995  504  136  503  502  835  672  319  667  320  495  314  127  664  662  310  309  487  308  485  484  305  483  482  652  480  479  478  477  476  475  474  473  472  471  470  469  468  467  466  465  284   95
 332  143  329  142  506  139  505  325  326  323  500  322  132  134  497  496  498  827  316  128  488  123  489  122  124  307  306  118  304  302  481  301  300  299  298  297  296  295  294  293  292  291  290  289  288  287  286  285   96
 145  331  144  141  328  327  140  138  137  324  135  321  131  133  318  130  129  315  125  491  126  311  490  312  121  120  119  117  116  303  115  114  113  112  111  110  109  108  107  106  105  104  103  102  101  100   99   98   97
