# This puzzle is unsolvable
30
  2   1 118   0   3   4   5   7 330 124   9  14 231 127 129  16  18 132 240  19 343 244 137 138  22 140 346  28  31 250
117 114 225 119 120 121 228   8 232 331  10 426  13 332  15 334 131 239  17 135 243 342  20  21  27 144  26 147 145  29
116 324 115 226 227 230   6 421 229 329 125 425 128 130 235 238 337 134 431 341 246 148  23  25 139 247 143 141  32 146
113 224 326 415 416 328 123 233 327  11  12 333 424 336 234 512 428 429 340 241 433 242  24 517 249 344 142 438  30 435
223 323 325 221 413 575 503 417 122 126 506 423 504 237 335 236 510 338 430 513 591 136 658 245 593 345 352 253 347 251
222 220 322 500 321 498 419 644 577 505 422 649 507 585 586 511 339 713 133 432 588 516 518 434 348 248  35 254 349  34
112 219 320 497 414 576 420 502 580 646 582 581 508 708 652 710 653 427 587 589 656 521 596 350 441 436  33 519 440  36
111 319 110 411 496 418 501 706 579 804 704 650 509 584 760 765 654 590 515 592 514 439 594 718 597 595 437 522 151 255
109 108 218 492 495 705 412 645 641 648 837 800 761 651 764 712 715 655 657 717 720 354 769 524 598 259 355 150 252 353
107 216 217 317 494 574 578 642 499 647 707 801 709 762 766 808 806 843 659 662 810 719 661 525 520 443 351 149  39 155
214 215 410 318 409 643 700 570 583 756 703 836 758 711 803 807 842 767 714 844 809 716 599 446 442 523 526 445  37  38
106 493 316 315 314 572 701 757 754 759 753 799 802 805 841 870 888 724 811 812 721 660 768 663 601 152 256 257 258 153
104 313 406 571 755 702 408 573 834 835 838 839 867 866 872 840 845 869 667 763 771 723 602 356 262  41 444  40 154 260
402 105 102 490 407 637 699 639 752 798 884 864 865 896 885 898 849 772 722 871 773 668 600 665 666 664 261  45  48  43
213 209 310 210 638 491 697 640 863 751 795 861 797 878 895 868 846 873 815 725 770 775 774 527 528 447 362 448 157 358
212 404 311 566 312 405 569 696 698 750 859 860 883 890 886 856 847 848 817 813 816 874 669 530 361  42 263 158 265 159
103 208 101 488 207 636 635 793 833 749 792 862 881 894 832 877 889 875 887 850 726 814 604 357 603 364 156 531  44 359
 98 100 567 489 486 565 568 748 790 829 827 882 897 893 899 825 822 891 852 736 776 727 670 360 160 264 532 529  46 449
401 308 398 562 487 694 695 747 745 796 831 830 858 854 876 879 880 821 777 606 607 728 533 729 451 453 450 365 266  47
403 307  99 211 563 746 484 631 794 789 791 828 857 783 824 823 784 820 818 851 778 605 671 534 163 455 452  49 162 270
205  95 305  97 309 634 561 692 743 687 788 740 620 826 892 853 855 738 782 819 673 543 672 535 536 166 366 269  50 363
 96 206 204 481 690 632 564 633 627 691 744 685 741 681 785 683 619 615 735 618 781 779 730 610 731 271 268 267 164 454
304 306 400 485 559 630 689 688 693 625 686 787 624 786 549 737 547 684 734 679 780 674 733 539 456 609 367 161 165  51
203 303 395 560 399 483 556 629 478 623 386 742 551 622 682 621 545 678 468 612 732 614 676 675 538 369 370 274  52 273
 94 397 301 479 557 555 477 389 626 553 474 475 739 546 383 471 680 617 616 465 677 463 608 541 458 537 457 272  53 167
202 201 302 396 480 482 558 390 388 554 476 291 385 472 469 287 381 467 464 377 462 542 611 374 540 461 169 368  55  56
 93  92 198 394 300 392 298 294 628 292 552 387 384 382 470 288 182 286 466 284 283 613 177 375 373 173 459 275  54 168
 91 199 299 195 393 296 391 192 193 190 290 473 187 548  73 185 184 285 544 281 282 376 176 279 460 371  63  62 170 171
200  90  87  88  86 297 194 191 295  79 189 188 289 550 183 181  72 380  70 280 178 379  66 277 278 174 372 172 276  58
 89 197  85  84  83 196  82 293  81  80  78  77 186  76  75  74  71  69 180 378 179  68  67 175  65  64  61  60  59  57
