# This puzzle is unsolvable
37
 144  145    5    3    7  150  530   10  154  414  288   11  155  160  158  293   16   19  162   20  163   22  167   23   25   26   27   28   29   31  308   32   33   35  176   40   36
 143    1    2  146    6  285  148  284  151  153  536  157   13  418  538  294   18   17  297  164  299   21  165   24  168  169  170  171  307  435   30  173  438  175  178   37  179
 141  528  280  281  147  286    8  643  411  289   12   15  159  415  540  292  161  541  296  298  545  300  166  302  303  304  305  306  172  309  436  310   34  313  314  312   41
 407  408  142    4  639  277  149  840  642  152  416  291  290   14  652  422  295  424  656  426  427  428  301  429  430  431  432  433  434  555  174  437  177  311  181   39   38
 279  409  405  410  641  412    9  644  287  413  844  533  648  420  650  421  543  423  653  425  546  547  548  659  549  550  551  552  665  666  667  557  439  441  315  316  182
 278  282  138  529  283  527  744  747  647  645  417  535  754  752  848  651  757  938  542  544  655  658  761  762  660  661  662  663  860  553  554  769  558  440  317  180   44
 406  140  745  404  531  743  532  929  534  751  748  646  933  539  846  850  649  758  853  854  657  759  943  760  945  858  764  765 1028  664  668  556  559  442  183  318   42
 274  275  139  640  839  524  746  742  841  843  156  537  419  755  937 1015  753  851  654  941 1022 1093  944  859 1024 1027 1025  949  766  863  768  669  560  443  184   45   43
 276  137  523  525  638  836  526  928  749 1010 1145  934 1079  842  936  847 1084  756  855 1019  940 1154  856  857 1096 1159  862 1029  671  771  864  770  670  320  444  185  187
 272  136  403  402  637    0  741  845 1144  838 1009  931  750 1147 1088 1081 1017  852 1016 1021 1018 1020 1091 1157  942  946 1023  763  767  948  562  561  445  319  446   46  186
 135  273  401  522  636  635  740  927 1008  837 1007 1012 1247  935 1082 1014  849 1090 1257 1089  939 1095 1026 1155 1161  947  954 1213  861  950  672  774  564  563  321  188   47
 134  271  634  632  519  924  926  925  930 1011 1013 1085 1146 1201 1150 1253 1086 1205 1251 1207 1152 1092 1094 1211 1156 1097 1098  951  952  865  772  953  773  323  673  189   48
 133  270  400  520  633  739 1080 1077 1143 1006 1078 1087 1199  932 1289 1203 1293 1148 1206 1151 1209 1296 1210 1260 1212 1158 1214  867 1031  868 1030  565  448  447  322  190   49
 132  269  399  631  521  920  737  738  834 1200 1141 1004 1319 1149 1202 1362 1346 1204 1153 1327 1294 1256 1258 1215 1259 1100 1160 1099  955  869  449  866  677  567  191  192   50
 268  397  398  736  518  833  630  922 1003  923 1249 1139 1140 1142 1290 1083 1344 1291 1255 1292 1295 1349 1297 1261 1162 1217 1101 1032  870  871  775  776  674  676  566  324   51
 131  517  396  129  835  735  734  832  918 1073 1248 1138 1246 1197 1286 1287 1252 1322 1254 1323 1350 1328 1326 1216 1103 1102 1164 1033  956  777  568  675  569  326  325  193   52
 130  267  628  629  395  733  830 1005  917  921 1196 1076 1285 1243 1245 1250 1321 1345 1348 1208 1330 1329 1298 1299 1262 1165 1163 1034  957  872  778  452  570  450  328  194   53
 127  394  266  391  514  627 1075 1001  919 1288 1002  999 1195 1244 1320 1343 1360 1342 1347 1324 1361 1325 1300 1263 1218 1104 1105 1035  958  873  779  678  451  327  453   55   54
 263  126  515  730  731  516  625 1072 1000 1074 1071 1198 1194 1242 1317 1367 1318 1363 1358 1368 1366 1351 1301 1264 1219 1166 1036 1037  959  781  780  679  571  454  329  195  196
 393  262  260  264  512  732  623  831  916 1136 1137 1241 1193 1282 1284 1338 1341 1355 1354 1364 1352 1331 1302 1265 1220 1167 1106  960  875  874  782  680  572  455  330  198   56
 265  128  626  513  510  728  829  997  996 1070 1135 1192 1283 1315 1316 1340 1356 1359 1336 1335 1308 1353 1303 1266 1221 1168 1107 1038  961  876  784  681  682  456  573  457  197
 389  123  622  392  828  826  915  995  998 1069 1134 1191 1240 1280 1281 1357 1312 1337 1273 1272 1332 1333 1304 1267 1222 1169 1108 1039  962  877  574  683  575  333   57  199   58
 125  261  511  824  823  827  994  624  825 1133 1132 1190 1239 1314 1234 1339 1233 1365 1275 1310 1334 1271 1305 1268 1223 1170 1109 1040  963  879  878  785  684  458  200  331   59
 257  124  390  387  505  729  727  914 1067 1068 1189 1238 1237 1236 1279 1313 1277 1181 1311 1230 1307 1228 1270 1269 1224 1171 1110 1041  964  786  686  783  576  459  334  332   60
 258  259  122  388  509  619  725  822  993 1066 1131 1188 1187 1185 1278 1183 1123 1276 1178 1274 1227 1306 1176 1226 1225 1111 1173 1042  965  880  787  685  577  460  335  201  202
 386  121  621  913  508  726  620  912  910  911  992 1065 1130 1186 1235 1184 1182 1232 1309 1180 1229 1051 1177 1175 1174 1172 1043  966  969 1045  881  788  578  461  336   63   61
 120  118  506  119  618  385  821  991  990 1064 1129 1128 1127 1059 1126 1125 1122 1179 1231 1120 1050 1119 1118 1116 1115 1114 1112 1046  882  688  789  687  581  579  337   62  203
 255  117  384  507  722  724  909  989  906  904 1063 1061 1060  986  983 1058 1121  981 1054 1053 1052  978 1117 1049 1048 1047 1113  885 1044  883  695  580  463  338  462  204   64
 253  383  617  254  381  502  815  717  988 1062  903  811  985 1057  982 1124 1056  897 1055  979  977  976  975  974  973  972  971  887  888  884  694  790  464  339  206  205   66
 116  616  820  504  721  720  818  908  907  715  813  987  901  604  900  899  980  806  805  894  891  802  892  890  889  800  799  967  794  968  690  689  582  340   65  207  208
 115  382  252  723  500  615  819  610  611  716  809  491  369  810  808  807  898  895  896  706  893  804  703  801  798  699  797  970  692  791  792  691  583  465  341   67   68
 114  379  503  256  501  719  494  714  816  490  902  489  710  984  711  709  708  707  599  597  481  803  701  704  700  698  796  696  886  793  588  693  584  466  342  209   69
 250  249  251  499  380  614  613  718  608  609  905  814  713  603  488  602  601  485  598  702  482  594  592  478  593  697  795  591  474  589  587  586  585  467  468  343  210
 113  248  378  498  497  817  375  372  371  368  492  605  606  235  712  487  363  600  484  483  705  596  227  595  480  479  590  477  475  473  472  471  470  469  344  211   70
 112  111  246  376  612  496  495  370  239  493  607  812  366  367  365  364  232  486   92  361  230  357   87  224  355  354  353  476  351  350  349  348  347  346  345  212   71
 110  377  247  245  374  243  242  105  373  237  100  238  236   96  234  233   91   93  359  360  362  228  358  356   85  222  221  352  220  219  218  217  216  215  214  213   72
 109  108  107  106  104  244  241  102   99  240  103  101   98   97   95   94  231   90   89   88  229  226  225   86   84  223   83   82   81   80   79   78   77   76   75   74   73
