# This puzzle is unsolvable
34
 133    2    3    4  373  137  261  136    7  262   10  266  142  144   15   13  145  146   18  151   24   23  155  278   26  157   27   28   29   30   31   32   33   34
   1  258  134  135    8  139    5  265    6  140    9   12   11   14  491  270  149  273   19   17  276   22  153  277  156   25  158  159  160  161  162  163   36  164
 131  132  371  374  376  263  138  485  676  379  380  147  384  267  268  269  387  274  388  150  154   21  599  393  392  280  281  282  283  284  285  165  166   35
 130  256  478  255  259  260  482  484  377  264  143  487  386  492  271  385  148   16  275  495   20  390  498  152  501  395  397  398  505  604  401  400  167   37
 252  257  372  582  479  483  583  141  757  382  381  488  490  589  681  590  594  497  391  597  389  394  688  279  502  775  692  503  399  603  286  287  289   38
 253  128  581  375  481  480  378  760  584  677  761  679  586  587  383  593  494  767  496  686  272  499  690  500  774  600  506  601  508  606  507  170  288   39
 254  251  580  671  575  477  675  672  759  585  489  762  756  680  683  765  493  684  685  770  771  689  772  691  694  396  778  602  504  605  291  402   40  510
 129  370  250  577  579  830  674  673  755  902  758  486  837  764  682  592  768  766  687  596  595  848  769  773  776  695  852  850  404  509   41  403  292   42
 368  249  369  367  576  475  669  833  588  829  678  836  903  838  763  591  909  841  845  912  846  847  914  915  916  693  851  607  608  174  290  168  406  169
 127  125  366  476  668  670  753  666  900  752  962  961 1015  839  966  840  908  842  969  910  911  598 1021  974  918  779  849  696  511  611  171  172  175  293
 126  248  122  121  474  578  831  754 1011  960  835  959  906  904  907  967  965  968 1018  843  844 1066  973  920  913  609  777  697  295  405  297  173   44  407
 124  365  362  574  473  899  665  897  898  901  834  963  905  964 1017 1016 1062 1020 1099  970  972 1064  856  781  853  854  783  700  701  512   43  513  177  298
 123  246  364  751  750  573  247  827  896  958  832 1056 1014 1058 1059 1060 1096 1061 1100  971 1019  978  975  977  917  782  855  780  299  296  409   45   46  408
 245  363  470  572  667  471  664  570  956  828 1092 1013 1119 1054 1093 1094 1122 1098 1126 1065 1023 1027 1022  919  921  699  784  514  610  612  613  178  517  176
 119  361  120  472  571  468  749  895  957 1055 1010 1012 1091 1120 1121 1095 1125 1063 1127 1097 1068 1026 1024  976 1025  857  859  703  698   47  294   48  411  412
 118  244  569  568  469  359  825  826  894  955 1053 1057 1090 1124 1089 1142 1147 1145 1146 1101 1102  983 1028 1069  979 1029 1067  702  515  614  413  302  300  410
 117  243  242  467  661  747  663  824  892  953 1008 1009 1051 1052 1140 1141 1123 1143 1154 1128 1144 1105  981  922  980  858  786  704  616  519  301   50   49   52
 116  240  360  358  662  746  748  823 1007  893 1005  954 1117 1115 1118 1139 1153 1155 1131 1129 1032 1130 1071  982 1073 1030  785  617  705  516  414  179  181  180
 115  357  241  466  567  660  745  822  891  951  952 1006 1050 1088 1116 1138 1151 1111 1132 1134 1110 1104 1103 1031 1033  860  707  615  518  415  520   51   53   54
 114  239  356  465  566  659  744  821  889  890 1004 1049 1087 1085 1136 1135 1149 1109 1072 1078 1070  984 1107 1074  928  925  861  924  618  521  304  303  183  182
 113  238  355  464  658  741  743  820  950  949 1003 1048 1086 1084 1082 1152 1148 1112 1077 1133  990 1076  923  930  789  926  787    0  416  790  417  418  184   55
 112  354  353  463  564  565  657  819  888  948 1002 1047 1114 1083 1081  996 1137 1080 1079 1108 1037  988 1075  986  985  927  622  706  863  305  708  187  522   56
 236  237  462  563  656  740  742  818  887  947 1001 1046  942  995 1113 1041 1150 1040  936 1038 1034  934 1106  931 1035  791  525  619  710  625  306  524  709  523
 111  110  234  461  562  655  817  886  946  885 1000  999  941  994  998 1042  877 1039  874  992 1036  932  871  865  792  788  711  864  528  620  529  420  186   57
 233  235  352  460  560  561  654  815  739  816  945  943  940 1045 1044  876  939  993  800  873  989  870  987  868  866  862  718  929  421  623  621  310  314   61
 109  350  351  459  653  738  814  884  813  883  882  997 1043  879  878  806  875  938  801  933  937  991  872  867  713  527  795  794  624  190  423  419  185  307
 108  232  349  559  651  652  736  737  734  811  732  880  944  808  807  640  639  805  804  802  637  634  721  799  869  796  628  716  714  626  191  712   62  422
 107  230  231  348  458  558  649  735  733  551  812  810  809  730  728  442  727  803  635  636  724  723  536  798  720  719  534  526  715  188  309   60   59   63
 106  105  347  557  457  554  555  648  647  646  644  881  443  729  547  642  641  638  726  722  539  633  935  717  630  793  797  431  424  531   58  189  308   64
 104  346  455  456  556  650  451  553  552  337  550  731  445  643  329  725  544  546  330  540  325  434  541  632  436  629  202  428  532  425  627  530  317   66
 103  229  228  454  223  453  339  342  450  219  446  645  548  334  333   84  441   87  543  438  439  538  631  324  433  535  197  203   68  312  316   67  193  195
 102  227  345  344  343  452  341  220  448  449  447  549  444   85  331  332  213   83  542  327  208  207  326  537  322  430  429   73  198  533  426  196  194  192
 101  226  225  224  222  221  340   93  338  215  336   90   88  210   86  212  545   81  440  205  437  204   76  435  432  323  320  318  319   71  313   69   65  315
 100   99   98   97   96   95   94   92   91  217   89  218  335  214  211  216   82  209  328   80   79  206   77   78   75   74  201  321   72  199  427  311   70  200
