# This puzzle is unsolvable
42
   2    3  165    4    5  169  170    9  173  174  329   11   12  333   16  179   17  182  181   19   20   21   22   24   25   26   27   28   29   30   31   32   33   34   35   36   37   38   39   40   41   42
 164    1  166  609    6  168  172    8    7  171  475  175  331   13   15  332  335   18  337  183  184  185   23  188  189  344  191  347  346  193  194  195  196  197  198  199  200  201  202  203  204   43
 161  163  608  167  469  323  325  326   10  476  328  330   14  176  177  178  334  336  180  338  339  340  186  187  342  345  491  190  494  348  349  350  351  352  353  354  355  356  357  358  205   44
 157  322  319  738  470  324  471  473  327  614  477  478  617  479  481  482  622  621  484  485  486  487  341  489  343  762  192  631  492  495  496  497  498  499  500  501  502  503  504  359  206   45
 467  466  162  317  610  472  743  615  867  745  746  616  618  619  480  620  753  876  623  624  625  757  626  628  629  490  761  493  632  633  635  636  637  638  639  640  641  642  505  360  207   46
 318  465  321  740  320  611  744  613  866  747  869  748  871  749  750  751  483  754  877  755  756  881  758  882  759  763  630  764  765  634  766  767  768  769  770  771  772  643  506  361  208   47
 315  159  607  316  606  980  612  865  742  474  982  870  986  872  873  874  752  875  878  993  879  880  627  488  760  883  884  886  887  888  889  890  891  892  893  894  773  644  507  362  209   48
 156  158  468  739  741  981 1087 1187  979  868 1092  983 1281  987  988  989  990  991  992 1100  994  996  997 1104  998  999  885 1000 1001 1002 1004 1005 1006 1007 1008  895  774  645  508  363  210   49
 604  160  603  602  863  864  605  737  862 1090 1189 1093  985 1094 1095 1096 1097 1098 1099 1101 1102  995 1103 1203 1205 1106 1206 1107 1109 1003 1111 1112 1113 1114 1009  896  775  646  509  364  211   50
 314  461  462  463  736  860  977 1282  861 1088 1280 1091 1192 1193 1194 1195 1196 1197 1198 1199 1200 1201 1294 1293 1105 1204 1108 1208 1209 1110 1210 1211 1212 1115 1010  897  776  647  510  365  212   51
 154  313  310  600  464  460  735 1085 1089 1186 1190 1191 1283 1284 1285 1286 1287 1288 1289 1373 1290 1291 1375 1202 1296 1379 1456 1207 1381 1299 1301 1302 1214 1213 1116  898  777  648  511  366  213   52
 311  458  309  459 1086  976  978 1084 1188 1278  984 1365 1366 1367 1368 1444 1369 1370 1372 1448 1374 1376 1292 1295 1378 1454 1297 1457 1298 1382 1384 1303 1118 1117 1011  899  778  649  512  367  214   53
 153  152  312  734  859  733  975 1184 1083 1364 1277 1440 1441 1442 1443 1511 1371 1513 1446 1515 1516 1449 1451 1377 1453 1520 1580 1455 1524 1300 1383 1215 1216 1013 1012  900  779  650  513  368  215   54
 155  601  732  731  599  858  857  974 1185 1363 1279 1439 1508 1509 1510 1571 1445 1572 1447 1575 1626 1518 1450 1452 1519 1579 1380 1525 1459 1305 1385 1458 1304 1119 1014  901  780  651  514  369  216   55
 151  308  457  597  598  856  973 1082 1183 1276 1362 1438 1507 1568 1569 1512 1570 1514 1624 1574 1627 1517 1577 1578 1630 1582 1521 1523 1526 1460 1386 1306 1217 1121 1120  902  781  652  515  370  217   56
 150  307  306  596  730  855  972 1081 1182 1275 1361 1437 1506 1567 1620 1621 1622 1623 1667 1625 1573 1576 1628 1629 1581 1631 1522 1632 1583 1461 1387 1388 1307 1219 1015 1016  903  653  516  371  218   57
 148  304  454  595  728 1181  853 1080 1274 1359 1360 1436 1505 1566 1619 1664 1665 1666 1668 1730 1669 1670 1671 1672 1673 1674 1633 1584 1527 1462 1389 1308 1122 1218 1017  904  782  654  517  372  219   58
 305  453  456  149  854  729  970  971 1079 1273 1358 1435 1504 1565 1618 1663 1700 1728 1701 1702 1703 1705 1706 1707 1708 1675 1634 1585 1528 1463 1390 1309 1220 1123 1018  905  783  655  518  373  220   59
 146  147  455  594  593  727  852  969 1180 1272 1357 1434 1503 1564 1616 1617 1698 1729 1747 1749 1704 1731 1732 1734 1709 1676 1635 1586 1529 1464 1391 1310 1221 1019  907  785  784  656  519  374  221   60
 303  145  452  592  726  851  968 1078 1179 1271 1356 1433 1501 1502 1563 1662 1660 1727 1699 1748 1750 1751 1733 1753 1735 1677 1636 1587 1530 1465 1392 1311 1125 1124 1021 1020  906  657  520  375  222   61
 144  300  302  451  725  850 1076 1077 1178 1270 1355 1432 1562 1561 1615 1659 1661 1724 1726 1761 1757 1738 1752 1754 1710 1711 1637 1588 1532 1531 1393 1312 1222 1223  908  909  786  658  521  376  223   62
 301  298  450  591  724  966  967 1176 1177 1269 1353 1354 1431 1500 1614 1657 1696 1697 1760 1746 1756 1755 1762 1736 1678 1680 1638 1589 1533 1466 1394 1313 1224 1126 1022  910  787  659  522  377  224   63
 299  143  590  589  723  849  848 1075 1175 1173 1268 1430 1499 1611 1558 1612 1613 1658 1725 1759 1758 1742 1737 1714 1679 1639 1640 1590 1467 1468 1395 1314 1225 1127 1023  789  788  660  523  378  225   64
 141  447  588  721  722  847  965  964 1174 1267 1351 1352 1560 1496 1498 1692 1722 1721 1743 1741 1720 1763 1717 1712 1715 1681 1591 1534 1470 1469 1315 1226 1227 1128 1129  911  790  661  524  379  226   65
 140  142  587  448  846 1172  845 1074 1071 1427 1350 1559 1656 1429 1655 1695 1745 1744 1693 1719 1688 1718 1739 1740 1645 1684 1682 1535 1536 1397 1396 1316 1229 1131 1024  912  791  662  525  380  227   66
 138  296  139  449  720  962 1171 1073 1072 1264 1266 1495 1557 1497 1609 1694 1691 1689 1723 1690 1649 1687 1685 1683 1713 1642 1592 1471 1399 1472 1398 1317 1228 1025 1130  913  792  663  526  381  228   67
 295  297  445  446  719  963  844  961 1070 1265 1426 1428 1425 1556 1555 1610 1653 1652 1651 1650 1648 1647 1686 1646 1641 1596 1643 1593 1537 1400 1473 1319 1318 1027 1026  914  793  664  527  382  229   68
 444  294  584  586  718  960 1069  959 1169 1170 1349 1493 1494 1608 1607 1654 1551 1605 1604 1484 1602 1412 1600 1544 1644 1598 1541 1716 1474 1403 1540 1320 1230 1132 1028  915  794  665  528  383  230   69
 137  136  293  585  841  843  840  583 1067 1423 1263 1342 1424 1554 1420 1418 1548 1490 1603 1552 1411 1601 1599 1482 1597 1542 1478 1594 1538 1405 1402 1401 1321 1133 1134 1029  916  795  529  384  231   70
 443  291  292  440  441  716  842 1262 1261 1345 1347 1259 1553 1348 1491 1417 1489 1606 1335 1337 1488 1483 1481 1543 1409 1480 1479 1539 1595 1325 1322 1404 1232 1135 1136  917  796  666  667  386  232   71
 134  135  580  582  957  956  717 1168  958 1346 1166 1257 1338 1550 1343 1487 1415 1251 1414 1486 1549 1332 1546 1410 1408 1407 1328 1326 1477 1475 1238 1231 1234 1031 1233  918  797  668  385  530  233   72
 714  579  839  437  954  952 1066 1260 1068 1167  829 1256 1157 1492 1158 1339 1250 1416 1248 1153 1485 1547 1245 1330 1329 1147 1241 1406 1327 1239 1476 1137 1324 1030 1032 1033  798  669  531  532  234   73
 132  439  713  290  581 1064  953 1258 1165 1255 1161 1421 1162 1156 1253 1419 1154 1155 1053 1545 1334 1331 1333 1243 1150 1044 1146 1240 1041 1143 1141 1237 1140  919  920  799  800  670  533  387  235   74
 289  133  442  715  838 1164  948  703 1063 1341 1059 1344 1340 1058 1252 1050 1054 1052 1249 1413 1151 1247 1046 1149 1242 1042 1148 1145 1144 1039 1040 1323 1139 1138 1034  921  801  671  534  388  236   75
 130  288  711  287  955  836  837  835  832 1065  425  944 1254 1422 1056 1055  820  940 1336  943  691 1246 1047 1244  686  817  815  931  930 1142 1235 1236 1037 1036 1035  922  802  672  536  389  237   76
 436  576  131  438  834  712  710 1163  951 1057  950  946 1159  701  695  945  824 1049 1051 1048  822  415 1045  554  935 1043  812  814  684  929  810  927  926  680  924  806  923  673  537  535  239  238
 286  127  129  578  705  577 1062 1061  704  949  830  426  827  420  694  823  697  825 1152  821  938  693  937  936  690  934  813  932  811  928 1038  808  677  807  804  925  803  675  391  390  392   77
 435  433  575  284  275  573  709  429  568  570 1160  700  698  826  269  561  696  939  941  942  818  819  816  692  552  551  933  256  255  809  683  682  681  543   92  679  674  538  539  393  240   78
 282  128  434  118  431  124  571  116  572  947  424  427  702  422  270  563  264  559  560  556  267  416  262  413  553  410  687  685  405  254  252  545  544   90  678  805  541  396   85  397   80   79
 283  280  708  123  430  279  122  707  833  566  828  564  565 1060  421  110  108  558  107  265  100  104  555  412  688  258  257  253  407  548  406  546  401  542  399  398  676  395  394  245   83  241
 126  121  432  831  277  574  281  119  423  567  273  271  111  699  109  112  266  414  418  260  557  689  103  408  411  550   97  259  547   96  404  402  249   89  400  246   87  540  244    0  242   81
 285  125  278  276  117  120  114  569  428  274  706  115  272  113  268  562  419  106  417  105  263  261  102   99  101  549  409   98   94   95  403   91  251  250  247   93  248   88   86   84   82  243
