# This puzzle is unsolvable
74
   2    1    3    4    5    6    7    8    9   10   11   12   13   14   15   16   17   18   19   20   21   22   23   24   25   26   27   28   29   30   31   32   33   34   35   36   37   38   39   40   41   42   43   44   45   46   47   48   49   50   51   52   53   54   55   56   57   58   59   60   61   62   63   64   65   66   67   68   69   70   71   72   73   74
 292  293  294  295  296  297  298  299  300  301  302  303  304  305  306  307  308  309  310  311  312  313  314  315  316  317  318  319  320  321  322  323  324  325  326  327  328  329  330  331  332  333  334  335  336  337  338  339  340  341  342  343  344  345  346  347  348  349  350  351  352  353  354  355  356  357  358  359  360  361  362  363  364   75
 291  576  577  578  579  580  581  582  583  584  585  586  587  588  589  590  591  592  593  594  595  596  597  598  599  600  601  602  603  604  605  606  607  608  609  610  611  612  613  614  615  616  617  618  619  620  621  622  623  624  625  626  627  628  629  630  631  632  633  634  635  636  637  638  639  640  641  642  643  644  645  646  365   76
 290  575  852  853  854  855  856  857  858  859  860  861  862  863  864  865  866  867  868  869  870  871  872  873  874  875  876  877  878  879  880  881  882  883  884  885  886  887  888  889  890  891  892  893  894  895  896  897  898  899  900  901  902  903  904  905  906  907  908  909  910  911  912  913  914  915  916  917  918  919  920  647  366   77
 289  574  851 1120 1121 1122 1123 1124 1125 1126 1127 1128 1129 1130 1131 1132 1133 1134 1135 1136 1137 1138 1139 1140 1141 1142 1143 1144 1145 1146 1147 1148 1149 1150 1151 1152 1153 1154 1155 1156 1157 1158 1159 1160 1161 1162 1163 1164 1165 1166 1167 1168 1169 1170 1171 1172 1173 1174 1175 1176 1177 1178 1179 1180 1181 1182 1183 1184 1185 1186  921  648  367   78
 288  573  850 1119 1380 1381 1382 1383 1384 1385 1386 1387 1388 1389 1390 1391 1392 1393 1394 1395 1396 1397 1398 1399 1400 1401 1402 1403 1404 1405 1406 1407 1408 1409 1410 1411 1412 1413 1414 1415 1416 1417 1418 1419 1420 1421 1422 1423 1424 1425 1426 1427 1428 1429 1430 1431 1432 1433 1434 1435 1436 1437 1438 1439 1440 1441 1442 1443 1444 1187  922  649  368   79
 287  572  849 1118 1379 1632 1633 1634 1635 1636 1637 1638 1639 1640 1641 1642 1643 1644 1645 1646 1647 1648 1649 1650 1651 1652 1653 1654 1655 1656 1657 1658 1659 1660 1661 1662 1663 1664 1665 1666 1667 1668 1669 1670 1671 1672 1673 1674 1675 1676 1677 1678 1679 1680 1681 1682 1683 1684 1685 1686 1687 1688 1689 1690 1691 1692 1693 1694 1445 1188  923  650  369   80
 286  571  848 1117 1378 1631 1876 1877 1878 1879 1880 1881 1882 1883 1884 1885 1886 1887 1888 1889 1890 1891 1892 1893 1894 1895 1896 1897 1898 1899 1900 1901 1902 1903 1904 1905 1906 1907 1908 1909 1910 1911 1912 1913 1914 1915 1916 1917 1918 1919 1920 1921 1922 1923 1924 1925 1926 1927 1928 1929 1930 1931 1932 1933 1934 1935 1936 1695 1446 1189  924  651  370   81
 285  570  847 1116 1377 1630 1875 2112 2113 2114 2115 2116 2117 2118 2119 2120 2121 2122 2123 2124 2125 2126 2127 2128 2129 2130 2131 2132 2133 2134 2135 2136 2137 2138 2139 2140 2141 2142 2143 2144 2145 2146 2147 2148 2149 2150 2151 2152 2153 2154 2155 2156 2157 2158 2159 2160 2161 2162 2163 2164 2165 2166 2167 2168 2169 2170 1937 1696 1447 1190  925  652  371   82
 284  569  846 1115 1376 1629 1874 2111 2340 2341 2342 2343 2344 2345 2346 2347 2348 2349 2350 2351 2352 2353 2354 2355 2356 2357 2358 2359 2360 2361 2362 2363 2364 2365 2366 2367 2368 2369 2370 2371 2372 2373 2374 2375 2376 2377 2378 2379 2380 2381 2382 2383 2384 2385 2386 2387 2388 2389 2390 2391 2392 2393 2394 2395 2396 2171 1938 1697 1448 1191  926  653  372   83
 283  568  845 1114 1375 1628 1873 2110 2339 2560 2561 2562 2563 2564 2565 2566 2567 2568 2569 2570 2571 2572 2573 2574 2575 2576 2577 2578 2579 2580 2581 2582 2583 2584 2585 2586 2587 2588 2589 2590 2591 2592 2593 2594 2595 2596 2597 2598 2599 2600 2601 2602 2603 2604 2605 2606 2607 2608 2609 2610 2611 2612 2613 2614 2397 2172 1939 1698 1449 1192  927  654  373   84
 282  567  844 1113 1374 1627 1872 2109 2338 2559 2772 2773 2774 2775 2776 2777 2778 2779 2780 2781 2782 2783 2784 2785 2786 2787 2788 2789 2790 2791 2792 2793 2794 2795 2796 2797 2798 2799 2800 2801 2802 2803 2804 2805 2806 2807 2808 2809 2810 2811 2812 2813 2814 2815 2816 2817 2818 2819 2820 2821 2822 2823 2824 2615 2398 2173 1940 1699 1450 1193  928  655  374   85
 281  566  843 1112 1373 1626 1871 2108 2337 2558 2771 2976 2977 2978 2979 2980 2981 2982 2983 2984 2985 2986 2987 2988 3183 2989 2991 2992 2993 2994 2995 2996 2997 2998 2999 3000 3001 3002 3003 3004 3005 3006 3007 3008 3009 3010 3011 3012 3013 3014 3015 3016 3017 3018 3019 3020 3021 3022 3023 3024 3025 3026 2825 2616 2399 2174 1941 1700 1451 1194  929  656  375   86
 280  565  842 1111 1372 1625 1870 2107 2336 2557 2770 2975 3172 3173 3174 3175 3176 3177 3178 3179 3180 3369 3181 3184 3185 2990 3186 3187 3188 3190 3377 3191 3192 3193 3194 3195 3196 3197 3198 3199 3200 3201 3202 3203 3204 3205 3206 3207 3208 3209 3210 3211 3212 3213 3214 3215 3216 3217 3218 3219 3220 3027 2826 2617 2400 2175 1942 1701 1452 1195  930  657  376   87
 277  564 1371  840 1370 1624 1869 2106 2335 2556 2769 2974 3171 3360 3361 3362 3363 3364 3365 3366 3367 3368 3182 3370 3372 3373 3374 3375 3376 3189 3556 3378 3379 3380 3381 3382 3383 3384 3385 3386 3387 3388 3389 3390 3391 3392 3393 3394 3395 3396 3397 3398 3399 3400 3401 3402 3403 3404 3405 3406 3221 3028 2827 2618 2401 2176 1943 1702 1453 1196  931  658  377   88
 841  278  563 1110 1109 1623 1868 2105 2334 2555 2768 2973 3170 3359 3540 3541 3542 3543 3544 3545 3546 3548 3720 3549 3371 3551 3552 3724 3553 3726 3555 3557 3558 3559 3560 3561 3562 3563 3564 3565 3566 3567 3568 3569 3570 3571 3572 3573 3574 3575 3576 3577 3578 3579 3580 3581 3582 3583 3584 3407 3222 3029 2828 2619 2402 2177 1944 1703 1454 1197  932  659  378   89
 279  838 1108 1369 1368 1622 1867 2104 2333 2554 2767 2972 3169 3358 3539 3712 3713 3714 3715 3716 3717 3547 3718 3719 3550 3722 3723 3554 3725 3727 3890 3728 3729 3730 3731 3732 3733 3734 3735 3736 3737 3738 3739 3740 3741 3742 3743 3744 3745 3746 3747 3748 3749 3750 3751 3752 3753 3754 3585 3408 3223 3030 2829 2620 2403 2178 1945 1704 1455 1198  933  660  379   90
 276  839  562 1106 1107 1621 1866 2103 2332 2553 2766 2971 3168 3357 3538 3711 3876 3877 3878 3879 3880 3881 3882 3883 3721 3885 3886 3887 3888 3889 4045 3892 4047 3893 3894 3895 3896 3897 3898 3899 3900 3901 3902 3903 3904 3905 3906 3907 3908 3909 3910 3911 3912 3913 3914 3915 3916 3755 3586 3409 3224 3031 2830 2621 2404 2179 1946 1705 1456 1199  934  661  380   91
 275  560  273 1105 1367 1620 1865 2102 2331 2552 2765 2970 3167 3356 3537 3710 3875 4032 4033 4034 4035 4036 4037 4038 3884 4040 4041 4042 4046 4190 4192 3891 4194 4048 4049 4050 4051 4052 4053 4054 4055 4056 4057 4058 4059 4060 4061 4062 4063 4064 4065 4066 4067 4068 4069 4070 3917 3756 3587 3410 3225 3032 2831 2622 2405 2180 1947 1706 1457 1200  935  662  381   92
 837  559  561 1366 1365 1619 1864 2101 2330 2551 2764 2969 3166 3355 3536 3709 3874 4031 4180 4181 4182 4183 4184 4185 4039 4186 4188 4189 4043 4191 4044 4193 4333 4195 4196 4197 4198 4199 4200 4201 4202 4203 4204 4205 4206 4207 4208 4209 4210 4211 4212 4213 4214 4215 4216 4071 3918 3757 3588 3411 3226 3033 2832 2623 2406 2181 1948 1707 1458 1201  936  663  382   93
 272  557  274  836 1104 1618 1863 2100 2329 2550 2763 2968 3165 3354 3535 3708 3873 4030 4179 4320 4321 4322 4323 4324 4325 4187 4327 4328 4329 4330 4331 4463 4332 4334 4335 4336 4337 4338 4339 4340 4341 4342 4343 4344 4345 4346 4347 4348 4349 4350 4351 4352 4353 4354 4217 4072 3919 3758 3589 3412 3227 3034 2833 2624 2407 2182 1949 1708 1459 1202  937  664  383   94
 553  270  271 1103 1364 1617 1862 2099 2328 2549 2762 2967 3164 3353 3534 3707 3872 4029 4178 4318 4319 4452 4453 4455 4456 4326 4457 4458 4460 4461 4462 4586 4464 4465 4466 4467 4468 4469 4470 4471 4472 4473 4474 4475 4476 4477 4478 4479 4480 4481 4482 4483 4484 4355 4218 4074 4073 3759 3590 3413 3228 3035 2834 2625 2408 2183 1950 1709 1460 1203  938  665  384   95
 834  558  835  832 1362 1616 1861 2098 2327 2548 2761 2966 3163 3352 3533 3706 3871 4028 4177 4317 4451 4576 4454 4578 4579 4580 4581 4459 4583 4582 4700 4585 4587 4588 4589 4590 4591 4592 4593 4594 4595 4596 4597 4598 4599 4600 4601 4602 4603 4604 4605 4606 4485 4356 4219 3922 3920 3760 3591 3414 3229 3036 2835 2626 2409 2184 1951 1710 1461 1204  939  666  385   96
 555  833  554 1363 1102 1615 1860 2097 2326 2547 2760 2965 3162 3351 3532 3705 3870 4027 4176 4316 4450 4575 4577 4693 4694 4695 4696 4697 4584 4807 4906 4701 4702 4703 4704 4705 4706 4707 4708 4709 4710 4711 4712 4713 4714 4715 4716 4717 4718 4719 4720 4607 4486 4357 4220 3921 3923 3761 3592 3415 3230 3037 2836 2627 2410 2185 1952 1711 1462 1205  940  667  386   97
1101  556 1100 1361 1614 1859 1858 2096 2325 2546 2759 2964 3161 3350 3531 3704 3869 4026 4175 4449 4574 4571 4573 4692 4801 4802 4803 4805 4806 4699 4698 4808 4809 4810 4811 4812 4813 4814 4815 4816 4817 4818 4819 4820 4821 4822 4823 4824 4825 4826 4721 4608 4487 4358 4221 4075 3924 3762 3593 3416 3231 3038 2837 2628 2411 2186 1953 1712 1463 1206  941  668  387   98
 269  268  831 1099 1359 1360 1613 2095 2324 2545 2758 2963 3160 3349 3530 3703 3868 4025 4174 4315 4448 4446 4799 4800 4901 4992 4902 4804 4995 4904 4905 4907 4908 4909 4910 4911 4912 4913 4914 4915 4916 4917 4918 4919 4920 4921 4922 4923 4924 4827 4722 4609 4488 4359 4222 4076 3763 3764 3594 3417 3232 3039 2838 2629 2412 2187 1954 1713 1464 1207  942  669  388   99
 267  552  830 1098 1358 1612 1857 2094 2323 2544 2757 2962 3159 3348 3529 3702 3867 4024 4314 4313 4447 4688 4691 4689 4900 4690 4993 4903 5220 4996 4997 4998 4999 5000 5001 5002 5003 5004 5005 5006 5007 5008 5009 5010 5011 5012 5013 5014 4925 4828 4723 4610 4489 4360 4078 4077 3925 3765 3595 3418 3233 3040 2839 2630 2413 2188 1955 1714 1465 1208  943  670  389  100
 266  828  829 1097 1855 1610 1611 2322 2321 2543 2756 2961 3158 3347 3528 3701 3866 4172 4173 4312 4570 4687 4572 4899 4798 5077 5152 5076 4994 5079 5080 5081 5082 5083 5084 5085 5086 5087 5088 5089 5090 5091 5092 5093 5094 5095 5096 5015 4926 4829 4724 4611 4490 4224 4223 4225 4079 3766 3596 3419 3234 3041 2840 2631 2414 2189 1956 1715 1466 1209  944  671  390  101
 265  551  550 1096  825 1609 1853 1856 2093 2542 2755 2960 3157 3346 3527 3700 3865 4023 4170 4445 4444 4796 4990 4898 4991 5078 5074 4989 5151 5154 5223 5155 5157 5158 5159 5160 5161 5162 5163 5164 5165 5166 5167 5168 5169 5098 5171 5097 4927 4830 4725 4612 4491 4361 4362 4081 3926 4080 3597 3420 3235 3042 2841 2632 2415 2190 1957 1716 1467 1210  945  672  391  102
 264  826  827 1356 1357 1854 1852 2092 2320 2541 2754 2959 3156 3345 3526 3699 3864 4171 4022 4311 4443 4686 4795 4797 5075 4897 4988 4896 5219 5153 5222 5224 5283 5225 5226 5227 5228 5229 5230 5231 5232 5233 5234 5235 5236 5172 5170 5016 4928 4831 4726 4613 4492 4363 4227 4226 3927 3767 3598 3421 3236 3043 2842 2633 2416 2191 1958 1717 1468 1211  946  673  392  103
 548  549 1094 1095 1355 1607 1608 2091 2319 2540 2753 2958 3155 3344 3525 3698 3863 4021 4169 4310 4442 4569 4685 4794 4793 5069 5149 5221 5332 5282 5279 5156 5334 5284 5285 5286 5287 5288 5289 5290 5342 5291 5292 5293 5294 5237 5099 5017 4929 4832 4727 4614 4493 4364 4228 4082 3928 3768 3599 3422 3237 3044 2843 2634 2417 2192 1959 1718 1469 1212  947  674  393  104
 547  546  824 1093 1354 1606 1851 2090 2318 2539 2752 2957 3154 3343 3524 3697 3862 4020 4168 4441 4440 4568 4684 4894 4895 4987 4985 5280 4986 5150 5375 5330 5377 5333 5335 5336 5338 5339 5340 5341 5343 5344 5345 5295 5238 5173 5100 5018 5019 4833 4728 4615 4494 4365 4229 4083 3929 3769 3600 3423 3238 3045 3047 2844 2635 2193 1960 1719 1470 1213  948  675  394  105
 263  261  823 1092 1351 1352 1850 2089 2088 2538 2751 2956 3153 3342 3523 3696 3861 4018 4167 4309 4566 4567 4791 4790 5072 4984 5148 5217 5218 5073 5412 5331 5374 5379 5380 5337 5381 5382 5446 5383 5385 5386 5423 5296 5239 5101 5175 4931 4930 4834 4729 4616 4495 4366 4230 4084 3930 3931 3602 3770 3239 3240 2845 2636 2418 2419 1961 1720 1471 1214  949  676  395  106
 820  262  258  545 1091 1605 2087 2316 2317 2537 2750 2955 3152 3341 3522 3860 4017 4019 4308 4307 4564 4683 4682 4792 5071 4891 4893 5147 5278 5329 5275 5281 5376 5378 5414 5415 5416 5417 5384 5418 5420 5346 5240 5241 5242 5174 5021 5020 5022 4835 4730 4617 4496 4367 4231 4085 3932 3771 3425 3601 3048 3046 2848 2846 2195 2194 1962 1721 1472 1215  950  677  396  107
 260  257  822 1090 1353 1604 1849 2086 2315 2536 2749 2954 3151 3340 3521 3695 4016 4166 4306 4305 4565 4563 4439 4892 4681 5070 5068 5146 5277 5214 5440 5411 5372 5413 5439 5443 5463 5444 5464 5445 5389 5298 5387 5388 5177 5103 5102 5023 4932 4836 4731 4618 4498 4497 4368 4086 3772 3604 3773 3424 2640 3241 2638 2197 2637 2420 1963 1722 1473 1216  951  678  397  108
 544  259 1089  821 1602 1350 1603 2085 2314 2535 2748 2953 3150 3339 3520 3694 3859 3693 4165 4015 4164 4438 4680 4789 4890 4982 4983 5145 5215 5274 5328 5373 5410 5459 5442 5461 5462 5474 5419 5390 5352 5449 5422 5299 5176 5297 5104 4934 4933 4837 4732 4619 4499 4369 3934 3935 4088 3603 3427 3426 3429 3049 2639 2422 2421 2196 1964 1723 1474 1217  952  679  398  109
 814  256  541 1349 1847 1848 2084 2312 2313 2747 2746 2952 3149 3338 3519 3692 3858 4014 4163 4304 4437 4562 4679 4788 4889 5067 5066 5144 5216 5276 5213 5409 5408 5441 5457 5460 5458 5469 5425 5447 5450 5391 5392 5347 5243 5178 5105 5024 4935 4838 4733 4620 4370 4232 4087 3933 3937 3428 3244 3605 3430 3050 2849 2423 2424 2198 1965 1724 1475 1218  953  680  399  110
 819  818 1087  543 1348 1601 2082 1845 2534 2533 2745 2951 3148 3337 3518 3691 3857 4161 4013 4303 4436 4561 4678 4787 4888 5065 4980 5211 5143 5273 5272 5327 5437 5371 5438 5472 5471 5424 5448 5465 5350 5421 5300 5349 5244 5179 5106 5025 4936 4839 4734 4621 4500 4371 4233 4089 3774 3775 3242 2847 3431 2851 3051 2642 2641 2199 1966 1725 1476 1219  954  681  400  111
 540  539  542 1088 1086 1346 1846 2083 2311 2531 2532 2950 3147 3336 3516 3517 3856 3690 4162 4302 4435 4560 4677 4786 4887 4981 5142 5212 5324 5323 5271 5326 5369 5435 5436 5475 5473 5426 5429 5393 5356 5351 5348 5302 5303 5180 5107 5026 4937 4840 4735 4622 4501 4372 4234 3936 3776 3606 3607 3608 3246 3052 3243 2850 2425 2200 1967 1726 1477 1220  955  682  401  112
 253  254 1084  255 1085 1347 2309 1600 1599 2743 1844 2744 3146 3335 3689 3855 3854 4012 4159 4160 4434 4559 4676 4785 4886 4979 5064 5141 5210 5368 5406 5434 5470 5456 5407 5468 5400 5466 5452 5453 5427 5246 5357 5301 5304 5245 5108 4938 4939 4736 4623 4624 4502 4235 4238 4090 4091 3938 3777 3432 3245 3053 2852 2643 2426 2201 1968 1727 1478 1221  956  683  402  113
 817  815  536 1345 1343 1344 1843 2081 2310 2530 2948 2949 3145 3334 3515 3687 3688 4011 4009 4010 4301 4558 4675 4784 4885 4978 5063 5140 5209 5270 5370 5367 5325 5433 5363 5364 5401 5397 5467 5395 5394 5430 5248 5305 5183 5247 5181 5182 4940 4841 4842 4503 4374 4373 4093 4092 3939 3778 3609 3433 3247 3054 2853 2644 2427 2202 1969 1728 1479 1222  957  684  403  114
 538 1083  813 1081 1597 1598 2075 2079 1842 2308 2742 2947 3144 3333 3514 3686 3853 4158 4431 4299 4300 4433 4674 4783 4884 4977 5062 5139 5269 5322 5321 5403 5405 5365 5404 5432 5454 5431 5358 5396 5309 5353 5308 5250 5109 5184 5030 5028 5027 4738 4737 4625 4504 4375 4237 4236 4239 3779 3611 3610 3248 3055 2854 2645 2428 2203 1970 1729 1480 1223  958  685  404  115
 534  252  816 1082 2307 1595 1593 2078 2306 2945 3142 3143 3332 3513 3512 3852 3851 4298 4430 4432 4155 4557 4673 4782 4883 4976 5059 5137 5208 5207 5366 5319 5318 5361 5315 5362 5398 5455 5311 5314 5310 5255 5354 5355 5249 5111 4941 4942 4843 4844 4739 4626 4505 4377 4376 4240 3940 4094 3780 3434 3249 3056 2855 2646 2429 2204 1971 1730 1481 1224  959  686  405  116
 251  249 1080 1079 1594 1839 2305 2080 2527 2529 2525 2739 3141 3330 3331 3685 3850 4008 4297 4157 4555 4556 4672 4781 4882 4974 4975 5138 5061 5268 5267 5320 5262 5316 5402 5399 5260 5313 5259 5360 5451 5254 5306 5251 5110 5185 5114 5113 5029 4847 4845 4627 4506 4378 4095 3942 3941 3781 3612 3435 3250 3057 2856 2647 2430 2205 1972 1731 1482 1225  960  687  406  117
 537  250 1078  535 1840 1841 2303 2077 1596 2740 2741 2528 2944 3328 3511 3684 3849 4156 4007 4006 4296 4429 4671 4780 4881 4973 5136 5205 5206 5203 5266 5265 5264 5317 5197 5261 5428 5359 5193 5122 5192 5256 5253 5252 5188 5307 5186 4943 5187 5031 4740 4846 4507 4379 4242 4096 4241 3782 3613 3436 3251 3058 2857 2648 2431 2206 1973 1732 1483 1226  961  688  407  118
 248  533  811  809  812 2076 1591 2074 1837 2304 2738 2946 3140 3138 3683 3848 4154 4005 4153 4295 4427 4554 4670 4779 4880 4972 5058 5060 5133 5204 5202 5201 5200 5263 5196 5198 5195 5312 5194 5258 5124 5191 5190 5189 5038 5116 5033 5032 4944 4741 4742 4628 4509 4508 4097 3944 3943 3783 3614 3437 3252 3059 2858 2649 2432 2207 1974 1733 1484 1227  962  689  408  119
 247  808 1339  807 1340 1341 2526 1338 2524 2523 1838 2737 3329 3509 3510 3682 3847 4004 4553 4292 4293 4428 4552 4778 4879 5057 5055 5135 5134 5132 5131 5130 5129 5128 5199 5125 5046 5045 5121 4955 5123 5120 5119 5118 4855 5037 5112 5036 4945 4848 4743 4629 4630 4380 4243 4098 3945 3784 3615 3438 3253 3060 2859 2650 2433 2208 1975 1734 1485 1228  963  690  409  120
1077 1076  532 1337 1342 1836 2073 1592 2302 2943 2736 2942 3137 3139 3508 3681 3846 4003 4152 4426 4667 4777 4776 4666 4878 4971 5056 4968 5054 5053 5051 4869 5050 5049 5127 5126 4959 4958 5257 5042 4860 5041    0 5039 5115 4951 5117 5035 4946 4849 4744 4631 4510 4381 4244 4099 3946 3785 3616 3439 3254 3061 2860 2651 2434 2209 1976 1735 1486 1229  964  691  410  121
 246  245  243 1589 2071 2300 2070 1835 2072 2734 2940 3136 3326 3327 3507 3680 3845 4002 4425 4294 4669 4549 4551 4775 4877 4970 4874 4969 4966 4965 5052 4963 4962 4961 5048 4960 5047 4957 4862 4956 4954 4953 5040 4952 4950 4752 5034 4948 4947 4850 4745 4632 4511 4382 4245 4100 3947 3786 3617 3440 3255 3062 2861 2652 2435 2210 1977 1736 1487 1230  965  692  411  122
 531  806  810  529 1834 1590 1335 1833 2521 2735 2937 2941 2939 3505 3506 3844 4001 4150 4151 4550 4291 4548 4663 4665 4773 4876 4660 4873 4967 4871 4964 4870 4868 4867 4866 4865 4864 4863 5044 4861 5043 4756 4858 4857 4856 4854 4751 4853 4852 4851 4746 4633 4512 4383 4246 4101 3948 3787 3618 3441 3256 3063 2862 2653 2436 2211 1978 1737 1488 1231  966  693  412  123
 530  244  528  804 1334 1588 2299 1587 2301 2522 2520 2733 3325 3135 3678 3679 3843 4000 4149 4424 4290 4287 4668 4774 4772 4771 4770 4875 4872 4768 4767 4766 4765 4764 4763 4762 4761 4760 4759 4647 4859 4758 4754 4643 4753 4641 4750 4949 4749 4748 4747 4634 4513 4384 4247 4102 3949 3788 3619 3442 3257 3064 2863 2654 2437 2212 1979 1738 1489 1232  967  694  413  124
 242  527  805 1336 1071 1075 1073 1832 2069 2298 2938 3134 3324 3504 3322 3503 3677 3998 3842 4147 4664 4421 4423 4547 4662 4661 4659 4658 4769 4657 4656 4655 4654 4653 4652 4651 4650 4649 4648 4528 4757 4646 4645 4755 4523 4642 4640 4639 4638 4637 4636 4635 4514 4385 4248 4103 3950 3789 3620 3443 3258 3065 2864 2655 2438 2213 1980 1739 1490 1233  968  695  414  125
 241  802  803 1070 1074 1333 2297 2296 1831 2518 2936 2732 3131 3323 3132 3676 3840 3999 4286 4146 4289 4422 4544 4282 4543 4542 4541 4540 4539 4538 4537 4536 4535 4534 4533 4532 4531 4530 4529 4401 4527 4399 4644 4526 4524 4522 4521 4520 4519 4518 4517 4516 4515 4386 4249 4104 3951 3790 3621 3444 3259 3066 2865 2656 2439 2214 1981 1740 1491 1234  969  696  415  126
 239  526  240 1330 1072 1830 2068 1584 2067 2519 2066 2935 3133 3500 3318 3674 3675 3997 3996 4148 4288 4419 4545 4416 4281 4415 4414 4413 4412 4411 4410 4409 4408 4407 4406 4405 4404 4403 4266 4265 4400 4525 4398 4397 4396 4395 4394 4393 4392 4391 4390 4389 4388 4387 4250 4105 3952 3791 3622 3445 3260 3067 2866 2657 2440 2215 1982 1741 1492 1235  970  697  416  127
 524  525  522 1331 1585 1332 2065 2729 1586 2728 2731 2934 3502 3319 3321 3673 3841 4145 4284 4285 4417 4420 4418 4139 4283 4280 4279 4278 4277 4276 4275 4274 4273 4272 4271 4270 4268 4402 4126 4123 4122 4264 4263 4262 4261 4260 4259 4258 4257 4256 4255 4254 4253 4252 4251 4106 3953 3792 3623 3446 3261 3068 2867 2658 2441 2216 1983 1742 1493 1236  971  698  417  128
 236  801  523 1069 1583 1582 2295 2294 2515 2516 3129 2933 3320 3128 3838 3837 3839 3836 4143 4546 4142 4140 3664 3988 4138 4137 4136 4135 4134 4133 4132 4131 4130 4129 4128 4127 3975 4267 4125 3974 4121 3970 4120 4119 4118 4117 4116 4115 4114 4113 4112 4111 4110 4109 4108 4107 3954 3793 3624 3447 3262 3069 2868 2659 2442 2217 1984 1743 1494 1237  972  699  418  129
1067  238  799  800 1329 1827 1829 2293 2513 2932 2517 2726 3130 3499 3501 3835 3995 3672 4144 3993 3832 3991 3989 3829 3987 3986 3985 3984 3983 3982 3981 3980 3979 3978 3977 3976 3816 4269 3814 3972 4124 3811 3969 3968 3967 3966 3965 3964 3963 3962 3961 3960 3959 3958 3957 3956 3955 3794 3625 3448 3263 3070 2869 2660 2443 2218 1985 1744 1495 1238  973  700  419  130
 798  521  237 1068 1327 1580 1828 1826 2063 2514 2730 2727 3316 3317 3498 3994 3669 3671 3834 3992 4141 3831 3990 3830 3828 3827 3826 3825 3824 3823 3822 3821 3820 3819 3818 3817 3815 3973 3648 3647 3812 3810 3643 3809 3808 3807 3806 3805 3804 3803 3802 3801 3800 3799 3798 3797 3796 3795 3626 3449 3264 3071 2870 2661 2444 2219 1986 1745 1496 1239  974  701  420  131
 795  520  797  234 1328 2061 1579 1581 2064 2511 2512 2931 2930 3496 3314 3313 3497 3309 3667 3833 3666 3489 3663 3662 3661 3659 3485 3658 3657 3656 3655 3654 3652 3477 3651 3475 3650 3474 3813 3646 3287 3971 3645 3642 3641 3640 3639 3638 3637 3636 3635 3634 3633 3632 3631 3630 3629 3628 3627 3450 3265 3072 2871 2662 2445 2220 1987 1746 1497 1240  975  702  421  132
 235  233  796 1065 1326 1066 1825 2292 2290 2721 2725 3127 2928 3126 3315 3125 3494 3118 3668 3305 3308 3665 3488 3304 3490 3486 3484 3483 3482 3481 3297 3480 3653 3294 3292 3293 3291 3473 3649 3097 3470 3644 3468 3467 3466 3465 3464 3463 3462 3461 3460 3459 3458 3457 3456 3455 3454 3453 3452 3451 3266 3073 2872 2663 2446 2221 1988 1747 1498 1241  976  703  422  133
 518  517 1324 1061 1325 1578 1824 2289 2060 2062 2724 2929 2927 3122 3312 3670 3495 3311 3493 3117 3492 3116 3306 3303 3660 3301 3110 3109 3300 3298 3105 3478 3479 3102 3104 3476 3100 3290 3472 3288 3471 3469 3285 3284 3283 3282 3281 3280 3279 3278 3277 3276 3275 3274 3273 3272 3271 3270 3269 3268 3267 3074 2873 2664 2447 2222 1989 1748 1499 1242  977  704  423  134
 794  793  519 1064 1823 1576 1323 2291 1822 2509 2722 2723 2925 3124 2923 3120 2921 3119 2918 2915 3115 3307 3487 3113 2912 2707 3111 2910 3299 3107 3296 3106 3295 2696 2905 3103 3101 3099 3098 3289 3096 3286 3094 3093 3092 3091 3090 3089 3088 3087 3086 3085 3084 3083 3082 3081 3080 3079 3078 3077 3076 3075 2874 2665 2448 2223 1990 1749 1500 1243  978  705  424  135
 232  516 1063 1322 1321 1062 1577 2288 2287 2059 2508 2926 2718 3123 2924 2714 2920 3121 2919 2495 3310 3114 2709 2708 2916 2911 2704 3302 3108 2909 2907 2906 2698 2904 2903 2902 2901 2900 2899 2898 2896 3095 2895 2894 2893 2892 2891 2890 2889 2888 2887 2886 2885 2884 2883 2882 2881 2880 2879 2878 2877 2876 2875 2666 2449 2224 1991 1750 1501 1244  979  706  425  136
 231  230 1060  792 1320 1575 2058 2057 2286 2510 2719 2503 2716 2500 2922 2713 2712 2498 3491 2917 2710 2706 2914 2492 2913 2705 2703 2488 2702 2908 2486 2699 2482 2483 2697 2695 2694 2693 2692 2690 2897 2689 2688 2687 2686 2685 2684 2683 2682 2681 2680 2679 2678 2677 2676 2675 2674 2673 2672 2671 2670 2669 2668 2667 2450 2225 1992 1751 1502 1245  980  707  426  137
 229  514  515 1574 1573 1820 1821 2056 2285 2507 2506 2505 2717 2504 2501 2715 2499 2497 2274 2711 2496 2494 2493 2491 3112 2490 2489 2265 2487 2700 2701 2485 2484 2480 2258 2257 2478 2477 2476 2691 2475 2474 2473 2472 2471 2470 2469 2468 2467 2466 2465 2464 2463 2462 2461 2460 2459 2458 2457 2456 2455 2454 2453 2452 2451 2226 1993 1752 1503 1246  981  708  427  138
 228  513  791 1058  790 1819 2055 2284 2283 1814 2720 2280 2281 2502 2278 2277 2276 1806 2275 2273 2272 2271 2270 2269 2268 2267 2266 2264 2263 2262 2261 2029 2030 2481 2027 2256 2479 2255 2254 2253 2252 2251 2250 2249 2248 2247 2246 2245 2244 2243 2242 2241 2240 2239 2238 2237 2236 2235 2234 2233 2232 2231 2230 2229 2228 2227 1994 1753 1504 1247  982  709  428  139
 227  512  788  789 1571 1059 1572 2054 2052 1812 2282 2051 2279 1810 2048 2047 2046 2044 2043 2042 2041 2040 2039 2038 2037 2036 2035 2034 2033 2032 1792 2031 1789 2260 1788 2026 2025 2024 2023 2022 2021 2020 2019 2018 2017 2016 2015 2014 2013 2012 2011 2010 2009 2008 2007 2006 2005 2004 2003 2002 2001 2000 1999 1998 1997 1996 1995 1754 1505 1248  983  710  429  140
 225  226 1319 1318 1817 1057 1816 1815 1567 2053 1813 2050 1811 2049 1808 1807 1559 2045 1557 1803 1801 1554 1800 1799 1797 1550 1796 1795 1794 1793 1791 1289 1790 2259 2028 1787 1786 1785 1784 1783 1782 1781 1780 1779 1778 1777 1776 1775 1774 1773 1772 1771 1770 1769 1768 1767 1766 1765 1764 1763 1762 1761 1760 1759 1758 1757 1756 1755 1506 1249  984  711  430  141
 510  787 1056 1818 1055 1570 1569 1312 1313 1049 1310 1309 1564 1809 1562 1561 1560 1804 1805 1555 1802 1553 1298 1552 1551 1798 1549 1548 1547 1546 1544 1292 1543 1542 1541 1540 1539 1538 1537 1536 1535 1534 1533 1532 1531 1530 1529 1528 1527 1526 1525 1524 1523 1522 1521 1520 1519 1518 1517 1516 1515 1514 1513 1512 1511 1510 1509 1508 1507 1250  985  712  431  142
 224  509  511  784 1317 1316 1052 1568 1565 1050 1566  775 1308 1306  493 1305 1041 1042 1558 1556 1301 1036 1299 1297 1296 1295 1294 1291  478 1545  756 1290 1288 1024 1286 1285 1284 1283 1282 1281 1280 1279 1278 1277 1276 1275 1274 1273 1272 1271 1270 1269 1268 1267 1266 1265 1264 1263 1262 1261 1260 1259 1258 1257 1256 1255 1254 1253 1252 1251  986  713  432  143
 223  508  786 1053 1054  781 1315 1311 1047  772  776 1563 1304 1046 1307  768  490 1302 1040 1039 1300 1035  197 1034 1033 1032 1027 1293 1029  192  190 1026  754  753 1023 1022 1021 1020 1019 1018 1017 1016 1015 1014 1013 1012 1011 1010 1009 1008 1007 1006 1005 1004 1003 1002 1001 1000  999  998  997  996  995  994  993  992  991  990  989  988  987  714  433  144
 222  507  785  783  782  780 1314  213  499  777  212  496  773 1043  774  492  204  491  489 1037 1038  765  198  764  761 1030  759 1031  757  479  758 1025 1287  475  752  751  750  749  748  747  746  745  744  743  742  741  740  739  738  737  736  735  734  733  732  731  730  729  728  727  726  725  724  723  722  721  720  719  718  717  716  715  434  145
 221  506  505  504  503  500  502  501  498 1048  497  211  495  207  205  771 1044 1303  769  202  766  486  485  196  763  483  482  760 1028  480  189  755  476  188  473  472  185  471  469  468  467  466  465  464  463  462  461  460  459  458  457  456  455  454  453  452  451  450  449  448  447  446  445  444  443  442  441  440  439  438  437  436  435  146
 220  219  218  217  216 1051  215  778  779  214  210  209  494 1045  208  206  770  203  488  767  487  201  200  199  484  195  762  481  194  193  477  191  187  474  186  184  183  470  182  181  180  179  178  177  176  175  174  173  172  171  170  169  168  167  166  165  164  163  162  161  160  159  158  157  156  155  154  153  152  151  150  149  148  147
