# This puzzle is unsolvable
58
   2    1    3    4    5    6    7    8    9   10   11   12   13   14   15   16   17   18   19   20   21   22   23   24  472   28   27  257   31  259  260  479  262  264  261  484   36  267  268  486   42   41  703   43   47  706  494  493   49  277   50   53   54  281  283   55   56   58
 228  229  230  231  232  233  234  235  236  237  238  239  240  241  242  243  244  245  246  247  248  249  469  250   26   25  684  475  473   29   32   34  690 1090   33   37  693  694  263  487   40 1097  488   44  489  700  270  275  272  707   51   52  280  501  282  284   57  285
 227  448  449  450  451  452  453  454  455  456  457  458  459  460  461  462  463  464  677  678  676  467  252  680  253  255  886  887  685  474  258  477  480  481  691  482  483  897  269  266  265  492 1099  490   45  491   48  497  276  274  278  279  498  499  916  502   61   59
 226  447  660  661  662  663  664  665  666  667  668  669  670  671  672  673  674  675  879  465  679  681  883  251  254  471  683  256  888  476  478  894  895 1089 1091  896  692   35   38  698 1096  699  903  905  702  271  704  908  495  909  496  913  911 1108  712  503   60  286
 225  446  659  864  865  866  867  868  869  870  871  872  873  874  875  876  877  878  880  881  466  882  682  468  885 1082  686  687 1084   30  688 1085 1622 1087   39  893  697  696 1094 1463  899  898  904   46  701  273 1289  906 1103  912 1293  914  709  710 1107  504  287   63
 224  445  658  863 1060 1061 1062 1063 1064 1065 1066 1067 1068 1069 1070 1071 1072 1073 1074 1075 1076 1078  470 1077  884 1268 1272 1086 1625 1275  890  689 1627 1276 1273 1093  485 1279  695  901 1095  902  900 1286 1284 1468 1102 1104  910  705 1294 1295  500  711  505  288   62   64
 223  444  657  862 1059 1248 1249 1250 1251 1252 1253 1254 1255 1256 1257 1258 1259 1260 1261 1262 1263 1264 1266 1079 1080 1081 1618 1269 1271 1619  892 1274 1088 1456 1277 1278 1458 1092 1280 1281 1283 1461 1464 1100 1287 1638 1288 1290 1291 1105 1110 1292 1106  713 1109  714  289  506
 222  443  656  861 1058 1247 1428 1429 1430 1431 1432 1433 1434 1435 1436 1437 1438 1439 1440 1441 1443 1444 1265 1616 1267 1445 1447 1270 1083  889 1450  891 1623 1451 1457 1629 1628 1460 1949 1282 1632 1098 1285 1101 1635 1637  907 1469 1471 1475 1642 1111  917  915 1112  716  290  291
 221  442  655  860 1057 1246 1427 1600 1601 1602 1603 1604 1605 1606 1607 1608 1609 1610 1611 1613 1442 1614 1615 1446 1780 1617 1449 1448 1620 1939 1624 1452 1621 1455 1453 1626 1459 1794 1630 1631 1466 1798 1633 1796 1465 1467 1802 1474 1958 1470  708  919 1472  918  715  507   65   69
 220  441  654  859 1056 1245 1426 1599 1764 1765 1766 1767 1768 1769 1770 1771 1772 1773 1774 1612 1775 1776 1777 1779 1781 1938 2085 1783 2087 1454 1786 1785 1788 1789 1790 2094 2095 2093 1948 1795 1634 1462 1797 1954 1799 1636 1640 1639 1641 1644 1473  920  719  509  292  717  510  508
 219  440  653  858 1055 1244 1425 1598 1763 1920 1921 1922 1923 1924 1925 1926 1927 1928 1929 1930 1931 1932 1778 1934 1935 1937 2086 2083 1782 1941 1944 2088 2092 1784 1791 2232 2235 1792 1793 1950 2096 1952 1953 1800 1801 2103 1960 1806 1805 1296 1297 1298  718 1113  511   68   66  294
 218  439  652  857 1054 1243 1424 1597 1762 1919 2068 2069 2070 2071 2072 2073 2074 2075 2076 2077 2078 2079 1933 2080 1936 2081 2082 2084 1942 1940 1787 2089 1945 2229 2090 1946 2236 2365 1947 1951 2099 2372 1955 2100 1956 1957 1803 1643 1645 1477 1804 1116 1114 1115   67  512  720   70
 217  438  651  856 1053 1242 1423 1596 1761 1918 2067 2208 2209 2210 2211 2212 2213 2214 2215 2216 2217 2218 2219 2220 2221 2222 2354 2223 2359 2596 2478 2091 1943 2230 2362 2231 2233 2097 2098 2234 2237 2239 2370 2492 2240 2101 2242 1959 2106 2104 1299 1300 1476  923  721  722  293  295
 216  437  650  855 1052 1241 1422 1595 1760 1917 2066 2207 2340 2341 2342 2343 2344 2345 2346 2347 2348 2349 2350 2474 2351 2352 2224 2479 2226 2227 2357 2360 2228 2485 2361 2363 2364 2366 2489 2367 2368 2607 2238 2102 2241 2243 2105 1808 1647 1807 1479 1646 1302 1301  922  297  513   71
 215  436  649  854 1051 1240 1421 1594 1759 1916 2065 2206 2339 2464 2465 2466 2467 2468 2469 2470 2471 2472 2473 2589 2475 2476 2353 2477 2225 2355 2356 2482 2483 2484 2600 2486 2487 2603 2488 2490 2369 2608 2491 2493 2371 2244 2107 1961 1809 1478 1480  921 1648 1117  723  514  296   72
 214  435  648  853 1050 1239 1420 1593 1758 1915 2064 2205 2338 2463 2580 2581 2582 2583 2584 2585 2586 2587 2588 2590 2591 2592 2699 2593 2480 2701 2358 2597 2598 2599 2601 2602 2808 2710 2604 2811 2605 2715 2609 2494 2496 2245 2248 2110 1650 2108 1649 1303 1118  924  925  515  299   73
 213  434  647  852 1049 1238 1419 1592 1757 1914 2063 2204 2337 2462 2579 2688 2689 2690 2691 2692 2693 2694 2695 2696 2697 2698 2700 2594 2595 2702 2703 2481 2705 2707 2898 2708 2709 2711 2810 2901 2606 2713 2374 2373 2611 2375 2109 1962 1482 1812 1481 1304  926  725  724  298  516   74
 212  433  646  851 1048 1237 1418 1591 1756 1913 2062 2203 2336 2461 2578 2687 2788 2789 2790 2791 2792 2793 2794 2795 2796 2797 2798 2799 2800 2802 2803 2704 2805 2706 2806 2980 2982 2809 2712 2812 2613 2497 2714 2610 2495 2376 1811 1810 1965 1814 1306 1305 1119  927  726  517  300   75
 211  432  645  850 1047 1236 1417 1590 1755 1912 2061 2202 2335 2460 2577 2686 2787 2880 2881 2882 2883 2884 2885 2886 2887 2888 2889 2973 2890 2976 2804 2894 2979 2895 3054 2981 2807 2900 2904 2902 2813 2903 2380 2498 2111 2377 1963 1651 1964 1652 1486 1485 1120  928  929  518  301   76
 210  431  644  849 1046 1235 1416 1589 1754 1911 2060 2201 2334 2459 2576 2685 2786 2879 2964 2965 2966 2967 2968 2969 2970 2971 2972 2892 2891 2801 2893 3052 2977 3053 2896 3055 2897 2983 2984 2717 2814 2716 2612 2250 2247 2379 2249 2112 1966 1483 1656 1308 1122  728  727  519  302   77
 209  430  643  848 1045 1234 1415 1588 1753 1910 2059 2200 2333 2458 2575 2684 2785 2878 2963 3040 3041 3042 3043 3044 3045 3046 3047 3048 3049 2974 3051 2975 2978 3122 3182 3057 2985 3058 2986 2815 2906 2719 2718 2252 2253 2381 2246 1817 1968 1654 1484 1307 1121 1123  729  930  303   78
 208  429  642  847 1044 1233 1414 1587 1752 1909 2058 2199 2332 2457 2574 2683 2784 2877 2962 3039 3108 3109 3110 3111 3112 3113 3114 3115 3117 3050 3176 3178 3119 3181 3121 3056 2899 3123 3059 2816 2817 2615 2614 2499 2501 2378 1813 1967 1653 1309 1969 1124  931  730  521  520  304   79
 207  428  641  846 1043 1232 1413 1586 1751 1908 2057 2198 2331 2456 2573 2682 2783 2876 2961 3038 3107 3168 3169 3170 3171 3172 3173 3174 3116 3227 3118 3177 3120 3231 3180 3125 3124 3060 2905 2987 2818 2500 2720 2115 2503 2113 2251 2114 1815 1658 1655 1310 1125  932  731  522  305   80
 206  427  640  845 1042 1231 1412 1585 1750 1907 2056 2197 2330 2455 2572 2681 2782 2875 2960 3037 3106 3167 3220 3221 3222 3223 3224 3225 3175 3228 3306 3271 3179 3230 3232 3183 3126 3061 2988 2907 2819 2721 2502 2616 2382 2117 1970 1819 1816 1657 1487 1489 1488  933  732  523  306   81
 205  426  639  844 1041 1230 1411 1584 1749 1906 2055 2196 2329 2454 2571 2680 2781 2874 2959 3036 3105 3166 3219 3264 3265 3266 3267 3269 3226 3270 3272 3276 3229 3273 3274 3184 3127 3062 2908 2820 2722 2617 2618 2383 2505 2254 1971 2116 1972 1818 1311 1127 1126  934  733  524  307   82
 204  425  638  843 1040 1229 1410 1583 1748 1905 2054 2195 2328 2453 2570 2679 2780 2873 2958 3035 3104 3165 3218 3263 3300 3301 3302 3268 3304 3305 3307 3308 3309 3233 3185 3186 3128 3063 2989 2910 2909 2723 2619 2504 2118 2119 1973 1974 1820 1659 1490 1312 1128  935  734  525  308   83
 203  424  637  842 1039 1228 1409 1582 1747 1904 2053 2194 2327 2452 2569 2678 2779 2872 2957 3034 3103 3164 3217 3262 3299 3328 3329 3303 3331 3332 3333 3334 3275 3235 3234 3129 3130 3064 2990 2991 2821 2724 2506 2385 2255 2384 2256 1821 1660 1491 1662 1313 1129  936  735  526  309   84
 202  423  636  841 1038 1227 1408 1581 1746 1903 2052 2193 2326 2451 2568 2677 2778 2871 2956 3033 3102 3163 3216 3261 3298 3327 3348 3330 3350 3351 3352 3335 3310 3277 3236 3187 3131 3065 2992 2911 2822 2725 2620 2507 2386 2257 2120 1975 1822 1661 1824 1314 1130  937  736  527  310   85
 201  422  635  840 1037 1226 1407 1580 1745 1902 2051 2192 2325 2450 2567 2676 2777 2870 2955 3032 3101 3162 3215 3260 3297 3326 3347 3349 3360 3362 3353 3336 3237 3278 3238 3188 3066 3067 2993 2912 2823 2726 2621 2508 2387 2258 2121 1976 1663 1316 1493 1492 1315 1131  737  528  311   86
 200  421  634  839 1036 1225 1406 1579 1744 1901 2050 2191 2324 2449 2566 2675 2776 2869 2954 3031 3100 3161 3214 3259 3296 3325 3345 3346 3361 3363 3354 3338 3311 3312 3280 3279 3132 3068 2994 2913 2824 2622 2509 2510 2388 2259 2122 1977 1825 1823 1498 1317  939  938  738  529  312   87
 199  420  633  838 1035 1224 1405 1578 1743 1900 2049 2190 2323 2448 2565 2674 2775 2868 2953 3030 3099 3160 3213 3258 3295 3324 3358 3343 3359 3357 3355 3313 3337 3239 3190 3189 3133 2996 3069 2914 2825 2727 2623 2389 2390 2260 2123 1979 1978 1664 1318 1494 1132  940  739  530  313   88
 198  419  632  837 1034 1223 1404 1577 1742 1899 2048 2189 2322 2447 2564 2673 2774 2867 2952 3029 3098 3159 3212 3257 3294 3323 3344 3342 3319 3356 3340 3339 3314 3281 3240 3191 3134 2995 2997 2915 2827 2728 2624 2625 2511 2261 2124 1826 1665 1319 1495 1134 1135  941  740  531  314   89
 197  418  631  836 1033 1222 1403 1576 1741 1898 2047 2188 2321 2446 2563 2672 2773 2866 2951 3028 3097 3158 3211 3256 3293 3322 3321 3320 3318 3341 3317 3316 3315 3282 3241 3192 3135 3070 2917 2916 2729 2826 2626 2730 2512 2262 2125 1827 1666 1497 1321 1496 1133  942  741  532  315   90
 196  417  630  835 1032 1221 1402 1575 1740 1897 2046 2187 2320 2445 2562 2671 2772 2865 2950 3027 3096 3157 3210 3255 3292 3291 3290 3289 3288 3287 3286 3285 3284 3283 3242 3193 3136 3071 2998 2918 2828 2731 2513 2391 2392 2127 2263 1980 1828 1667 1499 1320 1136  943  742  533  317  316
 195  416  629  834 1031 1220 1401 1574 1739 1896 2045 2186 2319 2444 2561 2670 2771 2864 2949 3026 3095 3156 3209 3254 3253 3252 3251 3250 3249 3248 3247 3246 3245 3244 3243 3194 3137 3072 2999 3000 2829 2732 2514 2515 2264 2126 2128 1981 1829 1668 1322 1323 1137  944  743  534   92   94
 194  415  628  833 1030 1219 1400 1573 1738 1895 2044 2185 2318 2443 2560 2669 2770 2863 2948 3025 3094 3155 3208 3207 3206 3205 3204 3203 3202 3201 3200 3199 3198 3197 3196 3195 3073 3001 3074 2830 2733 2628 2627 2394 2393 2265 1983 1982 1830 1669 1670 1325  945 1138  744  535   93   91
 193  414  627  832 1029 1218 1399 1572 1737 1894 2043 2184 2317 2442 2559 2668 2769 2862 2947 3024 3093 3154 3153 3152 3151 3150 3149 3148 3147 3146 3145 3144 3143 3142 3141 3140 3138 3139 3002 2919 2831 2734 2629 2516 2395 2266 2129 1984 1832 1833 1831 1324 1500 1139  745  321  319  318
 192  413  626  831 1028 1217 1398 1571 1736 1893 2042 2183 2316 2441 2558 2667 2768 2861 2946 3023 3092 3091 3090 3089 3088 3087 3086 3085 3084 3083 3082 3081 3080 3079 3078 3077 3005 3076 2921 2920 2832 2735 2630 2517 2396 2268 2267 1986 1671 1503 1501 1142  946  948  746  320  537  536
 191  412  625  830 1027 1216 1397 1570 1735 1892 2041 2182 2315 2440 2557 2666 2767 2860 2945 3022 3021 3020 3019 3018 3017 3016 3015 3014 3013 3012 3011 3010 3009 3008 3007 3006 2926 3004 3075 2922 2833 2736 2631 2518 2397 2269 2130 1673 1985 1502 1140 1141  949 1326  947  538   96   95
 190  411  624  829 1026 1215 1396 1569 1734 1891 2040 2181 2314 2439 2556 2665 2766 2859 2944 2943 2942 2941 2940 2939 2938 2937 2936 2935 2934 2933 2932 2931 2930 2929 2928 2839 2925 2924 3003 2923 2834 2737 2632 2519 2398 2132 1988 2131 1505 1834 1674 1327 1143  748  747  322  540   97
 189  410  623  828 1025 1214 1395 1568 1733 1890 2039 2180 2313 2438 2555 2664 2765 2858 2857 2856 2855 2854 2853 2852 2851 2850 2849 2848 2847 2846 2845 2844 2843 2842 2841 2927 2744 2840 2838 2837 2835 2738 2633 2520 2399 2270 1987 1835 1672 1837 1329 1330 1328  950  749  324  539   98
 188  409  622  827 1024 1213 1394 1567 1732 1889 2038 2179 2312 2437 2554 2663 2764 2763 2762 2761 2760 2759 2758 2757 2756 2755 2754 2753 2752 2751 2750 2749 2748 2747 2746 2745 2743 2742 2639 2836 2741 2526 2739 2521 2400 2271 2134 2133 1836 1675 1504 1507 1144  951  750  542  101   99
 187  408  621  826 1023 1212 1393 1566 1731 1888 2037 2178 2311 2436 2553 2662 2661 2660 2659 2658 2657 2656 2655 2654 2653 2652 2651 2649 2539 2648 2536 2647 2645 2644 2643 2642 2641 2640 2637 2638 2525 2740 2634 2522 2401 2272 2135 1990 1508 1989 1506 1145  952  325  541  752  323  326
 186  407  620  825 1022 1211 1392 1565 1730 1887 2036 2177 2310 2435 2552 2551 2550 2549 2548 2547 2426 2545 2425 2544 2543 2542 2541 2540 2650 2538 2537 2646 2416 2535 2532 2530 2410 2528 2409 2527 2406 2407 2635 2523 2402 2273 2137 1992 2136 1677 1509 1331 1146 1147  751  543  100  329
 185  406  619  824 1021 1210 1391 1564 1729 1886 2035 2176 2309 2434 2433 2432 2431 2430 2302 2429 2546 2299 2427 2424 2423 2422 2421 2420 2419 2418 2417 2289 2415 2533 2412 2531 2283 2411 2529 2408 2281 2636 2524 2404 2274 1991 2138 1678 1839 1676 1333 1510  954  955  953  544  327  545
 184  405  618  823 1020 1209 1390 1563 1728 1885 2034 2175 2308 2307 2306 2305 2304 2168 2303 2428 2301 2300 2298 2297 2296 2295 2294 2293 2157 2292 2291 2286 2290 2534 2284 2150 2285 2151 2148 2147 2279 2280 2278 2276 2142 2403 2275 1994 1993 1840 1511 1332  956 1148  756  753  754  102
 183  404  617  822 1019 1208 1389 1562 1727 1884 2033 2174 2173 2172 2171 2170 2169 2025 2167 2166 2165 2164 2163 2162 2161 2160 2159 2158 2156 2155 2288 2154 2153 2413 2149 1533 2414 2005 1696 2282 2002 1853 2405 2144 2143 1995 1843 2140 1838 1149 1334 1680  755 1150  957  331  105  328
 182  403  616  821 1018 1207 1388 1561 1726 1883 2032 2031 2030 2029 2028 2027 1876 2026 2024 1872 2023 2021 2020 2019 2018 2017 2016 2015 2014 2013 2152 2012 1700 2010 2287 1856 2007 2006 2146 1695 2003 1850 2145 2001 1849 1999 2141 1844 1846 1512 1152 1679 1681 1335  757  546  103  104
 181  402  615  820 1017 1206 1387 1560 1725 1882 1881 1880 1879 1878 1718 1877 1875 1874 1873 1713 2022 1870 1869 1868 1867 1707 1866 1865 1535 2011 1860 1702 1531 1859 1857 1858 2009 1355 1694 1854 1852 2277 2000 1997 1520 1998 2139 1996 1685 1336 1682 1514  959  960  958  330  548  332
 180  401  614  819 1016 1205 1386 1559 1724 1723 1722 1721 1720 1719 1717 1550 1374 1716 1546 1714 1871 1711 1709 1708 1540 1365 1705 1863 1864 1703 1862 1537 1699 1532 1697 2008 2004 1698 1528 1693 1692 1851 1689 1848 1523 1686 1687 1845 1684 1683 1513 1151  758  759  550 1153  107  106
 179  400  613  818 1015 1204 1385 1558 1557 1556 1555 1554 1553 1552 1551 1549 1372 1191 1373 1370 1712 1545 1185 1543 1541 1183 1706 1539 1538 1704 1361 1861 1536 1534 1356 1172 1855 1530 1526 1527 1524 1521 1690 1522 1847 1345 1842 1517  969 1342 1515 1337  961 1338  547  108  549  109
 178  399  612  817 1014 1203 1384 1383 1382 1381 1380 1379 1378 1377 1376 1192 1375 1715 1548 1187 1188 1544 1710  995 1366 1367 1364 1363 1362 1360 1701 1359 1358 1357 1173 1354 1353 1169 1529 1525 1691 1165 1164 1349 1519 1346 1841 1518 1344 1343 1339 1154  962  760  551  334  333  110
 177  398  611  816 1013 1202 1201 1200 1199 1198 1197 1196 1195 1193 1003 1002 1190  997  800 1547 1371  994 1369 1368 1542 1181 1180  989 1179 1178 1177 1176 1175 1174  982  980  979 1170 1351 1168 1167  974 1348 1163 1162  772 1688  968 1160 1157 1340  965  761 1156  553  552  335  111
 176  397  610  815 1012 1011 1010 1009 1008 1007 1006 1005 1004 1194  803  595  802 1189  999  998  798  993 1182 1184  793  991  990  988  987  788  986  985  984  983  981 1171  780 1352  779  978  976 1347  775  972  971 1161  771 1159 1516 1341  966  964  765 1155  763  762  336  112
 175  396  609  814  813  812  811  810  809  808  807  806  805  597  598  799 1001  379  801  996  591  992  585  588  151  792  146  791  790  787  786  364  579  784  783  782  574  781  357  977  777 1166 1350  566  352  970  769 1158  768  561  967  766  558  963  764  555  554  337
 174  395  608  607  606  605  604  603  602  601  600  599  383  804  158  594  592  797  378 1186  796  795  149  584    0  148  373  582  789  581  580  785  578  577  576  575  572  778  134  571  975  973  774  568  773  351  564  770  347  563  767  559  343  557  556  340  338  114
 173  394  393  392  391  390  389  388  387  386  385  384  160  381  382  596 1000  593  376  375  372  589  586  370  150  371  145  583  367  366  365  363  362  361  360  359  358  573  355  569  131  776  354  129  567  350  562  565  125  345  560  344  121  118  119  341  113  115
 172  171  170  169  168  167  166  165  164  163  162  161  159  156  157  155  380  377  374  154  153  590  587  152  794  147  369  368  144  143  142  141  140  139  138  137  136  135  132  356  133  570  353  130  128  127  349  126  348  124  123  346  122  120  342  117  339  116
