# This puzzle is unsolvable
49
   2    1  194    3    7  379  198    8    9   10   11   12  205   13   14   15   17   18   20   22   21   19  398  396   24  216   26   27   31  223   33  224  222  584  226   35   37   38   39   40   41   42   43   44   45   46   47   48   49
 192  193    5    6  196  380  197  199  200  201  202  203  204  388  206   16  390  209  391  210  395  736  214  213  399   25  215  217  402   30   29  221  225   34  410   36  228  229  230  231  232  233  234  235  236  237  238  239   50
 190  191  376    4  722  195  381  382  383  384  560  386  385  564  389  565  392  208   23  568  569  570  211  212  741  400  219  218  405  403  746   32  749  408  583  227  411  412  413  414  415  416  417  418  419  420  421  240   51
 189  378  719  552  554  723  881  556  558  727  563  559  888  387  731  566  733  207  735  393  571  572  397  900  574  742  575  401  220  578  404  406  750  747  582  585  586  587  588  589  590  591  592  593  594  595  422  241   52
 188  375  553  721  551  555  725  883  884  728  885  886  729  562  890  732  734  567 1045  394  898  737  739  573  740  576  745   28  906  579  908  407 1202  409  751  752  753  754  755  756  757  758  759  760  761  596  423  242   53
 372  377  549  879  718 1033  882  557  724  561  726 1039 1182  730  889  891  892  893  894  738 1190  895  896  899  901  902  743  577 1053  748  580 1057  581  907 1059  911  912  913  914  915  916  917  918  919  762  597  424  243   54
 374  373  550  187 1032  720  880 1034 1180 1178 1035  887 1040 1183 1041 1042 1043 1044 1046 1047 1048 1328  897 1050 1329 1196 1331  905  903 1055 1056 1058  909 1061  910 1467 1063 1064 1065 1066 1067 1068 1069  920  763  598  425  244   55
 186  371  548  717  878 1179 1176 1313 1177 1036 1037 1316 1038 1181 1318 1185 1186 1187 1323 1189 1325 1192 1049 1193 1052 1051 1054  744 1197 1334 1199 1201 1060 1337 1062 1339 1205 1207 1208 1209 1210 1211 1070  921  764  599  426  245   56
 185  370  547  716  877 1030 1031 1029 1311 1314 1442 1315 1319 1320 1564 1321 1322 1450 1324 1188 1571 1327 1194 1191 1330 1195 1332 1198  904 1333 1200 1465 1582 1338 1203 1585 1586 1342 1343 1344 1345 1212 1071  922  765  600  427  246   57
 184  369  546  715  876 1028 1173 1175 1174 1440 1441 1317 1445 1563 1566 1448 1678 1568 1449 1451 1572 1326 1454 1573 1455 1456 1457 1459 1460 1461 1335 1336 1464 1584 1340 1204 1206 1588 1470 1471 1346 1213 1072  923  766  601  428  247   58
 183  368  545  714  875 1027 1310 1439 1312 1560 1561 1443 1562 1565 1675 1184 1676 1677 1569 1452 1570 1453 1574 1575 1576 1577 1458 1578 1579 1580 1462 1463 1694 1466 1583 1587 1341 1468 1589 1472 1347 1215 1214  924  767  602  429  248   59
 182  367  544  713  874 1172 1309 1308 1438 1559 1672 1674 1776 1778 1873 1679 1781 1567 1680 1785 1682 1683 1684 1685 1686 1687 1688 1689 1690 1691 1581 1796 1695 1696 1697 1469 1698 1591 1699 1473 1348 1073 1074  768  769  603  430  249   60
 181  366  543  712  873 1170 1307 1558 1671 1557 1670 1673 1444 1446 1779 1447 1875 1782 1783 1681 1784 1786 1787 1788 1789 1790 1791 1792 1793 1794 1693 1692 1797 1798 1799 1894 1801 1702 1590 1474 1349 1216 1075  925  770  604  431  250   61
 180  365  542  711  872 1026 1171 1436 1437 1775 1669 1774 1872 1961 1962 1874 1780 1877 1878 1879 1880 1881 1882 1883 1884 1885 1886 1887 1888 1889 1795 1890 1892 1893 1895 1800 1701 1700 1592 1350 1351 1217 1218  928  926  605  432  251   62
 179  364  541  710  871 1024 1025 1306 1434 1435 1556 1871 1777 1960 2040 2041 1876 1964 2043 1966 1967 1968 1969 1970 1971 1972 1973 1974 1975 1977 1978 1891 1979 1980 1981 1896 1802 1803 1476 1475 1594 1077  927 1076  771  607  606  252   63
 178  363  540  870 1023 1168 1169 1305 1555 1554 1668 1773 1870 1959 2042 2112 1963 2044 1965 2045 2046 2047 2048 2049 2050 2051 2052 2053 2055 1976 2056 2057 2058 2059 1982 1898 1703 1897 1593 1478 1595 1219 1078  929  772  435  433  253   64
 177  362  539  709  707 1022 1167 1304 1433 1667 1772 1770 1869 1958 2039 2113 2176 2114 2115 2116 2117 2118 2119 2120 2121 2122 2123 2124 2054 2125 2127 2128 2129 2060 1984 1804 1705 1806 1805 1477 1352 1353  608  434  773  255  774   65   66
 176  361  538  706  708  869 1021 1166 1432 1553 1666 1769 1771 1868 1957 2038 2111 2177 2178 2179 2180 2181 2182 2183 2184 2185 2186 2188 2189 2126 2190 2191 2130 2061 1899 1983 1807 1704 1480 1596 1354 1220 1079  930  931  609  611  254   67
 175  360  537  867 1020  868 1302 1303 1431 1552 1665 1867 1956 1955 2037 2110 2175 2232 2233 2234 2235 2236 2237 2238 2239 2240 2242 2187 2243 2244 2245 2192 2131 2062 1985 1900 1706 1597 1708 1479 1355 1221 1222 1080 1081  776  436  438  256
 174  359  536  705  866 1019 1165 1164 1430 1551 1664 1768 1865 1866 2036 2109 2174 2231 2281 2283 2282 2284 2324 2323 2286 2287 2241 2288 2290 2291 2246 2193 2132 2063 1987 1986 1901 1707 1599 1598 1356 1083 1082  933  932  775  439  610  257
 173  358  535  704  865 1018 1163 1301 1429 1550 1663 1767 1954 2034 2035 2108 2173 2279 2280 2319 2353 2321 2325 2326 2356 2357 2328 2289 2330 2292 2247 2194 2133 2064 1988 1902 1808 1809 1481 1482 1357 1084 1223  936  437  612  259  258   68
 172  357  703  864 1017 1299 1428 1300 1427 1549 1661 1662 1864 1953 2107 2172 2229 2230 2320 2228 2352 2376 2285 2377 2380 2358 2327 2329 2359 2294 2248 2134 2135 2066 2065 1903 1810 1600 1709 1483 1358 1224 1085  934  777  440   70  260   69
 171  356  534  702  863 1016 1162 1298 1297 1548 1660 1765 1766 1863 2033 2106 2171 2278 2277 2317 2351 2322 2354 2379 2394 2395 2381 2360 2293 2196 2249 2195 2068 2067 1989 1711 1811 1602 1601 1359 1226 1225 1086  935  778  779  441  261   71
 170  532  700  861  862 1014 1161 1159 1296 1425 1547 1764 1862 1952 2105 2032 2169 2227 2314 2318 2276 2392 2355 2378 2396 2382 2383 2361 2331 2332 2197 2252 2251 2137 1990 1904 1812 1713 1485 1484 1360 1227  937  780  615  613  614  442   72
 355  533  701  530  699 1013 1015 1158 1426 1659 1546 1763 1860 1951 2170 2168 2103 2226 2275 2316 2349 2375 2374 2400 2393 2397 2362 2333 2334 2250 2296 2295 2199 2136 1991 1905 1815 1710 1712 1486 1361 1228 1087  938  781  616  443  262   73
 169  354  531  859  698  860 1294 1160 1544 1762 1424 1658 1950 1861 2031 2101 2104 2225 2272 2315 2350 2343 2348 2391 2390 2388 2384 2363 2335 2297 2253 2069 2198 1993 1906 1907 1813 1715 1605 1603 1487 1229 1088  939  782  617  444  263   74
 353  168  528  351 1012 1009 1011 1295 1543 1423 1655 1656 1859 2029 1949 2224 2030 2271 2371 2274 2373 2372 2369 2399 2389 2387 2398 2385 2364 2298 2254 2200 2070 2138 1992 1995 1817 1814 1604 1488 1362 1230 1089  940  783  618  445   76   77
 167  529  350  697 1010 1154  857 1157 1156 1657 1654 1858 1857 1948 1947 2167 2028 2313 2273 2312 2346 2370 2347 2368 2341 2386 2366 2365 2336 2299 2201 2141 2140 2139 1910 1909 1816 1714 1606 1489 1363 1364 1231 1090  784  619  446   75   78
 166  349  352  696  858  856 1155 1293 1421 1545 1760 1761 1856 2099 1946 2026 2102 2223 2221 2267 2311 2345 2344 2342 2306 2367 2339 2338 2337 2300 2255 1994 2202 2071 2074 1911 1908 1717 1607 1490 1365 1232  942  941  785  620  447  264  268
 523  164  527  695  854  693 1292 1153 1420 1542 1759 1945 1653 1943 2025 2100 2027 2222 2164 2269 2268 2308 2265 2264 2307 2340 2304 2303 2302 2301 2256 2203 2143 2072 1820 1913 1716 1819 1608 1491 1366 1233 1091 1092  449  622  621  265  266
 163  347  348 1006 1008 1422 1007 1419 1288 1539 1758 1757 2024 1855 2098 2165 2166 2163 2218 2310 2309 2270 2213 2266 2261 2305 2210 2260 2259 2258 2204 2205 2145 2142 1821 1996 1912 1610 1718 1367 1234 1235 1093  786  943  624  267   80  448
 524  165  345  525  522 1291  694 1290 1416 1538 1418 1540 1854 2097 1944 2096 2162 2220 2219 2217 2216 2215 2263 2154 2212 2152 2262 2209 2208 2207 2257 2079 2206 1998 1997 2073 1818 1719 1493 1609 1368 1094  945  944  787  623  450  269   79
 526  162  346 1152 1004  852 1149 1151 1005 1415 1541 1652 1942 1852 2023 2095 2160 2093 2159 2158 2155 2214 2089 2211 2086 2153 2151 2150 2149 2148 2147 2144 2076 2002 2077 1999 1822 1720 1611 1492 1494 1237 1236 1095  789  451  270   81   82
 692  855  521 1150  850  849 1289 1537 1414 1413 1755 1651 1853 1756 1941 2022 2161 1935 2092 2156 2157 2014 2088 2087 2011 2085 2084 2083 2082 2081 2080 2146 1919 1921 2075 1916 1914 1612 1495 1370 1369 1096  946  947  790  625  452  272  271
 161  520  158  342  853  691 1287 1417 1650 1649 1754 1752 1851 1940 2019 1937 2020 1934 2090 2015 2016 1930 2013 2012 1928 2010 2009 2008 2007 2006 2005 2078 2003 1828 2000 2001 1721 1823 1613 1496 1371 1238  788 1239  948  626  453  273   83
 343  690  519  155  851 1285 1001  518 1148 1536 1534 1751 1850 1938 2021 1936 2018 1843 2017 2091 1931 1839 1840 1929 1837 1927 1926 1924 1923 1733 1831 1920 1829 2004 1917 1824 1915 1722 1723 1499 1614 1372 1097  949 1098  627  454   84   85
 160  341  157  688 1003  344 1286 1145 1002 1753 1648 1849 1848 1939 1847 1748 2094 1844 1842 1932 1742 1841 1838 1632 1739 1836 1834 1925 1734 1833 1830 1922 1827 1622 1918 1826 1825 1724 1498 1615 1497 1240 1099  793  791  456  628  274   86
 156  338  159  517 1000 1146 1282 1284 1412 1535 1647 1644 1750 1529 1403 1845 1846 1524 1637 1744 1741 1933 1740 1738 1737 1736 1835 1513 1735 1626 1832 1732 1730 1729 1728 1727 1725 1616 1617 1373 1374 1100  795  950  792  629  794  455  275
 154  686 1283  848 1281 1147  847 1280 1411 1646 1532 1530 1643 1133 1747 1749 1640 1639 1634 1635 1520 1636 1633 1631 1516 1629 1628 1390 1627 1511 1625 1731 1624 1623 1621 1620 1726 1618 1502 1101 1375 1241  954 1102  276  952  796  457   87
 689 1533  515  339  682  684 1144  687 1409 1531 1407 1645 1273 1526 1134 1129 1641 1743 1525 1522 1397 1521 1396 1518 1515 1630 1514 1512 1258 1388 1510 1509 1508 1507 1506 1505 1619 1376 1500 1378 1245 1246 1242  951  631  798  277  630  459
 152  685  153  999  340  846 1143 1408 1277 1410 1275 1405 1642 1274 1528 1401 1746 1745 1638 1398 1266 1265 1519 1517 1393 1392 1391 1259 1119 1389 1257 1386 1385 1384 1383 1382 1504 1503 1379 1243    0 1380 1103 1244  633  278  797   88   89
 337  151  335  516  514  683  997  845 1278  993 1138 1136 1406 1137 1527 1272 1131 1270 1400 1399 1267 1264 1395 1394 1263 1262 1261 1120 1118 1256 1387 1255 1254 1253 1252 1251 1110 1111 1501 1377 1247 1249  953  799  956  458  461  460   90
 336  150  149  513  995  996 1142 1140 1279  998 1276 1139 1135 1402 1271  984 1268 1523 1269 1128 1126 1125  978 1124 1123 1122 1260 1121  969  972  971 1116 1114 1113 1112  965 1250 1248 1108 1381 1104  804  955 1105  800  632  634   91  279
 678  148  844  841  681 1141  843  838  994  991  990  989  987 1132 1404  828  666  983  981  826 1127  979  977  822  658  976  975  974  973  816 1117  653 1115  967  966  808  964  960  961  805  469 1107 1106  957  635  282  466  462  281
 680  334  510  507  840  839  992  675  837  836  674  500  835  831  833  830  988  985  982  663  980  490  823  659  821  820  819  818  815  482  651  968  814  812  811  646  810 1109  963  642  471  959  641  958  637  288  463   93   92
 332  511  842  508  333  330  676  677  673  834  672  671  497  832  496 1130  827  664  493  662  825  661  660  487  486  657  655  654  817  652  481  479  650  649  477  809  645  807  962  107  806  801  640  802  287  636  280  283  465
 145  509  512  506  327  679  502  504  322  320  503  669  670  986  319  667  495  665  494  312  492  824  491  308  485  306  656  484  483  303  115  970  813  298  299  647  295  643  472  644  293  638  467  290  803  284  464  286   94
 144  147  146  329  140  328  325  324  323  501  136  668  499  132  498  317  130  829  315  314  311  310  488  489  309  119  307  305  304  302  114  480  648  112  476  110  296  474  473  289  104  475  291  639  470  100  285   98   95
 143  142  331  141  505  139  326  138  137  135  321  133  318  134  131  316  128  129  127  313  126  125  124  123  121  122  120  118  117  116  301  113  478  300  297  111  109  108  292  294  105  106  468  103  102  101   99   97   96
