# This puzzle is unsolvable
43
   2    1    3    4    5    6    7    8    9   10   11   12   13   14   15   16   17   18   19   20   21   22   24  193  190   27  350   28   29   30   31   32   34   35   36  203   37   38   39   40   41   42   43
 168  169  170  331  171  173  174  175  176  177  178  179  180  181  182  183  184  185  186  187  188  189   23   25   26  194  780  195  196  197  198  199   33  201  361  200  363  204  206  207  367  208   44
 167  329  623  482  330  332  333  334  335  336  337  338  339  340  341  342  343  344  345  346  347  348  349  502  351  191  352  353  505  355  358  509  359  510  512  202  362  205  364  365  366  209  210
 166  328  481  479  172  483  484  485  486  487  488  489  490  491  492  493  494  496  497  498  640  499  642  500  192  504  506  354  356  786  508  652  511  360  655  513  514  515  516  517  368  211   45
 165  480  327  624  759  625  627  628  629  630  631  632  633  634  635  636  637  495  773  639  641  777  778  644  646  507  909  648  650  912  357  651  653  654  656  791  657  658  659  518  212   47   46
 164  326  478  760  888  626  762  763  764  765  766  767  768  769  770  771  772  638  776  774  903 1134  643  779  781  501 1028  782  910 1031  787  914  788  917  789  918  792  793  519  371  369  370   48
 163  325  477  622  758  761  889  890  891  892  893  894  895  896  897  898  899  900  901  902 1023  775  645  906  907  503  649  647  783  911 1030 1033  915  790 1249 1036  794  661  660  372   49  213   51
 323  324  476  621  757  887 1008 1009 1010 1011 1012 1013 1014 1015 1016 1017 1018 1019 1020 1132 1021 1236  905 1027 1137  784 1141 1029 1140 1144  913 1343 1247 1035  923 1037  919  795  662  214  520   50  215
 162  322  475  620  756  886 1007 1120 1121 1122 1123 1124 1125 1126 1127 1128 1129 1234 1022  904 1329 1024 1025 1026 1241 1240 1138  908 1243  785 1032 1143  916 1342 1148 1040 1147  920  664  663  523  374  521
 161  321  474  619  755  885 1006 1119 1224 1225 1226 1227 1229 1230 1231 1326 1328 1232 1130 1237 1133 1135 1136 1333 1239 1336 1139 1242 1244 1142 1245 1034 1145 1248 1146 1038  922  524  665  522  525   54  216
 160  320  473  618  884 1005 1004 1118 1223 1320 1321 1322 1228 1324 1325 1327 1233 1131 1235 1419 1418 1498 1238 1332 1335 1337 1424 1338 1339 1340 1341 1246 1344 1149 1153 1041  796 1039 1150  797  217  221   52
 159  319  472  617  883  753 1116 1003 1222 1319 1408 1409 1323 1411 1412 1413 1414 1415 1629 1331 1417 1330 1497 1334 1501 1422 1423 1425 1426 1427 1428 1429 1251  666 1151 1250  800  921  373  667  376  219   53
 158  318  471  616  754  882 1002 1117 1221 1318 1407 1488 1410 1490 1491 1492 1564 1493 1496 1416 1495 1569 1420 1421 1573 1572 1503 1504 1505 1506 1507 1430 1345 1042 1253 1043  926  799  220  377   56   57  218
 157  156  470  615  880  879  881 1113 1115 1405 1317 1560 1489 1561 1562 1626 1563 1566 1565 1631 1685 1571 1499 1500 1634 1502 1574 1575 1576 1577 1508 1432 1431 1346  925 1044 1152  668  798  528  379   55  375
 155  317  614  751  752 1001 1000 1110 1114 1406 1404 1487 1559 1624 1625 1681 1627 1628 1684 1568 1632 1633 1687 1570 1635 1636 1637 1638 1580 1639 1348 1578 1509 1349 1154 1252  802  927  669  222  381  223   58
 315  316  469  468  613  750 1217 1220 1315 1316 1485 1486 1558 1623 1680 1728 1682 1683 1630 1494 1733 1567 1686 1690 1736 1691 1692 1693 1640 1433 1510 1347 1254 1435 1255 1155  924  671  526  527  378  380  224
 154  314  467  612  749  878  999 1218 1314 1219 1403 1484 1557 1622 1679 1729 1768 1730 1731 1732 1772 1734 1688 1735 1738 1778 1739 1694 1641 1350 1512 1256 1258 1351  670 1045  803  801  672  529  530  382   59
 153  313  466  611  748  877  998 1112 1215 1216 1402 1556 1554 1678 1620 1621 1726 1769 1770 1801 1771 1804 1773 1774 1689 1740 1642 1743 1643 1579 1581 1257 1511 1047  807 1046  805  928  932  531  383  225   60
 152  312  465  610  876  746  997 1111 1108 1313 1401 1481 1553 1555 1551 1727 1725 1767 1824 1802 1828 1805 1775 1808 1737 1780 1776 1695 1696 1437 1436 1434 1259 1156 1157  930  806  929  532  385  384   61   62
 151  310  311  609  747  874 1109  995 1214 1398 1312 1483 1311 1676 1724 1619 1766 1799 1825 1826 1800 1831 1844 1777 1779 1810 1741 1644 1514 1513 1353 1438 1352 1260 1158  931  933  804  673  386  677  387  226
 150  149  464  463  608  996  992  875 1212 1306 1395 1399 1477 1618 1764 1765 1723 1722 1798 1823 1827 1829 1806 1807 1809 1744 1697 1647 1583 1700 1515 1354 1440 1355 1049 1048  808  533  675  674  228  227   63
 148  309  607  873  994  745  872 1107  993 1397 1310 1482 1552 1675 1615 1677 1762 1822 1821 1839 1803 1842 1845 1843 1811 1846 1699 1645 1585 1582 1516 1439 1161 1050 1052  934 1163  810  809  676  229  230   64
 147  308  462  744  606  868 1211 1400 1480 1213 1309 1106 1478 1616 1672 1674 1763 1794 1797 1840 1838 1835 1832 1830 1781 1783 1742 1646 1584 1698 1745 1517 1261 1159 1262 1160 1051  935  535  536  534   65   66
 146  307  461  460  743  991  869 1302 1210 1305 1476 1396 1550 1673 1479 1549 1796 1721 1847 1848 1836 1815 1841 1833 1812 1648 1782 1701 1586 1587 1588 1441 1162 1263 1053  678  814  936  680  537  232  389  231
 145  306  459  605  871  990  604 1105 1102 1208 1307 1614 1617 1720 1671 1719 1759 1795 1837 1818 1816 1814 1834 1788 1813 1785 1746 1784 1748 1518 1519 1443 1442 1356 1054 1165  812  538  811  540  388   67   68
 144  305  602  603  738  457  988 1394 1209 1104 1473 1475 1474 1670 1760 1792 1758 1761 1819 1791 1817 1754 1789 1750 1752 1786 1702 1747 1650 1649 1589 1359 1357 1264 1056 1164  939  938  937  813  390  233   69
 143  304  458  739  742  867 1103  741  987 1308 1207 1613 1547 1548 1668 1718 1793 1820 1757 1756 1711 1712 1790 1751 1787 1707 1749 1703 1590 1444 1520 1445 1358 1265 1267 1055  679  815  681  539  541  391  234
 141  303  601  870  866  740 1101 1206  989 1390 1611 1304 1610 1546 1612 1717 1716 1715 1714 1713 1755 1710 1753 1708 1655 1597 1656 1704 1653 1592 1521 1652 1522 1266 1057  942  940  682  236  392  235   70   71
 142  456  302  454  600 1100  737 1099 1391 1393 1389 1392 1669 1667 1665 1542 1606 1664 1663 1662 1661 1660 1659 1709 1598 1657 1706 1705 1654 1651 1446 1591 1360 1361 1268 1166  943  544  393  395  542   73   72
 140  301  599  598  736  985  864 1301 1303 1205 1471 1472 1544 1609 1666 1605 1607 1538 1604 1603 1602 1601 1600 1532 1599 1529 1530 1595 1594 1593 1176 1523 1524 1447 1270 1167 1169  685  816  941  543  683  237
 455  139  299  452  735  865 1098  986 1204 1203 1388 1545 1543 1608 1467 1540 1464 1539 1537 1536 1535 1459 1534 1533 1658 1531 1596 1528 1527 1526 1525 1450 1366 1059 1269  944  687  546 1061  684  394  396  239
 298  300  453  597  734  984 1097 1202 1201 1387 1300 1470 1468 1385 1466 1541 1381 1463 1462 1461 1460 1458 1457 1456 1455 1454 1281 1452 1368 1451 1367 1275 1449 1170 1363 1058 1168  818  545  686  238  241   74
 138  137  451  596  733  863  983 1096 1298 1469 1299 1295 1196  973 1384 1465 1383 1289 1380 1378 1377 1376 1375 1374 1373 1372 1280 1371 1369 1277 1364 1362 1274 1448 1064 1060  817  946  821  819  242  398  240
 136  135  296  595  732  862  982 1095 1200 1297 1296 1294 1386 1293 1292 1382 1291 1190 1379 1288 1080 1077 1185 1284 1283 1282 1181 1453 1279 1178 1278 1272 1271 1069 1365 1174 1063  945  688  548  397   75  399
 134  297  450  594  859  861  981 1093 1094 1198 1197 1089 1195 1193 1087 1192 1191 1189 1290 1187 1287 1285 1286 1184 1183 1182 1180 1179 1370 1072 1276  955 1172 1068  947 1062  824  820  822  550  401   76   77
 295  449  448  593  731  860  730  980 1091 1199  974  975 1088 1194  971 1086 1084 1083  967 1082 1188 1078 1186 1076  961 1075 1074 1073  956  563 1177  700 1175  953 1273  831 1171  691  689  400  249  547  243
 133  294  447  592  729  858  979 1092  978  977  976 1090  851  972  848 1085  970  969  968 1079  966  842  841  840  963  962  960  958 1071  701  699  952  834  698  948  950  557  692  825  823  402  551  555
 132  293  446  591  728  857  856  855  853  722  721  852  850  717  849  847  846  714  711  843 1081  964  965  708  839  838  959  704  562  835  957  560  951 1066   93 1173  949 1065  554   80  553  247  690
 131  292  445  590  727  726  586  725  724  854  582  580  720  718  716  713  712  844  845  572  710  709  570  568  706  705  836  564  833  830  559  828  954  412   91 1067  408  826  694  244  248  245  552
 130  291  444  589  588  440  587  281  585  584  436  435  583  719  579  715  576  575  574  426  571  569  423  707  567  837  420  565  415 1070  703  260  832  695  410  696  556  693  251  406   78   88   82
 129  290  443  442  286  441  285  723  434  282  279  433  278  431  578  577  430  429  428  425  573  424  268  422  421  419  566  418  417  261  702   92  413  258  558   95  827  253  549  250  405   81   79
 128  289  288  124  287  284  121  439  438  116  581  115  432  276  275  110  273  427  274  270  269  105  106  267  265  264  100  262   99  257   96  414  829  259  411    0  254  255  407   87  246   83  404
 127  126  125  123  122  120  283  119  437  118  280  117  114  277  113  112  111  109  271  108  272  107  104  103  266  102  263  101   98  416   97  561   94   90  697  409  256  252   89   86   84   85  403
