# This puzzle is unsolvable
60
   2    1    3    4    5    6    7    8    9   10   11   12   13   14   15   16   17   18   19   20   21   22   23   24   25   26   27   28   29   30   31   32   33   34   35   36   37   38   39   40   41   42   43   44   45   46   47   48   50  286   51   52   53  288   57   56   59  292  294   60
 236  237  238  239  240  241  242  243  244  245  246  247  248  249  250  251  252  253  254  255  256  257  258  259  260  261  262  263  264  265  266  267  268  269  270  271  272  273  274  275  276  277  278  279  280  281  284  509  285   49  511  512  515   54   55  293  295   61   62   63
 235  464  465  466  467  468  469  470  471  472  473  474  475  476  477  478  479  480  481  482  483  484  485  486  487  488  489  490  491  492  493  494  495  496  497  498  499  500  501  502  503  504  505  506  507  508  282  283  510  944  736  287  514  737 1151  521  291   64  296  298
 234  463  684  685  686  687  688  689  690  691  692  693  694  695  696  697  698  699  700  701  702  703  704  705  706  707  708  709  710  711  712  713  714  715  716  717  718  719  720  721  722  723  724  725  726  728  729  731  942 1341  945  943  733  732  738  290  520  518  947  739
 233  462  683  896  897  898  899  900  901  902  903  904  905  906  907  908  909  910  911  912  913  914  915  916  917  918  919  920  921  922  923  924  925  926  927  928  929  930  931  932  933  934  935  936  937  727  939  940  941 1145  289  516  735  734 1149  517  519  523  301   66
 232  461  682  895 1100 1101 1102 1103 1104 1105 1106 1108 1302 1109 1110 1111 1112 1113 1114 1115 1116 1117 1118 1119 1120 1121 1122 1123 1124 1125 1126 1127 1128 1129 1130 1131 1132 1133 1134 1135 1136 1137 1138 1139 1140  938 1143 1146 1144 1346 1344 1529 1150  950  948 1343   58  297  522   67
 231  460  681  894 1099 1296 1297 1298 1299 1300 1301 1107 1303 1304 1305 1306 1307 1308 1309 1310 1311 1312 1313 1314 1315 1316 1317 1318 1319 1320 1321 1322 1323 1324 1325 1326 1327 1328 1329 1330 1331 1332 1333 1334 1335 1141 1142 1339 1704  730 1531  946 1342 1152 1148 1147   65   68  740  302
 230  459  680  893 1098 1295 1484 1485 1486 1488 1490 1667 1669 1670 1491 1492 1494 1495 1496 1497 1498 1499 1500 1501 1502 1503 1504 1505 1506 1507 1508 1509 1510 1511 1512 1513 1514 1515 1516 1517 1518 1519 1520 1521 1522 1336 1525 1337  513 1338 1340 1527 1528 1530  949  951  741 1345  525  527
 229  458  679  892 1097 1294 1483 1664 1665 1487 2001 1666 1489 1840 1671 1493 1673 1674 1675 1676 1677 1678 1679 1680 1681 1682 1683 1684 1685 1686 1687 1688 1689 1690 1691 1692 1693 1694 1695 1696 1697 1698 1699 1700 1523 1524 1703 1875 1526 1877 1879 1706 1532 1709 1153  743  524  744  299  300
 228  457  678  891 1096 1293 1482 1663 1836 1837 1668 2003 1838 2005 1841 1672 1842 1845 1846 1847 1848 1849 1850 1851 1852 1853 1854 1855 1856 1857 1858 1859 1860 1861 1862 1863 1864 1865 1866 1867 1868 1869 1870 1871 1701 1702 1873 2037 1874 1705 1876 1707 1708 1347 1154  742  954  952   71   69
 227  456  677  890 1095 1292 1480 1481 1662 1833 2002 1839 2004 2159 1843 2308 1844 2007 2009 2010 2011 2012 2013 2014 2015 2016 2017 2018 2019 2020 2021 2022 2023 2024 2025 2026 2027 2028 2029 2030 2031 2032 2034 2035 1872 2036 2193 2038 2039 2040 1881 1711 1710 1350 1348  746 1349  526   70  528
 225  226  455  676  889 1093 1291 1479 1835 1834 1999 2156 2158 2306 2162 2161 2006 2008 2164 2165 2166 2167 2168 2169 2170 2171 2172 2173 2174 2175 2176 2177 2178 2179 2180 2181 2182 2183 2184 2185 2186 2187 2033 2189 2190 2476 2338 2191 1880 2195 1878 1712 1714 1533  529  955  953  305  303  745
 224  454  453  675 1290 1094 1660 1661 1998 2000 2157 2304 1997 2305 2160 2307 2309 2163 2311 2312 2313 2314 2315 2316 2317 2318 2319 2320 2321 2322 2323 2324 2325 2326 2327 2328 2329 2330 2331 2332 2333 2334 2188 2335 2336 2477 2339 2041 2194 2043 2042 1535 1157 1156 1155  747 1159  530  304   72
 222  452  223  886  888  887 1092 1659 1832 2155 2443 2303 2302 2576 2446 2447 2448 2310 2449 2451 2452 2453 2454 2455 2456 2457 2458 2459 2460 2461 2462 2463 2464 2465 2466 2467 2468 2469 2470 2471 2472 2473 2474 2475 2192 2337 2341 2609 2342 2196 2197 1713 1158 1536 1534  956  958  748  306   73
 884  671  674  673 1091 1289 1830 1657 1478 1658 2154 2301 2445 2444 2577 2578 2579 2580 2450 2582 2583 2584 2585 2586 2587 2588 2589 2590 2591 2592 2593 2594 2595 2596 2597 2598 2599 2600 2601 2602 2603 2604 2605 2606 2607 2608 2479 2340 2198 2044 1882 1883 1160  752  533 1352  749  531  532   74
 221  670  451  885 1090 1477 1288 1829 1995 1831 1996 2153 2442 2575 2700 2701 2702 2703 2581 2705 2706 2707 2708 2709 2710 2711 2712 2713 2714 2715 2716 2717 2718 2719 2720 2721 2722 2723 2724 2725 2726 2727 2728 2729 2730 2480 2478 2343 2199 2045 1884 1885 1715 1354 1539  957 1351  534  307  308
 220  450  672 1088 1089 1656 1285 1476 1655 1828 1994 2300 2440 2574 2699 2816 2817 2818 2704 2819 2821 2822 2823 2824 2825 2826 2827 2828 2829 2830 2831 2832 2833 2834 2835 2836 2837 2838 2839 2840 2841 2842 2843 2844 2731 2610 2481 2344 2046 1886 1716 1537 1163 1538 1353 1161  750  309   77   75
 447  449  882  883 1287 1284 1475 1826 2151 2149 2152 2441 2299 2573 2698 2815 2924 2925 2927 2820 2928 2929 2930 2931 2932 2933 2934 2935 2936 2937 2938 2939 2940 2941 2942 2943 2944 2945 2946 2947 2948 2949 2950 2845 2732 2611 2482 2345 2200 2047 1717 1718 1356 1540  959 1355 1162  310  311   76
 446  218 1087 1086 1472 1474 1282 1652 1654 1993 2150 2297 2439 2572 2697 2814 2923 3024 2926 3026 3027 3028 3029 3030 3031 3032 3033 3034 3035 3036 3037 3038 3039 3040 3041 3042 3043 3044 3045 3046 3047 3048 2951 2846 2733 2612 2483 2346 2202 2201 2048 1542 1541  960  535  753  751  536  312   78
 444  448  880  219  665 1286 1084 1827 1992 1991 2298 2296 2438 2571 2696 2813 2922 3023 3025 3117 3118 3119 3120 3121 3122 3123 3124 3125 3126 3127 3128 3129 3130 3131 3132 3133 3134 3135 3136 3137 3138 3049 2952 2847 2734 2613 2484 2347 2203 2049 1887 1888 1358 1357  962  961  964  754  537   79
 217  668  669  664 1283  881 1473 1469 1653 1990 2146 2148 2147 2437 2695 2812 2921 3022 3116 3201 3199 3202 3203 3204 3205 3206 3207 3208 3209 3210 3211 3212 3213 3214 3215 3216 3217 3218 3219 3220 3139 3050 2953 2848 2735 2614 2485 2348 2204 2050 1889 1719 1890 1164 1543  965  755  538  313   80
 445  879  667 1085 1651 1083 2144 1470 1825 1824 1989 2295 2569 2570 2694 2811 2920 3021 3115 3114 3276 3277 3278 3279 3280 3281 3282 3283 3284 3285 3286 3287 3288 3289 3290 3291 3292 3293 3294 3221 3140 3051 2954 2849 2736 2615 2486 2349 2051 2052 1891 1723 1720 1167  963 1165  756  539  314   81
 214  216 1648 1277 1279  876 1281 1471 1467 1823 2294 2435 2436 2568 2693 2810 2919 3020 3113 3200 3198 3344 3345 3346 3347 3348 3349 3350 3351 3352 3353 3354 3355 3356 3357 3358 3359 3360 3295 3222 3141 3052 2955 2850 2737 2616 2487 2350 1892 2206 2053 1721 1360 1722 1359 1166  757  540  315   82
 666  213  662  877 1081 1985 1082 1987 2145 2291 1821 2434 1988 2567 2692 2809 2918 3019 3112 3197 3275 3274 3403 3405 3406 3407 3408 3409 3410 3411 3412 3413 3414 3415 3416 3417 3418 3361 3296 3223 3142 3053 2956 2851 2738 2617 2488 2351 2205 1894 1545 1547 1544 1546 1361  966  758  759  316   83
 443 1280  663  215 1278 1465 1647 1822 2142 1649 2143 1820 2292 2566 2691 2808 2917 3110 3018 3272 3196 3404 3343 3456 3457 3458 3459 3460 3461 3462 3463 3464 3465 3466 3467 3468 3419 3362 3297 3224 3143 3054 2957 2852 2739 2618 2489 2352 2207 1725 2054 1724 1362 1169  968  969  542  541  317   84
 441  442  661 1080 1079 1276 1466 1464 1646 1986 1984 2290 2433 2564 2690 2916 2915 3017 3195 3194 3341 3273 3402 3455 3500 3501 3502 3503 3504 3505 3506 3507 3508 3509 3510 3469 3420 3363 3298 3225 3144 3055 2958 2853 2740 2619 2490 2353 2208 2055 2057 1550 1548 1363 1168  760  967  543  318   85
 437  440 1075  875  878 1275 1644 1819 1983 1468 2431 2430 2432 2563 2806 2807 3016 3015 3111 3271 3340 3342 3401 3454 3499 3536 3537 3538 3539 3540 3541 3542 3543 3544 3511 3470 3421 3364 3299 3226 3145 3056 2959 2854 2741 2620 2491 2354 2209 1893 1895 1549 1364 1171 1170  970  761  544  319   86
 212  211  439  438 1078 1274  873 1818 1650 2293 2289 2689 2565 2562 2688 2805 2914 3108 3109 3193 3270 3339 3400 3453 3498 3535 3564 3565 3566 3567 3568 3569 3570 3545 3512 3471 3422 3365 3300 3227 3146 3057 2960 2855 2742 2621 2492 2355 1897 2056 1728 1896 1726 1365 1172  971  762  545  320   87
 210  209 1077 1076 1271 1462 1645 1463 1817 2141 2288 2140 2139 2687 2804 2913 2803 3014 3107 3192 3269 3338 3399 3452 3497 3534 3563 3584 3585 3586 3587 3588 3571 3546 3513 3472 3423 3366 3301 3228 3147 3058 2961 2856 2743 2622 2493 2356 2210 2058 2059 1727 1551 1366 1173  972  763  546  321   88
 659  208  871  872  874  657 1273 1461 1643 1816 1982 2137 2287 2429 2686 2685 2802 3013 3106 3191 3268 3337 3398 3451 3496 3533 3562 3583 3596 3597 3598 3589 3572 3547 3514 3473 3424 3367 3302 3229 3148 3059 2962 2857 2745 2744 2495 2494 2211 2357 2060 1898 1552 1367 1174  973  764  547  322   89
 207  658  870  656  869 1272 1642 1815 1981 1814 2138 2286 2426 2428 2561 2912 2801 2911 3105 3190 3267 3336 3397 3450 3495 3532 3561 3582 3595 3592 3593 3599 3573 3548 3515 3474 3425 3368 3303 3230 3149 3060 2963 2858 2623 2624 2358 2359 2213 2212 1899 1554 1732 1553 1175  974  765  548  323   90
 205  655  435  660 1641  436 1073 1460 1979 1980 2136 2135 2285 2427 2559 2560 2910 3012 3104 3189 3335 3334 3396 3449 3494 3531 3560 3581 3594 3578 3554 3590 3574 3549 3516 3475 3426 3369 3304 3231 3150 3061 2964 2859 2746 2625 2496 2360 2214 2061 1731 1730 1729 1368 1176  975  766  549  324   91
 204  206 1074  868 1269 1640 1459 1812 1813 1977 1978 2284 2425 2683 2800 2799 2558 3011 3010 3188 3265 3266 3395 3529 3448 3530 3559 3580 3556 3579 3553 3577 3575 3550 3517 3476 3427 3370 3305 3232 3151 3062 2965 2861 2747 2860 2626 2497 2361 2062 1900 1555 1370 1177 1178  976  767  550  325   92
 203  653  432  434 1270 1072 1071 1639 1810 2134 2556 2424 2555 2684 2557 2682 2798 3102 3103 3187 3264 3333 3447 3393 3492 3528 3558 3557 3525 3555 3576 3591 3522 3551 3519 3518 3428 3371 3306 3233 3152 3063 2966 2749 2498 2748 2362 2216 1902 2063 2064 1733 1373 1369  977  978  768  551  326   93
 202  866  654  867 1457 1458 1267 1638 1811 1976 2283 2281 2132 2554 2680 2908 2909 3009 3101 3186 3263 3332 3493 3394 3490 3388 3527 3526 3487 3524 3483 3485 3552 3481 3520 3477 3429 3372 3307 3234 3153 3064 2967 2863 2862 2217 2363 2215 2218 2065 1901 1903 1371 1557 1179  979  769  552  327   94
 201  433  652  865 1069 1637 1070 1455 1975 2282 2131 2553 2133 2423 2422 2797 2906 3008 3100 3185 3262 3331 3445 3491 3446 3441 3386 3440 3489 3486 3523 3484 3521 3482 3479 3478 3430 3373 3308 3235 3154 3065 2969 2750 2629 2627 2630 2220 2219 1734 2221 1736 1556 1558 1372  770  771  328  329   95
 430  431  650  651  864 1456 1454 1266 1809 2130 1971 2279 2421 2552 2681 2796 3006 2907 3007 3184 3261 3330 3392 3443 3444 3389 3324 3442 3385 3438 3437 3436 3435 3433 3480 3431 3377 3374 3309 3236 3157 3156 2864 2970 2628 2499 2751 2501 2066 1735 1377 1738 1559 1374 1180  980  554  553  330   96
 200  429  649  863 1068 1268 1636 1453 1635 2280 1973 1972 2679 2419 2678 2795 2905 2904 3099 3098 3183 3329 3391 3390 3325 3387 3322 3321 3488 3384 3382 3381 3380 3434 3432 3378 3313 3376 3310 3311 3237 3155 3066 2968 2752 2753 2631 2068 2067 2222 1906 1376 1560 1375  981 1183  772  556  555   97
 199  648  862  860 1067 1265 1264 1634 1807 1808 1974 2420 2278 2551 2793 2677 2903 3004 3097 3182 3181 3259 3327 3326 3253 3254 3323 3252 3439 3383 3319 3318 3317 3316 3379 3243 3314 3375 3239 3312 3238 2971 2865 2867 2866 2632 2366 2500 2070 1909 1904 1737 1182 1181 1184 1185  982  773  332   98
 198  428  861  647 1066 1263 1452 1806 1970 1805 2128 2277 2418 2676 2794 2792 2902 3005 3095 3258 3260 3328 3177 3256 3255 3173 3174 3250 3249 3320 3169 3247 3246 3245 3315 3244 3242 3241 3240 3158 3069 3067 2972 2868 2755 2633 2502 2364 2368 2069 2072 1380 1740 1561  983  984  774  331  557   99
 197  427  426  859 1065    0 1261 1633 1632 2127 2126 2417 2276 2550 2675 2901 3003 3002 3180 3096 3179 3257 3178 3176 3175 3087 3172 3171 3170 3248 3168 3081 3167 3165 3078 3164 3163 3162 3074 3160 3159 2974 3068 2757 2503 2754 2505 2365 2504 1907 1908 1378 1905 1186  985 1379  558  333  100  101
 425  424  645  646 1260 1451 1262 1450 1804 1969 2275 2274 2129 2549 2674 2791 2900 3000 3094 3093 3092 3091 3090 3089 2992 3086 3085 3251 3084 3083 3082 2986 3080 3166 3077 3076 3075 2980 3073 3161 3072 2977 2875 2973 2756 2369 2224 2225 2367 2223 1741 1742 1562 1739  987  776  775  334  336  335
 196  423  194  644 1064 1063 1630 1631 1803 1968 2125 2416 2414 2415 2548 2790 3001 2899 2999 2998 2997 2996 2995 2994 3088 2889 2991 2990 2989 2988 2987 2985 2881 3079 2983 2982 2878 2981 2979 2874 3071 2975 3070 2870 2634 2635 2506 2760 2071 2073 1911 1912 1910 1187 1563  560  559  561  778  102
 195  422  857  858 1062 1629 1449 1447 1802 1967 2124 2412 2273 2671 2669 2789 2898 2896 2665 2895 2894 2893 2892 2779 2993 2890 2777 2887 2886 2885 2884 2772 2984 2883 2882 2879 2877 2766 2876 2978 2976 2381 2761 2869 2637 2759 2758 2507 2372 2371 1743 1188 1566 1564 1189  986  562  779  337  103
 192  193  642  856 1061 1259 1448 1627 1628 1801 2123 2272 2413 2788 2547 2672 2897 2787 2786 2785 2783 2782 2781 2891 2780 2888 2658 2776 2775 2774 2773 2771 2770 2769 2880 2768 2767 2765 2646 2764 2762 2872 2873 2641 2640 2636 2373 2638 2370 2226 1913 1914 1744 1565 1382  988  777  564  338  104
 191  643  420  854 1060 1258 1446 1800 1964 1966 2122 2271 2270 2546 2542 2541 2670 2668 2784 2538 2664 2536 2663 2661 2660 2778 2659 2531 2656 2655 2654 2653 2652 2651 2650 2649 2648 2647 2519 2516 2644 2763 2871 2642 2514 2512 2509 2074 2075 2076 1745 1568 1381 1383 1190  989  781  565  105  106
 418  189  421 1059 1256 1257 1625 1799 1626 1965 2120 2410 2545 2673 2543 2408 2540 2666 2667 2403 2537 2402 2662 2534 2533 2532 2530 2657 2529 2528 2527 2526 2525 2524 2523 2522 2521 2520 2518 2643 2517 2238 2645 2379 2515 2511 2639 2508 2227 1915 1916 1746 1567 1569 1191  990  339  563  107  566
 855  639  419  641 1254 1058 1445 1444 1797 2268 1962 2269 2121 2409 2411 2544 2406 2405 2539 2259 2260 2400 2535 2399 2398 2397 2396 2395 2394 2393 2392 2391 2390 2389 2388 2387 2386 2385 2384 2240 2383 2513 2380 2378 2510 2377 2376 2374 1923 2230 2077 1748 1747 1384 1385 1192  782  567  340  108
 415  188  187  852  640 1255 1443 1622 1798 1624 1963 2119 2267 2265 2264 2407 2263 2262 2404 2110 2401 2258 2257 2256 2255 2254 2253 2252 2251 2250 2249 2248 2247 2246 2245 2244 2243 2242 2241 2382 2239 2088 2237 2235 2084 2234 1922 2375 2228 2078 1918 1749 1571 1570 1194 1193  992  783  780  341
 417  638 1057  853 1056 1623 1442 1795 1441 1961 2118 2117 2116 2266 2114 2113 2112 2111 2109 1950 2108 2107 2106 2105 2104 2103 2102 2101 2100 2099 2098 2097 2096 2095 2094 2093 2092 2091 2090 2089 2087 1928 2085 1926 1924 1758 2083 2233 2232 2231 2229 1750 1917 1386 1387  342  786  569  109  112
 416  190  637  850 1055 1251 1253 1960 1793 1794 1959 1958 1956 2115 1955 1954 1953 1952 1951 1949 2261 1948 1947 1946 1945 1944 1943 1942 1941 1940 1939 1938 1937 1936 1935 1934 1933 1932 1931 1930 1929 1761 1927 1759 1583 2086 2236 2080 2081 2079 1752 1920 1572 1195  991  784  785  568  110  343
 186  634  636  851  414  849 1252 1620 1621 1796 1792 1791 1957 1789 1788 1787 1786 1785 1784 1783 1782 1781 1780 1779 1778 1777 1776 1775 1774 1773 1772 1771 1770 1769 1768 1767 1766 1765 1764 1763 1762 1760 1584 1757 1399 1925 1756 2082 1395 1919 1751 1573 1574 1575  994 1388  993  787  111  345
 635  633  185 1054 1052 1053 1440 1436 1617 1618 1434 1616 1790 1614 1613 1612 1611 1610 1609 1608 1607 1606 1605 1604 1603 1602 1601 1600 1599 1598 1597 1596 1595 1594 1593 1592 1591 1590 1589 1588 1587 1586 1585 1400 1398 1206 1921 1753 1581 1579 1578 1577 1000 1198  996 1196  571  995  997  346
 413  184  847  848 1051 1247 1249 1246 1619 1437 1433 1432 1615 1431 1430 1429 1428 1427 1426 1425 1424 1423 1422 1421 1420 1419 1418 1417 1416 1415 1414 1413 1412 1411 1410 1409 1408 1407 1406 1405 1404 1403 1402 1210 1397 1582 1755 1205 1754 1394 1392 1199 1389 1197 1391  344  572  998  347  573
 182  412  411  846 1248 1438 1250 1439 1245 1435 1243 1242 1241 1240 1239 1238 1237 1236 1235 1234 1233 1232 1231 1230 1229 1228 1227 1226 1225 1224 1223 1222 1221 1220 1219 1218 1217 1216 1215 1214 1213 1212 1401 1211 1209 1008 1208 1207 1007 1396 1203 1202 1576 1390  999  789  788  575  113  570
 183  410  629  845 1050 1049 1048  841 1045 1244 1044 1043 1042 1041 1040 1039 1038 1037 1036 1035 1034 1033 1032 1031 1030 1029 1028 1027 1026 1025 1024 1023 1022 1021 1020 1019 1018 1017 1016 1015 1014 1013 1012 1011 1010 1580 1009 1006 1204 1005 1004 1003 1393 1200 1002  793  574  348  114  115
 179  409  405  844  843  842 1047  839 1046  838  837  836  835  834  833  832  831  830  829  828  827  826  825  824  823  822  821  820  819  818  817  816  815  814  813  812  811  810  809  808  807  806  805  804  803  802  801  800  799  798  797  796 1201  580 1001  791  577  349  350  116
 181  180  630  406  628  626  625  840  624  623  622  621  620  619  618  617  616  615  614  613  612  611  610  609  608  607  606  605  604  603  602  601  600  599  598  597  596  595  594  593  592  591  590  589  588  587  586  585  584  583  582  581  357  795  790  794  578  792  576  118
 632  408  177  174  404  627  172  402  401  400  399  398  397  396  395  394  393  392  391  390  389  388  387  386  385  384  383  382  381  380  379  378  377  376  375  374  373  372  371  370  369  368  367  366  365  364  363  362  361  360  359  358  579  355  124  354  353  352  117  119
 178  176  631  407  175  173  171  403  170  169  168  167  166  165  164  163  162  161  160  159  158  157  156  155  154  153  152  151  150  149  148  147  146  145  144  143  142  141  140  139  138  137  136  135  134  133  132  131  130  129  128  127  126  356  125  123  122  121  351  120
