# This puzzle is unsolvable
68
   2    1    3    4    5    6    7    8    9   10   11   12   13   14   15   16   18  285   19   20   22   23   24   25  292   26   27   28   29   31  297   32  301   33   35   36   37   38   40  307   41   42   43   44   45   46   47   48   49   50   51   52   53   54   55   56   57   58   59   60   61   62   63   64   65   66   67   68
 268  269  270  271  272  273  274  275  276  277  278  279  280  281  282  284   17  793  286  287   21  289  290  291  551  293  553  294  555  296  557   30  560  300  561  304  305  306   39  308  309  569  310  311  312  313  314  315  316  317  318  319  320  321  322  323  324  325  326  327  328  329  330  331  332  333  334   69
 267  528  529  530  531  532  533  534  535  536  537  538  539  540  541  283  544  545  795  546  288  547  549  801  550  803  552  295  808  556 1051  298  299  302  813  562  563 1058  564  816 1057  568  820  570  571  572  573  574  575  576  577  578  579  580  581  582  583  584  585  586  587  588  589  590  591  592  335   70
 266  527  780  781  782  783  784  785  786  787 1031  788  790  791  792  542 1035 1038  797 1041 1277  548  798  799  802  804  554 1048  805  807 1055 1286  809   34  811  303  815  812 1291  565  567  566  818  821  822  823  824  825  826  827  828  829  830  831  832  833  834  835  836  837  838  839  840  841  842  593  336   71
 265  526  779 1024 1025 1026 1027 1028 1029 1030  789 1032 1033 1034 1928  794  543 1272  796 1276 1042  800 1043 1280 1044 1046 1047  806 1284 1049 1052 1053 1515  559  558 1293 1056 1290  817 1059  819 1062 1063 1064 1065 1066 1067 1068 1069 1070 1071 1072 1073 1074 1075 1076 1077 1078 1079 1080 1081 1082 1083 1084  843  594  337   72
 264  525  778 1023 1260 1261 1262 1263 1264 1265 1266 1268 1497 1269 1270 1717 1273 1499 1040 1502 1503 1275 1506 1045 1507 1509 1282 1511 1510 1050 1514 1288 1289  810 1517  814 1738 1520 1522 1294 1061 1297 1298 1299 1300 1301 1302 1303 1304 1305 1306 1307 1308 1309 1310 1311 1312 1313 1314 1315 1316 1317 1318 1085  844  595  338   73
 263  524  777 1022 1259 1488 1489 1490 1491 1492 1493 1267 1494 1495 1498 1271 1036 1037 1039 1274 1504 1505 1725 1278 1508 1281 1727 1729 1283 1285 1513 1287 1518 1516 1736 1519 1292 1740 1060 1295 1296    0 1523 1524 1526 1528 1529 1530 1531 1532 1533 1534 1535 1536 1537 1538 1539 1540 1541 1542 1543 1544 1319 1086  845  596  339   74
 262  523  776 1021 1258 1487 1708 1709 1710 1711 1712 1713 1714 1715 1926 1716 1930 1500 1720 1721 1722 1723 1279 1936 1726 1938 1940 1728 1731 1512 1732 1943 1945 1054 1946 1737 1949 1739 1951 1521 1741 1953 1744 1745 1527 1747 1748 1749 1750 1751 1752 1753 1754 1755 1756 1757 1758 1759 1760 1761 1762 1545 1320 1087  846  597  340   75
 261  522  775 1020 1257 1486 1707 1920 1921 1922 1923 1924 1925 1927 1718 1496 2133 1931 1501 1932 1933 1724 1935 1934 1937 1939 2524 2142 1730 1941 2146 1733 1735 1734 2150 1948 2153 1950 2349 1742 1743 1525 1956 1957 1746 1958 1959 1960 1961 1962 1963 1964 1965 1966 1967 1968 1969 1970 1971 1972 1763 1546 1321 1088  847  598  341   76
 260  521  774 1019 1256 1485 1706 1919 2124 2125 2126 2127 2128 2130 2131 1929 1719 2132 2134 2135 2136 2137 2138 2139 2140 2141 2143 2144 2339 2147 2341 1944 2148 2149 2151 1947 2152 2348 2154 2537 1952 1954 1955 2159 2160 2161 2162 2163 2164 2165 2166 2167 2168 2169 2170 2171 2172 2173 2174 1973 1764 1547 1322 1089  848  599  342   77
 259  520  773 1018 1255 1484 1705 1918 2123 2320 2321 2322 2323 2129 2325 2326 2327 2328 2329 2330 2331 2332 2333 2334 2335 2336 2337 2525 2338 2145 1942 2343 2530 2344 2345 2346 2347 2535 2156 2155 2353 2158 2157 2354 2355 2356 2357 2358 2359 2360 2361 2362 2363 2364 2365 2366 2367 2368 2175 1974 1765 1548 1323 1090  849  600  343   78
 258  519  772 1017 1254 1483 1704 1917 2122 2319 2508 2509 2510 2324 2511 2512 2514 2515 2516 2517 2518 2519 2520 2521 2522 2523 2703 2527 2340 2706 2528 2529 2342 2709 2531 2533 2534 2536 2715 2539 2352 2351 2540 2541 2542 2543 2544 2545 2546 2547 2548 2549 2550 2551 2552 2553 2554 2369 2176 1975 1766 1549 1324 1091  850  601  344   79
 257  518  771 1016 1253 1482 1703 1916 2121 2318 2507 2688 2689 2690 2691 2513 2693 2694 2695 2696 2697 2698 2699 2700 2701 2702 2704 2705 2526 2707 2878 2708 2710 2881 2532 2712 2713 2714 2716 2350 2717 2538 2718 2720 2721 2722 2723 2724 2725 2726 2727 2728 2729 2730 2731 2732 2555 2370 2177 1976 1767 1550 1325 1092  851  602  345   80
 256  517  770 1015 1252 1481 1702 1915 2120 2317 2506 2687 2860 2861 2862 2692 2864 2865 2866 2867 2868 2869 2870 2871 2872 2873 2874 2875 2876 3040 2877 2879 2880 2882 2711 2883 2884 2885 2886 2887 2888 3052 2719 2890 2892 2893 2894 2895 2896 2897 2898 2899 2900 2901 2902 2733 2556 2371 2178 1977 1768 1551 1326 1093  852  603  346   81
 255  516  769 1014 1251 1480 1701 1914 2119 2316 2505 2686 2859 3180 3025 2863 3027 3028 3029 3030 3031 3032 3033 3034 3035 3036 3037 3038 3039 3041 3196 3042 3043 3044 3045 3046 3047 3048 3049 3051 3205 2889 3053 3207 3055 3056 3057 3058 3059 3060 3061 3062 3063 3064 2903 2734 2557 2372 2179 1978 1769 1552 1327 1094  853  604  347   82
 254  515  768 1013 1250 1479 1700 1913 2118 2315 2504 2685 2858 3024 3023 3026 3182 3183 3184 3185 3186 3187 3188 3189 3190 3191 3192 3193 3194 3195 3343 3197 3198 3199 3200 3201 3202 3203 3204 3352 3050 3206 3054 2891 3210 3211 3212 3213 3214 3215 3216 3217 3218 3065 2904 2735 2558 2373 2180 1979 1770 1553 1328 1095  854  605  348   83
 253  514  767 1012 1249 1478 1699 1912 2117 2314 2503 2684 2857 3022 3328 3181 3329 3330 3331 3332 3333 3334 3335 3336 3337 3338 3339 3340 3341 3342 3482 3344 3345 3346 3347 3348 3349 3350 3351 3491 3354 3356 3208 3209 3357 3358 3359 3360 3361 3362 3363 3364 3219 3066 2905 2736 2559 2374 2181 1980 1771 1554 1329 1096  855  606  349   84
 252  513  766 1011 1248 1477 1698 1911 2116 2313 2502 2683 2856 3021 3179 3327 3468 3469 3470 3471 3472 3473 3474 3475 3476 3477 3478 3479 3480 3481 3613 3483 3484 3485 3486 3487 3488 3489 3490 3622 3353 3492 3355 3495 3496 3497 3498 3499 3500 3501 3502 3365 3220 3067 2906 2737 2560 2375 2182 1981 1772 1555 1330 1097  856  607  350   85
 251  512  765 1010 1247 1476 1697 1910 2115 2312 2501 2682 2855 3177 3178 3326 3467 3600 3601 3602 3603 3604 3605 3606 3607 3608 3609 3610 3611 3614 3616 3736 3615 3738 3617 3741 3618 3620 3621 3623 3625 3493 3494 3626 3627 3628 3629 3630 3631 3632 3503 3366 3221 3068 2907 2738 2561 2376 2183 1982 1773 1556 1331 1098  857  608  351   86
 250  511  764 1009 1246 1475 1696 1909 2114 2500 2310 2681 3019 3020 3176 3325 3466 3599 3724 3725 3726 3727 3728 3729 3730 3731 3732 3733 3734 3612 3735 3852 3737 3739 3619 3743 3742 3744 3745 3860 3747 3624 3862 3749 3750 3751 3752 3753 3754 3633 3504 3367 3222 3069 2908 2739 2562 2377 2184 1983 1774 1557 1332 1099  858  609  352   87
 249  510  763 1008 1245 1474 1695 1908 2113 2311 2680 2853 2854 3018 3175 3324 3465 3598 3723 3840 3841 3842 3843 3844 3845 3846 3847 3848 3849 3850 3851 3853 3855 3854 3856 3857 3964 3859 3966 3861 3746 3863 3748 3864 3865 3866 3867 3868 3755 3634 3505 3368 3223 3070 2909 2740 2563 2378 2185 1984 1775 1558 1333 1100  859  610  353   88
 248  509  762 1007 1244 1473 1694 1907 2112 2309 2499 2498 2852 3017 3174 3323 3464 3597 3722 3839 3948 3949 3950 3951 3952 3953 3954 3955 3956 3957 3958 3959 3960 3961 3963 4062 3740 4063 3858 4066 3968 3969 3970 3971 3972 3973 3974 3869 3756 3635 3506 3369 3224 3071 2910 2741 2564 2379 2186 1985 1776 1559 1334 1101  860  611  354   89
 247  508  761 1006 1243 1472 1693 1906 2111 2308 2497 2679 2851 3016 3173 3322 3463 3596 3721 3838 3947 4048 4049 4050 4051 4052 4053 4054 4055 4056 4057 4058 4059 4060 3962 3965 4155 3967 4238 4065 4067 4068 4069 4070 4071 4072 3975 3870 3757 3636 3507 3370 3225 3072 2911 2742 2565 2380 2187 1986 1777 1560 1335 1102  861  612  355   90
 246  507  760 1005 1242 1471 1692 1905 2110 2307 2496 2678 2850 3015 3172 3321 3462 3595 3720 3837 3946 4047 4140 4141 4142 4143 4144 4145 4146 4147 4148 4149 4150 4151 4061 4152 4064 4153 4240 4156 4158 4159 4160 4161 4162 4073 3976 3871 3758 3637 3508 3371 3226 3073 2912 2743 2566 2381 2188 1987 1778 1561 1336 1103  862  613  356   91
 245  506  759 1004 1241 1470 1691 1904 2109 2306 2495 2677 2676 3014 3171 3320 3461 3718 3594 3836 3945 4046 4139 4224 4225 4226 4227 4228 4229 4230 4231 4232 4233 4234 4235 4236 4154 4313 4381 4239 4241 4242 4243 4244 4163 4074 3977 3872 3759 3638 3509 3372 3227 3074 2913 2744 2567 2382 2189 1988 1779 1562 1337 1104  863  614  357   92
 244  505  758 1003 1240 1469 1690 1903 2108 2305 2494 2675 2849 3013 3170 3319 3460 3593 3719 3835 3944 4045 4138 4223 4300 4301 4302 4303 4304 4305 4306 4307 4308 4309 4310 4311 4314 4237 4315 4157 4442 4317 4318 4245 4164 4075 3978 3873 3760 3639 3510 3373 3228 3075 2914 2745 2568 2383 2190 1989 1780 1563 1338 1105  865  864  615  358
 243  504  757 1002 1239 1468 1689 1902 2107 2304 2674 3012 2848 3011 3169 3318 3590 3459 3717 3834 3943 4044 4137 4222 4299 4368 4369 4370 4371 4372 4373 4374 4375 4376 4377 4378 4312 4489 4438 4379 4440 4384 4319 4246 4165 4076 3979 3874 3761 3640 3511 3374 3229 3076 2915 2746 2569 2384 2191 1990 1781 1564 1339 1107 1106  616  359   93
 242  503  756 1001 1238 1467 1688 1901 2106 2303 2493 2846 3010 2847 3458 3316 3591 3592 3716 3833 3942 4043 4136 4221 4298 4367 4428 4429 4430 4431 4432 4433 4434 4435 4436 4488 4437 4380 4439 4316 4383 4385 4320 4247 4166 4077 3980 3875 3762 3641 3512 3375 3230 3077 2916 2747 2570 2385 2192 1991 1782 1565 1340 1341  617   95   94  361
 241  502  755 1000 1237 1466 1687 1900 2105 2302 2492 2672 2673 3317 3456 3588 3457 3714 3455 3832 3941 4042 4135 4220 4297 4366 4427 4480 4481 4482 4483 4485 4526 4486 4487 4531 4490 4568 4491 4382 4441 4386 4321 4248 4167 4078 3981 3876 3763 3642 3513 3376 3231 3078 2917 2748 2571 2386 2193 1992 1783 1566 1110  867  618  619  360   96
 240  501  754  999 1236 1465 1686 1899 2104 2490 2491 2844 2845 3168 3009 3165 3715 3589 3713 3940 4041 4134 4133 4219 4296 4365 4426 4479 4524 4525 4561 4528 4562 4484 4529 4567 4532 4493 4533 4444 4443 4387 4322 4249 4168 4079 3982 3877 3764 3643 3514 3377 3232 3079 2918 2749 2572 2387 2194 1993 1784 1567 1344  868  866  620  363   97
 239  500  753  998 1235 1464 1685 1898 2300 2301 2489 2671 2670 2843 3167 3453 3315 3454 3314 3831 3939 4039 4040 4218 4295 4364 4425 4478 4523 4560 4589 4527 4563 4564 4530 4565 4534 4536 4570 4492 4494 4388 4323 4250 4169 4080 3983 3878 3765 3644 3515 3378 3233 3080 2919 2750 2573 2388 2195 1994 1785 1568 1342 1108  870  362  869   98
 238  499  752  997 1234 1463 1684 1897 2103 2102 2299 2669 2842 3164 3166 3008 3312 3587 3830 3712 3938 4038 4132 4217 4294 4363 4424 4477 4522 4559 4590 4587 4591 4610 4613 4566 4593 4594 4446 4535 4445 4389 4324 4251 4170 4081 3984 3879 3766 3645 3516 3379 3234 3081 2920 2751 2574 2389 2196 1995 1786 1569 1343 1109  621  364   99  100
 237  498  751  996 1233 1462 1683 1896 2101 2298 2488 2668 3005 3163 3313 3162 3586 3711 3828 3829 3937 4037 4131 4215 4216 4293 4423 4476 4521 4558 4588 4606 4608 4620 4595 4592 4596 4571 4569 4495 4447 4390 4325 4252 4171 4082 3985 3880 3767 3646 3517 3380 3235 3082 2921 2752 2575 2390 2197 1787 1570 1345 1111 1112  871  622  365  101
 236  497  750  995 1232 1461 1682 1894 1895 2487 2839 2838 3003 3007 2841 3311 3452 3585 3710 3827 3936 4036 4130 4213 4292 4362 4361 4422 4520 4557 4584 4585 4586 4609 4622 4611 4597 4537 4496 4448 4449 4391 4326 4253 4172 4083 3986 3881 3768 3647 3518 3381 3236 2922 2923 2753 2576 2391 2198 1996 1571 1572 1346 1113  872  623  366  102
 235  496  749  994 1231 1460 1680 1681 1892 2297 2840 3006 2667 3004 3161 3310 3451 3584 3709 3826 3935 4035 4129 4291 4421 4360 4473 4474 4556 4605 4607 4621 4615 4619 4623 4600 4540 4614 4498 4450 4500 4392 4328 4327 4254 4085 4173 3987 3882 3648 3519 3382 3084 3085 3083 2755 2577 2579 2199 1997 1998 1788 1347 1114  873  624  367  103
 233  234  495  993 1230 1459 1893 1679 2296 2100 2099 2483 2485 2486 3158 3159 3309 3450 3708 3825 3932 3934 4128 4290 4214 4359 4420 4475 4519 4518 4583 4604 4579 4581 4618 4612 4539 4541 4538 4497 4393 4329 4255 4256 4174 4084 3988 3883 3769 3649 3520 3383 3239 3237 2754 2924 2393 1999 2200 1791 1789 1573 1348 1349 1115  625  368  104
 494  746  747  990 1229 1457 1458 2096 2295 2098 2484 2294 3002 3001 2837 3160 3449 3583 3707 3824 3706 4034 4127 4211 4212 4289 4419 4472 4517 4555 4553 4554 4548 4601 4617 4574 4546 4573 4598 4452 4499 4394 4395 4331 4330 3989 3884 3771 3770 3650 3521 3240 3384 3086 3088 2578 2396 2395 2392 2202 1790 2001 1575 1350  874  875  369  105
 493  748  991 1228  992 1678 1891 1890 2095 2482 2836 2666 2665 3000 3307 3308 3447 3582 3581 3933 3821 4033 4126 4210 4288 4358 4418 4471 4552 4516 4549 4580 4582 4616 4508 4602 4577 4545 4576 4505 4572 4332 4257 4177 4175 4086 3990 3885 3772 3651 3522 3385 2927 2925 3238 2756 2757 2203 2201 2002 1792 1574 1116 1117  876  877  627  106
 232  492  745  989 1227 1456 1677 2292 2293 2097 2481 2664 2999 2662 3306 3448 3446 3705 3579 3931 4032 4125 4122 4209 4287 4356 4357 4470 4514 4465 4462 4550 4603 4599 4547 4459 4544 4504 4543 4542 4501 4451 4397 4178 4176 4087 3991 4088 3773 3524 3652 3243 3087 3241 2758 2581 2394 2397 2580 1793 2000 1576 1351 1118  626  370  879  371
 231  491  743  744 1226 1455 1676 1889 2093 2094 2291 2663 2998 2834 3157 3156 3305 3580 3822 3704 4031 3823 4124 4030 4208 4355 4417 4515 4416 4551 4463 4407 4511 4461 4506 4578 4507 4457 4502 4575 4396 4453 4258 4333 4259 4089 4179 3888 3653 3523 3525 3242 3386 3090 2930 2759 2582 2205 2398 2003 1794 1577 1352 1119  878  372  628  107
 230  489  490  988 1225 1454 1674 1675 2092 2480 2661 2290 2660 2835 3577 2659 3155 3445 3576 3928 3820 4029 4284 4121 4415 4468 4467 4469 4513 4466 4410 4512 4344 4509 4343 4458 4402 4339 4338 4398 4503 4261 4260 4334 4092 4090 3890 3886 3774 3654 3387 3659 3245 2926 3247 3089 2760 2585 2204 2004 1795 1579 1120  630 1121  629  373  108
 229  228  742  986  987 1224 2090 1673 1886 1888 1887 2479 3302 3304 2997 3702 3578 3154 3703 3701 3930 4120 3927 4354 4286 4353 4414 4413 4349 4348 4275 4510 4406 4409 4404 4272 4405 4269 4268 4401 4400 4456 4337 4262 4335 3993 3887 3992 3775 3655 3656 3244 3388 3091 2761 2929 2928 2583 2401 2006 1354 1796 1353 1356  631  880  374  109
 227  488  741 1223 1222 1453 1452 2091 2089 2289 2477 2832 2658 2833 3301 3443 3444 3818 3816 3929 3817 4205 4206 4123 4352 4351 4200 4350 4411 4347 4464 4274 4346 4408 4460 4270 4403 4340 4341 4336 4264 4454 3899 4266 3995 4091 3891 3776 3994 3889 3527 3526 3093 3092 2763 2584 2209 2207 2005 1578 1580 1357  883 1355  881  633  632  110
 226  487  740  985 1221 1451 1450 1672 2476 2478 2288 2657 2996 2831 2995 3439 3442 3699 3575 3697 3926 3925 4285 3819 4283 4281 4201 4202 4412 4278 4276 4345 4195 4194 4106 4273 4271 4342 4189 4191 4188 4187 4265 4263 4180 3998 4093 3778 3777 3779 3390 3389 3246 2932 2762 2587 2400 1797 2402 2206 1799  882  884 1125 1123 1122  376  375
 225  486  739  984 1220 1449 1885 2656 2286 2829 2994 2653 2830 3153 3303 3151 3149 3152 3300 3700 4027 4025 4118 4207 4026 4028 4115 4280 4279 4277 4197 4109 4196 4193 4107 4104 4105 4007 4267 4455 4186 4399 4003 4182 4181 3996 3893 3658 3660 3394 3780 3528 3094 2934 2931 2403 2765 2007 1800 2208 2404 1582 1581 2008  634  377  113  111
 224  485  738  982  983 1669 1670 2088 2285 2086 2652 2475 2474 2828 3297 3299 3441 3574 3440 3813 3815 3924 4023 4119 4282 4203 4019 4114 4199 4017 4198 4014 4110 4013 4108 4192 4009 4103 4102 4101 4099 4184 4097 4185 4000 4094 3997 3892 3657 3781 3395 3531 3392 2586 2764 2588 2210 2399 2009 2211 1584 1798 1583 1124 1358  378  112  114
 223  484  737 1219 1217 1218 1883 1882 1671 2472 2827 2470 2993 2655 2654 3296 3148 3572 3698 4024 4117 3920 4022 4204 4021 4116 4020 4018 4112 4113 4111 4015 3910 4012 4011 4010 3905 4190 4008 3903 4100 4004 4098 4001 4096 4183 3898 3897 3782 3894 3529 3391 3396 2936 2938 3249 2766 2405 2589 1802 1585 1359 1127 1126  885  636  380  379
 222  483  736 1446  980 1880 1667 1884 2473 1881 2087 2287 2825 2992 3150 2991 3573 3438 3814 3922 3923 3921 3919 3918 3807 3917 3916 3915 3803 4016 3913 3800 3911 3909 3908 3907 3906 3794 4006 3902 4005 3901 4002 3900 3786 4095 3999 3784 3530 3393 3661 3251 3248 2933 2767 2590 2768 2212 2011 1801 2010 1586 1361  886  635  887  637  115
 221  482  735  981 1448 1445 1447 2284 1668 2085 2282 2824 2826 3294 2990 3437 3436 3298 3812 3691 3695 3811 3809 3689 3808 3806 3805 3804 3802 3914 3912 3801 3799 3798 3797 3796 3795 3674 3904 3793 3792 3791 3790 3788 3785 3787 3895 3783 3662 3536 3253 3250 3532 2940 3097 2769 2592 2591 2214 2213 1804 2013 1803 1360 1128  638  381  116
 220  481  734  979 1215 1444 1216 1879 2280 2084 2281 2471 2987 3147 2989 3693 3696 3571 3694 3566 3692 3810 3564 3690 3562 3687 3686 3685 3684 3683 3682 3681 3680 3679 3678 3677 3676 3675 3547 3672 3545 3671 3789 3670 3669 3667 3896 3665 3663 3535 3397 3254 3533 3098 2935 3096 3095 2406 2408 2012 2014 1805 1129 1130  888  639  382  117
 219  480  733  977 1664  978 1665 2083 2469 2283 2468 2651 2823 3145 3144 3295 3146 3568 3567 3431 3287 3288 3565 3563 3688 3560 3559 3558 3557 3556 3555 3554 3553 3552 3551 3550 3549 3548 3546 3411 3673 3266 3544 3668 3540 3405 3666 3539 3664 3399 3534 3398 3252 3101 2939 2595 2593 2407 2594 2015 1362 1587 1588 1363  889  640  383  118
 218  479  732 1214 1213 1443 1666 1877 2082 2279 2650 2822 2988 2649 3140 3143 3289 3569 3570 3430 3136 3432 3427 3426 3561 3282 3424 3423 3422 3421 3420 3419 3418 3417 3416 3415 3414 3413 3412 3410 3409 3267 3542 3541 3407 3403 3404 3538 3402 3258 3401 3257 3102 2771 3099 2937 2770 3100 2216 1807 1806 1589 1364 1132  890  641  384  119
 217  478  731  976 1212 2081 1878 1876 2080 2278 2467 2821 2820 2986 3434 3293 3435 3139 3433 3286 3135 3285 3428 3284 3425 3283 3281 3280 3279 3278 3277 3276 3275 3274 3272 3270 3271 3118 3269 3268 3117 3116 3265 3543 3406 3111 3109 3261 3537 3260 3400 3104 3256 3103 3255 2773 2772 2219 2215 2016 2217 1590 1131 1365  891  642  385  120
 216  477  730  975 1441 1442 1663 1875 2079 2277 2466 2648 2819 3142 3292 3141 3291 3290 3137 2979 2977 3134 2808 3133 3132 3131 3130 3129 3128 3127 3126 3125 3124 3123 3273 3121 3120 2960 3119 2958 2790 3115 3114 3408 3263 3262 2786 2951 3108 3259 2947 3105 2943 2944 2942 2596 2413 2409 2597 2017 1808 1367 1591 1133  892  643  386  121
 215  476  729  974 1211 1440 1662 1873 1874 2276 2647 2646 2643 2985 2983 2982 2814 2981 2980 2810 3138 3429 2633 2974 2973 2972 2971 2970 2969 2968 2967 2966 2965 2964 3122 2963 2795 2959 2791 2957 2615 2956 2955 3112 2954 2952 2610 2785 2950 3106 2605 2604 2776 3107 2941 2774 2411 2019 2414 2218 1809 1592 1366 1134  893  644  387  122
 214  475  728  973 1210 1661 1659 1660 2078 2464 2465 2645 2818 2984 2816 2815 2813 2812 2637 2978 2976 2809 2975 2807 2806 2805 2804 2803 2802 2801 2800 2624 2799 2797 2796 2794 2619 2792 2793 2616 2432 2788 2611 3264 3110 3113 2609 2424 2949 2782 2778 2946 2602 2418 2600 2777 2598 2220 2412 2018 1810 1593 1137 1136  646  389  645  123
 474  212  727  972 1208 1209 1658 1872 2077 2275 2463 2644 2460 2817 2642 2641 2639 2455 2638 2454 2811 2452 2634 2632 2631 2630 2629 2628 2627 2443 2626 2625 2798 2439 2623 2962 2436 2961 2618 2433 2431 2613 2612 2787 2953 2425 2607 2608 2783 2781 2779 2780 2606 2603 2419 2417 2410 2415 2221 2020 1811 1595 1368 1135 1369  896  388  124
 213  725  472  726  971 1437 1438 2076 2273 2274 2462 2270 1862 2461 2458 2640 2457 2456 2636 2453 2261 2635 2450 2449 2448 2447 2446 2445 2444 2442 2441 2440 2249 2438 2621 2622 2246 2435 2244 2617 2240 2430 2429 2789 2428 2426 2784 2235 2423 2948 2422 2228 2945 2230 2599 2775 2416 2222 2021 2022 1812 1594  895 1370  894  647  390  125
 211  473  970  969 1439 1435 1436 1871 1870 2271 2269 2072 2069 2459 2268 2266 2265 2264 2263 2262 2260 2451 2259 2258 2257 2256 2255 2254 2253 2252 2251 2250 2050 2248 2437 2620 2046 2245 2243 2434 2614 2241 2239 2238 2237 2427 2035 2234 2233 2231 2032 2420 2421 2601 2227 2226 2225 2224 2223 1813 1596 1372 1597  648  898  391  392  126
 210  471  724  968 1207 1206 1656 1657 2272 2075 1865 2073 2071 2068 2267 2067 2066 2065 2064 2063 2062 2061 2060 2059 2058 2057 2056 2055 2054 2053 2052 2051 1843 2049 2247 1840 2047 2045 2043 2242 2042 2041 2040 2039 2038 2236 2037 2034 1827 2232 1825 2030 2229 2029 2028 2027 2026 2025 2024 2023 1814 1371 1373  900  897  650  649  127
 209  470  723 1204  967 1655 1869 1867 1652 2074 1866 1864 1649 1863 1861 1860 1859 1858 1857 1856 1855 1854 1853 1852 1851 1850 1849 1848 1847 1846 1845 1844 1842 1841 1626 2048 1839 1838 2044 1836 1835 1834 1833 1832 1831 1829 2036 1828 1612 2033 1611 2031 1608 1822 1821 1820 1819 1818 1817 1816 1815 1598 1139 1140 1138  899  393  128
 208  469  722 1205 1433 1434 1430 1868 1653 1651 1650 1648 2070 1647 1646 1645 1644 1643 1642 1641 1640 1639 1638 1637 1636 1635 1634 1633 1632 1631 1630 1629 1628 1627 1625 1624 1623 1622 1837 1621 1620 1619 1618 1617 1616 1830 1614 1613 1826 1824 1386 1823 1609 1607 1606 1605 1604 1603 1602 1601 1600 1599 1374 1142 1141  651  394  129
 207  468  721  966 1203 1432 1654 1199 1429 1428 1427 1426 1425 1424 1423 1422 1421 1420 1419 1418 1417 1416 1415 1414 1413 1412 1411 1410 1409 1408 1407 1406 1405 1404 1403 1402 1401 1400 1399 1398 1397 1396 1395 1394 1393 1392 1391 1615 1389 1388 1610 1387 1385 1384 1383 1382 1381 1149 1380 1379 1378 1376 1375 1143  901  652  395  130
 206  467  720  965 1202 1201 1431 1200 1198 1197 1196 1195 1194 1193 1192 1191 1190 1189 1188 1187 1186 1185 1184 1183 1182 1181 1180 1179 1178 1177 1176 1175 1174 1173 1172 1171 1170 1169 1168 1167 1166 1165 1164 1163 1162 1161 1160 1390 1158  918 1157 1156 1154 1153 1151  912 1150  910 1148 1147 1377 1146 1145 1144  902  653  396  131
 205  466  719  964  963  962  961  960  959  958  957  956  955  954  953  952  951  950  949  948  947  946  945  944  943  942  941  940  939  938  937  936  935  934  933  932  931  930  929  928  927  926  925  924  923  922  921 1159  920  919  916 1155  915  914 1152  666  911  663  909  908  907  906  905  904  903  654  397  132
 204  465  718  717  716  715  714  713  712  711  710  709  708  707  706  705  704  703  702  701  700  699  698  697  696  695  694  693  692  691  690  689  688  687  686  685  684  683  682  681  680  679  678  677  676  675  674  673  672  671  917  670  669  668  667  913  665  664  661  660  405  659  658  657  656  655  398  133
 203  464  463  462  461  460  459  458  457  456  455  454  453  452  451  450  449  448  447  446  445  444  443  442  441  440  439  438  437  436  435  434  433  432  431  430  429  428  427  426  425  424  423  422  421  420  419  418  417  416  415  414  413  412  411  410  409  408  145  662  406  404  403  402  401  400  399  134
 202  201  200  199  198  197  196  195  194  193  192  191  190  189  188  187  186  185  184  183  182  181  180  179  178  177  176  175  174  173  172  171  170  169  168  167  166  165  164  163  162  161  160  159  158  157  156  155  154  153  152  151  150  149  148  147  146  144  407  143  142  141  140  139  138  137  136  135
