# This puzzle is unsolvable
10
 74   6  54  65  46  88  83   9  14  44
 67  36  23  64  84  47  13  20  89  19
 37   2  39  68  85  77  51  96  69  98
 61   7  43  45  76  99  94  32  11  66
 58  80  82  40  57   8  38  22  18  92
 48  10  17  12  29  49   0  97  72  41
  5  27  79  33  53  63  86   4  71  25
  1  75  31  28  78  15  26  55  59  50
 60  42  30  21  56  90  16  95  24  73
 62  91  81  35  34  93  70  52   3  87
