# This puzzle is unsolvable
54
   4    1    6    2  418    7  217  218    9   10   11   12   13   14   15   16  227   17   18   21  233   22   23  439  236   26  237   28   29   31  446   32   33   35  245   36   37   39  250   40  253   41   44  255   45   46   47   48   49   50   51   52   53   54
 212  215    5    3  417  216    8  422  219  221  222  223  224  225  228  430  229   19  231  433  232  435  436  437   24  235  238   27  240  242   30  243  244  448   34  246  247  248   38  252  455   42  254   43  256  257  258  259  260  261  262  263  264   55
 414  214  213  419  420  616  421  220  423  424  425  426  427  811  429  226   20  814  627  629  630  434 1000  234   25  438  440  239  639  443  241  642  641  447  449  450  451  249  452  453  251  456  457  458  459  460  461  462  463  464  465  466  265   56
 416  415  211  614  611  803  983  617  619  620  621  808  988  810  624  625  628  432  817  997  816  995  230  632  822  633  634  442  636  444  827  640  829  643  644  645  646  647  648  454  650  651  652  653  654  655  656  657  658  659  660  467  266   57
 610  210  981  978  799  615  984  804  618  806 1156  807  809  428  622  991  431  993  815  819  818  996  631  998  821  823  441  637  638  825  826  828  445  830  831  832  833  834  835  649  836  838  839  840  841  842  843  844  845  846  661  468  267   58
 208  612  800  979  802 1152 1316 1155 1154 1157  985  987  989  623  812 1162  992 1483  990  626 1165 1169 1001  820  635 1002 1003  824 1004 1176 1006 1007 1008 1009 1010 1011 1012 1013 1014 1015  837 1017 1018 1019 1020 1021 1022 1023 1024  847  662  469  268   59
 413  412  209  796  613  801 1153  982 1318  986 1158 1159 1322 1160 1161 1325 1163 1329  813  994 1168 1330 1332  999 1170 1172 1173 1174 1005 1175 1177 1178 1179 1180 1181 1182 1183 1184 1185 1186 1016 1188 1189 1190 1191 1192 1193 1194 1025  848  663  470  269   60
 207  410  609  797  798  977  805 1317 1620 1473 1319 1321 1323 1478 1479 1327 1482 1164 1166 1485 1487 1167 1331 1334 1171 1335 1336 1337 1338 1339 1340 1341 1342 1343 1344 1345 1346 1348 1349 1350 1187 1351 1352 1353 1354 1355 1356 1195 1026  849  664  471  270   61
 411  206  608  606 1150  980 1315 1151 1472 1474 1320 1476 1477 1625 1480 1324 1326 1328 1630 1484 1486 1488 1635 1333 1489 1490 1491 1492 1493 1494 1495 1496 1497 1498 1499 1500 1501 1347 1503 1504 1505 1506 1507 1508 1509 1510 1357 1196 1027  850  665  472  271   62
 205  408  409  607  976 1149 1314 1470 1471 1760 1622 1475 1624 1764 1626 1627 1629 1628 1768 1770 1631 1633 1634 1774 1636 1637 1638 1639 1640 1641 1642 1643 1644 1645 1646 1647 1648 1502 1649 1651 1652 1653 1654 1655 1656 1511 1358 1197 1028  851  666  473  272   63
 204  203  605  795  975 1148 1312 1313 1891 1621 1761 1623 1762 1763 1765 1896 1766 1767 1769 1632 1902 1772 1773 1906 1905 1776 1777 1778 1779 1780 1781 1782 1783 1784 1785 1786 1787 1788 1650 1790 1791 1792 1793 1794 1657 1512 1359 1198 1029  852  667  474  273   64
 202  407  793  794  974 1147 1619 1617 1469 1618 1759 1893 1894 1895 1897 1898 1481 1899 1900 1901    0 2025 1904 1775 2029 1907 1908 1909 1910 1911 1912 1913 1914 1915 1916 1917 1918 1919 1789 1921 1923 1924 1660 1658 1796 1513 1360 1199 1030  853  668  475  274   65
 406  405  604  792  973 1146 1311 1468 1467 1758 1757 2016 2017 2018 2019 2020 2021 2022 2138 2023 1903 2142 2249 2141 2028 2030 2031 2032 2033 2034 2035 2036 2037 2038 2039 2040 2041 2042 1920 2043 2044 1922 2045 1659 1797 1514 1361 1200 1031  854  669  476  275   66
 201  602  603  791  972 1145 1310 1616 1466 1754 2015 1615 2132 2133 2134 2135 2136 2137 2024 2140 2026 1771 2250 2027 2144 2145 2146 2147 2148 2149 2150 2151 2152 2153 2154 2155 2156 2157 2158 2161 2160 2046 2047 1927 1795 1515 1362 1201 1032  855  670  477  276   67
 200  199  601  790  971 1143 1144 1890 1888 1756 2014 2131 2013 2240 2241 2242 2243 2245 2246 2139 2247 2248 2143 2251 2252 2253 2352 2254 2255 2256 2257 2258 2259 2260 2261 2262 2362 2263 2159 2265 2267 2162 1929 1925 1928 1926 1363 1202 1033  856  671  478  277   68
 198  404  968  600  970 1142 1309 1465 1614 1755 1892 2012 2130 2239 2340 2432 2341 2342 2244 2345 2346 2347 2348 2349 2350 2442 2353 2354 2445 2355 2356 2357 2358 2359 2360 2452 2361 2363 2264 2266 2049 2048 1799 1800 1516 1517 1364 1203 1034  857  672  479  278   69
 197  403  599  789  788  969 1308 1464 1463 1887 1612 1889 1753 2129 2339 2515 2433 2435 2344 2436 2437 2438 2439 2440 2351 2441 2443 2444 2529 2528 2446 2448 2449 2450 2451 2453 2536 2365 2364 2268 2163 2050 1662 1661 1518 1798 1365 1204 1035  858  673  480  279   70
 196  402  401  787 1141 1306 1307 1611 2010 1613 1885 1886 2127 2238 2237 2516 2517 2434 2592 2661 2519 2521 2522 2523 2524 2525 2526 2527 2603 2530 2447 2531 2532 2533 2534 2535 2455 2454 2366 2269 2164 2051 1930 1801 1663 1519 1366 1205 1036  859  674  481  280   71
 597  399  598  786  967 1140 1305 1462 1610 1752 1749 2011 2128 2431 2338 2430 2334 2343 2594 2593 2520 2596 2597 2598 2599 2667 2600 2601 2602 2671 2605 2606 2607 2608 2609 2610 2537 2456 2367 2270 2165 2052 1931 1665 1664 1520 1367 1206 1037  860  675  482  281   72
 195  194  400  785  965  966 1304 1461 1751 2126 1884 2125 2009 2336 2429 2428 2518 2590 2591 2659 2721 2595 2664 2665 2666 2726 2668 2669 2604 2670 2672 2673 2674 2675 2676 2611 2457 2368 2369 2271 2166 2053 1803 1802 1666 1521 1368 1207 1038  861  676  483  282   73
 193  595  596  784  964 1139 1303 1460 1609 1750 2232 2007 2337 2235 2234 2512 2513 2511 2514 2589 2773 2662 2722 2723 2725 2778 2727 2728 2781 2780 2729 2733 2826 2734 2677 2612 2539 2538 2458 2272 2167 2054 1932 1933 1804 1522 1369 1208 1039  862  677  484  283   74
 192  398  396  783  963 1138 1137 1459 1608 2005 2008 2123 2335 2236 2124 2233 2510 2658 2660 2719 2663 2774 2775 2817 2776 2777 2821 2824 2779 2731 2783 2732 2784 2735 2678 2540 2541 2459 2370 2273 2168 2055 1934 1805 1667 1523 1370 1209 1040  863  678  485  284   75
 593  397  594  781  782 1136 1302 1458 1607 1748 1883 2003 2006 2004 2333 2509 2426 2427 2772 2771 2655 2816 2724 2818 2820 2822 2856 2857 2730 2823 2782 2785 2786 2680 2679 2613 2460 2461 2371 2274 2169 2056 1935 1669 1668 1524 1371 1210 1041  864  679  486  285   76
 191  591  592  960  962 1133 1301 1300 1457 1747 2122 2230 2121 2332 2231 2588 2585 2508 2657 2814 2720 2717 2852 2854 2819 2855 2883 2884 2858 2859 2825 2827 2737 2615 2736 2614 2542 2372 2275 2276 2170 2057 1936 1806 1807 1670 1372 1211 1042  865  680  487  286   77
 190  395  590  394  961 1299 1134 1605 1881 1880 1882 1879 2330 2331 2424 2586 2507 2716 2656 2718 2714 2770 2851 2853 2881 2882 2903 2885 2886 2887 2860 2861 2787 2738 2681 2616 2543 2462 2373 2171 2172 2058 1937 1808 1671 1525 1526 1213 1373  866  681  488  287   78
 189  187  779 1135  589 1456 1744 1602 1606 1745 2119 1746 2229 2228 2329 2423 2654 2425 2587 2769 2813 2879 2815 2880 2898 2900 2912 2901 2904 2862 2829 2828 2788 2739 2682 2617 2544 2463 2374 2277 2059 2060 1809 1810 1527 1528 1374 1212 1043  867  683  489  288   79
 780  186  393  392  777  959 1298 1604 1453 1294 1878 1877 2120 2001 2422 2421 2506 2584 2715 2767 2768 2766 2850 2849 2877 2899 2902 2913 2905 2888 2863 2830 2789 2740 2683 2618 2545 2464 2375 2278 2174 2173 1939 1673 1672 1375 1214 1044 1215  682  491  684  291  490
 390  188  588  957  778 1742 1130 1455 1603 1454 1876 2115 2002 2114 2328 2504 2582 2583 2653 2652 2713 2811 2812 2878 2897 2911 2915 2914 2906 2889 2864 2831 2790 2741 2684 2619 2546 2465 2376 2279 2061 1940 1811 1938 1674 1529 1376 1045 1046  868 1047  685  292   80
 587  185  775  776 1296  584 1132 1743 1297 1875 1741 2118 2326 2116 2226 2650 2420 2505 2581 2848 2711 2847 2896 2873 2876 2910 2909 2908 2907 2890 2865 2832 2791 2742 2685 2620 2547 2466 2377 2280 2175 2062 1941 1812 1675 1530 1377 1216 1048  289  870  869  290   81
 389  179  391  586  958 1600 1452 1874 1451 1601 2000 1598 2117 2227 2327 2419 2415 2503 2712 2810 2809 2765 2846 2875 2895 2872 2894 2893 2892 2891 2866 2833 2792 2743 2686 2621 2548 2467 2378 2281 2176 2063 1942 1813 1676 1531 1378 1217  871  493  492  686  293   82
 184  182  585 1131  774  956 1292 1295 1597 1997 1871 1740 1739 1998 2325 1873 2501 2648 2651 2710 2764 2760 2844 2806 2842 2841 2871 2870 2869 2868 2867 2834 2793 2744 2687 2622 2549 2468 2379 2282 2177 2064 1943 1814 1677 1532 1379 1218 1049  872  687  494   84   83
 773  388  181  771 1128 1129 1293 1444  955 1599 1872 2224 2225 1999 2222 2418 2223 2580 2762 2708 2763 2808 2874 2845 2843 2804 2840 2839 2838 2837 2836 2835 2794 2745 2688 2623 2550 2469 2380 2283 2178 2065 1944 1815 1678 1533 1380 1219 1050  873  688  495  294   85
 387  180  583 1291  953 1127  954 1446 1737 1738 1870 2112 2321 2502 2500 2324 2579 2416 2709 2649 2807 2758 2757 2805 2703 2802 2801 2800 2799 2798 2797 2796 2795 2746 2689 2624 2551 2470 2381 2284 2179 2066 1945 1816 1679 1534 1381 1220 1051  874  689  496  295   86
 384  183  386  952  950  772 1449  770 1996 1595 1995 1736 2113 1993 2220 2322 2417 2497 2578 2761 2706 2642 2759 2756 2803 2755 2754 2753 2752 2751 2750 2749 2748 2747 2690 2625 2552 2471 2382 2285 2180 2067 1946 1817 1680 1535 1382 1221 1052  875  690  497  296   87
 385  383  581 1290 1450 1126 1124 1289 1596 2110 1992 1447 2218 1594 1994 2575 2576 2414 2499 2577 2644 2704 2640 2702 2701 2700 2699 2698 2697 2696 2695 2694 2693 2692 2691 2626 2553 2472 2383 2286 2181 2068 1947 1818 1681 1536 1383 1222 1053  876  691  498  297   88
 177  178 1125  949 1286  768 1122 1448  951 1735 1868 2111 2413 2108 2320 2574 2323 2498 2646 2572 2705 2570 2641 2639 2638 2637 2636 2635 2634 2633 2632 2631 2630 2629 2628 2627 2554 2473 2384 2287 2182 2069 1948 1819 1682 1537 1384 1223 1054  877  692  499  298   89
 579  582  382  769  580 1123 1121 1288 1734 1866 1733 1869 2219 1991 2412 2317 2216 2647 2571 2707 2643 2645 2569 2568 2567 2566 2565 2484 2564 2562 2561 2560 2559 2558 2557 2556 2555 2474 2385 2288 2183 2070 1949 1820 1683 1538 1385 1224 1055  878  693  500  299   90
 176  577  578  948  380 1593 1285 1443 1442 1592 1590 2109 2217 1867 2221 2319 2411 2494 2573 2493 2492 2491 2490 2402 2489 2488 2485 2399 2563 2483 2482 2481 2480 2479 2478 2477 2476 2475 2386 2289 2184 2071 1950 1821 1684 1539 1386 1225 1056  879  694  501  300   91
 175  764  767  765  378 1441  946 1287 1445 1591 1864 1732 1865 2106 1990 2107 2496 2408 2208 2407 2405 2404 2403 2401 2487 2486 2306 2303 2398 2396 2394 2299 2393 2392 2391 2390 2389 2388 2387 2290 2185 2072 1951 1822 1685 1540 1387 1226 1057  880  695  502  301   92
 379  381  575  174 1283  942  574 1586 1440 1988 1729 1863 1989 2210 2318 2212 2410 2409 2406 2312 2309 2310 2308 2307 2203 2400 2200 2304 2397 2300 2395 2196 2298 2297 2296 2295 2294 2293 2292 2291 2186 2073 1952 1823 1686 1541 1388 1227 1058  881  696  503  302   93
 173  170  766  947  171 1119 1120 1439 1589 1730 1861 2105 2104 2215 2316 2213 2313 2315 1977 2207 2311 2206 2205 2204 2305 2201 2199 2090 2302 2198 2301 2197 2195 2194 2193 2192 2191 2190 2189 2188 2187 2074 1953 1824 1687 1542 1389 1228 1059  882  697  504  303   94
 374  573  571  762  576 1281 1284 1726 1588 1437 1986 2103 1987 2214 1984 2102 2099 2314 2495 2209 2096 2095 2094 2093 2092 2202 1707 2091 1970 2087 2086 2085 2084 2083 2082 2081 2080 2079 2078 2077 2076 2075 1954 1825 1688 1543 1390 1229 1060  883  698  505  304   95
 172  940  376  944 1282  945 1438 1279 1862 1731 1728 1985 1858 1983 1982 2211 2100 2098 1719 2097 1715 1976 1975 1974 1712 1973 1844 2088 2089 1968 1967 1839 1966 1964 1963 1962 1961 1960 1959 1958 1957 1956 1955 1826 1689 1544 1391 1230 1061  884  699  506  305   96
 377  372  375 1117  572 1113 1436  943 1587 1860 1725 1859 1857 1856 1855 1980 2101 1981 1852 1978 1979 1849 1713 1848 1846 1972 1971 1843 1969 1842 1840 1965 1838 1837 1702 1836 1834 1833 1832 1831 1830 1829 1828 1827 1690 1545 1392 1231 1062  885  700  507  306   97
1114  761  763 1118  941 1115 1585 1276 1584 1431 1581 1724 1723 1722 1721 1577 1720 1575 1853 1716 1572 1714 1569 1847 1568 1711 1845 1710 1709 1841 1705 1703 1559 1408 1700 1835 1701 1698 1697 1696 1695 1694 1693 1692 1691 1546 1393 1232 1063  886  701  508  307   98
 168  167  760 1116  939 1280 1278 1435 1727 1432 1583 1430 1580 1579 1578 1426 1854 1574 1718 1851 1850 1420 1570 1418 1416 1567 1566 1708 1706 1561 1562 1250 1560 1557 1558 1556 1699 1555 1554 1553 1552 1551 1550 1549 1548 1547 1394 1233 1064  887  702  509  308   99
 166  759  169  373 1112 1277 1111 1433 1274 1272 1273 1582 1428 1427  925  741 1424 1576 1573 1264 1571 1421 1419 1417 1257 1090 1564 1255 1414 1704 1563 1411 1249 1406 1080 1405 1404 1245 1403 1402 1401 1400 1399 1398 1397 1396 1395 1234 1065  888  703  510  309  100
 569  757  758  570  756  938  935 1275 1434 1105  929 1271 1429 1270 1267 1265 1100 1423 1098 1262 1095 1261 1260 1259 1258  915 1256 1565 1254 1413 1253 1409 1407 1251 1248 1081 1247 1246 1244 1243 1242 1241 1240 1239 1238 1237 1236 1235 1066  889  704  511  310  101
 371  165  164  567  937  936 1109 1108  932 1107 1104 1103 1102  927 1268 1269  743 1425 1717 1096 1422 1094 1092  734 1091  732  731  913 1412 1088 1252 1087 1410 1082  532  905 1079 1078 1077 1076 1075 1074 1073 1072 1071 1070 1069 1068 1067  890  705  512  311  102
 369  566  370  568 1110  755  751  934  750  747  555  355  930  354  742  926 1266 1099 1097 1093  918  919  735  917 1089 1415  730  912  728 1085  911 1083 1084  725  908  906  722  903  902  901  900  899  898  897  896  895  894  893  892  891  706  513  312  103
 368  162  565  753  560  360  562  752  359  558 1106  745  928 1101  552  924  548  546  922  739 1263  921  345  544  916  914  542  539  729  910  726  727  534  909  724  723  904  720  719  718  717  716  715  714  713  712  711  710  709  708  707  514  313  104
 163  366  754  563  362  749  154  561  748  933  357  746  148  352  744  549  923  348  350  547  545  736  138  541  543  733  340  341  540 1086  537  535  533  907  334  530  721  529  528  527  526  525  524  523  522  521  520  519  518  517  516  515  314  105
 161  564  367  158  361  156  364  153  151  931  556  150  553  554  145  353  550  144  143  140  142  346  920  137  343  136  342  339  538  337  536  336  335  333  531  332  124  330  329  328  327  326  325  324  323  322  321  320  319  318  317  316  315  106
 160  159  365  363  157  559  155  152  358  557  149  356  146  147  551  349  740  351  141  738  347  737  344  139  135  134  133  132  338  131  130  129  128  127  126  331  125  123  122  121  120  119  118  117  116  115  114  113  112  111  110  109  108  107
