# This puzzle is unsolvable
36
   2    1    3    4    5    6    7    8    9   10   11   12   13   14   15   16   17   18   19   20   21   22   23   24   25   26  167   28   30  169  171  303   32   36  305   35
 140  141  142  143  144  145  146  147  148  149  150  151  152  153  154  155  156  157  158  159  160  162  163  164  418  296   27  166   29   31  172  302   33   34  173   37
 139  272  273  274  275  276  277  278  279  280  281  282  283  284  287  409  410  288  289  291  414  161  293  294  532  165  295  297  168  300  299  647  304  175  174  176
 138  271  396  397  398  399  400  401  402  403  404  405  406  285  629  286  412  526  413  290  415  292  416  639  417  533  421  298  423  538  539  301  424  426   38  306
 137  270  395  512  513  514  515  516  517  518  519  520  521  408  524  525  632  411  527  528  529  530  531  419  534  420  535  742  422  745  645  747  427  170  177   39
 136  269  394  511  620  621  622  623  624  625  626  627  628  522  407  630  731  633  634  635  636  637  827  741  640  642  536  990  643  541  835  308  545  428  425   45
 135  268  393  510  619  720  721  722  723  724  725  817  726  523  730  821  631  732  733  734  735  737  829  638  738  739  830  641  644  537  744   42  307   44  178  309
 134  267  392  509  618  719  812  813  814  815  816  975  819  727  728 1154  822  823  824  825  826  736  828  986  915  831  743  832  649  834  917   40  180  312  310  544
 133  266  391  508  617  718  811  896  897  898  900  976  818  729  820  905  978  906  907  908  909  911  987  913  912 1056  833  916  430  836  542  646  651  543  181  183
 132  265  390  507  616  717  810  972  973  974  899  901 1043  902  903  904  980  981  982  983  985  910 1054  740  746  749  991  750  918  311  540  434  429  652  182  179
 131  264  389  506  614  615  809  895  971 1040 1041 1042 1044  979 1045  977 1047 1158 1048 1203 1109 1161 1163  914  988  920  989  919  837  433  648  549  546   41   43   46
 130  263  388  505  613  716  808  894  970 1039 1100 1152 1101 1102 1104 1046 1105 1107 1051 1049  984 1052 1111 1114 1115 1053 1055 1058  839  653  547  655  435  185  432  431
 129  262  503  612  386  715  892  893  969 1038 1098 1151 1099 1103 1198 1155 1106 1108 1265 1050 1159 1112 1167 1057 1059 1166 1164  748  921  650  840  438  436  548  184   47
 128  260  387  504  712  714  713  807  891 1037 1097 1195 1153 1232 1196 1197 1156 1234 1200 1201 1264 1204 1205 1116 1060 1113  996  654  838  994  753  552  752  314   48  313
 127  385  261  610  502  711  805  806  968 1035 1149 1194 1193 1231 1259 1233 1235 1281 1202 1241 1160 1207 1162 1117 1206  992 1118  841  922  656  751  189  550  318  186  187
 126  258  259  384  611  804  890 1036  889 1033 1096 1230 1192 1262 1199 1258 1237 1238 1157 1283 1110 1209 1240 1208 1165 1062  923  995  993  657  441  551   49  315   50   51
 125  257  383  501  609  710  803  888  967 1095 1148 1150 1229 1228 1280 1277 1285 1263 1267 1236 1284 1210 1239 1168 1063 1169 1119  842  756  924  439  190  440  188  316   52
 124  255  382  500  608  709  802  887  966 1034  964 1147 1191 1279 1260 1282 1261 1294 1278 1242 1268 1266 1120 1121 1170 1061 1064  998  658  843  754  442  846  321  317   53
 122  123  497  499  606  607  708  965  963 1092 1032 1227 1093 1255 1226 1290 1293 1292 1270 1245 1172 1211 1243 1244 1212 1123  999  997  925  845  659  437  553  319  320   54
 253  254  380  498  605  707  800  801  885  962 1090 1094 1146 1189 1254 1256 1291 1250 1286 1295 1271 1248 1247 1246 1001 1213  928 1000  847  554  660  557  443  192   55  191
 378  256  379  496  604  706  882  886  884  961 1143 1144 1145 1188 1257 1225 1220 1274 1289 1287 1219 1174 1126 1068 1066 1171 1122  757  758  844  661  755  558  555  193   56
 377  381  121  495  705  798  799  797  883 1031 1030 1187 1186 1091 1223 1276 1253 1288 1272 1221 1217 1269 1214 1176 1175 1173  929  930  848  926  444  322  559  195  323   57
 117  119  252  494  603  704  881  959 1026 1029  960 1141 1142 1190 1222 1252 1251 1275 1181 1273 1249 1178 1215 1127 1002 1069 1065  932  850  556  324  761  760  445  194   58
 118  373  120  375  493  703  958  880  794 1089  956 1027 1185 1224 1184 1182 1180 1133 1078 1179 1130 1216 1177 1011 1074 1003  931  759  446  662  927  560  664  763  196   59
 492  251  250  602  795  600  796  879  955 1028 1140    0 1088 1138 1136 1183 1135 1079 1134 1218 1014 1131  941  940 1067 1005 1124  935  849 1004  762  326  325  448  197   60
 114  372  249  376  374  701  877  957 1086 1025  950 1087 1139 1021 1137 1081 1080 1077 1132 1013  942 1076  939 1129 1072 1071 1006  933  851  666  447  562  663  327  198   61
 116  115  248  601  491  702  792  793  875  954 1023 1084 1019 1082  948 1018 1017 1016  945  863  679 1128  861 1125 1075 1009 1070 1007  852  667  665  328  563  329  199   62
 246  247  490  488  599  489  699  878  874  953 1024 1083  951 1022  782  947  946 1015  865  778  864  943  774  773 1073  766 1008  856  764  767  668  564  454  449  201  200
 110  112  485  700  371  595  692  876  587  786 1085  871  870 1020  869  868  780  944  779  867  777  677  862  859 1012 1010  771  858  854  561  565  672  330  452   64   66
 113  111  245  370  695  486  791  790  787  952  690  949  784  783  781  686  685  866  681  860  678  776  937  770  938  573  853  936  674  673  669  453  566  332   65   63
 596  597  242  368  367  698  694  789  788  873  590  872  691  689  688  687  683  684  580  682  775  576  769  574  855  772  571  934  451  765  450  459  768  333  202  331
 244  594  241  364  487  598  235  592  693  785  477  356  586  585  584  472  582  583  581  579  680  577  463  346  676  461  675  572  570  568  671  210  208  206  203  204
 243  484  593  237  696  361  363  357  589  591  476  231  228  474  475  473  352  471  470  467  222  575  466  465  345  341  214  857  569  458  670   74  338  334  205   67
 109  104  102  101  369  362  478  233  360   97  480  588  355   95   91   93  229  350  469  468  347  578  220  462  464  342  213  344  457  337  567   76  455  209  207   71
 108  240  483  107  105  103  482   99  100  359  481  230  354  353  227  223  225  351   87  349  221  348  219   84  215  216  340  460   81   79  339  456  336   73   68   72
 106  365  366  238  697  232  239  236  479   98  234  358   96   94   90   92  226  224   89   88   86   85  218   83  217  343   82   80  211   77  212   78   75  335   70   69
