# This puzzle is unsolvable
53
   2    1    3    4    5    6  413    7    8   10   11   12   13   14   15   17  224   18   19   20   21  230   22  231   25   26   27   28   29   30   31  239   32   33   34   36   38  246   40  247   41   44   43  251   45   46   47   48   49   50  257   52   51
 208  209  210  211  212  213  215  214    9  217  218  219  220  221  223   16  423  225  226  228  229   24  429   23  232  233  234  235  236  237  238  240  630  241   35  243   37  445   39  248  249   42  450  252  643  253  254  255  456  455  259  258   54
 207  408  409  410  412  414  603  605  216  416  417  418  419  421  222  422  424  615  425  227  427  428  430  621  431  432  433  434  435  436  437  629  631  443  632  815  244  245  995  448  447  449  250  641  451  826  453  454  256  458  457   53   55
 206  407  600  601  411  787  415  606  789  607  608  609  610  420  612  613  797  798  616  426  618  619  620  622  623  806  624  625  626  627  628  439  440  442  242  633  444  817  637  446  638  639  640  642  452  644  645  827  646  647  651  262  261
 406  599  784  783  602  786  604  788  964  790  791  792  794  611  795  614  796  973  800  617  801  802  803  804  805  807  982  808  809  810  811  438  991  441  812 1156 1159  634  635  818  820  821  822  999  824  825 1001  828  648  459  649   56  260
 205  405  598  960  785  961  962  963 1131  966  967  968  793  969  970  971  972  974  799  975  976  977  978  979  980  981  983  984 1151 1153  985 1154 1155  814  816  813 1157  636  819 1160 1162  996  823 1165  998 1169 1002 1003  830   60  460  461  263
 204  404  782  957  959  958 1129 1288 1132  965 1292 1134 1135 1136 1137 1138 1139 1140 1141 1142 1143 1144 1145 1146 1147 1148 1149 1308 1310 1152  986  987 1314  988  992  990 1158  993 1161 1321 1164 1323 1167 1000 1166 1004 1170 1005  829  832  462   57   58
 203  403  597  595  781 1128 1287 1130 1289 1133 1293 1444 1294 1295 1296 1297 1298 1299 1300 1301 1302 1303 1304 1305 1306 1307 1309 1460 1150 1311 1312 1313 1315 1316 1317  989 1318 1319  994 1163  997 1473 1474 1325 1326 1327 1168 1006  463  831  650  264   61
 202  402  780  596  956 1127 1440 1441 1290 1291 1586 1443 1445 1446 1447 1448 1449 1450 1451 1452 1453 1454 1455 1456 1457 1458 1459 1603 1461 1462 1463 1464 1465 1466 1467 1468 1469 1470 1322 1320 1617 1618 1324 1620 1478 1328 1329 1007  833  652   59  266  265
 201  200  594  779  778 1126 1125 1439 1584 1442 1585 1587 1588 1589 1590 1591 1592 1593 1594 1595 1596 1597 1598 1599 1600 1601 1602 1738 1604 1605 1606 1607 1608 1609 1610 1611 1612 1614 1471 1472 1616 1619 1475 1480 1477 1476 1171  835 1009  653  464  267   62
 400  401  592  593  955 1124 1286 1285 1438 1720 1721 1722 1723 1724 1725 1726 1727 1728 1729 1730 1731 1732 1733 1734 1735 1736 1864 1737 1739 1740 1741 1742 1743 1744 1745 1747 1748 1613 1749 1615 1751 1752 1753 1481 1621 1172 1479  834 1008  654  465  268   63
 199  399  591  777  954 1123 1284 1582 1583 1718 1848 1849 1850 1851 1852 1853 1854 1855 1856 1857 1858 1859 1860 1861 1862 1863 1983 1865 1866 1867 1868 1869 1870 1871 1873 1746 1994 1874 1875 1750 1878 1881 1879 1880 1333 1330 1173  836  655  466  269  270   64
 197  397  198  776 1121 1122 1283 1437 1719 1436 1846 1968 1969 1970 1971 1972 1973 1974 1975 1976 1977 1978 1979 1980 1981 2093 1982 1984 1985 1986 1987 1988 1989 1990 1872 1991 1993 1995 1876 1877 1996 1997 1883 1754 1331 1622 1174 1175 1010  837  656  467   66
 398  396  589  775  953 1120 1282 1435 1581 1847 1717 1967 2080 2081 2082 2083 2084 2085 2086 2087 2088 2089 2090 2091 2092 2094 2095 2198 2096 2097 2098 2099 2100 2101 2102 1992 2103 2104 2106 2107 1757 1999 1755 1482 1334 1332 1176 1011  838  657  468   65  271
 196  194  774  951  773 1119  952 1434 1580 1716 1845 1966 2079 2184 2185 2186 2187 2188 2189 2190 2191 2192 2193 2194 2195 2196 2197 2199 2294 2200 2201 2202 2203 2204 2205 2206 2207 2105 2208 2209 1998 1759 1882 1758 1483 1335 1177 1012  839  658  469  272   67
 195  193  395  590  950 1118 1281 1578 1579 1715 1844 1965 2078 2183 2280 2281 2282 2283 2284 2285 2286 2287 2288 2289 2290 2291 2292 2293 2381 2295 2296 2297 2298 2299 2300 2388 2301 2302 2304 2108 2000 2001 1756 1626 1623 1484 1178 1013  840  659  470  273   68
 394  393  587  772  949 1280 1433 1279 1577 1713 1843 1964 2077 2182 2279 2368 2369 2370 2371 2372 2373 2374 2375 2376 2377 2378 2379 2380 2461 2460 2383 2384 2385 2386 2387 2303 2212 2389 2210 2003 2109 1884 1625 1485 1624 1486 1179 1014  841  660  471  274   69
 588  190  585  586  948 1117 1278 1432 1431 1576 1842 1963 2180 2075 2181 2367 2448 2449 2450 2522 2451 2453 2454 2455 2456 2457 2458 2459 2531 2382 2462 2463 2464 2465 2466 2391 2468 2390 2211 2214 2110 2113 1760 1627 1337 1336 1180 1015  842  661  472  275   70
 192  191  392  771  947 1116 1277 1430 1714 1711 1840 1712 1962 2076 2278 2277 2447 2520 2584 2521 2452 2524 2525 2526 2527 2528 2529 2530 2594 2532 2533 2534 2535 2536 2537 2467 2305 1887 2213 2112 1885 1886 1762 1628 1487 1338 1181 1016  843  662  473  276   71
 189  391  390  770 1114  946 1276 1429 1575 1710 1574 1841 1961 2074 2445 2366 2365 2519 2583 2585 2523 2586 2588 2589 2590 2591 2592 2593 2649 2595 2596 2597 2598 2599 2538 2469 2392 2307 2115 2114 2002 1761 2306 1629 1488 1339 1182 1017  844  663  474  277   72
 188  944  584  769  768 1115 1275 1428 1573 1838 1960 2073 2178 2179 2276 2275 2446 2518 2582 2640 2641 2587 2643 2644 2645 2646 2647 2648 2650 2697 2651 2652 2653 2600 2539 2471 2393 2111 2215 2005 1888 1889 1763 1630 1489 1340 1183 1018  845  664  475  278   73
 186  389  583  582  945 1113 1274 1427 1571 1839 1959 2069 2072 2177 2274 2364 2363 2581 2517 2688 2689 2642 2690 2691 2692 2693 2694 2695 2696 2698 2737 2699 2654 2601 2540 2395 2470 2216 2308 2004 2006 1890 1764 1631 1490 1342 1341  846  847  665  476  279   74
 388  187  767  766  943 1112 1273 1426 1709 1572 1708 1958 2176 2070 2273 2362 2444 2443 2638 2639 2687 2728 2727 2730 2731 2732 2733 2735 2766 2736 2738 2702 2655 2700 2541 2542 2394 2472 2310 2116 2007 1891 1766 1765 1632 1184 1185 1019  848  666  477  280   75
 184  581  580  765  942 1111 1272 1425 1570 1707 1836 1957 2071 2174 2175 2272 2361 2514 2516 2637 2686 2760 2729 2761 2762 2763 2764 2734 2803 2739 2656 2602 2603 2604 2474 2396 2397 2218 2217 2309 2117 2008 1492 1635 1493 1343 1186 1021 1020  667  478  281   76
 386  387  385  579  941 1110 1271 1424 1569 1837 1706 1955 1956 2271 2270 2360 2442 2515 2580 2636 2685 2726 2759 2784 2785 2786 2787 2765 2767 2789 2768 2701 2657 2605 2475 2312 2399 2311 2219 2118 2009 1892 1634 1633 1491 1344 1187 1022  849  668  479  282   77
 185  183  763  764  940 1109 1269 1270 1568 1705 1835 1834 2068 2173 2359 2441 2440 2579 2578 2635 2683 2684 2725 2782 2783 2800 2802 2801 2788 2703 2658 2659 2606 2546 2741 2473 2314 2313 2010 1893 2011 1768 1767 1636 1494 1345  850  851 1023  669  480  283   78
 384  383  578  762  939 1107 1108 1423 1422 1704 1833 1954 2067 2172 2268 2358 2439 2512 2513 2634 2724 2758 2756 2757 2799 2808 2794 2791 2769 2804 2770 2607 2740 2398 2476 2544 2315 2220 2121 2221 2119 1894 1769 1637 1347 1495 1188 1190 1025  670  481  284   79
 182  382  577  575  760  938 1420 1565 1567 1566 1832 1953 2171 2065 2267 2269 2511 2510 2577 2631 2682 2723 2755 2781 2797 2807 2806 2805 2790 2743 2792 2660 2545 2608 2543 2400 2316 2120 2317 2223 2012 1896 1895 1771 1346 1189 1024 1026  852  671  482  285   80
 181  381  761  576 1267 1266 1268 1419 1703 1702 1951 1831 2170 2168 2356 2357 2437 2438 2633 2576 2632 2721 2722 2780 2778 2798 2795 2793 2747 2706 2704 2771 2661 2609 2477 2547 2401 2318 2224 2222 2123 2013 1638 1497 1770 1496 1192 1191 1027  853  483  286   81
 572  574  759 1106 1104 1105 1265 1830 1421 1950 1952 2064 2062 2066 2167 2355 2509 2508 2575 2574 2681 2680 2754 2779 2777 2796 2776 2774 2772 2744 2742 2773 2662 2663 2550 2478 2403 2402 2015 2225 2016 2122 1772 1498 1348 1351 1349 1028  673  672  484  287   82
 180  758  573  935 1264  936 1418 1563 1700 1263 2061 1949 2265 2264 2266 2354 2436 2573 2571 2630 2679 2720 2753 2752 2751 2750 2749 2748 2713 2746 2705 2665 2666 2664 2745 2479 2481 2124 2404 2014 1900 1899 1773 1640 1499 1500 1193 1029  854  674  675  485   83
 179  378  571  937 1103 1417 1561 1262 1564 1828 1827 2169 2060 2166 2353 2433 2434 2435 2572 2628 2629 2678 2719 2717 2716 2715 2714 2775 2668 2707 2709 2612 2708 2611 2480 2548 2551 2319 2126 2125 1897 1901 1774 1641 1350 1502 1353 1030  856  855   84  288   85
 757  380  756  570  379 1101  755 1413 1701 1416 1829 1562 1947 1826 2063 2351 2507 2506 2570 2627 2677 2676 2718 2674 2673 2672 2670 2669 2711 2667 2616 2615 2556 2614 2610 2482 2320 2228 2226 2017 2127 1898 1639 1775 1352 1194 1195  290  857  486   86  291  289
 178  376  176  934  377  932 1261 1560 1415 1698 1559 2059 1946 1948 2352 2164 2165 2503 2505 2499 2500 2626 2625 2623 2622 2621 2671 2561 2620 2712 2710 2488 2613 2484 2552 2549 2407 2227 2229 1902 2018 2019 1643 1503 1197 1777 1501  677 1032  676  487  293   87
 177  175  753  931  933  754 1100 1697 1699 1558 1944 1825 2058 2263 2260 2163 2504 2502 2431 2426 2568 2675 2624 2564 2563 2562 2493 2418 2619 2617 2490 2557 2413 2486 2553 2406 2408 2405 2323 2230 2321 1776 1354 1644 1647 1642 1033 1034 1031  679  858  292  491
 174  375  569  568  929 1098 1557 1099 1696 1102 1945 2057 1824 2347 2262 2430 2350 2569 2567 2566 2424 2565 2497 2496 2420 2495 2494 2560 2491 2558 2555 2554 2412 2489 2411 2483 2329 2410 2130 2231 2020 1903 1778 1196 1357 1198 1199  859  488  493  294  489   88
 173  374  566  930  752 1258 1260 1414 1555 1693 1695 2429 2261 2056 2162 2349 2345 2346 2428 2425 2427 2423 2498 2422 2419 2421 2492 2618 2417 2332 2415 2414 2330 2238 2487 2409 2322 2485 2232 2129 2128 1904 1645 1648 1358 1504 1355 1035  678  681  296  490  860
 172  565  751  567  927 1097 1412 1691 1822 1259 1556 1943 2258 1942 2259 2432 2256 2344 2343 2342 2501 2341 2248 2339 2338 2245 2559 2335 2333 2416 2241 2331 2328 2137 2030 2237 2324 2326 2325 2233 2021 2022 1507 1506 1505 1356  861 1036  680  863  492  295   89
 171  373  564  928  750 1096 1411 1257 1823 1692 1694 2161 1941 2257 2160 2255 2156 2254 2253 2252 2251 2250 2340 2247 2148 2337 2336 2244 2334 2242 2243 2240 2139 2236 2140 2327 2234 2135 2132 2131 1907 1905 1906 1509 1646 1359 1200 1037  682   91  684  494   90
 170  372  371  749  926 1095 1256 1409 1408 1821 1820 1819 2055 2159 2158 2348 2157 2048 2154 2153 2152 2151 2249 2149 2147 2246 2146 2145 2144 2036 2143 2142 2141 2032 2136 1918 2235 2028 2134 2133 1782 1781 1779 1780 1649 1202 1201  866  685  862  298  495   92
 169  370  748  925  563 1094 1255 1553 1554 1410 1690 2053 2054 1938 2051 1935 2050 1934 1933 2046 2045 2044 2150 2043 2041 1924 1925 2038 1798 1921 2035 2034 2239 2033 1917 1915 1661 2027 1913 2025 2023 1909 1908 1651 1508 1650 1360 1203 1039  864  497  297   93
 168  369  562  747  924 1093 1254 1407 1552 1818 1688 1816 2052 1681 1937 1936 1932 2155 2049 1808 1931 1930 1928 2042 2040 1927 1926 1922 2037 1665 1667 1224 1919 2138 1663 2031 1791 1790 2026 1911 2024 1910 1784 1653 1783 1361 1204 1038  867  683  865  300   94
 167  368  561  746  923 1253 1091 1406 1551 1689 1817 1940 1939 1544 1680 1813 1811 2047 1677 1678 1807 1929 1806 1805 1803 1802 2039 1528 1923 1920 1796 1525 1793 1664 1662 1916 1788 1912 1789 1518 1657 1512 1655 1654 1206 1510 1511 1040  686  496  498  299   95
 166  367  560  745  922 1092 1252 1405 1550 1687 1815 1684 1814 1685 1545 1812 1392 1679 1810 1809 1676 1675 1534 1804 1673 1671 1670 1801 1668 1530 1799 1379 1797 1377 1524 2029 1914 1521 1787 1372 1371 1368 1786 1785 1652 1362 1205 1041  869  868  687   97  301
 165  366  559  744  921 1251 1402 1404 1548 1547 1686 1399 1546 1683 1543 1682 1542 1240 1540 1538 1537 1536 1674 1535 1672 1532 1531 1800 1669 1666 1526 1378 1523 1059 1376 1374 1659 1519 1520 1216 1051 1214 1369 1515 1514 1363 1207 1042  870  302  499   96   98
 164  365  558  743  920 1090 1248 1249 1549 1401 1400 1244 1397 1243 1242 1077 1541 1239 1539 1391 1390 1234 1388 1387 1533 1386 1385 1382 1529 1380 1527 1060 1061 1794 1058 1660 1792 1375 1658 1218 1373  702 1656 1367 1513 1364 1210 1043  871  689  500  501  303
 163  364  557  742  919 1089 1088 1403 1247 1246 1245 1081 1398 1078 1395 1076 1394  724 1393 1236 1072 1233 1389 1232 1231 1230 1228 1229 1381 1065 1063  890 1795 1222 1220 1522  886  884 1215 1370 1050  880 1211 1366 1365 1044 1208 1046 1045  690  502  688   99
 162  363  556  741  918 1087 1086 1250 1085 1083  911 1082 1080 1079 1241 1074  906  905 1237 1071 1235  900 1070 1069 1068 1067 1383  895 1226  893 1227 1225  888 1223  887 1057 1219  704  883 1517 1053 1516 1213 1212 1048  876 1209 1047  872  692  691  304  503
 161  362  555  740  917  916  915  913 1084  546  912  732  909  729  541  908 1396 1075  902 1238 1073  901  899  898  897  896  715 1066 1384  892  712 1062  889  708 1221  709 1056 1055 1217 1054  879 1052  878 1049  877  697  875  874  693  306  307  305  100
 160  361  554  739  738  737  736  914  735  734  730  910  543  728  727  907  904  903  725  723  722  721  720  719  718  716  530    0  527  894  525  891  325  710  707  520  885  705  703  881  516  701  318  513  511  698  696  695  873  694  102  504  103
 159  360  553  552  551  550  549  548  547  545  733  146  348  542  539  538  726  537  342  536  535  534  533  532  531  717  529  528  713 1064  331  711  523  521  123  326  706  518  882  517  320  319  514  699  700  315  509  507  312  506  505  101  104
 158  359  358  357  356  355  354  353  352  351  731  544  349  347  346  540  345  344  343  341  340  339  338  337  336  335  333  524  526  714  332  129  327  328  522  125  519  323  322  321  515  116  115  114  510  112  314  508  109  108  310  308  309
 157  156  155  154  153  152  151  150  149  148  350  147  145  144  143  142  141  140  139  138  137  136  135  134  133  132  131  334  128  127  130  330  329  126  124  122  324  121  120  119  117  118  512  316  317  113  313  111  110  107  311  106  105
