# This puzzle is unsolvable
15
 57 102  61 147   1   5  60  65  11  15  66  10  13  17  14
105  56 107   8 108 218 106 200  62   4 180 224 114  69 153
178 176  53 109   6  51  59 152 146 182 115 151  68  16  71
142   2   3  54 103 113 111 185 183  63 110  12 117 184 156
173  55 104   7 144  58 116 112 149   9  67  19  73  20 155
 47  50 100  49 204 143 210 223 219 187  72 205  64  78 181
 99 198 101  98 171 179 175 203  48 186 119 122 123 188  70
133  92 195 174 192 197 217 199 211 157 216 154 207  18  74
 52 196 139 202 136 161 201  34 148  81 189 150 159  21 160
214 145 172 140  43 213 220 212 206  26 120  76 124  29 125
 36  44 170 132  86 177 215  87  75 221 138  77   0  30 118
193  41 165 135 169 208 166 121  83  32  89  79  25 129  23
 91  46  97  45  84  90 167 141 131 163  37 127 126  33  28
137  42  96  94 134  38 222 209  24 164  88 162  27  85  82
 93 194  95  40 191 128 168  39  31  35  22  80 158 190 130
