# This puzzle is unsolvable
30
117   1   3   5   7 227 123 122   9  10  11  12  13  14  15 131  16  19  20 135  21  22  23  24  25  26  27  28  29  30
226 115 116 121   6 324 124 229 232 231 126 127 128 129 130 337  18  17 132 342 136 137 138 139 140 141 142 143 144  31
113 224   2 118 225 328   8 329 230 125 233 234 235 236 336 237 238 133 134 242 243 244 245 246 247 248 249 250 145  32
114 120 223 119 418   4 228 330 421 331 332 333 334 335 428 429 239 240 338 339 433 343 344 345 346 348 251 350 146  33
222 323 325 112 417 326 327 503 504 422 423 424 425 426 427 513 588 430 515 241 341 434 435 436 520 437 347 349 147  34
111 221 416 499 500 501 420 577 419 505 506 507 508 509 510 511 512 340 431 590 592 659 518 519 439 438 252 148  35  36
109 322 220 415 575 502 576 579 646 581 647 582 583 584 585 586 655 514 589 432 516 658 593 594 441 521 352 253 149  37
321 320 497 414   0 498 574 644 578 580 648 707 649 650 652 653 587 714 715 517 717 660 595 522 443 440 442 150 151  38
319 110 108 573 413 410 701 645 706 759 837 803 761 651 711 712 766 657 843 591 844 656 718 598 353 258 351 254  39 153
318 218 219 409 494 704 411 757 705 758 760 797 710 839 762 713 654 716 810 811 768 767 523 596 528 662 525 256  40 354
217 216 317 496 643 315 642 755 571 754 800 802 806 708 709 764 765 809 808 720 719 663 661 872 447 255 357 444 155  42
215 316 495 702 572 756 703 838 699 799 801 865 867 836 807 805 842 804 814 847 665 773 770 724 664 524 526 355  41  44
106 107 313 641 412 491 408 637 638 700 798 834 840 845 866 841 895 869 889 721 667 666 356 723 448 599 358 154 152  43
212 214 105 492 493 639 640 881 695 896 567 751 883 864 893 763 812 846 871 771 722 597 604 529 359 360 259 602  46 257
102 104 405 570 213 636 490 569 752 884 796 830 753 894 897 848 888 898 886 870 813 772 769 600 531 446 260 261 156 158
103 211 406 404 407 697 568 831 634 833 882 835 861 863 868 899 825 821 815 774 775 726 361 603 264 601 527 445 262 263
210 311 310 314 312 563 489 749 696 750 827 794 791 892 885 887 860 852 851 875 873 850 668 816 725 451 449 157  45 265
101 208 100 403 698 692 746 793 826 828 565 693 877 876 824 874 780 890 680 785 727 728 818 669 670 530 266 364 267 362
 99 207 486 401 633 564 792 635 795 687 694 790 879 829 853 784 738 823 783 778 776 777 671 363 453 605 160 452  47  48
 98 400 485 209 632 787 748 691 741 631 832 880 858 681 855 620 682 891 733 817 781 849 673 162 606 450 456 365 159  49
307 205 560 309 402 566 484 483 742 857 854 789 688 859 285 465 862 547 546 878 676 735 537 540 269 268 454 163 161  50
308  97 206 487 561 398 559 488 562 686 623 186 737 822 683 618 786 820 819 734 779 729 672 607 533 534 165 455 270  51
 96 306 301 399 397 745 629 305 689 788 619 739 684 551 469 856 468 730 732 378 608 532 675 610 368 458 366 167 164  52
204 302 303 396 481 197 630 747 744 293 743 552 740 471 383 384 782 615 736 731 678 464 536 612 166 371 541  53 169 272
 95  94 395 196 477 202 387 482 627 189 624 472 291 554 548 550 679 544 613 543 609 677 375 535 538 460 367  55 274  54
203  91  90 480 304 299 558 690 388 625 555 470 389 382 622 288 283 282 545 616 180 674 374 614 372 459 611 457 168 369
 93 201 394 393 479 478 557 391 626 292 685  80 188 621 290 381 617 466 379 377 376 542 461 175 462 539 271 170  56 275
200  84  87 300 556 296 297 628 390 190 475 386 385 287 289 380 553  72 183 467 281 463 279 278 277 276 370 273  61  60
 89  88 199  85 195 392 298 476 295 474 192  76  79  77 549 185 182 286 284 181 280  66 177 373  63  64 172 173  58  62
198  92  86  83  81  82 193 194  78 294 191 473 187  74  75 184  73  71  70  69  68 179 178  67  65 176 174 171  57  59
