# This puzzle is unsolvable
38
   2    1    3    4    6    5    7  425    8    9  158  159  160  161  165   16  303   17   18  437  167   22   26  171  441  311  175   29  178   30  177  180  176   32  181  182   35  320
 148  149  289  150  151  154  155  293  157   11   10  298   12  299  556   15  305  166  306   21   20  170   23   25   24   27  445  312  315  316   34   31  451   33  184   45   41   37
 147  287  288  291  152  548  153  294  427  295  156  296  300   13  431  433  302  162   19  307  562  308  310  440  174  173  443   28  317  448  321  572  450  318  322   40  325   36
 146  286  420  290  292  546  426  547  550  428  551  297  429  163  164  430   14  555  304  438  169  168  309  567  172  442  566  313  314  446  319  449  323  574  183   38  575  453
 285  143  419  422  421  423  662  661  424  665  668  553  667  552  671  557  435  673  558  434  679  563  784  564  565  788  683  568  570  447  571  687  179  326  324  457  186  189
 142  145  417  284  543  768  664  663  549  771  666  774  301  432  670  778  672  559  436  675  561  560  786  439  682  444  684  887  569  685  686  688  573  452  456   39  327  187
 141  657  542  659  541  544  770  867  959  773  872  772  554  874  777  877  879  781  676  674  783  883  677  787  785  885  789  681  790  791  793  454  689  578   42  328  455  192
 418  283  545  658  660  866  765  764  870  963  960  669  965  873  775  878 1053  969  880  779  782  881  884  886  977  678  680  891  890  792  892  794  577  796  893  795  193  188
 282  144  416  540  769  539  868  961  962  869  871 1046  964  875  776 1049  967  780  970  972  882  976 1056 1059  978 1135 1061  888  981  982  894  692  331  190  579   43  458  185
 140  281  414  656  415  767  654  958 1117 1044 1047 1189 1048  876 1050 1126  968 1052  971 1130  975  974 1134 1133 1060 1137  979  889 1065  983  985  895  461  691   44   46  191   47
 139  413  538  655  763  863  762 1040 1043 1045 1247 1188 1121  966 1123 1124 1194 1127 1054  973 1057 1055 1058 1201 1136 1138 1139  980 1066  984  896  799  797   49  459  460   48   52
 280  279  412  536  865  864 1042  862  955 1190 1186 1122 1248 1302 1191 1051 1252 1128 1305 1255 1131 1132 1200 1202 1203 1314 1262 1141 1068  897  580  690  697  693  583  329  576  695
 138  137  411  537  761  651  766 1118 1185 1120 1041 1250 1193 1303 1344 1251 1196 1129 1197 1307 1258 1259 1260 1311 1204 1205 1062 1064 1070 1063 1067  802  582  330  463  462   50  194
 136  278  535  534  652  861  954  860  653 1119 1299 1246 1249 1125 1343 1192 1304 1195 1254 1257 1199 1351 1353 1355 1261 1264 1313  987 1263  800  801  699  584  581  900  464  332  195
 276  410  277  758  760  957  649  956 1184 1187 1116 1245 1300 1301 1345 1347 1256 1346 1306 1309 1308 1198 1310 1354 1312 1315 1206  988  986 1140  694  696  698  585  798  334   51  198
 135  275  407  409  650  859  759  952  953 1295 1036 1115 1298 1341 1378 1382 1349 1383 1385 1386 1412 1352 1388 1433    0 1265 1208 1071 1207  990  898  989  465  700  335  196   53  333
 134  274  408  532  648  533  858 1111 1038 1183 1039 1182 1342 1297 1379 1253 1411 1348 1384 1350 1413 1414 1387 1318 1266 1209 1210 1069 1142 1143  805 1144  901  804  467  468   54   56
 133  132  647  406  756  855  951 1037 1241 1114 1244 1181 1296 1406 1380 1440 1381 1410 1429 1431 1432 1389 1358 1357 1356 1267 1145 1072  991  903  992  899  803  466  336  197  337  200
 272  405  273  404  757  856  857  950 1113 1180 1243 1240 1408 1377 1428 1441 1409 1426 1420 1430 1417 1392 1393 1390 1391 1270 1211 1146 1073  904  905  902  807  587  588  202  586   57
 131  271  531  530  529  754  949  948 1035 1112 1110 1109 1376 1294 1340 1407 1443 1434 1435 1442 1422 1436 1416 1316 1360 1213 1212 1147  993  701  906  806  589  469  590  199  201  338
 130  402  269  527  645  753  646 1032  853 1034 1242 1293 1339 1338 1405 1375 1404 1438 1423 1439 1419 1415 1395 1317 1268 1214 1148 1075 1074  994  808  706  702  340  704  204   55   59
 528  129  270  403  644  854 1033  755 1031 1178 1179 1238 1239 1374 1373 1425 1424 1427 1437 1421 1418 1397 1394 1359 1361 1362 1216 1149  995  996  809  591  471  339   61  472  207  203
 128  401  400  267  643  752  946  947 1030 1108 1177 1237 1292 1337 1372 1403 1399 1329 1400 1398 1326 1396 1319 1269 1320 1215 1150 1077 1151  997  908  907  810  594  592  470   58  206
 127  268  399  526  525  751  852  945 1029 1107 1176 1289 1291 1334 1336 1402 1370 1369 1401 1280 1367 1277 1327 1364 1322 1271 1272 1273 1076  909  998  473  811  342   62  205  343  341
 266  124  524  523  642  641  851  944 1027 1106 1175 1335 1290 1285 1287 1331 1371 1283 1368 1328 1365 1366 1325 1363 1321 1218 1152 1078 1079 1080  705  708  475  346  813  593   60   65
 126  265  639  640  522  750  943 1103  940 1172  941 1236 1235 1288 1284 1333 1330 1227 1229 1282 1281 1279 1276 1223 1323 1153 1275 1217 1001  999  910  812  703  474  344  345   63  347
 123  398  264  395  749  849  850  942 1026 1028 1104 1174 1233 1232 1231 1332 1228 1230 1162 1226 1163 1224 1278 1222 1324 1221 1274 1154 1082 1081  911  709  814  597  596  595  211  208
 122  125  521  638  396  746  747  848 1105 1101 1173 1170 1234 1286 1018 1168 1166 1094 1165 1225 1161 1160 1159 1158 1157 1220 1219 1156 1002 1003  815  816  707  478  598  210  348  209
 119  120  397  121  262  745  748  636  846 1102 1100 1098 1171 1169 1097 1167 1095 1015 1093 1013 1164 1090 1089 1087 1008 1086 1085 1155 1084 1000  913  912  710  476  212  477   64   66
 263  261  393  394  637  939  744  938 1025 1024 1023 1021 1099  930  931 1096 1016 1092  926 1014 1012 1091  925 1009 1088 1007 1006 1005 1083  820  914  817  349  712  714  351  213   67
 259  518  118  635  743  520  844  847  937  934 1022  933 1020  837 1019  932  929  928  927  831 1011  922 1010  921  920  919  918  917 1004  916  715  915  716  711  599  480  350   68
 257  258  519  634  517  631  633  845  840  936  935  378  839  621  733 1017  836  833  616  726  830  923  924  828  827  722  825  824  822  823  818  718  819  600  713  479  214   69
 391  116  260  516  742  630  740  741  841  738  737  626  838  735  619  624  835  617  832  727  725  496  829  724  826  723  610  720  719  821  605  485  602  601  481  352  215   70
 117  392  390  514  515  512  843  739  842  507  736  381  625  506  731  618  729  500  728  498  615  497  614  613  612  721  611  609  362  608  489  487  717  606  482  353  216   71
 115  255  256  389  632  513  510  629  627  509  508  245  377  734  242  730  623  239  237  499  235  238   93  494  493  492  491  490  361  488  607  604  486  358  483  354  217   72
 114  254  388  387  386  385  250  511  382  384  100  628  732  505  376  373  501  374  372   94  236  495  369  233  367  365  363  229  227  360  224  225  357  603  356  355  218   73
 113  253  110  251  108  106  105  104  383  379  244  380  622  503  502   99  620  834   97  370  371  234  368  232  366   87  230  364  228  226  359  223  222  484   79  220  219   74
 112  111  109  252  107  249  248  247  246  103  102  101  504  375  243  241  240   98   96   95   92   91   90   89  231   88   86   85   84   83   82   81   80   78  221   77   76   75
