# This puzzle is unsolvable
63
 250    2  719    3  491  252  253    9   10   11  495  258  260   13   14   15   16  265   19   20   21   22   23   24   25   26   27   28   29   30   31   32   33   34   35   36   37   38   39   40   41   42   43   44   45   46   47   48   49   50   51   52   53   54   55   56   57   58   59   60   61   62   63
 488    1  721  251  490  946    6  255    8  497  729   12  259  501  262  263   18   17  266  267  268  269  509  270  271  272  274  275  276  277  278  279  280  281  282  283  284  285  286  287  288  289  290  291  292  293  294  295  296  297  298  299  300  301  302  303  304  305  306  307  308  309   64
 247    4  248  943  723  494    7  493    5  256  727  257  261  500  499  502  264  504  505  506  738  507  508  510  511  273  513  514  515  516  517  518  519  520  521  522  523  524  525  527  758  528  529  530  531  532  533  534  535  536  537  538  539  540  541  542  543  544  545  546  547  310   65
 486  249  244  492  487  725  254  948  949  726  496  498  953  731  733  956  503  734  735  737  961  740  741  742  743  512  744  745  746  747  748  749  751  974  975  752  755  978  757  526  981  759  760  761  762  763  764  765  766  767  768  769  770  771  772  773  774  775  776  777  548  311   66
 489  246  945  720 1159  944 1369 1164 1162  950 1166  730 1167  952  732 1378  958  959  736 1175  960  739  963  964  965  966  967  968  969  970  971  972  973  750 1190  754  753  976 1194  979  980  982  983  984  985  986  987  988  989  990  991  992  993  994  995  996  997  998  999  778  549  312   67
 245  942  718  716  724  947 1370 1163 1571 1371  951 1375 1374  954  955 1379  957 1171 1173 1174 1176  962 1177 1179 1181 1386 1182 1183 1184 1185 1186 1188 1396 1395 1189 1398  977 1400 1192  756 1196 1197 1198 1199 1407 1200 1201 1203 1204 1205 1206 1207 1208 1209 1210 1211 1212 1213 1000  779  550  313   68
 242  485  941  484  722 1161 1368 1568 1569  728 1373 1573 1168 1377 1170 1172 1380 1579 1381 1382 1383 1384 1178 1385 1387 1180 1389 1390 1391 1392 1393 1187 1593 1595 1397 1399 1597 1401 1600 1195 1403 1404 1405 1605 1406 1408 1202 1409 1411 1412 1413 1414 1415 1416 1417 1418 1419 1214 1001  780  551  314   69
 483  482  243 1160 1157 1366 1158 1567 1570 1762 1572 1764 1376 1169 1576 1577 1578 1580 1771 1581 1582 1583 1584 1586 1388 1587 1589 1780 1590 1591 1592 1594 1394 1786 1596 1193 1788 1599 1598 1402 1602 1603 1604 1796 1606 1607 1609 1410 1610 1611 1612 1613 1614 1615 1616 1617 1420 1215 1002  781  552  315   70
 241  715  940  717 1365 1156 1760 1372 1945 1944 1165 1765 1574 1575 1767 1768 1769 1770 1772 1955 1773 1775 1776 1585 1777 1778 1779 1588 1781 1782 1783 1784 1785 1969 1971 1191 2146 1974 1789 1601 1793 1794 1795 1797 1980 1798 1608 1800 1801 1802 1803 1804 1805 1806 1807 1618 1421 1216 1003  782  553  316   71
 240  481  714  939 1367 1566 1565 1761 1757 1946 1763 2122 1947 1766 1950 1951 1952 1953 1957 2128 1956 1774 1958 1959 1961 1962 2137 1963 1964 1965 1966 1967 1968 2144 1787 1790 2148 2150 1791 1792 1976 1977 1978 1979 2155 1981 1799 1982 1983 1985 1986 1987 1988 1989 1808 1619 1422 1217 1004  783  554  317   72
 239  480  713  938 1155 1364 1758 1759 1942 2120 2121 2289 1948 1949 2124 2125 2126 2127 1954 2298 2130 2133 2300 2135 1960 2302 2303 2138 2139 2140 2141 2142 2143 1970 2145 1972 2149 1973 1975 2477 2476 2318 2152 2154 2322 2156 2157 2158 1984 2159 2161 2162 2163 1990 1809 1620 1423 1218 1005  784  555  318   73
 238  479  712  937 1154 1363 1564 1756 2119 1943 2288 2447 2123 2290 2292 2294 2295 2296 2129 2132 2457 2131 2460 2299 2134 2136 2304 2305 2306 2308 2307 2311 2469 2313 2314 2623 2147 2317 2315 2151 2628 2319 2153 2321 2481 2323 2324 2325 2326 2160 2328 2329 2164 1991 1810 1621 1424 1219 1006  785  556  319   74
 237  478  711  936 1153 1362 1563 1941 2118 2287 2448 2600 2603 2291 2451 2293 2454 2455 2606 2456 2297 2458 2459 2301 2461 2462 2464 2465 2467 2466 2310 2620 2312 2470 2471 2474 2472 2316 2627 2770 2320 2773 2478 2630 2479 2482 2483 2484 2485 2327 2487 2330 2165 1992 1811 1622 1425 1220 1007  786  557  320   75
 236  477  710  935 1152 1361 1562 1754 1940 2116 2117 2286 2449 2601 2450 2452 2453 2605 2749 2750 2607 2609 2610 2611 2612 2613 2463 2614 2615 2760 2468 2309 2617 2766 2764 2473 2625 2475 2624 2629 2772 2771 2480 2632 2633 2634 2635 2636 2637 2486 2488 2331 2166 1993 1812 1623 1426 1221 1008  787  558  321   76
 235  476  709  934 1151 1360 1561 1939 1755 2115 2285 2446 2598 2745 2746 2602 2604 2748 2884 2608 2887 2753 2754 2889 2755 2756 2895 2894 2616 2761 2619 2762 2621 2898 3027 2900 2622 2768 2626 2905 2769 2907 2908 2631 2774 2776 2777 2778 2779 2638 2489 2332 2167 1994 1813 1624 1427 1222 1009  788  559  322   77
 234  475  708  933 1150 1359 1560 1753 1937 1938 2284 2599 2743 2445 2879 2880 2881 2883 2885 2886 2752 2751 2890 3017 2891 2892 2757 3019 2758 2759 3023 2897 2765 2763 3026 2767 2903 2904 3031 3033 2906 3153 3035 3156 2775 2910 2912 2913 2780 2639 2490 2333 2168 1995 1814 1625 1428 1223 1010  789  560  323   78
 233  474  707  932 1149 1358 1559 1752 2114 2283 2740 2597 2444 2744 3008 2747 3009 3007 3011 3012 3013 3014 2888 3015 3016 3018 3020 2893 2618 3021 3022 3024 2899 3025 3148 3147 2902 3363 3032 3365 3034 3154 2909 3037 3038 3036 2911 3039 2781 2640 2491 2334 2169 1996 1815 1626 1429 1224 1011  790  561  324   79
 232  473  706  931 1148 1357 1558 1751 1936 2113 2742 2441 2596 2878 2877 2882 3129 3010 3130 3131 3132 3133 3134 3135 3247 3136 3137 3139 3140 2896 3142 3143 3359 3255 2901 3028 3149 3029 3150 3151 3152 3265 3367 3368 3158 3268 3040 2914 2782 2641 2492 2335 2170 1997 1816 1627 1430 1225 1012  791  562  325   80
 231  472  705  930 1147 1356 1557 1750 2112 2282 2111 2281 2595 2876 3006 3127 3128 3240 3241 3242 3243 3244 3245 3246 3350 3248 3138 3250 3251 3141 3253 3254 3256 3144 3358 3257 3030 3459 3259 3364 3262 3464 3266 3155 3159 3157 2918 2783 2784 2642 2493 2336 2171 1998 1817 1628 1431 1226 1013  792  563  326   81
 230  471  704  929 1355 1354 1556 1749 1935 2279 2278 2280 2443 2440 2741 3005 3126 3239 3344 3345 3346 3347 3348 3349 3445 3446 3249 3448 3353 3252 3356 3452 3357 3360 3145 3146 3362 3260 3261 3461 3458 3271 3263 3370 3465 3041 3043 2915 2916 2643 2494 2337 2172 1999 1818 1629 1432 1227 1014  793  564  327   82
 229  470  703 1145 1146 1555 1554 1748 2277 1933 2438 2594 2738 2875 2739 3004 3123 3125 3343 3440 3441 3442 3443 3444 3532 3352 3351 3535 3449 3354 3450 3451 3453 3258 3542 3455 3544 3546 3457 3547 3460 3366 3042 3548 3267 3161 3160 2917 2785 2644 2495 2338 2173 2000 1819 1630 1433 1228 1015  794  565  328   83
 228  469  702  928 1144 1353 1553 1747 1934 2110 2593 2442 2592 2736 2874 2737 3002 3238 3341 3342 3439 3528 3530 3531 3611 3533 3447 3536 3537 3355 3538 3539 3540 3454 3541 3361 3623 3545 3624 3625 3549 3371 3162 3462 3372 3269 3044 2919 2786 2645 2496 2339 2175 2174 1820 1631 1434 1229 1016  795  566  329   84
 227  468  701  927 1143 1352 1552 1746 1932 2108 2109 2439 2591 2873 2872 3003 3124 3237 3236 3438 3527 3529 3609 3610 3612 3683 3613 3534 3615 3616 3617 3618 3619 3620 3621 3456 3695 3694 3543 3626 3627 3264 3550 3466 3369 3270 3163 2920 2788 2787 2497 2342 2340 2001 2002 1632 1435 1230 1017  796  567  330   85
 226  467  700  926 1142 1351 1745 1930 1931 2107 2276 2437 2590 2734 2735 3001 3122 3235 3340 3437 3607 3608 3680 3681 3682 3684 3685 3614 3686 3687 3688 3689 3690 3691 3692 3693 3622 3696 3759 3697 3628 3551 3463 3373 3273 3272 3045 2921 3046 2646 2500 2177 2003 2004 1821 1633 1436 1231 1018  797  568  331   86
 225  466  699  925 1141 1350 1551 1744 1929 2106 2275 2436 2589 2871 3000 3121 3339 3120 3338 3436 3526 3606 3679 3744 3745 3746 3747 3748 3749 3750 3751 3752 3753 3754 3755 3756 3757 3758 3760 3698 3629 3552 3467 3374 3164 3047 3048 2922 2341 2647 2499 2498 2176 2005 1822 1437 1438 1232 1019  798  569  332   87
 224  465  923  924 1140 1349 1550 1743 1928 2105 2434 2274 2588 2733 2870 2999 3119 3234 3233 3435 3525 3524 3605 3743 3800 3801 3802 3803 3804 3805 3806 3807 3808 3809 3810 3811 3812 3813 3761 3699 3630 3553 3468 3375 3274 3165 3049 2649 2790 2648 2179 2178 2344 1824 1823 1635 1634 1233 1020  799  570  333   88
 223  464  698  922 1139 1348 1549 1742 1927 2104 2435 2586 2732 2731 2869 2998 3232 3231 3337 3434 3523 3603 3678 3742 3799 3848 3849 3850 3851 3852 3853 3854 3855 3856 3857 3858 3814 3860 3700 3701 3631 3554 3469 3376 3275 3050 2924 2789 2650 2347 2501 2343 2502 1825 1827 1636 1439 1234 1021  800  571  334   89
 463  695  697  696 1138 1347 1548 1741 1926 2103 2273 2432 2585 2587 2868 2997 3118 3230 3336 3433 3522 3677 3604 3741 3798 3847 3888 3889 3890 3891 3892 3893 3894 3895 3896 3897 3859 3816 3815 3762 3632 3555 3470 3377 3276 3166 3051 2923 2791 2503 2651 2007 2180 2346 1638 1637 1440 1235 1022  801  572  335   90
 222  221  462  921 1137 1346 1547 1740 1925 2102 2271 2272 2430 2730 2867 2996 3117 3335 3431 3334 3521 3602 3676 3675 3740 3797 3846 3887 3921 3922 3923 3924 3925 3926 3927 3898 3861 3817 3763 3702 3633 3556 3378 3379 3277 3167 3168 2925 2652 2792 2653 2345 2006 2504 1829 1639 1441 1236 1023  802  573  336   91
 220  461  694  920  919 1345 1546 1739 1924 2101 2584 2433 2270 2729 2866 2995 3229 3430 3228 3520 3519 3601 3674 3739 3796 3845 3886 3920 3944 3961 3945 3947 3948 3949 3928 3899 3862 3818 3764 3703 3634 3557 3472 3471 3169 3052 2927 2926 2793 2794 2505 2181 2182 1826 2008 1828 1442 1237 1024  803  574  337   92
 219  460  693  918 1136 1344 1545 1738 1923 2100 2583 2580 2431 2582 2865 2994 3116 3227 3115 3333 3518 3600 3673 3738 3795 3844 3885 3919 3918 3960 3946 3962 3963 3950 3929 3901 3900 3863 3765 3704 3635 3474 3473 3279 3278 3170 3053 2928 2796 2795 2655 2348 2010 2009 1830 1640 1443 1238 1025  804  575  338   93
 218  459  692  917 1135 1342 1343 1544 1737 2269 2428 2268 2429 2728 3113 3114 2993 3332 3429 3432 3599 3598 3737 3670 3794 3843 3884 3917 3943 3942 3968 3966 3965 3964 3930 3902 3864 3819 3766 3705 3636 3558 3559 3380 3280 3171 3054 2929 2506 2654 2349 2350 2183 2011 1831 1641 1444 1239 1026  805  576  339   94
 217  458  691 1341 1134  914 1133 1922 2099 2098 2266 2579 2581 2864 2727 2863 2992 3226 3331 3428 3517 3671 3735 3672 3793 3842 3915 3883 3957 3959 3958 3955 3954 3951 3931 3903 3866 3820 3767 3706 3637 3560 3475 3381 3281 3056 3172 3055 2797 2657 2656 2187 2507 2186 2012 1642 1445 1240 1027  806  577  340   95
 216  457  690  916 1132 1543 1736 1921 1735 2097 1920 2094 2725 2726 2861 2862 3112 3225 3330 3427 3516 3597 3736 3792 3841 3840 3916 3879 3941 3940 3956 3967 3909 3952 3953 3865 3867 3821 3768 3707 3638 3561 3476 3382 3383 3282 2931 2930 2798 2508 2351 2353 2184 2185 2013 1643 1446 1241 1028  807  578  341   96
 215  456  689  915 1131 1340 1542 1734 1541 2577 2267 2427 2426 2724 2991 2989 2990 3224 3329 3425 3426 3596 3669 3734 3791 3913 3882 3939 3878 3938 3937 3936 3876 3872 3906 3932 3933 3822 3769 3708 3639 3562 3477 3384 3283 3173 3174 2932 2799 2658 2509 2016 2014 2352 1832 1644 1447 1242 1029  808  579  342   97
 214  455  687  688  913 1130 1339 1918 2095 1919 2265 2264 2425 2860 2722 2723 3110 3223 3327 3328 3515 3595 3668 3733 3790 3881 3914 3880 3912 3911 3935 3908 3934 3907 3829 3904 3868 3823 3770 3709 3640 3563 3478 3385 3284 3175 3057 3059 2934 2659 2510 2015 2188 1834 1833 1835 1448 1243 1030  809  580  343   98
 213  454  686  912 1129 1732 1540 1539 1916 2263 2096 2093 2721 2576 2578 3111 2859 3109 3221 3424 3514 3594 3667 3732 3789 3839 3836 3877 3835 3875 3910 3832 3873 3830 3870 3869 3905 3824 3771 3710 3641 3564 3388 3479 3386 3285 3058 2935 2801 2933 2512 2189 2190 1836 1646 1645 1449 1244 1031  810  581  344   99
 212  453  911  910 1128 1338 1917 1915 1914 1733 2261 2575 2422 2423 2987 2988 2986 3107 3222 3512 3513 3593 3666 3731 3788 3837 3838 3785 3834 3833 3831 3874 3778 3828 3871 3827 3826 3825 3772 3711 3642 3565 3387 3481 3286 3060 3176 2936 2660 2800 2661 2354 2355 2017 1647 1450 1451 1245 1032  811  582  345  100
 211  451  452  685 1335 1127 1538 1731 1536 2262 2090 2424 2259 2858 2984 3218 3106 3108 3326 3423 3422 3511 3592 3665 3787 3786 3726 3658 3784 3782 3781 3780 3720 3779 3777 3776 3775 3774 3773 3712 3643 3566 3480 3389 3287 3177 2802 2803 2662 2513 2511 2192 2357 2019 2191 1648 1452 1246 1033  812  583  346  101
 209  210  450  909 1126 1336 1337 1728 1912 1729 2092 2421 2719 2720 2857 2855 2983 3219 3325 3509 3421 3510 3663 3730 3662 3727 3660 3725 3783 3724 3656 3722 3653 3719 3718 3717 3716 3715 3714 3713 3644 3567 3482 3288 3289 3062 2804 2937 3061 2663 2356 2358 1838 2018 1837 1650 1649 1247 1034  813  584  347  102
 208  683 1123  906  908  907 1535 1726 1730 2091 2260 1537 2718 2717 2981 2985 3324 3220 3420 3419 3590 3589 3591 3728 3729 3661 3584 3659 3581 3580 3723 3721 3654 3652 3651 3650 3649 3648 3647 3646 3645 3568 3483 3390 3180 3179 3178 2938 2806 2664 2515 2514 2193 2020 1840 1839 1453 1248 1035  814  585  348  103
 684  682  681 1125 1333  905 1911 1910 2089 2258 1913 2420 2574 2572 2856 3216 3104 3217 3323 3508 3507 3506 3664 3588 3586 3585 3410 3582 3657 3579 3655 3406 3578 3577 3576 3575 3574 3573 3572 3571 3570 3569 3484 3391 3290 3181 3063 2666 2805 2667 2665 2516 2194 2021 1841 1651 1454 1249 1036  815  586  349  104
 447  449  207 1331 1120 1334 1124 1532 2088 2419 2257 2418 2573 2571 2854 3105 3103 3321 3322 3418 3416 3505 3504 3587 3503 3411 3502 3583 3500 3499 3405 3497 3495 3494 3493 3492 3491 3490 3489 3488 3487 3486 3485 3392 3291 3182 3064 3065 2940 2808 2517 2359 2360 2195 2022 1652 1455 1250 1037  816  587  350  105
 205  680  204  448  904 1531 1534 1530 2084 1724 2255 2417 2570 2853 2715 2852 2982 2980 3214 3417 3317 3415 3414 3413 3412 3312 3409 3501 3408 3498 3307 3496 3404 3403 3402 3401 3400 3399 3398 3397 3396 3395 3394 3393 3292 3183 3066 2939 2809 2807 2518 2361 2196 2023 1842 1653 1456 1251 1038  817  588  351  106
 206  678 1328  679 1330 1725 1332 1121 1909 1727 2087 2415 2416 2714 2716 2851 3101 3213 3215 3320 3318 3316 3315 3314 3204 3205 3310 3309 3202 3407 3200 3306 3305 3304 3303 3302 3301 3300 3299 3298 3297 3296 3295 3294 3293 3184 3067 2941 2942 2668 2519 2362 2197 2024 1843 1654 1457 1252 1039  818  589  352  107
 446  677  444 1722  903 2086 1122 1327 2085 1907 2252 2254 2568 2567 2850 2979 3102 3100 3319 3212 3210 3209 3208 3207 3313 3206 3311 3203 3087 3308 3201 3199 3198 3197 3196 3195 3194 3193 3192 3191 3190 3189 3188 3187 3186 3185 3068 2943 2810 2669 2520 2363 2198 2025 1844 1655 1458 1253 1040  819  590  353  108
 203  445  900  675 1529 1528 1118 1533 1723 2256 2412 2712 2713 2569 2566 2849 3099 3098 3097 3211 3096 2970 3094 3093 3091 3090 3089 3088 2964 3086 3085 3084 3083 3082 3081 3080 3079 3078 3077 3076 3075 3074 3073 3072 3071 3070 3069 2944 2811 2670 2521 2364 2199 2026 1845 1656 1459 1254 1041  820  591  354  109
 201  202 1908 1526 1329  901 2083 1326 1905 2081 2413 2253 2564 2977 2565 2978 2976 2975 2842 2841 3095 2973 2839 3092 2968 2967 2966 2965 2833 2963 2962 2961 2960 2959 2958 2957 2956 2955 2954 2953 2952 2951 2950 2949 2948 2947 2946 2945 2812 2671 2522 2365 2200 2027 1846 1657 1460 1255 1042  821  592  355  110
 443  676  902 1115 1116 1325 1719 1527 1906 1903 2082 2251 2711 2710 2706 2845 2705 2704 2844 2703 2974 2972 2971 2969 2838 2836 2835 2834 2694 2832 2831 2830 2829 2828 2827 2826 2825 2824 2823 2822 2821 2820 2819 2818 2817 2816 2815 2814 2813 2672 2523 2366 2201 2028 1847 1658 1461 1256 1043  822  593  356  111
 442  200  441  899 1119 1117 1720 1721 1904 2414 2249 2250 2709 2847 2848 2846 2559 2560 2843 2701 2840 2702 2699 2698 2837 2697 2549 2696 2695 2693 2692 2691 2690 2689 2688 2687 2686 2685 2684 2683 2682 2681 2680 2679 2678 2677 2676 2675 2674 2673 2524 2367 2202 2029 1848 1659 1462 1257 1044  823  594  357  112
 199  674  673 1324  440 1717 1902 1718 2077 2080 2410 2411 2562 2708 2707 2561 2404 2557 2556 2555 2700 2399 2554 2553 2552 2550 2548 2393 2547 2546 2545 2544 2543 2542 2541 2540 2539 2538 2537 2536 2535 2534 2533 2532 2531 2530 2529 2528 2527 2526 2525 2368 2203 2030 1849 1660 1463 1258 1045  824  595  358  113
 671  195  439  897 1321 1715 1323 1901 1525 2078 2079 2563 2409 2407 2405 2406 2071 2558 2402 2401 2400 2236 2398 2397 2551 2396 2394 2230 2229 2391 2390 2389 2388 2387 2386 2385 2384 2383 2382 2381 2380 2379 2378 2377 2376 2375 2374 2373 2372 2371 2370 2369 2204 2031 1850 1661 1464 1259 1046  825  596  359  114
 438  198  436  672 1114 1524 1521 1716 2248 1711 1900 2246 2247 2244 2243 2403 2242 2240 2239 2238 2237 2065 2235 2234 2233 2395 2232 2231 2228 2056 2392 2226 2225 2224 2223 2222 2221 2220 2219 2218 2217 2216 2215 2214 2213 2212 2211 2210 2209 2208 2207 2206 2205 2032 1851 1662 1465 1260 1047  826  597  360  115
 670  892  898 1320  896 1714 1316 1113 2075 2076 1709 1523 2408 2074 2073 1891 1892 2070 2069 1888 1699 2067 2064 2063 2062 1882 2060 2061 2059 2057 2227 2055 2054 2053 2052 2051 2050 2049 2048 2047 2046 2045 2044 2043 2042 2041 2040 2039 2038 2037 2036 2035 2034 2033 1852 1663 1466 1261 1048  827  598  361  116
 435 1322  437  891 1522 1109 1112 1898 1317 1516 2245 1897 1513 1896 1707 2072 2241 1890 1703 2066 1887 1886 1504 1885 1884 1883 1881 1879 2058 1877 1876 1689 1875 1874 1873 1872 1871 1870 1869 1868 1867 1866 1865 1864 1863 1862 1861 1860 1859 1858 1857 1856 1855 1854 1853 1664 1467 1262 1049  828  599  362  117
1520  197 1319  895  669  887 1518 1318 1713 1899 1311 1895 1514 1894 1706 1893 1705 1508 1889 1701 1700 1698 1697 1501 1696 1695 1295 1693 1691 1496 1878 1690 1688 1687 1686 1685 1684 1683 1682 1681 1680 1679 1678 1677 1676 1675 1674 1673 1672 1671 1670 1669 1668 1667 1666 1665 1468 1263 1050  829  600  363  118
 667  894  890 1108  666 1111 1104 1315 1712 1313 1710 1310 1708 1512 1511 1510 1704 1702 2068 1506 1505 1503 1502 1088 1500 1499 1880 1694 1692 1083 1495 1494 1493 1492 1491 1490 1489 1488 1487 1486 1485 1484 1483 1482 1481 1480 1479 1478 1477 1476 1475 1474 1473 1472 1471 1470 1469 1264 1051  830  601  364  119
 192  668  193  889 1110 1106 1519 1314 1517 1515 1100 1098 1312    0 1308 1307 1509 1094 1304 1507 1302 1301 1300 1297 1089 1296 1498 1294 1082 1497 1292 1291 1290 1289 1288 1287 1286 1285 1284 1283 1282 1281 1280 1279 1278 1277 1276 1275 1274 1273 1272 1271 1270 1269 1268 1267 1266 1265 1052  831  602  365  120
 434  196  433  893  194  888 1105  885  884  883 1103  882  881 1309  878 1097 1306 1305  873  645 1091 1090 1299 1298  640 1087 1085  868 1084 1293 1081 1080 1079 1078 1077 1076 1075 1074 1073 1072 1071 1070 1069 1068 1067 1066 1065 1064 1063 1062 1061 1060 1059 1058 1057 1056 1055 1054 1053  832  603  366  121
 191  432  431  665 1107  661  662  886  422  654 1101  880 1099  879 1095  875 1093  647  874 1092  410  872  871  870  869 1086  866  864  637  863  862  861  860  859  858  857  856  855  854  853  852  851  850  849  848  847  846  845  844  843  842  841  840  839  838  837  836  835  834  833  604  367  122
 430  190  428  429  664  426  660  179  657 1102  655  417  418  416  652 1096  649  877  169  413  409  644  643  641  407  405  638  865  402  636  635  634  633  632  631  630  629  628  627  626  625  624  623  622  621  620  619  618  617  616  615  614  613  612  611  610  609  608  607  606  605  368  123
 189  186  427  184  663  424  659  656  180  421  653  419  175  651  172  650 1303  171  414  646  412  408  164  165  867  642  404  639  403  401  400  399  398  397  396  395  394  393  392  391  390  389  388  387  386  385  384  383  382  381  380  379  378  377  376  375  374  373  372  371  370  369  124
 188  187  185  183  425  182  423  658  181  178  420  177  176  174  173  648  876  415  170  411  168  167  166  163  406  162  161  160  159  158  157  156  155  154  153  152  151  150  149  148  147  146  145  144  143  142  141  140  139  138  137  136  135  134  133  132  131  130  129  128  127  126  125
