# This puzzle is unsolvable
71
   2    1    3    4    5    6    7    8    9   10   11   12   13   14   15   16   17   18   19   20   21   22   23   24   25   26   27   28   29   30   31   32   33   34   35   36   37   38   39   40   41   42   43   44   45   46   47   48   49   50   51   52   53   54   55   56   57   58   59   60   61   62   63   64   65   66   67   68   69   70   71
 280  281  282  283  284  285  286  287  288  289  290  291  292  293  294  295  296  297  298  299  300  301  302  303  304  305  306  307  308  309  310  311  312  313  314  315  316  317  318  319  320  321  322  323  324  325  326  327  328  329  330  331  332  333  334  335  336  337  338  339  340  341  342  343  344  345  346  347  348  349   72
 279  552  553  554  555  556  557  558  559  560  561  562  563  564  565  566  567  568  569  570  571  572  573  574  575  576  577  578  579  580  581  582  583  584  585  586  587  588  589  590  591  592  593  594  595  596  597  598  599  600  601  602  603  604  605  606  607  608  609  610  611  612  613  614  615  616  617  618  619  350   73
 278  551  816  817  818  819  820  821  822  823  824  825  826  827  828  829  830  831  832  833  834  835  836  837  838  839  840  841  842  843  844  845  846  847  848  849  850  851  852  853  854  855  856  857  858  859  860  861  862  863  864  865  866  867  868  869  870  871  872  873  874  875  876  877  879  880  881  882  620  351   74
 277  550  815 1072 1073 1074 1075 1076 1077 1078 1079 1080 1081 1082 1083 1084 1085 1086 1087 1088 1089 1090 1091 1092 1093 1094 1095 1096 1097 1098 1099 1100 1101 1102 1103 1104 1105 1106 1107 1108 1109 1110 1111 1112 1113 1114 1115 1116 1117 1118 1119 1120 1121 1122 1123 1124 1125 1126 1127 1128 1129 1130 1131 1132  878 1134 1135  621  622  352   75
 276  549  814 1071 1320 1321 1322 1323 1324 1325 1326 1327 1328 1329 1330 1331 1332 1333 1334 1335 1336 1337 1338 1339 1340 1341 1342 1343 1344 1345 1346 1347 1348 1349 1350 1351 1352 1353 1354 1355 1356 1357 1358 1359 1360 1361 1362 1363 1364 1365 1366 1367 1368 1369 1370 1371 1372 1373 1374 1375 1376 1377 1378 1379 1133 1381 1136  883  623   76   77
 275  548  813 1070 1319 1560 1561 1562 1563 1564 1565 1566 1567 1568 1569 1570 1571 1572 1573 1574 1575 1576 1577 1578 1579 1580 1581 1582 1583 1584 1585 1586 1587 1588 1589 1590 1591 1592 1593 1594 1595 1596 1597 1598 1599 1600 1601 1602 1603 1604 1605 1606 1607 1608 1609 1610 1611 1612 1613 1614 1615 1616 1848 1617 1380 1382 1137  884  354  353   78
 274  547  812 1069 1318 1559 1792 1793 1794 1795 1796 1797 1798 1799 1800 1801 1802 1803 1804 1805 1806 1807 1808 1809 1810 1811 1812 1813 1814 1815 1816 1817 1818 1819 1820 1821 1822 1823 1824 1825 1826 1827 1828 1829 1830 1831 1832 1833 1834 1835 1836 1837 1838 1839 1840 1841 1842 1843 1844 1845 1846 2071 1847 1619 1620 1849 1383  885  355   79  356
 273  546  811 1068 1317 1558 1791 2016 2017 2018 2019 2020 2021 2022 2023 2024 2025 2026 2027 2028 2029 2030 2031 2032 2033 2034 2035 2036 2037 2038 2039 2040 2041 2042 2043 2044 2045 2046 2047 2048 2049 2050 2051 2052 2053 2054 2055 2056 2057 2058 2059 2060 2061 2062 2063 2064 2065 2066 2067 2068 2069 2070 1621 1852 1618 1384 1138 1139  624  359  886
 272  545  810 1067 1316 1557 1790 2015 2232 2233 2234 2235 2236 2237 2238 2239 2240 2241 2242 2243 2244 2245 2246 2247 2248 2249 2250 2251 2252 2253 2254 2255 2256 2257 2258 2259 2260 2261 2262 2263 2264 2265 2266 2267 2268 2269 2270 2271 2272 2273 2274 2275 2276 2277 2278 2279 2280 2281 2282 2283 2284 2285 1850 1624 1623 1851 1385  887  358  627  357
 271  544  809 1066 1315 1556 1789 2014 2231 2440 2441 2442 2443 2444 2445 2446 2447 2448 2449 2450 2451 2452 2453 2454 2455 2456 2457 2458 2459 2460 2461 2462 2463 2464 2465 2466 2467 2468 2469 2470 2471 2472 2473 2474 2475 2476 2477 2478 2479 2480 2481 2482 2483 2484 2485 2486 2487 2488 2489 2490 2491 2286 2072 1386 1389 1622 1140  626  625  628   81
 270  543  808 1065 1314 1555 1788 2013 2230 2439 2640 2641 2642 2643 2644 2645 2646 2647 2648 2649 2650 2651 2652 2653 2654 2655 2656 2657 2658 2659 2660 2661 2662 2663 2664 2665 2666 2667 2668 2669 2670 2671 2672 2673 2674 2675 2676 2677 2678 2679 2680 2681 2682 2683 2684 2685 2686 2688 2689 2691 2492 2288 1853 1625 2287 1387   82  888 1141  890   80
 269  542  807 1064 1313 1554 1787 2012 2229 2438 2639 2832 2833 2834 2835 2836 2837 2838 2839 2840 2841 2842 2843 2844 2845 2846 2847 2848 2849 2850 2851 2852 2853 2854 2855 2856 2857 2858 2859 2860 2861 2862 2863 2864 2865 2866 2867 2868 2869 2870 2871 2872 2873 2874 3058 2875 2877 2687 2878 2879 2690 2493 2073 2074 1142 1854  889  631  629   83  361
 268  541  806 1063 1312 1553 1786 2011 2228 2437 2638 2831 3016 3017 3018 3019 3020 3021 3022 3023 3024 3025 3026 3027 3028 3029 3030 3031 3032 3033 3034 3035 3036 3037 3038 3039 3040 3041 3042 3043 3044 3045 3046 3047 3048 3049 3050 3051 3052 3053 3054 3055 3056 3057 3233 2876 3235 3061 2692 3060 2494 1390 2076 2075 1855 1388  891 1144  632  360   84
 267  540  805 1062 1311 1552 1785 2010 2227 2436 2637 2830 3015 3192 3193 3194 3195 3196 3197 3198 3199 3200 3201 3202 3203 3204 3205 3206 3207 3208 3209 3210 3211 3212 3213 3214 3215 3216 3217 3218 3219 3220 3221 3222 3223 3224 3225 3226 3227 3228 3229 3230 3231 3232 3400 3234 3236 2881 2882 2880 2290 2495 2077 2078 1857 1391 1145 1628  362  630  364
 266  539  804 1061 1310 1551 1784 2009 2226 2435 2636 2829 3014 3191 3360 3361 3362 3363 3364 3365 3366 3367 3368 3369 3370 3371 3372 3373 3374 3375 3376 3377 3378 3379 3380 3381 3382 3383 3384 3385 3386 3387 3388 3389 3390 3391 3392 3393 3394 3395 3396 3397 3398 3399 3559 3401 3059 3062 2883 2693 2291 2079 1143 2289 1393 1629 1626 1147  363   86   85
 265  538  803 1060 1309 1550 1783 2008 2225 2434 2635 2828 3013 3190 3359 3520 3521 3522 3523 3524 3525 3526 3527 3528 3529 3530 3531 3532 3533 3534 3535 3536 3537 3538 3539 3540 3541 3542 3543 3544 3545 3546 3547 3548 3549 3550 3551 3552 3553 3554 3555 3556 3557 3558 3560 3238 3237 3065 2694 2498 2497 2292 1627 2080 1858 1392  365 1148 1146  633  635
 264  537  802 1059 1308 1549 1782 2007 2224 2433 2634 2827 3012 3189 3358 3519 3672 3673 3674 3675 3676 3677 3678 3679 3680 3681 3682 3683 3684 3685 3686 3687 3688 3689 3690 3691 3692 3693 3694 3695 3696 3697 3698 3699 3700 3701 3702 3703 3704 3705 3706 3707 3708 3709 3402 3403 3063 2884 3064 2496 2499 2695 1856 2293 1631 1630 1394  892  895  893   88
 263  536  801 1058 1307 1548 1781 2006 2223 2432 2633 2826 3011 3188 3357 3518 3671 3816 3817 3818 3819 3820 3821 3822 3823 3824 3825 3826 3827 3828 3829 3830 3966 3831 3833 3834 3835 3836 3837 3838 3839 3840 3841 3842 3843 3844 3845 3846 3847 3848 3849 3850 3851 3710 3561 3404 3239 3066 2886 2885 2696 2294 2081 1859 1860  898  897  636  896   87   89
 262  535  800 1057 1306 1547 1780 2005 2222 2431 2632 2825 3010 3187 3356 3517 3670 3815 3952 3953 3954 3955 3956 3957 3958 3959 3960 3961 3962 3963 3964 3965 4093 3832 3967 3968 3969 3970 3972 3973 3974 3975 3976 3977 3978 3979 3980 3981 3982 3983 3984 3985 3852 3711 3562 3405 3240 3068 3067 2698 2500 2295 2082 1862 1632 1395  634  894 1149  366  367
 261  534  799 1056 1305 1546 1779 2004 2221 2430 2631 2824 3009 3186 3355 3516 3669 3814 3951 4080 4081 4082 4083 4084 4085 4086 4087 4088 4089 4090 4091 4092 4212 4094 4095 4097 4098 3971 4099 4100 4101 4102 4103 4104 4105 4106 4107 4108 4109 4110 4111 3986 3853 3712 3563 3406 3241 2697 2888 2887 2501 2296 2083 1633 1861 1396 1151 1150  368   91   90
 260  533  798 1055 1304 1545 1778 2003 2220 2429 2630 2823 3008 3185 3354 3515 3668 3813 3950 4079 4200 4201 4202 4203 4204 4205 4206 4207 4208 4209 4210 4213 4323 4324 4214 4096 4216 4217 4218 4219 4220 4221 4222 4223 4224 4225 4226 4227 4228 4229 4112 3987 3854 3713 3564 3407 3242 3069 2699 2700 2502 2297 2084 1863 1634 1398 1397  899  637  369   92
 259  532  797 1054 1303 1544 1777 2002 2219 2428 2629 2822 3007 3184 3353 3514 3667 3812 3949 4078 4199 4312 4313 4314 4315 4316 4420 4318 4319 4320 4607 4424 4321 4427 4325 4215 4327 4328 4329 4330 4331 4332 4333 4334 4335 4336 4337 4338 4339 4230 4113 3988 3855 3714 3565 3408 3243 3070 2889 2503 2504 2298 2085 1864 1635 1152 1153  900  638  370   93
 258  531  796 1053 1302 1543 1776 2001 2218 2427 2628 2821 3006 3183 3352 3513 3666 3811 3948 4077 4198 4311 4416 4417 4418 4419 4421 4516 4317 4422 4423 4211 4426 4520 4429 4326 4430 4431 4432 4433 4434 4435 4436 4437 4438 4439 4440 4441 4340 4231 4114 3989 3856 3715 3566 3409 3244 3071 2890 2702 2701 2299 2086 1865 1636 1399 1154  901  639  371   94
 257  530  795 1052 1301 1542 1775 2000 2217 2426 2627 2820 3005 3182 3351 3512 3665 3810 3947 4076 4197 4310 4415 4512 4513 4514 4515 4604 4605 4518 4519 4425 4522 4521 4428 4524 4525 4526 4527 4528 4529 4530 4531 4532 4533 4534 4535 4442 4341 4232 4115 3990 3857 3716 3567 3410 3245 3247 3072 2891 2505 2300 2087 1866 1637 1400 1155  641  640  372   95
 256  529  794 1051 1300 1541 1774 1999 2216 2425 2626 2819 3004 3181 3350 3511 3664 3809 3946 4075 4196 4309 4414 4511 4600 4601 4602 4603 4683 4517 4685 4757 4322 4606 4523 4611 4612 4613 4614 4615 4616 4617 4618 4619 4620 4621 4536 4443 4342 4233 4116 3991 3858 3717 3568 3246 3413 3073 2892 2703 2506 2301 2088 1867 1638 1401  903  902  642  373   96
 255  528  793 1050 1299 1540 1773 1998 2215 2424 2625 2818 3003 3180 3349 3510 3663 3808 3945 4074 4195 4308 4413 4510 4599 4680 4681 4682 4754 4684 4686 4758 4608 4610 4689 4690 4691 4692 4693 4694 4695 4767 4696 4697 4699 4622 4537 4444 4343 4234 4117 3992 3859 3718 3569 3411 3251 3248 3074 2893 2704 2507 2089 1868 1402 1157 1156  904  643  374   97
 254  527  792 1049 1298 1539 1772 1997 2214 2423 2624 2817 3002 3179 3348 3509 3662 3807 3944 4073 4194 4307 4412 4509 4598 4679 4751 4752 4753 4755 4756 4687 4688 4609 4760 4761 4762 4763 4764 4765 4766 4768 4770 4698 4700 4623 4538 4445 4344 4235 4118 3993 3860 3719 3414 3570 3252 3249 3075 2894 2705 2302 2090 1869 1639 1403 1158  905  644  375   98
 253  526  791 1048 1297 1538 1771 1996 2213 2422 2623 2816 3001 3178 3347 3508 3661 3806 3943 4072 4193 4306 4411 4508 4597 4677 4678 4816 4817 4818 4819 4820 4822 4759 4823 4824 4825 4826 4827 4828 4829 4830 4769 4701 4702 4624 4539 4446 4345 4236 4119 3861 3862 3572 3720 3412 3078 2897 3076 2706 2303 2304 2091 1870 1640 1641 1159  906  645  376   99
 252  525  790 1047 1296 1537 1770 1995 2212 2421 2622 2815 3000 3177 3346 3507 3660 3805 3942 4071 4192 4305 4410 4507 4596 4676 4750 4815 4872 4873 4874 4876 4821 4877 4878 4879 4880 4881 4882 4884 4885 4832 4831 4771 4703 4627 4625 4447 4346 4237 4120 3995 3994 3571 3573 3250 3723 2898 2895 2707 2508 2510 2305 2092 1642 1404 1161 1160  907  647  377
 251  524  789 1046 1295 1536 1769 1994 2211 2420 2621 2814 2999 3176 3345 3506 3659 3804 3941 4070 4191 4304 4409 4506 4594 4595 4749 4814 4871 4920 4921 4875 4923 4924 4925 4926 4927 4928 4929 4883 4931 4886 4833 4772 4704 4626 4540 4347 4238 4240 4121 3996 3722 3863 3721 3416 3254 3077 2896 2708 2509 1871 1872 2093 1643 1405 1408  908  646  101  100
 250  523  788 1045 1294 1535 1768 1993 2210 2419 2620 2813 2998 3175 3344 3505 3658 3803 3940 4069 4190 4303 4408 4505 4675 4748 4747 4813 4870 4960 4922 4959 4962 4995 4965 4966 4967 4998 4930 4970 4932 4887 4834 4773 4542 4541 4449 4448 4239 4348 4122 3997 3998 3864 3574 3415 3079 3253 2709 2512 2511 2306 1873 1644 1407  909 1406  648  649  379  102
 249  522  787 1044 1293 1534 1767 1992 2209 2418 2619 2812 2997 3174 3343 3504 3657 3802 3939 4068 4189 4302 4407 4504 4593 4674 4812 4869 4918 4917 4919 4993 4991 4964 4963 5019 4997 5020 4968 4969 4971 4933 4888 4774 4705 4628 4543 4450 4349 4241 4123 3865 3575 3576 3577 3417 3081 2710 2513 2095 2309 2307 2094 1646 1165 1645 1162  380  650  378  104
 248  521  786 1043 1292 1533 1766 1991 2208 2417 2618 2811 2996 3173 3342 3503 3656 3801 3938 4067 4188 4301 4406 4503 4592 4673 4746 4811 4868 5016 4961 4990 4992 4994 5032 5018 5022 4996 5000 4999 4972 4934 4835 4836 4706 4629 4544 4452 4451 4350 4124 3999 3724 3726 3578 3725 3082 2712 2900 2308 2514 2096 1409 1874 1166 1647  910  911  651  103  381
 247  520  785 1042 1291 1532 1765 1990 2207 2416 2617 2810 2995 3172 3341 3502 3655 3800 3937 4066 4187 4300 4405 4502 4591 4672 4745 4810 4867 4958 4916 4956 5015 5031 5017 5036 5034 5023 5021 4973 4890 4837 4889 4775 4707 4630 4545 4351 4242 4243 4125 4000 3866 3869 3867 3418 3420 3419 3083 2899 2515 2310 2097 1875 1876 1164 1163  912  652  382  105
 246  519  784 1041 1290 1531 1764 1989 2206 2415 2616 2809 2994 3171 3340 3501 3654 3799 3936 4065 4186 4299 4404 4501 4590 4671 4744 4809 4866 4914 4915 4957 4988 5030 5035 5033 5026 5024 5001 4974 4935 4891 4838 4776 4778 4632 4631 4454 4453 4352 4126 4001 3868 3255 3728 3421 3084 3080 2901 2711 2713 2516 2098 1877 1648 1410 1411  913  653  383  106
 245  518  783 1040 1289 1530 1763 1988 2205 2414 2615 2808 2993 3170 3339 3500 3653 3798 3935 4064 4185 4298 4403 4500 4589 4670 4743 4808 4865 4913 4955 5014 4987 5039 5038 5040 5027 5002 5003 4938 4936 4892 4839 4708 4777 4709 4546 4547 4353 4244 4127 4002 3579 3581 3257 3422 3256 2714 2903 2902 2517 2311 2099 1878 1649 1413 1412 1167  914  384  107
 244  517  782 1039 1288 1529 1762 1987 2204 2413 2614 2807 2992 3169 3338 3499 3652 3797 3934 4063 4184 4297 4402 4499 4588 4669 4742 4807 4864 4912 4954 4986 4989 5013 5012 5008 5037 5025 5004 4937 4976 4893 4840 4779 4710 4633 4548 4549 4355 4245 4128 4003 3870 3727 3423 3258 2716 3085 2904 2905 2313 2312 2100 1879 1650 1414 1168  915  654  385  108
 243  516  781 1038 1287 1528 1761 1986 2203 2412 2613 2806 2991 3168 3337 3498 3651 3796 3933 4062 4183 4296 4401 4498 4587 4668 4741 4806 4863 4953 4952 5011 5029 5028 5010 4981 5007 5006 5005 4939 4975 4894 4841 4780 4711 4634 4456 4354 4356 4246 4129 4004 3729 3580 3730 3086 2906 3087 2907 2518 2314 2715 2102 2101 1880 1415 1169  916  655  386  109
 242  515  780 1037 1286 1527 1760 1985 2202 2411 2612 2805 2990 3167 3336 3497 3650 3795 3932 4061 4182 4295 4400 4497 4586 4667 4740 4805 4862 4910 4911 4985 4984 4983 5009 4982 4980 4979 4978 4977 4940 4895 4842 4781 4712 4635 4550 4455 4457 4247 4130 4005 3871 3731 3583 3424 3260 2719 2908 3259 2519 2315 2103 1881 1651 1170 1171  917  656  387  110
 241  514  779 1036 1285 1526 1759 1984 2201 2410 2611 2804 2989 3166 3335 3496 3649 3794 3931 4060 4181 4294 4399 4496 4585 4666 4739 4803 4909 4951 4860 4950 4949 4948 4947 4946 4945 4944 4943 4942 4941 4896 4843 4782 4713 4636 4551 4458 4357 4248 3873 4132 3872 3732 3584 3425 3261 3426 2717 2718 2520 2521 1882 1653 1416 1654 1172  918  657  388  111
 240  513  778 1035 1284 1525 1758 1983 2200 2409 2610 2803 2988 3165 3334 3495 3648 3793 3930 4059 4180 4293 4398 4495 4584 4664 4665 4737 4861 4857 4797 4908 4906 4905 4904 4903 4902 4901 4900 4899 4898 4897 4844 4783 4714 4637 4552 4459 4358 4131 4006 3874 3582 3585 3733 3427 3262 3088 3089 2720 2522 2316 2104 1652 1884 1418 1417  919  658  389  112
 239  512  777 1034 1283 1524 1757 1982 2199 2408 2609 2802 2987 3164 3333 3494 3647 3792 3929 4058 4179 4292 4397 4494 4583 4663 4802 4858 4738 4799 4732 4907 4856 4854 4852 4793 4851 4850 4849 4848 4847 4846 4845 4784 4715 4638 4553 4460 4359 4249 4250 4009 4007 3875 3428 3429 3263 3090 2909 2523 2524 2317 2318 1655 1883 1419 1173  920  659  390  113
 238  511  776 1033 1282 1523 1756 1981 2198 2407 2608 2801 2986 3163 3332 3493 3646 3791 3928 4057 4178 4291 4396 4493 4582 4662 4736 4734 4801 4657 4800 4798 4855 4795 4853 4727 4792 4791 4790 4789 4788 4787 4786 4785 4716 4639 4554 4461 4360 4251 4133 4010 3587 4008 3734 3264 3091 3092 2910 2721 2525 2319 2105 1885 1657 1656 1420  921  660  391  114
 237  510  775 1032 1281 1522 1755 1980 2197 2406 2607 2800 2985 3162 3331 3492 3645 3790 3927 4056 4177 4290 4395 4492 4581 4735 4733 4859 4731 4804 4730 4729 4796 4728 4794 4726 4725 4724 4723 4722 4721 4720 4719 4718 4717 4640 4556 4555 4361 4252 3736 4135 4011 3877 3586 3430 3265 2911 2912 2722 2321 2108 2106 2107 1886 1175 1174  922  661  392  115
 236  509  774 1031 1280 1521 1754 1979 2196 2405 2606 2799 2984 3161 3330 3491 3644 3789 3926 4055 4176 4289 4394 4491 4580 4661 4660 4659 4574 4575 4656 4655 4654 4653 4652 4567 4651 4650 4648 4647 4646 4645 4644 4643 4642 4641 4462 4463 4362 4253 4136 3876 3735 4134 3433 3588 3431 3093 3266 2723 2526 2322 2320 1887 1658 1421 1176  923  662  393  116
 235  508  773 1030 1279 1520 1753 1978 2195 2404 2605 2798 2983 3160 3329 3490 3643 3788 3925 4054 4175 4288 4393 4490 4579 4578 4577 4576 4484 4658 4573 4572 4571 4570 4569 4568 4566 4565 4474 4564 4563 4562 4561 4560 4559 4558 4466 4363 4465 4254 4364 4012 3589 3878 3737 3432 3267 3094 2914 2913 2724 2527 2109 1888 1659 1422 1177  924  663  394  117
 234  507  772 1029 1278 1519 1752 1977 2194 2403 2604 2797 2982 3159 3328 3489 3642 3787 3924 4053 4174 4287 4392 4489 4488 4487 4486 4485 4385 4483 4482 4481 4480 4479 4477 4476 4475 4649 4473 4374 4472 4471 4470 4469 4468 4467 4367 4557 4365 4255 4137 4015 3881 3879 3880 3434 3095 2915 2916 2725 2528 2323 2110 1889 1660 1423 1178  925  664  395  118
 233  506  771 1028 1277 1518 1751 1976 2193 2402 2603 2796 2981 3158 3327 3488 3641 3786 3923 4052 4173 4286 4391 4390 4389 4388 4387 4386 4384 4277 4383 4382 4381 4380 4478 4377 4272 4376 4375 4267 4373 4372 4371 4370 4369 4368 4366 4464 4258 4256 4138 4013 4140 3740 3591 3590 3593 3096 2917 2726 2529 2324 2111 1890 1661 1424 1179  926  665  396  119
 232  505  770 1027 1276 1517 1750 1975 2192 2401 2602 2795 2980 3157 3326 3487 3640 3785 3922 4051 4172 4285 4284 4283 4282 4281 4280 4279 4278 4276 4161 4275 4273 4157 4379 4378 4269 4155 4270 4268 4266 4265 4264 4263 4262 4261 4260 4259 4257 4142 4139 3738 3436 3739 3742 3435 3268 3269 3273 2727 2530 2325 2112 1891 1662 1425 1180  927  666  397  120
 231  504  769 1026 1275 1516 1749 1974 2191 2400 2601 2794 2979 3156 3325 3486 3639 3784 3921 4050 4171 4170 4169 4168 4167 4166 4165 4164 4163 4162 4038 4160 4274 4159 4158 4156 4271 4154 4029 4028 4153 4151 4149 4148 4147 4146 4145 4144 4143 4019 4141 4016 4014 3592 3741 3098 3270 3097 2918 2728 2531 2326 2113 1892 1663 1426 1181  928  667  398  121
 230  503  768 1025 1274 1515 1748 1973 2190 2399 2600 2793 2978 3155 3324 3485 3638 3783 3920 4049 3917 4047 3915 4046 4044 4043 4042 4041 4040 4039 3907 4037 4036 4035 4034 4032 3902 3761 4030 4152 3897 4150 4026 4025 4024 4023 4022 4021 4020 4018 3887 4017 3882 3883 3594 3437 3271 3099 3272 2729 2532 2327 2114 1893 1664 1427 1182  929  668  399  122
 229  502  767 1024 1273 1514 1747 1972 2189 2398 2599 2792 2977 3154 3323 3484 3637 3782 3919 3918 3778 3916 4045 3775 3914 3913 3911 3910 3909 3908 3768 3906 3905 3904 3903 4033 3901 4031 3899 3898 3896 4027 3895 3894 3893 3892 3891 3890 3889 3888 3748 3884 3746 3596 3743 3595 3438 3274 2919 2730 2533 2328 2115 1894 1665 1183  930  931  123  669  400
 228  501  766 1023 1512 1272 1746 1971 2188 2397 2598 2791 2976 3153 3322 3483 3636 3781 3780 3779 3631 4048 3776 3628 3774 3912 3772 3773 3771 3770 3769 3767 3766 3765 3764 3763 3900 3614 3760 3759 3758 3757 3756 3755 3754 3753 3752 3751 3750 3749 3599 3744 3443 3885 3439 3101 3275 3100 2920 2731 2534 2329 2116 1895 1667 1428 1184  932  670  401  124
 227  500 1022 1271 1270 1513 1745 1970 2187 2396 2597 2790 2975 3152 3321 3482 3635 3634 3633 3632 3777 3630 3473 3474 3627 3626 3624 3625 3622 3467 3621 3465 3620 3619 3617 3616 3762 3296 3613 3612 3611 3610 3609 3608 3607 3606 3605 3604 3603 3602 3600 3747 3745 3444    0 3597 3440 3278 2921 2732 2535 2331 2117 1896 1669 1666  672 1185  671  404  402
 499  764  765 1021 1269 1511 1744 1969 2186 2395 2596 2789 2974 3149 3320 3481 3480 3145 3316 3479 3478 3313 3629 3472 3309 3471 3307 3470 3469 3623 3466 3301 3463 3618 3462 3460 3297 3615 3459 3457 3456 3455 3291 3454 3452 3451 3450 3449 3448 3447 3601 3446 3442 3886 3598 3441 3103 3102 2922 2734 2733 2118 1897 1431 1429 1668 1187 1186 1430  128  125
 226  498  763 1268 1510 1509 1743 1968 2185 2394 2594 2595 2788 3150 3151 2967 3318 3315 3314 3142 3476 3310 3139 3308 3140 3306 3136 3468 3133 3305 3303 3302 3464 3300 3299 3298 3461 3125 3458 3294 3293 3122 3292 3453 3290 3288 3287 3286 3285 3113 3284 3445 3281 3280 3279 3277 3276 3104 2923 2735 2538 2536 2537 2119 1670 1188 1432  934  403  933  126
 225  497  762 1020 1018 1508 1742 1967 2184 2393 2786 2787 2973 3319 3147 2968 3317 3146 3143 3475 2963 3141 2960 3311 2958 2576 2771 2956 3135 3304 3132 2952 3131 3130 3129 3128 3127 3126 3295 3124 2944 2942 3120 3119 3289 3118 3116 2748 2935 3114 3282 3283 3111 3110 3108 3107 3106 3105 2927 2736 2925 2333 2330 1671 1433 1189 1436  935  673  674  127
 224  496  761 1267 1019 1507 1741 1966 2183 2392 2593 2177 2971 2972 2782 2969 2966 2779 3144 2965 2776 3312 2962 2774 2578 2772 2373 2769 3134 2572 2954 2953 2951 2949 2762 2948 2945 2946 2947 3123 2561 3121 2940 2939 2355 3117 2937 3115 2936 2933 3112 2932 2931 3109 2930 2929 2928 2926 2924 2335 2334 2332 1899 1898 2121 1902  405  409  133  130  406
 223  222  760 1017 1265 1266 1740 1965 2182 2391 2592 2175 2784 2785 2970 3148 2781 2777 2581 3138 3477 2583 2580 3137 2164 2959 2372 2770 2955 2768 2766 2765 2764 2950 2565 2151 2761 2760 2758 2755 2943 2941 2753 2752 2558 2938 2749 2555 2553 2934 2747 2744 2550 2743 2741 2740 2739 2131 2738 2539 2541 2122 2120 1900 1435  937  676  407  675  134  129
 494  493  495 1506 1015 1014 1738 1964 2181 2591 2590 2386 2589 2174 2588 2383 2780 2584 2964 2169 1950 2961 2579 2957 2376 2162 2575 2574 2369 2368 2767 2569 2568 2566 2363 2567 2564 2759 2361 2563 2756 2559 2147 2357 2556 2751 2140 2750 2554 2552 2746 2745 2134 2549 2742 2345 2544 1911 2542 2540 2737 2336 2124 1672 1673 1190  936  938  677  131 1194
 757  218  759 1016 1736 1739 1505 1963 2388 2390 1958 2387 2587 1729 2783 2385 2382 2173 2585 2778 2171 2378 2377 2165 2775 2773 2577 2371 2370 2573 2156 1939 2364 2763 1933 1934 2362 2150 2360 2757 2562 2560 2754 1925 2353 1696 2352 2139 2351 2348 2551 2136 2344 2547 2548 2546 1913 2545 2340 2543 2123 2339 2337 1901 1191 1434 1437 1192  410  678  132
 221  492  220  758 1264 1013 1737 2178 2180 2389 1732 2176 1956 1954 2384 2172 1952 2381 2380 1724 2379 2168 2166 1945 2374 2163 2160 1940 2157 2571 2158 2570 2154 2366 2365 1706 2152 1932 2149 1928 2359 1927 2356 2358 2557 2142 2143 1921 2349 2350 2137 1916 2347 2343 2346 2135 2133 2132 2130 2128 2127 2338 2125 1903 1674 1439 1675  943  939  412  408
 219  754 1262 1263 1504 1502 1734 2179 1961 1960 1957 1730  999 2586 1727 1491 1726 2167 1723 1721 1948 1720 2582 1717 1719 1237 2375 2161 1941 2159 1937 1935 2367 1471 2153 1472 1705 1931 1930 2148 2146 2145 1698 2354 2144 1923 1695 2141 2138 1692 1918 1690 1917 1915 1914 1912 2342 2341 2129 1909 2126 1680 1904 1907 1676 1438  941  681  940  679  135
 217  756  491 1012 1009 1261 1503 1962 1735 1497 1959 1731 1492 1955  997 1490 1725 1953 1722 1486 1487 1947 1484 1946 1718 1943 1714 1942 1713 1712 1938 1710 2155  980 1708 1230 1470 1704 1703 1702 1929 1700 1926 1699 1922 1924 1461 1694 1920 1693 1211 1691 1454 1687 1688 1684 1450 1449 1910 1682 1445 1681 1446 1679 1193 1678 1440  683  680  411  682
 489  490  216 1011  748 1500 1733 1498 1255 1499 1496 1253 1728 1493 1494 1249 1247 2170 1951 1949 1242 1485 1481 1483 1944 1716 1715 1480 1477 1476 1711 1936 1233 1709 1227 1707  977 1469 1468 1467 1701 1465 1464 1463 1218 1697 1460 1459 1458 1216 1456 1212  959 1210 1686 1685 1207 1448 1683 1447 1908 1202 1444 1905 1199 1442 1195  944  942  136  413
 214  488 1008  215 1010 1257  750  479 1252 1256 1001  742 1495  740 1000  738  996 1489 1488 1245 1241  992  990 1482 1238 1236  985  984 1479 1234 1475  723  978 1232 1229 1228  975 1225 1224 1223 1466 1221 1220  969 1219  708 1217  965  966 1919 1455  960 1213 1209 1689 1208  956 1206 1205 1204 1201 1200  950 1677 1443 1196 1441 1198  414  684  137
 487  486  749  753 1006  755 1258 1007 1005 1259 1254  474  743  741  998  470  468 1250  994 1244  733 1240  988  730  987 1239  986 1478  983 1474  982  456  979 1231  451  717 1226  976  974  973 1222  972  970 1462  710  968  964  705 1457 1214  703 1453 1452  699 1451  957  697  955  954  953 1203  424  951 1906  949  947 1197  419  945  415  138
 212  752  483  481  747 1260  482  478  745 1003 1002 1248 1251  739  471  737  735  995  191 1243  993  991  989  731  729  728  726 1235  725  981  724  721 1473  453  718  719  448  716  714  712  971  445  711  444  441  707  967  438  962  436  437  701  702  700  432  430  431  695  694  693  952  426  692  689  948  688  686  420  685  416  139
 485  213  209  207  751 1501  480  203  746  744  476  473  472  198  197  736  193 1246  732  469  190  465  463  188  462  461  727  459  458  457  455  722  179  720  452  175  449  447  715  446  713  443  169  442  167  709  706  164  963  161  435  434  433  958  157  698  429  696  428  427  425  423  690  691  147  687  946  418  143  417  140
 211  484  210  208  206  205  204 1004  477  202  201  200  475  199  196  195  194  467  192  734  466  189  464  187  186  185  460  184  183  182  181  454  180  178  177  450  176  174  173  172  171  170  168  166  165  440  439  163  162  704 1215  160  961  159  158  156  155  154  153  152  151  150  149  422  148  421  146  145  144  142  141
