# This puzzle is unsolvable
46
   2    1    3    4    5    6    7    8    9   10   11   12   13   14  194   15  195   16   19   20   21  201   22   24   25   26   27   28   29   30   31   32   33   34   35   36   37   38   39   40   41   42   43   44   45   46
 180  181  182  183  184  185  186  187  188  189  190  191  192  193  365  197   18  367  198  370  199  200   23  203  204  205  206  207  209  380  210  211  212  213  214  215  216  217  218  219  220  221  222  223  224   47
 179  352  353  354  355  356  357  358  359  360  361  362  363  364  366   17  196  531  368  369  371  372  202  373  374  375  376  377  378  542  381  382  383  384  385  386  387  388  389  390  391  392  393  394  225   48
 178  351  516  517  518  519  520  521  522  523  524  525  526  527  683  529  530  686  532  533  534  535  691  536  538  539  695  541  208  379  543  544  545  702  547  549  550  551  552  553  554  555  556  395  226   49
 177  350  515  672  673  674  675  676  677  678  679  680  681  682  684  528  685  834  833  688  975  689  690  537  692  694  696  540  697  698  699  700  546  848  548  703  705  706  707  708  709  710  557  396  227   50
 176  349  514  671  820  821  822  823  824  825  826  827  828  829  830  831  832  972  687  835 1229  836  838  839  693  841  842  843  844  845  846  847  701  987  851  704  852  853  854  855  856  711  558  397  228   51
 175  348  513  670  819  960  961  962  963  964  965  966  967  969 1100  970  971  973  974 1105 1230  837  976  978  840  980  981  982  983  984  985  986  849 1120  850  989  991  992  993  994  857  712  559  398  229   52
 174  347  512  669  818  959 1092 1093 1094 1095 1096 1221 1097 1099  968 1225 1101 1103 1342 1104 1228  977 1231 1110  979 1235 1349 1113 1114 1354 1115 1117 1118  988 1119  990 1122 1123 1124  995  858  713  560  399  230   53
 173  346  511  668  817  958 1091 1216 1217 1218 1220 1335 1098 1223 1224 1339 1102 1226 1106 1107 1452 1344 1234 1232 1233 1456 1111 1236 1237 1239 1116 1241 1242 1463 1243 1121 1244 1245 1246 1125  859  714  561  400  231   54
 172  345  510  667  816  957 1090 1215 1332 1333 1219 1443 1444 1337 1336 1338 1446 1340 1227 1343 1108 1552 1109 1345 1453 1348 1112 1351 1352 1353 1460 1461 1240 1356 1358 1359 1360 1247  997  996  860  715  562  401  232   55
 171  344  509  666  815  956 1089 1214 1330 1331 1334 1635 1633 1222 1543 1445 1448 1341 1549 1639 1450 1642 1449 1347 1457 1455 1645 1350 1557 1650 1559 1238 1464 1357 1465 1466 1248  999 1127  998  861  716  563  402  233   56
 170  343  508  663  664  813  955 1088 1329 1440 1441 1442 1542 1541 1544 1636 1447 1547 1548 1451 1551 1725 1644 1553 1454 1647 1731 1648 1556 1459 1560 1562 1462 1653 1564 1362 1468 1361 1128 1126  862  717  564  403  234   57
 169  506  662  810  665  814 1087 1213 1212 1437 1438 1632 1540 1545 1634 1719 1638 1722 1640 1724 1800 1550 1801 1555 1346 1458 1730 1558 1649 1651 1561 1355 1654 1563 1565 1467 1253 1363 1129 1000  863  718  565  404  235   58
 505  660  341  953  507  954 1086 1211 1439 1328 1539 1631 1716 1717 1718 1637 1546 1721 1723 1797 1726 1926 1643 1646 1554 1728 1805 1732 1808 1734 1735 1652 1736 1655 1566 1469 1132 1249 1130 1001  864  719  566  405  236   59
 168  811  504  342  661  812 1085 1210 1327 1538 1536 1537 1792 1793 1794 1795 1720 1861 1796 1641 1799 1727 1867 1803 1802 1729 1872 1807 1733 1873 1809 1811 1810 1737 1567 1134 1470 1250 1365 1002  865  720  567  406  237   60
 166  337  340  948  503 1084  952 1209 1326 1436 1535 1629 1630 1715 1791 1920 1863 1860 1862 1798 1866 1925 1868 1929 1869 1871 1804 1806 1934 1875 1876 1738 1656 1657 1255 1473 1568 1364 1131 1003  866  721  568  407  239  238
 165  339  167  502  806  808 1208 1325 1433 1435 1627 1533 1713 1714 1790 1859 1921 1922 1864 1865 1924 1927 1928 1979 1870 1930 1931 1982 1874 1933 1812 1813 1739 1658 1251 1366 1569 1471 1133 1004  867  722  569  409  408   61
 338  807  332  951  501  950 1083 1324 1434 1432 1534 1628 1712 1789 1858 1919 1972 1973 1923 2018 1974 1976 1978 2022 1980 1981 2025 1932 1984 1935 1878 1877 1740 1659 1256 1368 1252 1367 1254 1006 1005  868  723  570  240   62
 164  163  945  944  657  809  946 1205 1207 1206 1626 1710 1711 1788 1857 1918 2016 2017 1975 2055 2020 2056 2021 2084 2023 2024 2026 1983 1985 1936 1879 1814 1741 1660 1570 1472 1476 1370 1136 1007  725  869  571  410   64   63
 162  335  336  658  804 1080 1082 1321 1322 1323 1532 1624 1625 1787 1856 1917 1971 2015 2052 1977 2082 2081 2083 2058 2087 2103 2059 2060 2027 1937 1880 1661 1744 1743 1573 1475 1371 1369 1135 1257  870  724  572  411  241   65
 333  497  500  334  949 1081  947 1431 1430 1530 1429 1531 1706 1786 1855 1916 1970 2013 2014 2053 2057 2079 2054 2114 2085 2086 2028 2029 1986 1987 1881 1815 1742 1663 1474 1571 1372 1258 1009 1137  871  726  574  573  242   66
 160  656  499  655  805 1204  803  659 1201 1319 1426 1623 1785 1854 1915 1969 2051 1967 2078 2047 2080 2101 2019 2105 2104 2088 2062 1988 1938 1882 1817 1816 1572 1664 1662 1477 1574 1260 1374 1008  872  727  575  243  412  244
 161  157  654  159 1078 1320 1075 1079 1528 1428 1527 1529 1709 1707 1784 1914 1968 2045 2050 2112 2049 2110 2098 2102 2063 2064 2030 1989 1939 1940 1883 1818 1745 1665 1575 1478 1138 1373 1011 1010  873  728  415  413   68   67
 158  330  331  942  653  802 1203 1317 1076 1202 1427 1619 1622 1708 1705 1853 1912 2048 2012 2077 2100 2099 2113 2061 2107 2106 2089 2031 1990 1941 1884 1820 1819 1666 1576 1375 1141 1259 1012  874  729  576  246  414  245   69
 156  496  495  652  800 1077  801  943 1315 1316 1318 1621 1620 1783 1852 1913 1966 2010 2011 2075 2097 2111 2108 2115 2092 2090 2065 2032 1991 1942 1885 1821 1746 1747 1481 1577 1479 1261 1140 1013  875  730  577  416  247   70
 155  494  493  498  941 1073 1200 1425 1198 1423 1525 1526 1851 1704 1781 1965 1964 2074 2008 2044 2076 2109 2094 2093 2069 2091 2033 1992 1944 1943 1748 1887 1749 1579 1667 1480 1263 1262 1139 1014  876  731  578  417  248   71
 329  492  327  651  940  799 1199 1072 1313 1618 1617 1782 1850 1780 1701 1911 2007 2009 2095 2046 2073 2096 2071 2038 2039 2068 2066 2067 1993 1888 1823 1668 1750 1669 1578 1482 1376 1143 1142 1015  877  732  579  418  249   72
 328  650  490  648  939 1071 1314 1074 1422 1424 1524 1702 1703 1849 1910 1779 1909 1959 2006 2003 1957 2042 2072 2070 2037 1998 2036 2034 2035 1889 1945 1886 1751 1670 1580 1483 1378 1377 1144  734  879  733  580  419  250   73
 491  649  152  647  798  938 1196 1197 1312 1421 1523 1616 1700 1778 1847 1848 1907 1963 2043 1956 2005 2041 2040 1999 1896 1997 1895 1950 1994 1996 1822 1754 1824 1671 1581 1484 1379 1264 1266  878  880 1017  581  420  251   74
 326  151  489  153  797  937 1069 1070 1195 1420 1522 1615 1777 1776 1846 1960 1962 1958 1961 2004 1901 2002 2000 1955 2001 1683 1952 1948 1947 1995 1890 1825 1752 1672 1582 1485 1267 1265 1145 1016 1146  735  582  421  252   75
 154  150  324  323  646  794  936 1194 1311 1419 1521 1614 1699 1845 1906 1843 1908 1904 1903 1902 1838 1900 1898 1899 1954 1833 1760 1949 1892 1946 1827 1828 1826 1753 1583 1486 1380 1269 1149 1018  883  737  422  253   76   77
 321  485  487  644  796  795 1068 1192 1193 1310 1520 1613 1775 1697 1773 1905 1844 1842 1840 1839 1767 1837 1764 1953 1951 1835 1762 1893 1894 1829 1759 1891 1488 1673 1278 1676 1755 1384 1148  881 1147  736  583  423  254   78
 325  149  643  486  488  933  934 1067 1418 1308 1519 1612 1698 1774 1694 1772 1771 1692 1841 1768 1688 1765 1836 1685 1761 1763 1681 1831 1758 1679 1678 1757 1677 1383 1586 1023 1268 1382 1019  882  587  740  584  424  255   79
 322  484  935  793  645  932 1066 1307 1190 1309 1417 1611 1609 1696 1695 1693 1770 1603 1769 1602 1687 1506 1686 1684 1501 1897 1593 1830 1680 1591 1590 1495 1756 1674 1585 1584 1271 1270 1487 1150  428  585  589  586  425  256
 319  148  642  792  641  791 1065 1191 1306 1415 1518 1416 1610 1608 1607 1606 1509 1691 1689 1766 1690 1598 1597 1599 1594 1834 1832 1682 1498 1592 1589 1390 1494 1385 1389 1152 1381 1272 1020 1274  739  738  884  426  257   80
 147  146  318  320  790  931 1064 1189 1305 1414 1516 1517 1515 1514 1512 1511 1604 1508 1510 1507 1292 1505 1600 1290 1398 1503 1595 1499 1497 1282 1391 1394 1588 1281 1675 1276 1151 1386 1156 1021  741  885  259  590  427   81
 143  145  483  640  789  930 1063 1188 1413 1303 1302 1411 1410 1513 1409 1408 1407 1605 1405 1403 1404 1601 1400 1504 1401 1502 1399 1396 1284 1395 1167 1393 1392 1158 1387 1489 1492 1490  890 1022  888 1025  588  261  430   82
 481  144  480  482  788  929 1062 1187 1304 1184 1301 1412 1300 1299 1297 1178 1296 1294 1293 1402 1171 1172 1046 1291 1289 1170 1288 1286 1287 1496 1283  900 1493 1279 1161 1388  896 1491 1028 1275  887  742  744 1024  260   84
 477  317  142  639  928  786 1061 1186 1057 1058 1183 1182 1181 1179 1298 1051 1177 1406 1295 1176 1174 1045  767 1043 1042 1285 1397 1164 1500 1163 1036 1162  898  899 1280 1587 1159 1153 1273 1026  429  433  263  743  258  886
 316  479  314  636  638  787  925 1059 1185  922 1056 1055 1054 1180 1052  915  914 1048 1175 1047 1173  906  613 1596 1041  761 1169  904 1166 1037 1035  757  605  897 1277  606  894 1029    0  271  748  432  594  592  434  746
 478  315  476  138  637 1060  927  781  779  780  921  920  918 1053  917  916 1049  913  912  911  910 1044  909  288  611  763 1165  905  901  760  756  754  755  604 1160  602  601 1030  745  891 1157  889  747  264  431   87
 309  313  634  635  139  926  782  923  924  629  628  777  919  623  773 1050  772  771  770  769  768  766  765  907  908 1168 1040  610 1038  447  277 1034  279  103 1033  893  750 1031   97  751 1154  270  267  591   83   85
 141  311  312  784  783  785  472  471  468  778  627  299  776  774  625  775  622  620  619  617  616  457  615  287  764  614  285  758  607  609  759  902  446  444  753  895  752 1155 1027  273  599  892  595  436   86  266
 140  310  134  633  475  473  470  127  630  467  626  624  466  297  465  296  295  621  459  618  292  291  455  113  112  283  453  903  450  449  284  608  104 1032  278  439  276  441   98  600  596  437   92  593   89   93
 135  632  136  631  132  306  131  304  128  303  300  125  464  123  298  461  463  460  120  293  116  458  456  289  454  612  452 1039  108  106  281  282  280  440  275  603  100  598   99  438  272  435   95   88  268   91
 137  133  308  307  474  305  129  130  302  469  126  301  124  121  122  462  119  294  118  117  115  114  290  111  286  109  762  110  451  107  445  105  102  101  448  274  442  443   94   96  597  269  749   90  262  265
