# This puzzle is unsolvable
35
   3    1    4  265  140    5    6    7    8    9   11  148   13   12   15   16   17   18  155   19   21   22   23   25  407   27   29  410  290  165   32  412   33   36  295
 136    2  137  138  266  269  141  144  271  273  146  147  145   14  276  151  152  153  154   20  156  157  158   24  161  288   28   30  164  521   31   34   38  167   35
 135  134  264  139  385  143  268  270  272  502  274  395  391  149  392  150  278  279  282  401  283  284  285  159  160  162  163  291  293   26  166  523   40  168  294
 133  262  263  384  267  387  499  388  390   10  394  393  507  506  277  397  398  280  400  281  402  403  404  286  287  518  406  408  292  522  411  171   37  297  172
 261  132  383  496  386  497  142  500  389  275  605  607  504  508  396  611  510  399  512  513  514  617  515  405  516  620  519  623  409  625  414  296  169  299  416
 260  382  380  495  600  498  601  602  604  698  503  700  505  608  610  705  509  613  511  615  616  618  713  619  622  517  520  289  624  525  626  413  173  170   39
 130  128  131  381  599  696  603  786  501  864  788  701  609  870  793  612  792  707  614  710  711  712  714  715  802  621  717  718  719  524  417  298  415   42  174
 259  379  494  492  598  695  697  699  606  867  702  703  790  869  794  704  706  708  795  709  798  799  800  801  803  716  804  805  720  526  300  301  177  418   41
 129  378  597  693  493  783  936  865  787  785  866  789  868  871  791  872  873  874  875  797  876  877  878  880  881  882  883  628  806  627  420  528  527  175   43
 127  258  491  490  694  692  596  782  863  937  938  939  940  941  942  943  944  945  796  947  948 1068  879  950  952  885  953  884  629  421  723  419  302  176   44
 256  376  253  595  487  784  691  780  935 1000 1001 1002 1003 1004 1005 1006 1007 1008  946 1009 1012 1013  949 1153  951 1015  808  722  809  721  530  303  529  179  178
 488  257  377  594  861  781  779  862  932  999 1056 1057 1058 1059 1060 1061 1111 1063 1064 1011 1010 1113 1067 1014 1069 1070  955  724  807  630  633  631  304  180   46
 126  489  375  373  690  778  934  859  860  933 1055 1104 1105 1106 1107 1108 1062 1178 1112 1065 1114 1066 1115 1020 1016  954  886  887  810  533  632  422   47   45  305
 122  374  254  591  688  483  777  858  998  997 1054 1103 1144 1145 1147 1180 1148 1109 1150 1151 1152 1154 1019 1018 1017  956  811  726  725  531  423  306  307   49  181
 124  590  125  592  689  593  687  855  775  931 1102 1142 1101 1175 1179 1176 1110 1149 1181 1182 1183 1116 1117 1072  957  888 1071  729  813  635  535  425  308   50  183
 118  255  123  773  370  589  372  776  930 1053  996 1143 1141 1177 1174 1146 1203 1204 1218 1205 1184 1120 1155  958 1118 1021  959  727  728  812  424  636  426  532   48
 371  486  121  252  481  685  774  686  856  857 1050 1100 1052 1172 1201 1202 1200 1211 1220 1207 1185 1119 1158 1073 1074  960  889  890  730  634  814  311  427  182  184
 119  251  485  480  772  587  771  853  929  995 1051 1140 1173 1199 1216 1214 1217 1222 1206 1221 1186 1187 1123 1156 1022  961  892  891  817  637  185  314  309  310   52
 117  366  250  484  585  249  927  852  683  989  994 1048 1139 1197 1198 1224 1215 1223 1219 1157 1159 1121 1023 1122 1077  962  893  816  819  731  537  534   53   54   51
 248  586  120  854  369  588  684  993  928 1049  992 1099 1138 1171 1196 1213 1212 1208 1189 1210 1128 1188  964 1075 1024  894  638  815  639  536  432  538  428  187  186
 247  245  368  584  367  583  923  926 1047  990 1097 1098 1096 1170 1195 1167 1131 1192 1194 1190 1162 1161  965 1026 1076  733  732  818  539  540  312  431  430   55  188
 246  244  478  479  482  681  851  991  988 1046 1136 1137 1169 1134 1168 1089 1166 1165 1193 1191 1209 1078 1027  899  898  966  963  895  734  640  541  194  313  429  191
 363  365  582  475  476  682  768  924  925  987 1044 1095 1041 1133 1088 1090 1132 1130 1164 1129 1163 1160 1124 1126  738  644 1025  822  643  543  315  544   57   60   56
 243  112  113  364  680  769  849  770  922  986 1093 1045  981 1135 1094 1092 1037 1087 1086 1034 1082 1084 1080 1125  896  972 1030  542  821  318  737  316  433  190   59
 242  116  362  581  847  360  679  850  767  842  921  985  755 1091  912  978 1036  977 1035 1127 1085  906 1083 1032  820  735  897  736  641  824  642  545  436   61  192
 115  114  238  678  846  579  577  766  917 1043  915  841 1042 1040  982 1039  837  976  910  973 1033  905 1079 1081  828  900  967  968 1029  739  546  434   64   58  435
 110  111  241  477  674  920  764  848  762  571  758  843  979  759  836 1038  911  835  975  974  831  832  904  971  970  744  741  823  646  645  195  193  189  547  320
 108  474  473  677  578  580  765  352  919  845  757  675  983  756  980  662  916  840  909  749  907  903  748  827 1031  745  902  826  650  825  901  438   63  440  317
 109  237  240  673  361  572  465  573  761  918  669  984  566  913  753  563  663  834  658  908  555  558  750  830 1028  652  746  743  442  647  740  649  444   62  439
 236  359  239  472  763  676  844  466  464  671  670  668  839  754  666  562  838  661  336  833  659   82  829  654  449  969  553  448  742  653  322  323  319  196  437
 357  358  576  471  574  672   95  351   94  667  461   90  665  460  914  457  752  342  751  454  656  559  557  655  447  551  648  441  550  552   71  651  326  198   65
 106  234  356  469  354  355  575  463  350  462   87  760  459  567  664  458  561  340  453  660  214  747  334  335  450  554  556  445  549  204   73  207  324  548  321
 104  107  105  231  470  227  570   97  348  569  347  346  568  565   88  564   86  220  339  560  451  657  211  446  210  328  327  333  329  330   72  199   70  197   66
 103  232  235   99  468  230  225  353  349  228  223   93  345  343   89  456  337  341  217  212  338  455   79  209   81  208  332    0   77   75  202  206  325   67  200
 102  233  101  100  467   98  229  226  224   96   92   91  344  221  222  218   85  219  215  216   83   84   80  452  331  213   76   78   74  205  203   69  443   68  201
