# This puzzle is unsolvable
50
   1  384  200    4    5  202    7  740    8  206   11  208  745   13  211  210   17   18   20   19  214  215   24   25   26   27   28  223   29  412   30   35  229  232  417   36  233   39  773  422   41   40   43   45  426  242   48  608  243   50
   2  196  197    3  389  387    6  569    9  203  205   10   15   14   16  212  213  400  752  216   21   23  218  219  220  221  222  410  224  413  228   33   32  596  231  234  765  419  235  423  604  237   42  240  603  236   44  432   49  431
 198  386  199  385  566  201  571  204  393  394  743   12  207  395  397  398  399  401  402  217  403  585   22  756  586  407  408  409  411  226  414  225   31  932   37   38  421  767  418  601  778  939  606  605  238   51  239   47  429   52
 190  734  565  739  562  388  738  567  572  392  573  574  396  575  748  577  576  579  750  580  404  406  916  755  920  587  588  589  590  591  764  592  227  593  415  416  600  772  774  602  771  775  241   46  427  250  612  609  245  244
 195  382  563  564  736 1058  568  904  391  742  741  744  746  907  209  749  578  914  753  751  582  754  584  757  917  758  759  760  761  762  928  595   34  766  599  930  230  420  938  936 1090  935  425  776  611  430  942  246  247  433
 194  383  737  381  900  903  390  902 1057 1207 1061  906 1349  909 1066  911 1067  913  915  918  581 1072  405  583  921  922 1077  924 1226  925  763  926  927 1083  931 1088  770  424 1506 1087  937  777  940  428  607  614 1093   53  434   54
 193  379  561  192 1054 1055  570 1206  905 1060 1208 1062 1063  908  747  910 1068  912 1069 1070 1071 1219 1073 1075  919 1076 1078  923 1080 1081 1227 1082  929  594  769  597 1085 1086 1238 1237 1379 1091 1094 1095  610  248  252  784   55  435
 733  558  378  559  901  735 1056 1059 1347 1346 1345 1210 1211 1064 1065 1213 1214 1215 1216 1217 1218 1220 1221 1074 1222 1223 1224 1364 1079 1225 1365 1230 1371 1501  768  598 1233  933  934 1236 1378 1244  944 1092 1096  780  783  249   56   59
 560  380  191  899  732 1204 1344 1205 1201 1478 1479 1348 1209 1350 1212 1352 1353 1354 1355 1356 1357 1358 1359 1360 1361 1362 1363 1495 1366 1620 1228 1229 1500 1370 1231 1627 1372 1234 1235 1089 1376  782 1239 1240  779  945   58  251   57  437
 189  377  556  731  898  897 1203 1200 1343 1477 1601 1602 1481 1605 1351 1483 1484 1485 1486 1487 1488 1489 1490 1491 1492 1493 1494 1618 1496 1369 1499 1368 1622 1084 1628 1740 1626 1625 1242 1508 1246  943  941 1245  781 1098  438  613  436  253
 376  557  730 1052  728 1053  895 1342 1476 1475 1716 1603 1480 1482 1604 1606 1607 1608 1609 1610 1611 1612 1613 1614 1615 1616 1617 1733 1619 1367 1498 1497 1846 1502 1847 1739 1624 1232 1505 1507 1631 1241 1510 1514 1377  789 1243 1097  255   60
 188  187  375 1051 1202  896  894 1341 1474 1600 1599 1717 1718 1719 1720 1721 1722 1723 1724 1725 1726 1727 1728 1729 1730 1731 1839 1732 1734 1735 1736 1737 1621 1848 1503 1375 1373 1504 1744 1629  785  786 1102 1509  946  787  439  440  616   61
 186  374  555  893  892 1050 1199 1340 1473 1598 1715 1824 1825 1826 1827 1828 1829 1830 1831 1832 1833 1834 1835 1836 1837 1838 1938 1840 1842 1843 1943 1844 1738 1623 1849 1374 1946 1743 1381 1630 1512 1100 1382 1515  617 1380  441  442  619  254
 185  184  554  729  727 1049 1198 1339 1472 1597 1714 1823 1924 1925 1926 1927 1928 1929 1930 1931 1932 1933 1934 1935 1936 1937 2029 1940 1841 2032 2035 2033 1950 1845 1947 1948 1742 1741 1746 1635 1745 1632 1101  615  948  788  949  618   63  256
 183  373  553  726  891 1048 1197 1196 1471 1596 1713 1822 1923 2016 2017 2018 2019 2020 2021 2022 2023 2024 2025 2026 2027 2028 2030 1939 1941 2031 1942 2118 2039 1944 1945 2038 1851 1952 1850 1633 1855 1511 1247  947  950  791  951  258  257   62
 182  372  552  725  890 1047 1337 1338 1470 1595 1712 1821 1922 2015 2100 2101 2102 2103 2104 2105 2106 2107 2108 2109 2110 2111 2112 2113 2190 2189 2115 2034 2036 2119 1951 1748 2120 1634 1516 1513 1250 1636 1248 1099  622  790  621  443  259   64
 181  371  370  724  889 1046 1195 1336 1469 1594 1711 1820 1921 2014 2099 2176 2177 2178 2179 2180 2181 2182 2183 2184 2185 2186 2187 2188 2257 2192 2114 2193 2259 2121 1853 1953 2037 1517 1854 1747 1637 1384 1383 1103 1108  952  445  620   65   67
 179  180  551  550  888 1045 1194 1335 1468 1593 1710 1819 1920 2013 2098 2175 2244 2245 2246 2247 2248 2249 2250 2251 2252 2253 2254 2255 2316 2315 2116 2317 1852 2318 2122 2042 1751 1749 1955 1252 1520 1387 1251 1386  953 1106  260  261  623  444
 369  549  722  723  887 1044 1193 1334 1467 1592 1709 1818 1919 2012 2097 2174 2243 2304 2305 2306 2307 2308 2309 2310 2311 2312 2313 2314 2366 2256 2191 2367 2117 2261 2194 2197 2040 1750 1640 1388 1638  954 1249 1385  448  793  263   66   68  449
 367  368  548  721  886 1043 1333 1332 1466 1591 1708 1817 1918 2011 2096 2173 2242 2303 2356 2357 2358 2359 2360 2361 2362 2363 2364 2365 2409 2410 2319 2368 2196 2195 2200 1949 2044 2045 1956 1754 1104 1518 1105 1107  624  626  447  262  792   70
 178  177  366  720  885 1042 1192 1190 1465 1590 1707 1816 1917 2010 2095 2172 2241 2302 2355 2400 2401 2402 2403 2404 2405 2406 2407 2408 2444 2370 2263 2258 2043 2264 2260 2041 1859 1856 1957 1639 1752 1390 1641 1254 1109 1519   69  794  446  795
 176  365  547  546  719 1041 1191 1331 1464 1589 1706 1815 1916 2009 2094 2171 2240 2301 2354 2399 2436 2437 2438 2439 2440 2441 2442 2443 2445 2265 2369 2412 2125 2127 1954 2123 1858 1861 1753 1857 1392 1253 1110 1111 1389  955  627  625  265  264
 175  364  545  718  884 1040 1188 1329 1189 1588 1705 1814 1915 2008 2093 2170 2239 2300 2353 2398 2435 2464 2465 2466 2467 2468 2469 2470 2446 2411 2323 2262 2320 2322 2124 2126 2198 1521 2128 1391 1523 1393 1256  956  958  797   71  628   72  266
 174  363  544  717  883 1039 1187 1463 1586 1462 1587 1813 1914 2007 2092 2169 2238 2299 2352 2397 2434 2463 2483 2484 2487 2488 2490 2471 2414 2413 2371 2204 2199 2321 2266 1863 2129 1644 1643 1642 1255 1525 1257  796  957  959  450  452   73   74
 173  362  716  881  882 1038 1186 1330 1703 1585 1704 1812 1913 2006 2091 2168 2237 2298 2351 2396 2433 2462 2495 2485 2493 2486 2497 2472 2373 2372 2325 2374 1862 2202 2267 2047 2046 1756 1645 1755 1394 1113 1258 1395  799 1114  451  629   75  267
 542  541  543  715  880 1037 1327 1328 1461 1584 1702 1811 1912 2005 2090 2167 2236 2297 2350 2395 2432 2460 2496 2480 2492 2489 2498 2447 2473 2324 2203 2130 2268 2375 1960 2053 1860 2050 1959 1758 1522 1259 1396  798  960  632  631  630  455  270
 172  171  361  540  714 1036 1185 1326 1460 1583 1701 1810 1911 2004 2089 2166 2235 2296 2349 2393 2394 2482 2461 2457 2481 2499 2478 2474 2450 2415 2326 2448 2048 2049 2269 2132 2052 1757 1759 1760 1526 1646 1260  633 1112 1115  456  454  453  268
 170  360  713  878  879 1035 1184 1325 1459 1582 1700 1809 1910 2003 2088 2165 2234 2295 2348 2431 2430 2458 2459 2479 2494 2453 2491 2475 2417 2376 2328 2327 2270 2201 2205 1958 2131 1647 1961 1864 1528 1524 1527  962  961  964  802  963   76  269
 169  359  358  539  877 1034 1183 1324 1458 1580 1699 1808 1909 2002 2164 2163 2233 2294 2347 2392 2429 2456 2387 2386 2454 2476 2477 2421 2449 2416 2418 2271 2133 2272 2206 2051 1962 2134 1963 1761 1648 1397 1261 1399  800 1116  803  634   78   77
 168  357  538  712  711  876 1033 1181 1457 1579 1581 1698 1908 2001 2086 2087 2232 2293 2346 2391 2428 2427 2339 2425 2423 2452 2422 2420 2451 2377 2378 2329 2208 2273 2207 2054 1964 1865 1868 1649 1529 1262 1398 1118  801  966  636   80  271   81
 167  356  537  710  874  875 1323 1456 1182 1030 1697 1807 1906 2084 2000 2162 2231 2292 2345 2390 2389 2388 2338 2455 2337 2424 2280 2382 2380 2419 2379 2276 2330 2209 2135 1965 1867 1762 1866 1763 1650 1400 1117 1263  635  804  457  460  458   79
 166  355  536  709 1031 1029 1032 1321 1455 1453 1454 1907 1806 1999 2085 2161 2230 2291 2344 2343 2287 2342 2285 2284 2282 2336 2383 2426 2381 2333 2278 2332 2331 2274 2136 2055 1966 1869 1764 1651 1530 1401    0 1264 1119  806  805  461  273  272
 165  354  535  708  872  873 1180 1320 1322 1578 1696 1905 1904 1998 2083 2160 2229 2290 2289 2288 2224 2341 2286 2283 2384 2340 2281 2335 2334 2215 2214 2277 2212 2210 2137 2056 1967 1870 1765 1652 1531 1402 1265 1120  965  967  807  462  275  459
 164  353  534  706  707 1178 1319 1318 1452 1577 1805 1804 1903 1997 2082 2159 2228 2227 2226 2225 2223 2222 2151 2221 2385 2220 2219 2217 2279 2216 2143 2275 2213 2211 2138 2057 1968 1871 1766 1653 1532 1403 1266 1121  968  463  637   82   83  274
 163  352  533  705  871 1177 1179 1451 1576 1695 1803 1692 1802 1996 2081 2158 2157 2156 2155 2154 2074 2153 2152 2150 2149 2148 2218 2066 2145 2144 1977 2064 2141 2140 2139 2058 1969 1872 1767 1654 1533 1404 1267 1122  970  969  638  276  277   86
 162  351  532  870 1026 1028 1176 1317 1450 1575 1694 1693 1902 1995 2080 2079 2078 2077 2076 2075 1987 2073 2072 2071 2070 2069 2147 2146 2065 1978 2142 2062 1880 2061 2060 2059 1970 1873 1768 1655 1534 1405 1123  971  972  809  639  640  278   85
 161  350  531  704 1027  869 1175 1316 1449 1574 1691 1801 1800 1994 1993 1992 1991 1990 1989 1988 1986 1891 1985 1984 1983 1982 2068 2067 1979 1883 1976 2063 1881 1879 1973 1972 1971 1874 1769 1656 1535 1269 1268 1124 1125  808  641  279   84   87
 160  349  530  703  868 1025 1174 1315 1448 1573 1690 1799 1901 1899 1898 1897 1896 1895 1894 1893 1892 1788 1890 1889 1887 1886 1981 1980 1885 1884 1974 1776 1975 1777 1878 1877 1876 1875 1770 1657 1536 1406 1407 1270  811  810  642  464  465  280
 159  348  529  702  867 1024 1173 1314 1447 1572 1689 1798 1900 1797 1796 1794 1793 1792 1791 1790 1678 1789 1787 1785 1888 1672 1784 1782 1781 1669 1882 1780 1778 1665 1775 1774 1773 1772 1771 1658 1537 1408 1271 1126  973  812  643   89  281  282
 158  347  528  701  866 1023 1172 1313 1446 1571 1688 1687 1686 1685 1795 1684 1682 1562 1681 1680 1559 1677 1676 1786 1674 1673 1783 1671 1670 1550 1779 1668 1667 1666 1664 1663 1662 1661 1660 1659 1538 1409 1272 1127  974  813  644  466  467   88
 157  346  527  700  865 1022 1171 1312 1445 1570 1569 1568 1567 1566 1436 1683 1437 1563 1561 1679 1432 1557 1556 1675 1555 1554 1426 1552 1551 1423 1549 1548 1547 1546 1545 1544 1543 1542 1541 1540 1539 1410 1273 1128  975  814  645  468  283   90
 156  345  526  699  864 1021 1170 1311 1444 1443 1442 1441 1440 1439 1565 1438 1564 1435 1299 1560 1433 1558 1431 1293 1428 1553 1427 1425 1424 1288 1422 1421 1420 1419 1418 1417 1416 1415 1414 1413 1412 1411 1274 1129  976  815  646  469  284   91
 155  344  525  698  863 1020 1169 1310 1309 1308 1307 1306 1305 1304 1303 1302 1301 1300 1298 1434 1297 1296 1294 1430 1292 1149 1291 1290 1289 1145 1287 1286 1285 1284 1283 1282 1281 1280 1279 1278 1277 1276 1275 1130  977  816  647  470  285   92
 154  343  524  697  862 1019 1168 1167 1166 1165 1164 1163 1162 1161 1160 1159 1158 1157 1156 1155 1154 1153 1000 1429 1151 1150 1148 1147  995 1146 1144 1143 1142 1141 1140 1139 1138 1137 1136 1135 1134 1133 1132 1131  978  817  648  471  286   93
 153  342  523  696  861 1018 1017 1016 1015 1014 1013 1012 1011 1010 1009 1008 1007 1006 1005 1003 1002 1001 1295  841  999  998  997  669  996  994  993  992  991  990  989  988  987  986  985  984  983  982  981  980  979  818  649  472  287   94
 152  341  522  695  860  859  858  857  856  855  854  853  852  851  850  849  848  847  846 1004  844  843 1152  674  840  839  838  837  836  494  834  833  832  831  830  829  828  827  826  825  824  823  822  821  820  819  650  473  288   95
 151  340  521  694  693  692  691  690  689  688  687  686  685  684  683  682  681  680  678  845  677  676  842  675  673  672  495  670  835  311  667  666  665  664  663  662  661  660  659  658  657  656  655  654  653  652  651  474  289   96
 150  339  520  519  518  517  516  515  514  513  512  511  510  509  508  507  506  322  679  503  319  502  318  316  499  498  671  312  493  668  492  491  490  489  488  487  486  485  484  483  482  481  480  479  478  477  476  475  290   97
 149  338  337  336  335  334  333  332  331  330  329  328  327  326  324  323  131  504  505  321  320  500  317  501  315  497  496  122  119  310  309  308  307  306  305  304  303  302  301  300  299  298  297  296  295  294  293  292  291   98
 148  147  146  145  144  143  142  141  140  139  138  137  136  135  325  134  133  132  130  129  128  127  125  126  124  123  314  313  121  120  118  117  116  115  114  113  112  111  110  109  108  107  106  105  104  103  102  101  100   99
