# This puzzle is unsolvable
37
   2    1    4  148    5  150    7  289    8  154  291  419   11  157  159  156   18  424   20  161  166   25  163   23  302   28  168  431  309   29  436   31   34   33   35  177   37
 144  145    3  146  283    6  149  151    9  152  533   10  153  418   16  294  425   19  298  164  303  657   21  548  167  430  308  663  305  174  437  310  313  311  180   36   38
 143  280  281  147  282  284  286  416  155  288   15   13  541  538   14  421   17  295  162  299  165  544   22   24  545   27   26  171  172  170  173   30  176  178   40  179   39
 142  279  409  407  410  531  285  414  530  415  290  417  536   12  293  158  542  292  297  423  429  301  304  169  547  661  551  432  435  666  554   32  175   41  314  181   42
 141  278  408  639  528  411  642  413  287  532  534  647  649  420  652  539  160  857  761  755  654  428  546  300  433  550  664  861  863  306  438  556  440  439  315  312  320
 140  277  406  640  529  526  745  644  645  748  412  750  535  650  752  543  753  850  296  655  656  855  852 1019  760  765  660  307  767  552  770  555  769  557  317  183  441
 139  276  404  405  524  744  746  643  929  747  646  842  537  540 1012  422  936  940 1016  757  758  427  759  658  947  553  665  434  766  865  560  558  667  182  185  316  186
 138  274  527  742  638  641  841  928 1008  844  749  847  648  845  933  754  851  426 1156  659  853  942  945  763  858  662 1025  549 1029  948  768  559  562  670  444   43   44
 137  273  275  525  637  743  840  838  930 1009 1011  935  751  934 1087  651  849 1014  762 1022 1092  756  946  859 1090 1094    0 1028  669  864  949   46  862  867  563  442   45
 136  272  403  523  636  741  926  839  931 1080  843 1083 1010 1015 1148 1204  937  653  939 1152 1021 1091 1158  944  943 1159  764  860 1031 1026  953  443  561  188  771  187  318
 135  271  402  401  635  837  927 1007 1006 1081  846 1146 1088  932 1249 1082  938 1017 1089 1295  941 1155 1018 1098 1157 1099  856 1100 1024  672  950  668  319  445  866  184   47
 134  400  399  522  633  836  740  835  925 1142 1144 1145 1200 1084  848 1250 1322 1086 1013 1294 1020  854 1213 1023 1093 1259  776  772  567  951  773  673  671  446  190  323  189
 132  521  269  634  738  739  834 1079 1078 1077 1143 1076 1147 1251 1149 1206 1151 1207 1253 1327 1255 1256 1257 1153 1209 1161 1027  775 1097  774  321  952  869  565  675   49   48
 133  270  737  519  520  735  833  924 1005 1139 1198 1202 1289 1085 1205 1252 1203 1150 1254 1296 1261 1095 1212 1258 1162  868 1216  871 1030  447  322  677  449  568  324  191   50
 397  267  131  396  517  632 1001 1004 1002  923 1075 1140 1199 1246 1247 1287 1288 1290 1208 1154 1324 1211 1096 1300 1260 1214 1160 1032  954  674  870  564  676  571  450  193  448
 268  130  398  631  518  629  734  736  831 1003  921 1141 1245 1344 1248 1321 1292 1291 1299 1293 1349 1210 1297 1218 1262 1101 1215 1102  779  873  451  777  326  566  328  195  325
 128  266  516  515  630  919  733 1000  922  920 1194 1138 1286 1201 1320 1319 1345 1323 1347 1362 1325 1326 1298 1163 1103 1033 1036  956  955  957  452 1034  569  192  778  194   51
 265  129  127  395  628  830  832  917 1071 1074 1197 1243 1244 1284 1285 1318 1346 1343 1361 1351 1302 1264 1328 1164 1217 1104  958 1165  872  959  874  678  453  333  196   52   53
 393  394  264  514  627  732  828  829  918 1073 1072 1195 1283 1317 1342 1360 1358 1368 1363 1330 1352 1329 1364 1303 1166 1219 1037  960 1038  782  781  570  455  329  327   56   54
 126  262  263  625  626  731  827  998  999 1136 1193 1196 1137 1282 1316 1341 1357 1359 1355 1348 1366 1265 1263 1266 1220 1105 1107 1168  875  876  679  780  456  331   57  572   55
 261  125  391  513  512  730  997  916 1070 1135 1192 1242 1281 1315 1314 1340 1339 1350 1356 1301 1333 1353 1221 1167 1222 1106 1035 1039  961  682  681  680  458  332  573  330  197
 123  124  392  390  624  729  826  914  996 1069 1191 1241 1240 1280 1313 1312 1310 1274 1275 1337 1335 1306 1304 1331 1169 1108 1110 1040  962  684  783  574  200   60  457  199   58
 122  260  389  511  510  728  824  825  915 1133 1134 1132 1189 1190 1276 1309 1311 1273 1230 1365 1354 1308 1270 1268 1267 1172 1170  965  963  683  784  877  576  575  454  198  334
 259  388  387  622  623  727  913  912  995 1131 1188 1066 1238 1239 1235 1277 1367 1121 1332 1336 1229 1334 1269 1305 1174 1171 1041 1223 1042  882  879  878  785  459   59  202  201
 121  258  508  509  621  726  823  993 1067 1068  994 1187 1236 1278 1234 1338 1233 1231 1307 1232 1228 1272 1271 1227 1173 1224  964 1109  966  687  880  686  578  577  460  335  203
 120  257  386  507  620  725  822  911  992 1065 1130 1128 1237 1279 1185 1184 1183 1053 1179 1180 1178 1176 1117 1226 1047 1112 1114 1113  967  881  786  788  461  685  336   62   61
 119  256  385  506  619  724  821  910  991 1064 1129 1127 1186 1126 1125 1182 1124 1123 1055 1181 1118 1177 1050 1175 1115  972 1045 1225 1043 1044 1111  688  787  579  337  204   63
 118  255  384  505  618  723  820  909  990 1063 1062 1061 1060 1059 1058 1057 1122 1054 1120 1119  893 1051 1048 1116  974 1046  971  968  884  791  689  580  464  462  338  205   64
 117  254  383  504  617  722  819  908  989  988  987  986  985  984  983  981 1056  897  980 1052  979  894  976 1049  975  973  970  969  789  883  690  790  463  581  339  206   65
 116  253  382  503  616  721  818  907  906  905  904  903  902  900  899  982  808  710  806  895  804  977  802  891  890  889  888  887  886  885  792  691  582  465  340  207   66
 115  252  381  502  615  720  817  816  815  814  813  812  810  709  708  898  809  807  896  805  803  801  892  800  799  798  797  796  795  794  793  692  583  466  341  208   67
 114  251  380  501  614  719  718  717  716  715  492  714  603  901  601  366  487  706  705  978  703  595  596  702  700  699  698  697  696  695  694  693  584  467  342  209   68
 113  250  379  500  613  612  611  495  609  608  713  607  811  712  491  711  488  707  599  598  597  704  594  701  593  592  591  590  589  588  587  586  585  468  343  210   69
 112  249  378  499  498  497  373  496  610  493  606  490  365  605  364  602  485  600  483  360  482  481  480  479  478  477  476  475  474  473  472  471  470  469  344  211   70
 111  248  377  376  375  374  372  241  494  371  370  368  367  604  234  233  486  484  362  229  359  358  357  356  355  354  353  352  351  350  349  348  347  346  345  212   71
 110  247  246  245  244  243  242  240  101  369  238   99  237  235  489  232  363  231  361  230  228  227  226  225  224  223  222  221  220  219  218  217  216  215  214  213   72
 109  108  107  106  105  104  103  102  100  239   98   97  236   96   95   94   93   92   91   90   89   88   87   86   85   84   83   82   81   80   79   78   77   76   75   74   73
