# This puzzle is unsolvable
21
 79  80 153  82   3 154   7  90 159  12  11  95 280  15 164  17  92 101  99  23 171
  5   2 157   4 156   9 364 275  10 162 166  91 230  14 232  98  94  19  96  21  22
271 269  87 152  81  88 222  83 161  89 281 331  93  13 284 332 337  27  20 231 100
 78 213  86  84   8 220  85 390 155 226 224 160 158 330 168 165 282  97  18  16 170
  1  77 150 151 322 221 219 225 323 362 277 228 163 329 167 287 173 236 285 105  24
215 272 216 218   6 270 320 393 324 273 397 227 368 290 106 334 169 371  29 175 102
 76 149 360 211 416 214 365 217 366 419 420 363 327  25 317 421 372 333 229  30  28
 75 316 319  74 358 318 394 395 278 223 398 429 369 367 174 286 239 233 104 172 335
146 274  72 212 208 147 359 276 325 321 430 326 423 370 283 404 238 375  26 107 237
145  73 148 267 361 418 357 415 391 431 426 103 279 434 291 435 289 234 240 176 180
 71  70 209 264 355 413 356 432 436 424 437 392 403 328 373 427 407 235 293 292  31
 69 143 266 388 384 389 268 288 387 422 402 304 439 409 400 374 377 399 109 108 177
144 142 261 210 314 313 352 433 417 414 412 408 302 425 406 179 376 178 338 110  32
311 205  68 263 354 307 262 410 312 252 351 336 438 396 440 296 339  33 241 295  34
 67  65 265 260   0 309 130 256 305 386 349 401 343 378 379  45 405 341 242  35 111
 63 140 207 206 428 141 254 308 411 385 345 346 381 300 249 189 184 294 244  36  37
201 196 134 200 315 310 255 347 128 350 383 195  47 342 340 188 183 181 182 114  38
138 202 203  64 199 382 348 353 253 344 192 301 298 248 247 297 118 186 243  39 112
137 139 135 258 204 133 259 306  55 197 126 380 251 191 115 245 299 120 246 113 116
 61  60  58 257  57 198 194 131  54 127 125 123  50 122 187 124 190 121  44  42  41
 62 136  66  59  56 132  52 129  53 250  51 119 303 193  49  48  46 185 117  40  43
