# This puzzle is unsolvable
39
   2    1    3    4    5    6    7    8    9  162   11   12   15  164  165   16   20  172  168  171  446  313  454  316   25  453  322   29   27  180  326   30  323   31   35   36   37   38   39
 152  153  154  155  156  157  158  159  160   10  161  163   13  309  310  166  167   17  169  577  448  317   22  179  175  585  324  704  456  321  460  182  185   33  186  187  188  189   40
 151  296  297  298  299  300  301  302  303  304  305  306  307  444  308  445  311  170   18  450   26   24  581  174  178  451   28  584  181  459  458   32  184   34  328  330  329  190   41
 150  295  432  433  434  435  436  437  438  439  440  441  443   14  689  572  312  449   19  695  315   21  176  698  318  173  700  320  815  587  462  183  707  463  464  466  331  191   42
 149  294  431  560  561  562  563  564  565  566  567  568  442  800  571  573  447  906  575  314  578   23  580  811  582  455  583  177  705  706  327  818  588  590  591  333  332   43   44
 148  293  430  559  680  681  682  683  684  685  686  687  569  688  691  570  574  694  692  805  576  697  452  696  579  701  319  703  325  461  702  589  921  709  593  465  335  192  194
 147  292  429  558  679  792  793  794  795  796  797  798  799  801  802  690  803  693 1005  908  806  913  914  699 1006  809  813  814  918  586  816  819  708  710  467  592  193  336  334
 146  291  428  557  678  791  896  897  898  899  900  901  902  903  904 1000  907  804 1002  909  912 1007 1094 1009  910 1097  457  920 1100  817  919 1015  820  594  470  468  469   46   45
 145  290  427  556  677  790  895  992  993  994  995  996 1085  998  999 1001  905 1168 1090 1004  911  807 1008  812  808 1010 1011  917 1012 1102  925 1013  821  711  471  338   47  195  339
 144  289  426  555  676  789  894  991 1080 1081 1082 1083  997 1163 1086 1087 1089 1169 1003 1170 1091 1092 1093 1174  810  915 1018  924  926 1179 1178 1014  923  713  196  595  596  473   48
 143  288  425  554  675  788  893  990 1079 1160 1161 1162 1164 1084 1165 1166 1088 1240 1242 1171 1244 1307 1363 1175  916 1095 1247 1096 1176 1099 1016  714  472  597  712  198  197  474  337
 142  287  424  553  674  787  892  989 1078 1159 1232 1233 1234 1298 1235 1236 1167 1357 1239 1305 1362 1172 1448 1173 1246 1098 1248 1101 1019 1311  823  922 1017    0  715  598   51  199   49
 285  141  423  673  786  785  891  988 1077 1158 1231 1296 1297 1238 1303 1300 1302 1358 1237 1241 1243 1361 1405 1309 1310 1365 1177 1180 1103 1021  825  822  824  718  600  717  340   50  200
 140  286  422  552  672  890  888  987 1076 1157 1230 1295 1352 1353 1299 1355 1354 1402 1304 1306 1359 1479 1245 1308 1515 1312 1181 1182 1104 1105 1020  716  827  344  342  476  477  201   52
 139  284  421  671  783  889  986 1074  985 1075 1229 1294 1351 1400 1401 1356 1301 1407 1442 1446 1408 1409 1410 1364 1366 1368 1411 1249 1252 1251 1106  927  928  602  826  830  202  341  343
 138  283  420  551  781  784  887  984 1155 1156 1228 1293 1350 1398 1399 1440 1473 1472 1360 1500 1445 1443 1447 1414 1315 1313 1314 1184 1250 1183 1022  929  719  601  603  203  599  345   54
 137  419  549  550  670  669  782  983 1073 1154 1227 1292 1348 1349 1471 1496 1474 1404 1403 1406 1475 1478 1518 1449 1367 1316 1186 1253 1185 1107 1023  930  828  721  479  605  475   55   53
 281  282  548  547  668  780  779  886 1072 1153 1226 1347 1291 1438 1439 1436 1470 1497 1441 1444 1450 1501 1481 1451 1482 1413 1254 1257 1258 1108 1026  931  829  831  348  480  606   56  346
 280  417  418  546  667  885  982 1070 1071 1224 1152 1290 1396 1397 1437 1493 1469 1512 1499 1520 1477 1412 1452 1372 1317 1370 1369 1255 1111 1024 1109  932  832  720  478  208  206  204  349
 136  134  416  542  665  543  778  884  980  981 1225 1288 1289 1395 1468 1490 1510 1517 1495 1494 1503 1476 1483 1502 1455 1256 1189 1112  934 1025 1028 1110  607  724  347  481  722  205  212
 278  133  415  776  135  883 1151  979 1068 1149 1150 1346 1287 1435 1509 1519 1514 1516 1385 1498 1506 1504 1480 1415 1418 1371 1373 1114 1190 1188  933  834  833  604  723  207   61   57   60
 279  275  544  666  545  664  880  882  881 1344 1286 1223 1393 1394 1392 1434 1467 1507 1486 1508 1513 1459 1484 1423 1419 1416 1417 1261 1187 1259 1113  936 1027  610  608  209  352   58   59
 277  132  413  662  414  777  975 1222  978 1147 1221 1220 1345 1285 1433 1466 1492 1488 1424 1485 1453 1505 1379 1377 1318 1420 1374 1319 1191 1260 1030  935  483  727  482  485  210  211  353
 131  274  273  540  663  661  775 1069  977 1067 1219 1284 1343 1432 1430 1431 1489 1428 1511 1487 1330 1425 1421 1331 1378 1422 1456 1029 1262 1032 1033 1115  728  609  350  938   64   62   63
 537  272  130  411  539  538 1066  879 1148 1145 1218 1341 1465 1491 1334 1388 1275 1335 1426 1427 1464 1454 1462 1458 1328 1375 1321 1320 1118 1031 1193  835  937  837  484  729  486  351   65
 129  410  412  276  877  878  774 1339  976 1065 1146 1280 1390 1342 1391 1277 1463 1386 1332 1460 1382 1380 1327 1270 1376 1323 1457 1263 1197 1192 1116  836  941  726  725  487  611  355  354
 541  409  658  128  660  875  974  773  973 1063 1144 1217 1340 1336 1387 1337 1208 1274 1461 1383 1129 1384 1381 1200 1271 1324 1322 1325 1196 1194  939  839 1119  614  838  616  217  214  213
 125  127  126  771  659  770 1064 1062  972  876 1140 1283 1282 1278 1389 1276 1429 1333 1207 1273 1272 1203 1268 1202 1329 1195 1264 1199 1120 1265  940 1117  612  843  942  488  613   67  356
 124  408  271  536  407  535  772  657 1142 1143 1281 1056 1138 1279 1211 1210 1209 1050 1133 1206 1204 1269 1267 1128 1201 1124 1125 1326 1035 1036 1123  841  842  731  732  491  216  215   66
 123  270  269  406  654  656  874  971 1215 1059 1216 1139 1338 1055 1053 1134 1135  960 1049 1132 1047 1205 1127 1044 1042 1266  949 1040 1039 1037 1034 1038  840  730  733  735  615  359  358
 267  403  404  533  766  769  970 1060 1141 1058 1057 1061 1214 1212 1054 1136  861 1052  958 1131 1048 1130 1045  953 1126  952 1043 1198  851 1121  946  943  618  357  493  617  490  489   68
 121  534  268  767  405  655  873  869  968  966  964  965 1137  963  962  961  959 1051  957  636  858  856 1046  954  852  745 1041  744 1122  847  846  844  944  619  494  360  219  492   69
 266  265  531  532  764  872  768  871  868  967  762  866 1213  865  864  862  516  637  859  860  748  635  750  955  855  743  950  850  849  945  948  947  845  736  734  361  362  218   70
 120  402  122  530  651  969  765  870  763  649  867  760  758  757  863  641  756  639  753  751  638  854  633  853  951  629  630  628  504  740  625  624  623  737  495  496  221  220   72
 119  264  400  401  653  650  648  526  523  645  761  644  759  519  642  755  640  754  515  514  956  749  747  632  746  509  506  375  627  742  370  738  739  620  498  363  497  222   71
 118  116  397  529  652  395  647  525  646  522  391  521  643  388  518  517  247  513  857  634  512  511  510  379  508  507  505  626  373  848  500  230  621  741  622  364   75   73   74
 262  263  260  258  528  527  256  253  254  393  389  251  520  249  387  386  384  382  752  246  383  380  240  378  376  631  235  236   90  371  374  499  368  369  367  366  365  223   76
 399  261  117  113  398  110  394  255  524  106  107  390  103  250  248  100   98  385  244  381  243  241  239  238   89  237   88  234  232  503  502  501   84  229  228  227  226  224  225
 115  114  259  111  112  396  109  257  108  252  392  105  104  102  101   99  245   97   96   95  242   94   93   92  377   91   87  233  372   86   85   83  231   82   81   80   79   78   77
