# This puzzle is unsolvable
41
   1  159  166    6  164  165    8    9  169   10  598   11   12   13   14  174   15   17  178   20   19   21  182   24   25   26   27   28   30  189   31   32   33   34  194   35   36   37   38   40   39
 312    5  162  161  160  840    4  461  320  171  170  325  172  324  173  175  177  328   18  179  180   23  333  183  184  185  187   29  188  341  190  192  344  487  343  196  195  345   42   43  199
   2  158  157    3  167  460    7  168  317  319  321  322  466  467  323   16  176  471  329  330  474   22  332  478  479  336  186  339  482  340  191  342  193  622  490  491  201  349  198  200   41
 456  719  593  723  314  459  595  597  318  464  599  600  465  603  730  469  606  326  607  609  331  181  334  335  337  480  614  338  484  483  618  485  486  488  624  347  346  489  197  350   44
 156  163  311  455  457  718  316  463  596  462  726  601  468  602  731  327  734  472  850  736  608  611  612  741  477  613  481  744  615  746  617  866  750  749  625  492  626  348  351  202   45
 592  313  590  952  454  452  842  841  721  594  724  725  727  604  849  961  470  605  855  473  610  739  966  858  740 1073  742  743  616  745  620  747  619  621  623  869  493  629  352  203   46
 307  308  310  720  315  458  588  955  957  722  956  845  729  848 1062 1066 1065  963  853  856  475  732  967  476  860 1072  971  862  863  864  865  867  977  868  752  751  753  495  353  204   47
 153  451  306  449  591  950  951  953  843  844 1059  728 1061  959  958  962 1160  733 1164  965 1165 1253  857  738  859 1071  861  973  974  975  976  978  748  979  871  870  627  494  354  205   48
 586  309  448  584  453  839 1056  837 1058 1153 1154  847  846 1063 1248  960  735 1328 1330  854 1329  968  737 1167  970 1076  972 1169 1078 1075 1079 1080 1081  980  872  628  630  496  355  206   49
 155  154  450  838  587 1151  717 1057 1055 1241 1152 1155 1158 1156 1245 1159 1162 1070  851 1064 1463 1331 1332 1166 1333 1168 1256 1171 1259 1077 1172 1175  983  874  873  754  755  497  356  208   50
 152  715  305  836  716  589  949  954 1148 1240 1319 1244 1060 1323 1157 1247 1067 1163 1564 1399 1252 1068 1465 1254  969 1074 1170 1260 1409 1339  981  982 1176 1177  757  756  631  498  207  357  209
 150  151  711  304  585  948  947 1053 1236 1239 1242 1392 1320 1321 1326 1246 1250 1069  964  852 1462 1570 1403 1406 1472 1255 1257 1408 1173 1174 1083 1340 1085 1082  758  633  632  358  501   54   51
 302  303  446  714 1052  834 1237 1051 1146 1235 1150 1322 1324 1394 1396 1514 1603 1325 1249 1402 1461 1251 1404 1405 1469 1335 1258 1336 1337 1341 1411 1084 1178  984  875  759  634   53  360   52  212
 583  148  713  149  835  831  946 1147  945 1390 1391 1393 1243 1397 1458 1457 1517 1161 1327 1520 1464 1568 1401 1521 1525 1407 1410 1471 1262 1473 1264 1179 1261 1086  876  760  500  499  361  359   55
 147  300  299  301  582  833  445 1050 1317 1318 1238 1455 1454 1456 1562 1395 1398 1515 1604 1400 1565 1607 1468 1470 1334 1467 1338 1263 1342 1180 1088 1181 1087  985  986  877  635  502  364  213  210
 145  146  298  708 1054  944 1049  832 1234 1149 1387 1389 1453 1512 1459 1600 1636 1460 1601 1518 1569 1466 1522 1638 1572 1524 1526 1528 1527 1266 1265 1090 1267 1089  988  987  761  503  362   57  211
 444  297  581  447  704  830 1048  827 1144 1145 1315 1452 1388 1511 1513 1630 1563 1602 1633 1605 1519 1608 1567 1610 1571 1640 1661 1475 1343 1345 1344 1183 1182  880  878  637  636  504  215   56    0
 144  441  443  712  709  829  828  940  942 1143 1233 1386 1510 1560 1557 1561 1516 1509 1631 1566 1658 1606 1523 1637 1641 1573 1611 1414 1412 1268 1346 1269  989  881  879  763  638  505  217  363  216
 143  296  579  710  442  707  943 1047 1142 1046 1314 1316 1451 1508 1507 1629 1558 1657 1634 1598 1674 1635 1639 1642 1612 1574 1474 1476 1413 1418 1415 1091 1185  990  765  762  764  639  367   58  214
 141  295  292  577  703  705  580  706 1311 1232 1230 1312 1385 1506 1599 1559 1656 1632 1672 1671 1675 1676 1609 1662 1613 1575 1529 1477 1270 1272 1271 1092  993 1093  883  767  640  506  507  366  365
 142  438  293  702  578  575  939  941 1138 1231 1313 1450 1383 1449 1556 1597 1555 1596 1655 1673 1654 1663 1659 1660 1643 1576 1530 1531 1416 1417  991 1347 1095  884  882  369  509  220   61  218   59
 439  140  824  576  440  826 1045  937 1141 1229 1309 1310 1448 1505 1554 1595 1628 1653 1670 1679 1680 1666 1677 1614 1615 1577 1532 1478 1419 1186 1350 1184  992 1097  766  510  642  512  368  219   60
 138  294  139  572  437  574 1040 1044 1225 1140 1139 1384 1228 1504 1552 1553 1627 1652 1669 1667 1668 1678 1644 1645 1616 1578 1533 1479 1480 1348 1187 1349 1276  886  994  370  641  508   63  225   64
 434  573  701  436  823 1041  938  825 1043 1226 1446 1381 1444 1447 1503 1594 1593 1651 1650 1649 1621 1665 1664 1619 1617 1579 1534 1481 1420 1351 1273 1188 1094  885  887  888  643  768  511  513  374
 291  137  290  571  700  935  821 1307 1227 1380 1502 1382 1443 1445 1551 1592 1626 1624 1623 1622 1586 1646 1648 1647 1583 1580 1535 1482 1421 1352 1274 1098 1096  995  770  998  222  644  221   62   65
 136  289  433  568  435  822 1137 1037 1042 1038 1305 1308 1501 1549 1591 1590 1625 1589 1588 1587 1585 1618 1541 1582 1540 1536 1483 1484 1422 1354 1189  999 1190  996  771  645  769  647  226  223   66
 287  288  432  698  570  699 1039 1136 1224 1379 1304 1378 1500 1550 1548 1547 1546 1545 1544 1543 1492 1620 1542 1584 1489 1581 1537 1423 1277 1353 1278 1193 1191  889  646  515  891   68  371  516   67
 135  133  569  697  936  934  820 1134 1222 1377 1306 1442 1441 1499 1498 1497 1496 1495 1494 1493 1491 1432 1488 1539 1538 1429 1486 1485 1424 1355 1194 1275 1192  773 1000  772  648  224  774  375   70
 131  430  931 1036  818  932  933 1135 1221 1133 1302 1131 1440 1373 1439 1438 1437 1436 1435 1434 1433 1431 1490 1430 1428 1487 1427 1426 1425 1279 1195 1357 1101 1099  890  514  373  649  650  518   69
 134  431  286  565  696  819  930 1132 1035 1303 1223 1376 1374 1372 1297 1371 1370 1369 1368 1367 1366 1365 1364 1363 1362 1361 1360 1359 1356 1280 1283 1103  997 1001  892  775  651  519  372  377   71
 283  132  285  566  815  817  694  816 1034 1301 1300 1375 1299 1298 1214 1296 1295 1294 1293 1292 1291 1290 1289 1288 1287 1286 1285 1284 1282 1196 1358 1100 1102 1002  893  777  517  776  227  228  376
 284  428  427  429  693  567  928 1033 1220 1128 1219 1218 1216 1215 1213 1122 1212 1211 1210 1209 1208 1207 1206 1205 1204 1203 1202 1201 1281 1200 1199 1198 1197 1003  894  778  652  229  230  231   72
 129  282  563  695  692  814  927  929 1130 1029 1127 1217 1126 1125 1123 1023 1121 1021 1119 1118 1117 1116 1115 1114 1113 1112 1111 1110 1109 1108 1107 1106 1104 1105 1004  895  653  378  520  379   73
 281  130  426  564  925  812  813 1032 1030 1028  921 1027 1026 1124 1024  916 1120 1022 1020 1019 1018 1017 1016 1015 1014 1013 1012 1011 1010 1009 1008 1006  900 1005  896  779  654  521  380  232   74
 128  127  425  560  424  691  926 1031  924  807  922  805  920 1025  919  917  915  914  913  912  911  910  909  908  907  906  905  904  903  902  901 1007  898  784  897  780  655  522  381   75   76
 126  423  690  562  689  811  810  808 1129  553  806  918  549  680  802  801  800  799  798  797  796  795  794  793  792  791  790  789  788  787  786  785  899  660  783  781  656  524  523  234  233
 125  280  559  277  688  561  687  809  923  685  683  804  682  548  803  678  677  676  675  674  542  673  671  670  669  668  667  665  534  664  663  662  661  782  528  659  658  657  382   77   78
 278  279  421  558  418  686  557  555  684  554  552  551  681  679  409  547  546  545  544  543  403  672  402  400   96  537  536  535  666  533  532  531  530  529  527  388  526  525  383  385   79
 124  274  273  420  422  271  556  417  416  415  414  412  550  411  410  408  407  406  405  101  257  540  541  255  538  398  399  250  395  247  394  392  391  390  389  241  387  386  235  384  236
 123  275  276  272  117  419  270  269  267  113  413  265  264  263  107  262  261  104  259  258  404  100   99  401   97  252  251  397  249  248  393  246   89  244   87  242  240  239  238  237   80
 122  121  120  119  118  116  115  114  268  112  266  111  110  109  108  106  260  105  103  102  254  256   98  253  539   95   94  396   93   92   91  245   90  243   88   86   85   84   83   82   81
