# This puzzle is unsolvable
10
  7  85  84  25  65  64  97  18  82  21
 33  57  43  49  87  38  71  90  92  96
  1  26   9  32  23   4  44   8  91  55
 12   5  14  45   2  75  51  50  15  77
 39  66  62  56  48  68  41   0  74   3
 86   6  28  70  17  63  11  19  93  42
 10  60  34  61  40  69  89  13  88  98
 67  58  35  94  83  30  78  20  72  22
 31  29  27  80  47  59  79  46  52  99
 24  81  37  36  54  53  95  16  76  73
