# This puzzle is unsolvable
74
   2    1    3    4    5    6    7    8    9   10   11  303   13   14  307   16  309  306  310   20   21   22   23   24   25   26   27   28   29   31  322  608  607   32  324  327   38   39  332  613   41  617   43  334   45   46   47   48   49   50   51   52   53   54   55   56   57   58   59   60   61   62   63   64   65   66   67   68   69   70   71   72   73   74
 292  293  294  295  296  297  298  299  300  301  302  304   12  305   17  590   18  308  592  311  312  313  314  315  316  317  318  320  321   30  605   33   36   35 1155   37  328  612  329   40  333  890  335   44  336  337  338  339  340  341  342  343  344  345  346  348  349  632  350  351  352  353  354  355  356  357  358  359  360  361  362  363  364   75
 291  576  577  578  579  580  581  582  583  584  585  587  862  588   15  589   19  591  594  869  595  596  597  598  600  601  602  319  604  880  606  883   34  323  325  888 1412 1152  614  886  330  331  615  616  619  896  620  621  899  623  625  626  627  628  629  347  631  907  633  634  635  636  637  638  639  640  641  642  643  644  645  646  365   76
 290  575  852  853  854  855  856  858 1125  859  861  586  863 1132 1131  865  866  867  593  870  871  872 1139  873  599  875  876  877  603  878 1147  882  881  326  609  611  889 1154 1153  891   42 1159  893  618 1161  894  897  622 1165  624  900  901  902  903  904  630  905  908 1175  909  910  911  912  913  914  915  916  917  918  919  920  647   77   78
 289  574  851 1120 1121 1122 1124  857 1126 1127  860 1128 1129 1130 1390  864 1133 1135  868 1136 1137 1138 1140 1141  874 1142 1143 1144 1145  879 1406 1148 1149 1150 1151 1414 1411  610 1156 1415 1416  892 1158 1160  895 1162 1163  898 1164 1166 1167 1168 1169 1170 1171 1172  906 1174 1434 1176 1177 1178 1179 1180 1181 1441 1182 1183 1185 1186  921  648  366   79
 288  573  850 1119 1380 1381 1123 1383 1635 1384 1386 1387 1388 1389 1641 1391 1392 1134 1393 1394 1395 1396 1398 1399 1400 1401 1402 1403 1404 1146 1405 1407 1408 1410  884 1662  885 2143 1413 1665 1417 1157 1418 1419 1421 1672 1422 1423 1424 1425 1426 1427 1428 1429 1430 1431 1173 1433 1435 1687 1686 1437 1438 1439 1440 1442 1184 1445 1694  649 1188  368  367   80
 287  572  849 1118 1379 1632 1382 1633 1634 1385 1636 1637 1639 1640 1642 1885 1643 1645 1646 1889 1647 1397 1648 1649 1650 1651 1652 1654 1655 1656 1657 1658 1659 1660 1409 1905  887 1907 1664 1908 1669 1666 2147 1671 1914 1420 1673 1674 1675 1676 1677 1678 1679 1680 1681 1683 1926 1432 1684 1685 1929 1688 1689 1691 1935 1693 1446 1443 1447 1189 1444  650  369  370
 286  571  848 1117 1378 1631 1876 1877 1878 1879 1881 1638 1882 1883 1884 1886 1887 1644 1888 1890 1891 1892 2354 2128 1894 1893 1653 1897 1898 1899 1900 2135 1901 1902 1661 1904 1663 1906 1910 1668 2369 1911 1667 1913 1670 1915 1916 1917 1918 1919 1920 2156 1923 1921 1925 1924 1682 1927 1928 2164 1436 1931 1932 2168 1933 1695 1937 1696  923 1938 1187  372  651   82
 285  570  847 1116 1377 1630 1875 2112 2113 2114 1880 2116 2117 2118 2119 2120 2121 2122 2123 2124 2126 2574 2127 2358 1895 2130 1896 2131 2132 2133 2134 2363 1903 2139 2365 2366 2367 2141 1909 2144 2145 2373 2146 2149 1912 2150 2151 2152 2153 2155 2157 2383 1922 2385 2160 2606 2161 2163 2610 2388 1930 2165 2167 1690 2169 1936 2170 2171 1939  926  922  924  652   81
 284  569  846 1115 1629 1873 1874 2111 2340 2341 2115 2343 2344 2345 2346 2347 2348 2349 2350 2351 2125 2352 2353 2355 2575 2129 2357 2359 2360 2361 2362 2582 2136 2583 2586 2140 2368 2370 2142 2371 2372 2374 2593 2148 2375 2376 2378 2379 2380 2154 2601 2382 2602 2603 2158 2818 2162 2607 2609 2390 2393 2166 2613 2394 2396 1692 1934 1697 1191 1698  927  653  371   83
 283  568  845 1114 1376 1375 1628 2110 2339 2560 2342 2562 2563 2564 2565 2566 2567 2568 2569 2570 2571 2783 2572 2576 2573 2356 2577 2578 2579 2791 2581 2794 2997 2796 2138 2585 2587 2588 2799 2589 2802 2591 2592 2595 2805 2597 2807 2598 2599 2381 2600 2159 2384 2604 2386 2387 2817 2819 2391 2611 2392 2823 2612 2395 2397 2172 1940  925 1450 1448 1190  654  373   85
 282  567  844 1113 1374 1627 1872 2109 2338 2559 2561 2772 2774 2775 2776 2980 2777 2779 2780 2781 2782 2986 2785 3184 2990 2787 2788 2789 2790 2792 2580 2584 2996 2364 2137 2797 2798 3002 2800 2801 2590 2803 3202 2377 3008 2806 2808 3012 2809 2811 2812 2813 3017 2814 2815 2816 3021 2389 2608 2820 3025 2822 2824 2614 2615 2398 1699 1702 1449 1192  655  374   84   86
 281  566  843 1112 1373 1626 1871 2108 2337 2558 2771 2773 2976 2978 2979 3176 2778 2981 2983 2984 2985 3181 2784 3370 2786 2989 3186 2991 2992 2993 3191 2793 2998 3193 3194 3000 3001 3197 3003 3004 3005 3006 3007 3009 2804 2596 3010 3207 2810 3013 3015 3211 3016 3018 2605 3019 3020 3022 3023 2821 3024 3026 2825 2617 2400 2616 2399 2173 1451 1193  928  930  929  656
 280  565  842 1111 1372 1625 1870 2107 2336 2557 2770 2975 2977 3173 3362 3174 3177 2982 3178 3366 3179 3180 2987 3369 2988 3183 3373 3188 3375 2994 3556 2995 3190 2795 2999 3195 3196 3384 3198 3199 3200 3201 3203 2594 3390 3392 3011 3206 3208 3014 3397 3210 3212 3213 3214 3215 3216 3217 3218 3219 3220 3027 2826 2618 2401 2174 1700 1941 1452 1195  657 1194  375   87
 279  564  841 1110 1371 1624 1869 2106 2335 2556 2769 2974 3172 3171 3360 3175 3363 3364 3365 3546 3545 3368 3548 3182 3371 3185 3372 3187 3376 3377 3727 3558 3559 3379 3380 3381 3382 3562 3383 3386 3387 3388 3568 3389 3204 3571 3205 3394 3395 3209 3396 3398 3399 3400 3401 3402 3403 3404 3405 3406 3221 3028 2827 2620 2619 1701 2175 1942 1197 1196  658  377  376   88
 278  563  840 1109 1370 1623 1868 2105 2334 2555 2768 2973 3170 3359 3361 3541 3542 3543 3544 3716 3367 3718 3547 3549 3550 3551 3552 3374 3554 3189 3555 3378 3192 3557 3560 3561 3563 3564 3385 3565 3566 3567 3569 3391 3393 3742 3572 3573 3574 3575 3576 3577 3578 3579 3580 3581 3582 3583 3584 3407 3222 3029 2829 2828 2176 2177 1943 1703  932 1453  931  659  378   89
 277  562  839 1108 1369 1622 1867 2104 2333 2554 2767 2972 3169 3358 3540 3539 3712 3713 3715 3714 3879 3717 3719 3720 3721 3722 3886 3553 3726 3728 3891 3892 3729 3732 3896 3734 3733 3897 3735 3736 3737 3738 3739 3570 3740 3741 3743 3744 3745 3746 3747 3748 3749 3750 3751 3752 3753 3754 3585 3408 3223 3030 2830 2403 2402 1704 1945 1944 1456 1198  934  933  379  660
 276  561  838 1107 1368 1621 1866 2103 2332 2553 2766 2971 3168 3357 3538 3711 3876 3877 4033 3878 3880 4035 3882 3883 3884 4040 3885 3723 3724 4189 4045 3890 4048 3730 3893 3894 4051 3898 3899 4055 3900 3901 3902 3903 3904 3905 3906 3907 3908 3909 3910 3911 3912 3913 3914 3915 3916 3755 3586 3409 3224 3031 2621 2404 2179 2178 1946 1454 1199 1455  661  662   91   90
 275  560  837 1106 1367 1620 1865 2102 2331 2552 2765 2970 3167 3356 3537 3710 3875 4032 4180 4034 4036 3881 4037 4038 4039 4041 4327 4043 3725 3889 4044 4193 4046 4195 3731 3895 4198 4050 4052 4053 4201 4056 4057 4058 4059 4060 4061 4062 4063 4064 4065 4066 4067 4068 4069 4070 3917 3756 3587 3410 3225 3032 2831 2622 2405 2180 1947 1705 1200 1458  935  663   92  380
 274  559  836 1105 1366 1619 1864 2101 2330 2551 2764 2969 3166 3355 3536 3709 3874 4030 4031 4181 4182 4183 4184 4185 4186 4187 4042 3888 3887 4330 4190 4332 4194 4334 4049 4335 4337 4339 4199 4200 4054 4202 4204 4205 4206 4207 4208 4209 4210 4211 4212 4213 4214 4215 4216 4071 3918 3757 3588 3411 3226 3033 2832 2623 2407 2181 2406 1948 1457 1203  664  937 1201  382
 273  558  835 1104 1365 1618 1863 2100 2329 2550 2763 2968 3165 3354 3535 3708 3872 3873 4179 4320 4321 4322 4323 4324 4456 4325 4326 4188 4329 4460 4191 4331 4333 4336 4047 4196 4197 4470 4340 4341 4342 4203 4343 4344 4345 4346 4347 4348 4349 4350 4351 4352 4353 4354 4217 4072 3919 3758 3589 3412 3227 3034 2833 2624 2408 2182 1949 1708 1706  936  383  665  381   93
 272  557  834 1103 1364 1617 1862 2099 2328 2549 2762 2967 3164 3353 3534 3707    0 4029 4178 4319 4452 4453 4454 4455 4579 4457 4459 4328 4584 4461 4192 4701 4464 4465 4466 4467 4338 4592 4709 4471 4472 4473 4474 4475 4476 4477 4478 4479 4480 4481 4482 4483 4484 4355 4218 4073 3920 3759 3590 3413 3228 3035 2834 2625 2409 2183 1950 1707 1709 1202  939  938  384   95
 271  556  833 1102 1363 1616 1861 2098 2327 2548 2761 2966 3163 3352 3533 3706 3871 4028 4177 4318 4451 4576 4577 4578 4581 4458 4580 4583 4699 4700 4462 4587 4702 4588 4590 4591 4468 4813 4707 4593 4595 4596 4597 4598 4599 4600 4601 4602 4603 4604 4605 4606 4485 4356 4219 4074 3921 3760 3591 3414 3229 3036 2835 2626 2184 1951 1710 1461 1462 1459 1204  666   94   96
 270  555  832 1101 1362 1615 1860 2097 2326 2547 2760 2965 3162 3351 3532 3705 3870 4027 4176 4317 4450 4575 4692 4693 4694 4695 4696 4582 4698 4808 4463 4810 4586 4809 4589 4469 4705 4706 4914 4594 4710 4711 4712 4713 4714 4715 4716 4717 4718 4719 4720 4607 4486 4357 4220 4075 3922 3761 3592 3415 3230 3037 2836 2627 2410 2185 1952 1711 1205 1460  940  667  385  386
 269  554  831 1100 1361 1614 1859 2096 2325 2546 2759 2964 3161 3350 3531 3704 3869 4026 4175 4316 4449 4574 4691 4802 4801 4901 4804 4805 4906 4585 4806 4997 4908 4909 4704 4911 4814 4708 4815 4816 4915 4817 4819 4820 4821 4822 4823 4824 4825 4826 4721 4608 4487 4358 4221 4076 3923 3762 3593 3416 3231 3038 2837 2628 2411 2186 1953 1712 1463 1206  668  387   98   97
 268  553  830 1099 1360 1613 1858 2095 2324 2545 2758 2963 3160 3349 3530 3703 3868 4025 4174 4315 4448 4573 4690 4800 4799 4902 4993 4803 4697 4903 4807 4703 5082 4910 4912 5002 4812 4913 4917 4916 5008 4818 4918 4919 4920 4921 4922 4923 4924 4827 4722 4609 4488 4359 4222 4077 3924 3763 3594 3417 3232 3039 2838 2629 2412 2187 1954 1713 1464 1207  941  669  388   99
 267  552  829 1098 1359 1612 1857 2094 2323 2544 2757 2962 3159 3348 3529 3702 3867 4024 4173 4314 4447 4572 4798 4687 4900 4991 4992 5078 5076 5153 5077 4998 5081 5001 4811 5003 5087 5086 5004 5088 5007 5091 5009 5010 5011 5012 5013 5014 4925 4828 4723 4610 4489 4360 4223 4078 3925 3764 3595 3418 3233 3040 2839 2630 2413 2188 1955 1714 1208  943  942  670  389  100
 266  551  828 1097 1358 1611 1856 2093 2322 2543 2756 2961 3158 3347 3528 3701 3866 4023 4172 4313 4446 4571 4689 4688 4899 4989 4994 4996 4904 5079 4907 4905 5000 4999 5083 5084 5162 5161 5005 5163 5089 5090 5092 5093 5094 5095 5096 5015 4926 4829 4725 4724 4611 4361 4224 4079 3926 3765 3596 3419 3234 3041 2840 2631 2414 2189 1956 1715 1465 1210  944  671  390  101
 265  550  827 1096 1357 1610 1855 2092 2321 2542 2755 2960 3157 3346 3527 3700 3865 4022 4171 4312 4445 4570 4796 4898 4797 4990 4988 5152 4995 5221 5080 5223 5157 5158 5159 5085 5006 5228 5230 5164 5165 5166 5167 5168 5169 5170 5097 5016 4927 4830 4726 4612 4490 4491 4362 4080 3927 3766 3597 3420 3235 3042 2841 2632 2415 2190 1957 1716 1209 1466  945  672  391  102
 264  549  826 1095 1356 1609 1854 2091 2320 2541 2754 2959 3156 3345 3526 3699 3864 4021 4170 4311 4444 4569 4686 4795 4897 5073 5151 5075 5154 5220 5156 5155 5224 5225 5226 5160 5227 5288 5229 5290 5232 5293 5233 5234 5236 5171 5098 5017 4928 4831 4613 4492 4493 4363 4225 3929 4082 3928 3767 3421 3236 3043 2842 2633 2416 2191 1717 1468 1467 1211  946  673  392  103
 263  548  825 1094 1355 1608 1853 2090 2319 2540 2753 2958 3155 3344 3525 3698 3863 4020 4169 4310 4442 4443 4568 4895 4896 5074 5072 5150 5219 5281 5222 5282 5283 5284 5337 5286 5287 5340 5339 5231 5291 5292 5294 5235 5237 5172 5099 5018 4929 4832 4727 4614 4364 4226 4228 4081 3930 3599 3598 3422 3237 3044 2843 2634 2417 2192 1958 1718 1469 1212  947  674  393  104
 262  547  824 1093 1354 1607 1852 2089 2318 2539 2752 2957 3154 3343 3524 3697 3862 4019 4168 4309 4567 4566 4794 4685 4894 4987 5149 5218 5332 5280 5333 5334 5377 5335 5379 5285 5338 5384 5289 5386 5342 5343 5344 5295 5238 5173 5100 5019 4930 4833 4728 4615 4494 4365 4229 4227 3931 3768 3600 3423 3238 3045 2844 2635 2418 2194 1959 1960 1470 1213  948  675  394  105
 261  546  823 1092 1353 1606 1851 2088 2317 2538 2751 2956 3153 3342 3523 3696 3861 4018 4167 4308 4441 4565 4684 4683 4893 4986 5071 5148 5279 5217 5278 5376 5411 5378 5415 5336 5441 5381 5341 5383 5420 5385 5345 5296 5239 5174 5101 5020 4931 4834 4729 4616 4495 4366 4084 4083 3769 3601 3771 3424 3239 3046 2845 2636 2419 2195 2193 1719 1471 1214  949  676  395  106
 260  545  822 1091 1352 1605 1850 2087 2316 2537 2750 2955 3152 3341 3522 3695 3860 4017 4166 4307 4440 4564 4792 4793 4892 4985 5070 5147 5215 5216 5331 5277 5374 5412 5380 5442 5416 5382 5445 5418 5419 5387 5346 5297 5240 5175 5102 5021 4932 4835 4730 4617 4496 4367 4230 4085 3932 3770 3425 3240 3047 2846 2847 2420 2421 1720 1962 1961 1721 1215  950  677  396  107
 259  544  821 1090 1351 1604 1849 2086 2315 2536 2749 2954 3151 3340 3521 3694 3859 4016 4165 4306 4563 4791 4681 4682 4790 4984 5069 5146 5275 5214 5329 5330 5375 5460 5414 5444 5417 5461 5464 5465 5421 5388 5347 5298 5241 5176 5103 5022 4933 4836 4731 4618 4497 4368 4231 4086 3772 3603 3602 3426 3241 3048 2638 2637 2422 2196 1474 1722 1472 1216  951  678  397  108
 258  543  820 1089 1350 1603 1848 2085 2314 2535 2748 2953 3150 3339 3520 3693 3858 4015 4164 4305 4439 4438 4680 4890 4891 4983 5067 5068 5145 5276 5372 5328 5373 5413 5472 5439 5462 5443 5447 5446 5422 5389 5348 5299 5242 5177 5104 5023 4934 4837 4732 4619 4498 4369 4087 3934 3933 3773 3604 3427 3242 3049 2848 2639 2197 1964 1963 1473 1475 1217  952  679  398  109
 257  542  819 1088 1349 1602 1847 2084 2313 2534 2747 2952 3149 3338 3519 3692 3857 4014 4163 4304 4437 4562 4788 4789 4889 4888 4982 4981 5212 5274 5213 5409 5410 5436 5437 5471 5459 5463 5474 5448 5423 5390 5349 5300 5243 5178 5105 5024 4935 4838 4733 4620 4499 4370 4232 4233 4088 3774 3605 3428 3243 3050 2849 2640 2423 2198 1723 1965 1724 1218  953  680  399  110
 256  541  818 1087 1348 1601 1846 2083 2312 2533 2746 2951 3148 3337 3518 3691 3856 4013 4162 4303 4436 4560 4679 4678 4787 4887 5065 5144 5211 5327 5371 5370 5438 5408 5440 5458 5468 5475 5466 5449 5424 5391 5350 5301 5244 5179 5106 5025 4936 4839 4734 4621 4500 4371 4234 3936 3935 3775 3606 3429 3244 3051 2850 2641 2424 2199 1966 1725 1476 1219  954  681  400  111
 255  540  817 1086 1347 1600 1845 2082 2311 2532 2745 2950 3147 3336 3517 3690 3855 4012 4161 4302 4434 4435 4561 4786 4886 4980 5143 5066 5142 5272 5273 5326 5369 5407 5435 5470 5473 5469 5467 5450 5425 5392 5351 5302 5245 5180 5107 5026 4937 4840 4735 4622 4501 4372 4090 4089 3937 3776 3607 3430 3245 3052 2851 2642 2425 2200 1967 1726 1477 1220  955  682  401  112
 254  539  816 1085 1346 1599 1844 2081 2310 2531 2744 2949 3146 3335 3516 3689 3854 4011 4160 4301 4559 4676 4677 4785 4885 4979 5140 5064 5210 5271 5325 5324 5406 5456 5457 5455 5454 5453 5452 5451 5426 5393 5352 5303 5246 5181 5108 5027 4938 4841 4736 4623 4502 4373 4235 4091 3939 3777 3608 3431 3246 3053 2852 2643 2426 2201 1968 1727 1478 1221  956  683  402  113
 253  538  815 1084 1345 1598 1843 2080 2309 2530 2743 2948 3145 3334 3515 3688 3853 4010 4159 4300 4433 4558 4675 4784 4978 5063 5062 5141 5270 5323 5322 5368 5405 5434 5433 5432 5431 5430 5429 5428 5427 5394 5353 5304 5247 5182 5109 5028 4939 4842 4737 4624 4503 4374 4237 3938 4092 3778 3609 3432 3247 3054 2853 2644 2427 2202 1969 1728 1479 1222  957  684  403  114
 252  537  814 1083 1344 1597 1842 2079 2308 2529 2742 2947 3144 3333 3514 3687 3852 4009 4158 4299 4432 4557 4674 4783 4884 4977 5061 5139 5209 5321 5269 5367 5404 5403 5402 5401 5400 5399 5398 5397 5396 5395 5354 5305 5248 5183 5110 5029 4940 4843 4738 4504 4375 4238 4093 4236 3940 3779 3610 3433 3248 3055 2854 2645 2428 2203 1970 1729 1480 1223  958  685  404  115
 251  536  813 1082 1343 1596 1841 2078 2307 2528 2741 2946 3143 3332 3513 3686 3851 4008 4157 4298 4431 4556 4673 4782 4883 4975 4976 5138 5208 5320 5207 5366 5365 5364 5363 5362 5361 5360 5359 5358 5357 5356 5355 5306 5249 5184 5111 5030 4941 4844 4739 4625 4505 4376 4239 4094 3941 3780 3611 3434 3249 3056 2855 2429 2204 2205 1971 1730 1481 1224  959  686  405  116
 250  535  812 1081 1342 1595 1840 2077 2306 2527 2740 2945 3142 3331 3512 3685 3850 4007 4156 4297 4430 4555 4672 4781 4882 5060 5137 5206 5267 5268 5319 5264 5317 5262 5316 5315 5314 5313 5312 5311 5310 5309 5308 5307 5250 5185 5112 5031 4942 4845 4740 4626 4507 4506 4377 4096 3942 3781 3612 3435 3250 3058 2646 2431 2430 2206 1972 1731 1482 1225  960  687  406  117
 249  534  811 1080 1341 1594 1839 2076 2305 2526 2739 2944 3141 3330 3511 3684 3849 4006 4155 4296 4429 4554 4671 4780 4881 4974 5059 5204 5205 5266 5201 5263 5318 5261 5260 5197 5259 5257 5194 5256 5255 5254 5253 5252 5251 5186 5113 5032 4943 4846 4741 4627 4628 4241 4242 4095 3944 3782 3613 3436 3251 3059 2649 2856 2648 2647 1973 1732 1483 1226  961  688  407  118
 248  533  810 1079 1340 1593 1838 2075 2304 2525 2738 2943 3140 3329 3510 3683 3848 4005 4154 4295 4428 4553 4670 4779 4880 5057 5134 5136 5135 5203 5265 5202 5200 5199 5198 5196 5195 5258 5123 5193 5192 5191 5190 5189 5187 5116 5114 4944 4847 4848 4742 4508 4378 4240 4098 3943 3783 3784 3614 3438 3252 3060 2857 3057 2432 2207 1974 1733 1484 1227  962  689  408  119
 247  532  809 1078 1339 1592 1837 2074 2303 2524 2737 2942 3139 3328 3509 3682 3847 4004 4153 4294 4427 4552 4669 4778 4971 4879 4973 5058 5133 5132 5131 5130 5129 5128 5127 5126 5125 5124 5044 5122 5121 5120 5119 5118 5188 5115 5034 5033 4946 4945 4743 4629 4380 4379 4097 4243 3946 3945 3615 3439 3437 2858 2859 2650 2433 2208 1975 1734 1485 1228  963  690  409  120
 246  531  808 1077 1338 1591 1836 2073 2302 2523 2736 2941 3138 3327 3508 3681 3846 4003 4152 4293 4426 4551 4668 4776 4970 4777 5056 5055 5054 5053 5051 4965 5050 5049 5048 5047 5046 5045 5043 4956 5042 5041 5040 5039 5117 5037 5036 5035 4849 4744 4631 4630 4509 4510 4244 4245 3947 3785 3616 3061 3253 2860 2861 2651 2434 2209 1976 1735 1486 1229  964  691  410  121
 245  530  807 1076 1337 1590 1835 2072 2301 2522 2735 2940 3137 3326 3507 3680 3845 4002 4151 4292 4425 4667 4666 4878 4972 4969 4874 4966 4872 4871 5052 4963 4764 4868 4962 4960 4959 4958 4957 4955 4860 4954 4953 4952 5038 4950 4949 4948 4850 4632 4745 4633 4511 4381 4383 4101 4100 3786 3617 3255 3254 3063 3062 2652 2435 2210 1977 1736 1487 1230  965  692  411  122
 244  529  806 1075 1336 1589 1834 2071 2300 2521 2734 2939 3136 3325 3506 3679 3844 4001 4150 4291 4424 4550 4775 4549 4877 4875 4873 4968 4967 4964 4766 4767 4866 4961 4865 4763 4761 4864 4862 4861 4859 4756 4858 4754 4951 4855 4854 4853 4947 4748 4851 4746 4747 4099 4382 4246 3948 3788 3618 3441 3440 2862 2653 2654 2436 2211 1978 1737 1488 1231  966  693  412  123
 243  528  805 1074 1335 1588 1833 2070 2299 2520 2733 2938 3135 3324 3505 3678 3843 4000 4149 4290 4423 4548 4665 4774 4876 4661 4770 4769 4658 4870 4656 4869 4654 4765 4867 4651 4762 4863 4759 4758 4757 4645 4755 4856 4857 4752 4751 4750 4852 4637 4634 4513 4384 4512 4247 3949 3787 3789 3619 3442 3256 3064 2863 2655 2437 2212 1979 1738 1489 1232  967  694  413  124
 242  527  804 1073 1334 1587 1832 2069 2298 2519 2732 2937 3134 3323 3504 3677 3842 3999 4148 4289 4422 4547 4664 4663 4773 4771 4772 4539 4412 4768 4537 4655 4409 4653 4652 4650 4404 4760 4648 4647 4646 4644 4643 4753 4522 4523 4640 4639 4749 4518 4636 4514 4515 4385 4248 4102 3951 3950 3620 3443 3257 3258 3065 2864 2438 2213 1980 1739 1490 1233  968  695  414  125
 241  526  803 1072 1333 1586 1831 2068 2297 2518 2731 2936 3133 3322 3503 3676 3841 3998 4147 4288 4421 4546 4545 4544 4662 4543 4659 4660 4278 4657 4411 4536 4534 4273 4533 4532 4406 4531 4530 4527 4402 4526 4264 4642 4397 4641 4395 4520 4638 4391 4635 4517 4388 4386 4104 4103 3790 3791 3621 3444 3259 3066 2865 2656 2439 2214 1981 1740 1491 1234  969  696  415  126
 240  525  802 1071 1332 1585 1830 2067 2296 2517 2730 2935 3132 3321 3502 3675 3840 3997 4146 4287 4420 4419 4418 4417 4416 4542 4541 4415 4275 4276 4538 4410 4408 4130 4407 4269 4405 4649 4403 4529 4266 4400 4528 4399 4525 4524 4396 4393 4519 4392 4390 4516 4387 4252 4249 4105 3952 3792 3445 3446 3260 3067 2866 2657 2440 2215 1982 1741 1492 1235  970  697  416  127
 239  524  801 1070 1331 1584 1829 2066 2295 2516 2729 2934 3131 3320 3501 3674 3839 3996 4145 4286 4285 4284 4283 4282 4281 4414 4135 4540 4413 3984 4132 4274 4272 4535 4129 4271 4128 3974 4125 4268 4122 4401 4398 4261 4118 4521 4260 4394 4258 4257 4256 4389 4110 4253 4250 4107 3953 3623 3624 3622 3261 3068 2867 2658 2441 2216 1983 1742 1493 1236  971  698  417  128
 238  523  800 1069 1330 1583 1828 2065 2294 2515 2728 2933 3130 3319 3500 3673 3838 3995 4144 4143 4142 4141 4140 4139 4138 4280 4279 4277 4133 3981 3820 4131 3980 3979 4127 4270 4126 4267 3973 4124 4263 4120 4121 4119 4262 4117 4259 4116 4114 3964 4113 4254 4111 3957 4106 4251 3956 3954 3625 3447 3262 3069 2868 2659 2442 2217 1984 1743 1494 1237  972  699  418  129
 237  522  799 1068 1329 1582 1827 2064 2293 2514 2727 2932 3129 3318 3499 3672 3837 3994 3993 3992 3991 3990 3989 3988 3987 4137 4136 3985 4134 3823 3824 3478 3982 3654 3976 3817 3975 3814 3815 3970 4265 4123 3968 3967 3808 3965 3806 3638 4115 4255 3803 4112 3959 4108 3631 3955 3630 3793 3627 3448 3263 3070 2869 2660 2443 2218 1985 1744 1495 1238  973  700  419  130
 236  521  798 1067 1328 1581 1826 2063 2292 2513 2726 2931 3128 3317 3498 3671 3836 3835 3834 3833 3832 3831 3830 3829 3828 3986 3660 3827 3658 3298 3480 3656 3821 3818 3819 3978 3649 3972 3812 3971 3645 3809 3811 3969 3641 3966 3805 3804 3801 3961 3963 3633 4109 3958 3800 3797 3796 3794 3449 3450 3264 3071 2870 2661 2444 2219 1986 1745 1496 1239  974  701  420  131
 235  520  797 1066 1327 1580 1825 2062 2291 2512 2725 2930 3127 3316 3497 3670 3669 3668 3667 3490 3666 3663 3489 3662 3486 3659 3482 3300 3826 3653 3479 3295 3651 3977 3816 3650 3474 3648 3647 3813 3644 3643 3810 3642 3466 3807 3637 3636 3962 3463 3460 3802 3634 3632 3799 3629 3798 3795 3626 3452 3265 3072 2871 2662 2445 2220 1987 1746 1497 1240  975  702  421  132
 234  519  796 1065 1326 1579 1824 2061 2290 2511 2724 2929 3126 3315 3496 3495 3310 3494 3307 3308 3491 3664 3305 3661 3485 3657 3483 3983 3825 3655 3477 3822 3293 3652 3102 3294 3289 3097 3471 3287 3470 3469 3468 3284 3467 3640 3639 3464 3462 3635 3457 3084 3458 3456 3455 3081 3270 3453 3269 3451 3266 3073 2872 2663 2446 2221 1988 1747 1498 1241  976  703  422  133
 233  518  795 1064 1325 1578 1823 2060 2289 2510 2723 2928 3125 3314 3313 3312 3492 3493 3309 3117 3665 3488 3304 3487 3112 3302 3484 3110 3299 3297 3481 3296 3103 3476 2902 2693 2899 3646 3473 3096 3286 3285 3094 3093 3283 3465 3282 3280 3279 3461 3086 3459 3960 2884 3273 3080 3271 3628 3078 3268 3267 3074 2873 2664 2447 2222 1989 1748 1499 1242  977  704  423  134
 232  517  794 1063 1324 1577 1822 2059 2288 2509 2722 2927 3124 3123 3122 3121 3311 2921 3118 2918 3116 3306 2914 3303 2913 3111 3301 2910 3109 3108 3106 2903 2905 3291 3292 3475 3472 3101 2901 2900 2897 3098 2895 2894 3092 3091 3281 3089 3088 3277 2886 3274 3085 3275 3272 2881 3082 2880 3079 3077 3076 3075 2874 2665 2448 2223 1990 1749 1500 1243  978  705  424  135
 231  516  793 1062 1323 1576 1821 2058 2287 2508 2721 2926 2925 2924 2923 2714 3119 3120 2920 2711 3115 2915 3113 3114 2706 2704 2912 2702 2908 2909 2907 3104 3105 2483 2699 2696 2697 2692 3099 2896 2475 3095 2689 2893 2892 2891 3090 2890 2889 3278 2887 2885 3276 3083 2882 2676 3454 2673 2879 2878 2877 2876 2875 2666 2449 2224 1991 1750 1501 1244  979  706  425  136
 230  515  792 1061 1322 1575 1820 2057 2286 2507 2720 2719 2718 2717 2716 2922 2715 2713 2919 2710 2917 2916 2707 2709 2268 2705 2911 2703 3107 2701 2700 2906 2482 2904 2695 2480 2478 3100 3288 3290 2691 2690 2688 2687 2686 2684 2469 2683 2682 3087 2680 2678 2677 2462 2883 2675 2234 2458 2671 2459 2670 2669 2668 2667 2450 2225 1992 1751 1502 1245  980  707  426  137
 229  514  791 1060 1321 1574 1819 2056 2285 2506 2505 2504 2503 2502 2501 2500 2499 2498 2712 2496 2495 2271 2037 2708 2490 2492 2489 2488 2487 2486 2485 2029 2261 2698 2481 2479 2694 2024 2255 2898 2474 2473 2472 2250 2470 2685 2468 2245 2012 2888 2464 2679 2008 2009 2463 2461 2672 1765 2236 2674 2455 2454 2453 2452 2451 2226 1993 1752 1503 1246  981  708  427  138
 228  513  790 1059 1320 1573 1818 2055 2284 2283 2282 2281 2280 2279 2278 2277 2275 2274 2497 2273 2272 2270 2491 2269 2493 2267 2266 2265 2264 2263 2031 2262 2484 2259 2258 2026 1539 2257 2477 2476 2251 2020 2019 2248 1777 2247 2246 2466 2244 2681 2465 2239 1771 1521 2460 2004 2238 2237 2003 2457 2231 2000 2230 2229 2228 2227 1994 1753 1504 1247  982  709  428  139
 227  512  789 1058 1319 1572 1817 2054 2053 2052 2051 2050 2049 2048 2047 2046 2276 2045 2043 2042 2041 2040 2039 2038 1798 2036 2035 2034 2033 2032 2260 1791 2030 1790 1788 2027 2256 2023 2022 2253 1534 2021 2018 1781 2471 2015 1776 2013 2467 2242 2243 1770 2241 1769 1520 1768 2005 1517 2002 2456 2233 2001 1999 1998 1997 1996 1995 1754 1505 1248  983  710  429  140
 226  511  788 1057 1318 1571 1816 1815 1814 1813 1812 1811 1810 1809 1808 1807 1806 2044 1804 1803 1802 1801 1800 2494 1799 1797 1549 1796 1795 1291 1794 1792 1543 2028 1789 1787 2254 2025 1785 1537 2252 1535 1780 2249 2016 2017 1775 2014 1773 1527 1772 2011 1522 1267 1268 1523 1764 1767 2006 2232 1762 1761 1760 1759 1758 1757 1756 1755 1506 1249  984  711  430  141
 225  510  787 1056 1317 1570 1569 1568 1567 1566 1565 1564 1563 1562 1560 1558 1304 1805 1557 1556 1555 1554 1553 1297 1551 1552 1550 1548 1793 1027 1546 1545 1544 1542 1541 1540 1786 1281 1784 1536 1538 1280 1782 1532 1778 1529 1528  738 1011 1273 1271 1524  452 2007 1519 1001 1266 1262 2235 1763 1515 1514 1513 1512 1511 1510 1509 1508 1507 1250  985  712  431  142
 224  509  786 1055 1316 1315 1314 1313 1312 1311 1310 1309 1308 1307 1042 1559 1561 1041 1303 1301 1300 1299 1298 1296 1295 1293 1294 1292 1547 1290 1028 1289 1288 1287 1286 1284 1283 1282 1019 1279 1014 1278 1779 1533 1531 1276 1530 1012 1272 1774 1526 2240 2010 1005 1264 1518 1265  999 1261 1516 1260 1259 1258 1257 1256 1255 1254 1253 1252 1251  986  713  432  143
 223  508  785 1054 1053 1052 1051 1050 1049 1048 1047  774 1045  493 1039  772 1305 1040 1302 1038 1037 1036 1035 1034 1033 1032 1031 1030 1029  756  757 1025  754 1023 1022 1285 1021 1020  469 1783 1018  746 1277  743  465 1275  737 1274 1010  457 1007 1269 1006 1003  733 1000 1766 1263  728  998  997  996  995  994  993  992  991  990  989  988  987  714  433  144
 222  507  784  783  782  781  780  779  778  777  776 1046  775 1044 1306  494 1043  770  768  488  767  766  765  763  762  761  760  480  759  758  755 1026  753 1024  752  751  470  471  749  748  744 1017 1015  177  740  741  173  462  460 1525 1008 1270  171  734  732 1004  731  730  729  727  726  725  724  723  722  721  720  719  718  717  716  715  434  145
 221  506  505  504  503  502  501  500  499  498  497  496  209  208  773  491  771  769  202  489  487  486  764  485  484  483  482  481  479  478  477  476  475  474  473  472  750  183  468  467  747  745 1016  178  742  464  175  739 1009  736  735  458  169  454  453 1002  451  450  449  448  447  446  445  444  443  442  441  440  439  438  437  436  435  146
 220  219  218  217  216  215  214  213  212  211  210  495  207  492  205  206  204  490  203  201  200  199  198  197  196  195  194  193  192  191  190  189  188  187  186  185  184  182  181  179  180  466  176 1013  174  461  463  459  456  455  172  170  168  167  166  165  164  163  162  161  160  159  158  157  156  155  154  153  152  151  150  149  148  147
