# This puzzle is unsolvable
70
   2    1    3    4    5  549    6  283    7    9   11   12  288   13   14   15   16   20   18  822  295   21  297   25  301  300   26   27   29   30   31   32   33   34   35   36   37   41  317   40  582  316   44  586  319  321  323   46   49   50   51   52   53   54   55   56   57   58   59   60   61   62   63   64   65   66   67   68   69   70
 276  277  278  279  280  282    8  808  284   10  286  287  289  814  556  291   17  293  561   19  823  296  827   23  299  826  568   28  304  305  306  307  308  309  837  310  312   38  315   39   42  583   43   45   47  320  588   48  324  325  326  327  328  329  330  331  332  333  334  335  336  337  338  339  340  341  342  343  344   71
 275  544  545  546  547  281  548  809  552  285  553  554  555  816  817  290  294  560 1070  562  564   22 1075  298  565  567  570  828  571  572  573  574  575  576  578  311  313  838  841  581  314  584  843  587  845  847  589  322  591  592  593  594  595  596  597  598  599  600  601  602  603  604  605  606  607  608  609  610  345   72
 274  541  804 1056  806 1059  810 1058 1060  550 1063  812 1064  815  559  292  557 1069  563  821 1315  820  824   24  303  829  569  302  830  831 1326  832  835 1085 1087  836 1089  579  839  840 1093  318  585  844 1097  846  849  590  850  851  852  853  854  855  856  857  858  859  860  861  862  863  864  865  866  867  868  611  346   73
 543  542  273  805  807 1302 1299  551 1062  811 1306 1305  813 1066 1067  558 1068  818  819 1072 1073  566 1076 1077  825 1078 1079 1080 1081 1082 1788  833 1083  834 1086  577 1332  580 1335 1091  842 1095 1339 1098 1096 1099  848 1100 1101 1102 1103 1104 1105 1106 1107 1108 1109 1110 1111 1112 1113 1114 1115 1116 1117 1118  869  612  347   74
 272  802  803 1054 1300 1057 1537 1303 1061 1540 1307 1065 1769 1308 1309 1312 1313 1314 1071 1550 1074 1316 1551 1318 1320 1321 1323 1324 1785 1559 1325 1561 1084 1564 1330 1088 1567 1090 1092 1337 1336 1094 1338 1574 1340 1341 1342 1343 1344 1345 1346 1347 1348 1349 1350 1351 1352 1353 1354 1355 1356 1357 1358 1359 1360 1119  870  613  348   75
 271  540 1055  801 1536 1301 1763 1538 1765 1539 1541 1543 1770 1310 1311 1546 1547 1548 1549 1778 1552 1553 1317 1319 1554 1555 1556 1558 2007 1560 1789 1562 1329 1563 1792 1565 1566 1333 1334 1798 1797 1571 1572 1573 1575 1576 1577 1578 1579 1580 1581 1582 1583 1584 1585 1586 1587 1588 1589 1590 1591 1592 1593 1594 1361 1120  871  614  349   76
 270  539  800 1053 1298 1534 1535 1764 1304 1766 1768 1772 2200 1542 1990 1773 1993 1774 1776 1777 1997 1779 1780 1781 1782 1783 1322 1557 2004 1786 2218 1790 1327 1328 2220 1331 1793 2226 2224 1569 1570 1799 1800 1801 1802 1803 1804 1805 1806 1807 1808 1809 1810 1811 1812 1813 1814 1815 1816 1817 1818 1819 1820 1595 1362 1121  872  615  350   77
 269  538  799 1051 1052 1297 1762 1984 1986 1767 1987 1988 1771 1544 1992 1545 2204 1775 2206 1995 1996 1998 1999 2000 2001 2002 2003 2005 1784 2010 2006 2421 1791 2009 2011 1794 1568 1795 1796 2016 2017 2018 2019 2020 2021 2022 2023 2024 2025 2026 2027 2028 2029 2030 2031 2032 2033 2034 2035 2036 2037 2038 1821 1596 1363 1122  873  616  351   78
 268  537  798 1050 1296 1533 1983 2196 1985 2197 2198 2199 2201 1989 1991 2202 2407 1994 2207 2410 2208 2209 2210 2211 2212 2213 2214 2215 2419 2008 2216 2616 2619 2222 2426 2013 2225 2427 2014 2227 2228 2229 2230 2231 2232 2233 2234 2235 2236 2237 2238 2239 2240 2241 2242 2243 2244 2245 2246 2247 2248 2039 1822 1597 1364 1123  874  617  352   79
 267  536  797 1295 1294 1532 1761 1982 1979 2195 2400 2402 2403 2404 2405 2203 2408 2791 2603 2605 2606 2412 2413 2414 2415 2416 2417 2418 2801 1787 2618 2422 2423 2221 2424 2012 2015 2809 2623 2430 2431 2432 2433 2434 2435 2436 2437 2438 2439 2440 2441 2442 2443 2444 2445 2446 2447 2448 2449 2450 2249 2040 1823 1598 1365 1124  875  618  353   80
 266  535  796 1049 1531 1530 1760 2398 2194 2596 2401 2597 2598 2599 2600 2406 2789 2409 2205 2411 2793 2607 2608 2609 2610 2611 2799 2612 2613 2217 2219 2615 2617 2807 2806 2223 2808 2429 2428 2626 2813 2627 2628 2629 2630 2631 2632 2633 2634 2635 2636 2637 2638 2639 2640 2641 2642 2643 2644 2451 2250 2041 1824 1599 1366 1125  876  619  354   81
 265  534  795 1048 1293 1759 1981 2193 1980 2399 2595 2784 2785 2786 2787 2602 2601 2790 2792 2604 2794 2795 2974 2796 2797 2798 2978 2800 2802 2420 2803 2804 2985 2984 2425 2988 2621 2622 2811 2625 2624 2814 2815 2816 2817 2818 2819 2820 2821 2822 2823 2824 2825 2826 2827 2828 2829 2830 2645 2452 2251 2042 1825 1600 1367 1126  877  620  355   82
 264  533  794 1047 1292 1529 1756 1757 2192 2397 2783 2964 2965 3136 2967 2788 2968 2969 2970 2971 2972 2973 2975 2976 2977 3148 3149 2980 2981 2614 2982 2983 2805 2986 2987 2620 3157 2989 2990 2991 2992 2993 2994 2995 2996 2997 2998 2999 3000 3001 3002 3003 3004 3005 3006 3007 3008 2831 2646 2453 2252 2043 1826 1601 1368 1127  878  621  356   83
 263  532  793 1046 1291 1528 1976 1758 1977 2594 2593 2782 2963 3137 2966 3138 3139 3140 3141 3142 3143 3144 3308 3145 3146 3147 3150 2979 3151 3152 3153 3154 3155 3320 3319 3322 3159 2812 3161 3163 3481 3164 3165 3166 3167 3168 3169 3170 3171 3172 3173 3174 3175 3176 3177 3178 3009 2832 2647 2454 2253 2044 1827 1602 1369 1128  879  622  357   84
 262  531  792 1045 1290 1527 2190 1978 2393 2396 2781 2591 2962 3135 3300 3301 3302 3303 3304 3305 3306 3462 3307 3309 3310 3311 3312 3313 3314 3315 3316 3317 3318 3156 3475 3158 2810 3160 3162 3324 3325 3326 3327 3329 3330 3332 3487 3333 3334 3335 3336 3337 3338 3339 3340 3179 3010 2833 2648 2455 2254 2045 1828 1603 1370 1129  880  623  358   85
 261  530  791 1044 1289 1526 1755 1975 2191 2189 3132 2592 2780 3134 3299 3456 3457 3458 3459 3460 3461 3609 3463 3464 3465 3466 3467 3468 3469 3470 3471 3472 3473 3474 3476 3321 3624 3323 3479 3480 3628 3482 3328 3484 3485 3331 3633 3488 3489 3490 3491 3492 3493 3494 3341 3180 3011 2834 2649 2456 2255 2046 1829 1604 1371 1130  881  624  359   86
 260  529  790 1043 1288 1524 1525 2395 2394 2188 2590 2779 2961 3133 3298 3455 3604 3605 3606 3607 3747 3608 3610 3611 3612 3613 3614 3615 3616 3617 3618 3619 3620 3621 3622 3895 3762 3477 3625 3626 3766 3629 3483 3631 3632 3772 3486 3904 3636 3637 3638 3639 3640 3495 3342 3181 3012 2835 2650 2457 2256 2047 1830 1605 1372 1131  882  625  360   87
 259  789  527 1042 1286 1287 1752 1974 1754 2392 2589 2960 2958 3297 3451 3454 3603 3744 3745 3746 3878 3748 3749 3750 3751 3752 3753 3754 3755 3756 3757 3758 3759 3760 3761 3623 3764 3478 4019 3765 3768 3767 3630 4139 3769 3771 3635 3634 3776 3777 3908 3778 3641 3496 3343 3182 3013 2836 2651 2458 2257 2048 1831 1606 1373 1132  883  626  361   88
 258  528  788 1041 1285 1753 1751 1973 2187 2390 2391 2586 3130 2588 2587 3453 3602 3743 3876 3877 4001 3879 3881 4004 3882 3883 3884 3885 3886 3887 3888 3889 3890 3891 3892 4016 3763 3894 3898 3899 4021 3900 4024 3902 3901 4026 4027 3773 3775 3774 3906 3779 3642 3497 3344 3183 3014 2837 2652 2459 2258 2049 1832 1607 1374 1133  884  627  362   89
 526  525  787 1040 1284 1523 1522 1972 2186 2185 2778 2959 2777 2954 3292 3295 3601 3742 3875 4000 4002 4117 4003 3880 4005 4006 4007 4008 4009 4010 4011 4012 4013 4014 4130 4015 3893 3896 4018 4020 4137 3627 4022 4023 4025 3770 3905 3903 4029 3907 3909 3780 3643 3498 3345 3184 3015 2838 2653 2460 2259 2050 1833 1608 1375 1134  885  628  363   90
 257  786  784  785 1521 1750 1749 1971 2184 2389 2776 3129 3131 2957 3294 3296 3600 3741 3874 3999 4116 4118 4119 4120 4227 4121 4122 4123 4124 4125 4126 4127 4128 4129 4238 4017 4131 4133 4134 3897 4136 4244 4138 4140 4141 4142 4143 4028 4144 4030 3910 3781 3644 3499 3346 3185 3016 2839 2654 2461 2260 2051 1834 1609 1376 1135  886  629  364   91
 256  523  524 1038 1039 1283 1520 2183 1969 2388 2953 2956 2775 3293 3450 3452 3599 3740 3873 3998 4115 4224 4225 4325 4226 4228 4229 4230 4231 4232 4233 4234 4235 4236 4132 4237 4239 4240 4241 4135 4242 4243 4245 4344 4438 4247 4248 4250 4145 4031 3911 3782 3645 3500 3347 3186 3017 2840 2655 2462 2261 2052 1835 1610 1377 1136  887  630  365   92
 253  255  254  782 1282 1967 1748 1747 1970 2182 2585 2955 2774 3127 3128 3449 3598 3738 3739 3997 4114 4223 4324 4416 4326 4327 4328 4329 4330 4331 4332 4333 4334 4335 4336 4337 4338 4339 4431 4340 4341 4343 4342 4346 4246 4347 4249 4349 4147 4032 3912 3783 3646 3501 3348 3187 3018 2841 2656 2463 2262 2053 1836 1611 1378 1137  888  631  366   93
 522  783  251 1037 1517 1518 1519 2180 1968 2772 2770 2583 2773 3126 3291 3448 3596 3597 3872 3996 4113 4222 4322 4323 4417 4418 4419 4420 4421 4422 4423 4424 4425 4426 4427 4428 4429 4590 4430 4514 4660 4435 4592 4345 4519 4350 4146 4033 4348 4034 3913 3784 3647 3502 3349 3188 3019 2842 2657 2464 2263 2054 1837 1612 1379 1138  889  632  367   94
 252 1278  520 1281  781 1746 2386 2181 2385 2383 2387 2951 2771 3125 3290 3737 3870 3447 3871 3995 4112 4221 4321 4415 4500 4501 4502 4503 4504 4505 4506 4507 4508 4509 4510 4511 4512 4513 4515 4432 4433 4661 4436 4593 4594 4254 4439 4251 4253 4035 3914 3785 3648 3503 3350 3189 3020 2843 2658 2465 2264 2055 1838 1613 1380 1139  890  633  368   95
 249 1035  521 1030 1036 1279 1516 2179 2384 2178 2584 2582 2952 3289 3123 3124 3446 3595 3594 3994 4110 4111 4319 4220 4320 4576 4577 4578 4579 4580 4581 4582 4583 4584 4585 4586 4587 4589 4655 4517 4516 4518 4437 4434 4520 4352 4252 4440 4148 4036 3915 3786 3649 3504 3351 3190 3021 2844 2659 2466 2265 2056 1839 1614 1381 1140  891  634  369   96
 519  250 1514 1515 1280 1744 1966 1745 2177 2581 2579 2950 2769 3444 2949 3288 3592 3736 3866 3869 4219 4218 4413 4498 4499 4574 4575 4644 4645 4646 4647 4649 4650 4651 4711 4763 4652 4713 4588 4591 4716 4720 4718 4595 4521 4441 4351 4255 4149 4150 3916 3787 3650 3505 3352 3191 3022 2845 2660 2467 2266 2057 1840 1615 1382 1141  892  635  370   97
 780  518 1034  779 1033 1277 1963 1965 1964 2176 2580 2382 2768 3285 3287 3443 3733 3867 3734 3868 3992 4411 4109 4414 4412 4497 4643 4704 4705 4706 4648 4707 4709 4761 4710 4654 4712 4764 4766 4658 4768 4663 4659 4596 4522 4523 4353 4256 4151 4037 4038 3917 3651 3506 3353 3192 3023 2846 2661 2468 2267 2058 1841 1616 1383 1142  893  636  371   98
 248  517 1031  778 1275 1276 1962 1743 2577 2381 2948 3121 2944 3122 2947 3284 3286 3735 3593 3993 4108 4216 4107 4318 4496 4572 4573 4642 4756 4758 4801 4708 4760 4805 4804 4807 4762 4844 4715 4656 4719 4662 4597 4524 4442 4443 4354 4152 4039 3918 3789 3788 3652 3507 3354 3193 3024 2847 2662 2469 2268 2059 1842 1617 1384 1143  894  637  372   99
 247  516  777 1029 1273 1513 1512 2175 1742 2174 2767 2578 2946 3120 3442 3445 3591 3732 3991 3865 4106 4317 4217 4409 4495 4570 4641 4703 4702 4755 4836 4759 4802 4803 4653 4765 4714 4809 4870 4657 4811 4770 4598 4599 4444 4445 4258 4257 4153 4040 3919 3790 3653 3508 3355 3194 3025 2848 2663 2470 2269 2060 1843 1618 1385 1144  895  638  373  100
 246  515 1028 1027 1032 1741 1510 1961 2379 2764 2380 2766 3118 2945 3282 3119 3283 3863 3729 3990 4105 4215 4410 4316 4494 4571 4640 4701 4754 4757 4800 4837 4838 4839 4806 4867 4841 4767 4808 4810 4769 4717 4721 4526 4525 4356 4355 4259 4154 4041 3920 3791 3654 3509 3356 3195 3026 2849 2664 2471 2270 2061 1844 1619 1386 1145  896  639  374  101
 245  514  775  776 1740 1509 1511 1739 1960 2574 2173 2576 3117 3116 2575 3730 3731 3864 3987 3988 3989 4214 4315 4408 4493 4639 4700 4753 4798 4799 4835 4864 4865 4866 4868 4840 4842 4871 4845 4812 4771 4722 4664 4601 4600 4446 4357 4260 4155 4042 3921 3792 3655 3510 3357 3196 3027 2850 2665 2472 2271 2062 1845 1620 1387 1146  897  640  375  102
 244  513  774 1026 1274 1271 2171 1736 1959 2762 2943 2573 2765 3439 3440 3441 3589 3590 3862 3986 4104 4213 4314 4407 4492 4569 4638 4699 4752 4797 4863 4884 4883 4885 4886 4887 4888 4869 4846 4813 4723 4725 4665 4666 4530 4448 4447 4261 4156 4043 3922 3793 3656 3511 3358 3197 3028 2851 2666 2473 2272 2063 1846 1621 1388 1147  898  641  376  103
 243  512  772  773 1508 1272 1958 1957 2376 2170 2378 2760 2763 3279 3588 3586 3438 3728 3861 4103 4212 4313 4312 4406 4491 4568 4637 4698 4751 4833 4832 4834 4862 4898 4889 4872 4847 4843 4814 4724 4774 4772 4667 4528 4527 4449 4358 4359 4157 4044 3923 3794 3657 3512 3359 3198 3029 2852 2667 2474 2273 2064 1847 1622 1389 1148  899  642  377  104
 242  511 1025 1024 1270 1737 1956 1955 2761 2172 2572 2377 3115 3281 3113 3437 3587 3727 3860 3985 4102 4211 4405 4490 4489 4567 4636 4697 4795 4796 4831 4882 4895 4896 4897 4899 4890 4873 4848 4816 4668 4603 4669 4604 4602 4531 4262 4159 4263 4045 3924 3795 3658 3513 3360 3199 3030 2853 2668 2475 2274 2065 1848 1623 1390 1149  900  643  378  105
 241  510  771 1023 1269 1507 2169 2168 2375 2570 2569 2571 2941 3280 3436 3585 3726 3983 3725 3984 4101 4210 4311 4404 4566 4565 4635 4696 4750 4794 4860 4861 4881 4894 4893 4892 4876 4891 4874 4773 4815 4775 4605 4671 4450 4361 4364 4363 4158 4047 4046 3796 3659 3514 3361 3200 3031 2854 2669 2476 2275 2066 1849 1624 1391 1150  901  644  379  106
 240  509  770 1268 1505 1735 1738 2373 1734 2167 2372 3114 2940 2942 3278 3435 3583 3584 3859 3982 4100 4209 4310 4403 4488 4564 4634 4695 4749 4793 4830 4859 4880 4879 4878 4877 4853 4875 4850 4849 4817 4776 4727 4606 4670 4451 4360 4264 4161 4160 4048 3925 3660 3515 3362 3201 3032 2855 2670 2477 2276 2067 1850 1625 1392 1151  902  645  380  107
 239  508  769 1022 1267 1504 1506 1733 1954 2374 2758 2759 2939 3112 3277 3433 3434 3724 3858 3981 4099 4208 4309 4402 4486 4487 4633 4694 4748 4792 4828 4829 4857 4856 4824 4855 4854 4852 4851 4818 4777 4728 4726 4672 4532 4529 4452 4265 3928 4162 3798 3799 3797 3516 3363 3203 3202 2856 2671 2478 2277 2068 1851 1626 1393 1152  903  646  381  108
 238  507  768 1021 1266 1503 1732 1953 2166 2371 2568 2757 2938 3111 3276 3582 3581 3857 3856 3980 4098 4207 4308 4401 4485 4563 4632 4693 4747 4746 4827 4826 4858 4825 4823 4784 4822 4821 4820 4819 4778 4607 4534 4533 4535 4453 4267 4362 4266 3926 3927 3801 3661 3517 3364 3204 3033 2858 2857 2672 2278 2069 1852 1627 1394 1153  904  647  382  109
 237  506  767 1020 1265 1502 1731 1952 2165 2370 2567 2756 2937 3110 3275 3432 3723 3721 3722 3855 4097 4206 4307 4400 4562 4561 4631 4692 4790 4789 4791 4741 4788 4786 4785 4783 4782 4735 4781 4780 4730 4729 4673 4608 4536 4454 4365 4268 4050 4049 3800 3662 3518 3519 3205 3365 3366 3034 2674 2479 2279 2070 1853 1628 1395 1154  905  648  383  110
 236  505  766 1019 1264 1501 1730 1951 2164 2369 2566 2755 2936 3109 3274 3431 3580 3720 3854 3979 4096 4205 4306 4399 4483 4484 4630 4691 4745 4743 4686 4623 4740 4684 4739 4738 4736 4680 4734 4733 4779 4731 4674 4610 4609 4455 4366 4269 4163 3929 3930 3665 3520 3663 3367 3037 3036 3035 2859 2480 2280 2071 1854 1629 1396 1155  906  649  384  111
 235  504  765 1018 1263 1500 1729 1950 2163 2368 2565 2754 2935 3108 3273 3430 3578 3579 3978 4095 4204 4304 4203 4305 4482 4560 4629 4690 4744 4689 4742 4685 4622 4787 4683 4737 4681 4617 4679 4678 4732 4677 4612 4675 4456 4270 4457 4165 4164 4051 3931 3664 3803 3038 3207 3206 2675 2673 2482 2481 2281 2072 1855 1630 1397 1156  907  650  385  112
 234  503  764 1017 1262 1499 1728 1949 2162 2367 2564 2753 2934 3107 3429 3577 3576 3851 3719 3977 3853 4094 4303 4398 4481 4628 4627 4556 4554 4626 4687 4552 4624 4621 4620 4682 4619 4618 4616 4615 4614 4676 4611 4539 4537 4538 4367 4054 4371 4053 3934 3932 3933 3368    0 2861 3039 2860 2676 2483 2282 2073 1856 1631 1398 1157  908  651  386  113
 233  502  763 1016 1261 1498 1727 1948 2161 2366 2563 2752 2933 3106 3272 3428 3427 3718 3852 3976 4093 4202 4302 4480 4397 4559 4557 4555 4476 4474 4388 4553 4551 4550 4549 4548 4547 4545 4544 4543 4542 4613 4541 4462 4459 4540 4370 4369 4272 4271 4166 3804 3805 4052 3521 3041 3208 3040 2677 2484 2283 2074 1857 1632 1399 1158  909  652  387  114
 232  501  762 1015 1260 1497 1726 1947 2160 2365 2562 2751 2932 3270 3271 3426 3575 3717 3850 3975 4092 4201 4396 4395 4393 4558 4479 4477 4625 4688 4475 4473 4472 4471 4470 4469 4468 4546 4466 4464 4375 4374 4460 4461 4458 4373 4372 4167 4055 4273 3666 3369 3802 3524 3370 3523 2863 2862 2678 2485 2284 2075 1858 1633 1400 1159  910  653  388  115
 231  500  761 1014 1259 1496 1725 1946 2159 2364 2561 2750 2931 3105 3104 3425 3574 3849 3848 3974 4091 4200 4301 4196 4394 4297 4478 4391 4390 4387 4292 4385 4384 4383 4382 4287 4381 4467 4378 4465 4377 4376 4463 4175 4280 4278 4368 4275 4274 4168 4057 3935 3667 3808 3522 3209 3210 2864 2679 2486 2285 2076 1859 1634 1401 1160  911  654  389  116
 230  499  760 1013 1258 1495 1724 1945 2158 2363 2560 2749 2930 3103 3269 3268 3715 3714 3716 3973 4090 4199 4299 4298 4194 4392 4296 4295 4389 4291 4189 4386 4290 4289 4288 4286 4183 4380 4181 4283 4180 4281 4067 4279 4064 4277 4173 4276 4172 3936 3810 3669 3668 3525 3371 3373 3211 2865 2680 2487 2286 2077 1860 1635 1402 1161  912  655  390  117
 229  498  759 1012 1257 1494 1723 1944 2157 2362 2559 2748 2929 3102 3267 3424 3573 3713 3847 3972 4089 4198 4300 4195 3838 4192 4080 4191 4294 4190 4188 4077 4187 4185 3955 4072 4184 4182 4284 4285 4379 4176 4178 4065 3946 3944 4174 4061 4171 4170 3806 3937 3374 3213 3212 3372 3042 3043 2681 2488 2287 2078 1861 1636 1403 1162  913  656  391  118
 228  497  758 1011 1256 1493 1722 1943 2156 2361 2558 2747 2928 3101 3266 3423 3572 3846 3971 4088 4087 4086 4197 4084 4083 4082 4193 4079 3960 4078 4293 3958 4076 4186 4073 3954 4071 4070 3952 4069 4282 4177 4068 3947 4063 4062 3943 4169 3670 3809 4056 3807 4059 3671 3526 3214 2867 2866 2682 2489 2288 2079 1862 1637 1404 1163  914  657  392  119
 227  496  757 1010 1255 1492 1721 1942 2155 2360 2557 2746 2927 3100 3265 3422 3571 3712 3845 3970 3969 3968 3967 3966 4085 3965 3964 4081 3834 3698 3833 3959 3957 3956 3953 3827 3951 3950 3823 4179 3949 3820 3948 3819 3945 3817 3942 4060 4058 3813 3811 3938 3527 3672 3528 3045 3044 2868 2683 2490 2289 2080 1863 1638 1405 1164  915  658  393  120
 226  495  756 1009 1254 1491 1720 1941 2154 2359 2556 2745 2926 3099 3264 3421 3570 3711 3844 3843 3842 3841 3840 3839 3837 3963 3836 3962 3961 3832 3831 3830 3829 4075 4074 3693 3825 3690 3824 3688 3822 4066 3541 3682 3540 3683 3816 3680 3940 3941 3814 3939 3529 3375 3215 3376 3046 2870 2684 2491 2290 2081 1864 1639 1406 1165  916  659  394  121
 225  494  755 1008 1253 1490 1719 1940 2153 2358 2555 2744 2925 3098 3263 3420 3569 3710 3709 3708 3707 3706 3705 3704 3703 3702 3701 3557 3700 3699 3697 3696 3695 3551 3692 3550 3826 3691 3689 3687 3544 3543 3686 3391 3685 3818 3681 3679 3678 3815 3676 3812 3673 3674 3530 3216 2869 3047 2685 2492 2291 2082 1865 1640 1407 1166  917  660  395  122
 224  493  754 1007 1252 1489 1718 1939 2152 2357 2554 2743 2924 3097 3262 3419 3568 3567 3566 3565 3564 3563 3562 3561 3560 3559 3558 3835 3556 3405 3554 3553 3401 3552 3694 3828 3548 3547 3546 3394 3545 3821 3392 3542 3684 3387 3539 3536 3534 3675 3535 3532 3677 3381 3531 3218 3048 2871 2686 2493 2292 2083 1866 1641 1408 1167  918  661  396  123
 223  492  753 1006 1251 1488 1717 1938 2151 2356 2553 2742 2923 3096 3261 3418 3417 3416 3415 3414 3413 3412 3411 3410 3409 3408 3407 3247 3404 3555 3403 3402 3400 3399 3549 3398 3397 3395 3237 3235 3231 3234 3393 3062 3230 3390 3388 3228 3385 3225 3223 3224 3380 3383 3377 3378 3217 2872 2687 2494 2293 2084 1867 1642 1409 1168  919  662  397  124
 222  491  752 1005 1250 1487 1716 1937 2150 2355 2552 2741 2922 3095 3260 3259 3258 3257 3256 3255 3254 3253 3252 3251 3250 3249 3248 3246 3406 3245 3244 3243 3242 3241 3240 3239 3238 3396 3236 3233 3232 3066 2889 3063 3227 2887 3538 3537 3386 3057 3222 3226 3384 3055 3382 3050 3049 2873 2688 2495 2294 2085 1868 1643 1410 1169  920  663  398  125
 221  490  751 1004 1249 1486 1715 1936 2149 2354 2551 2740 2921 3094 3093 3092 3091 3090 3089 3088 3087 3086 3085 3084 3083 3082 3081 3080 3079 3078 3077 3076 3075 3074 3073 3072 3071 3070 3069 3068 3067 3065 3064 2888 2886 2703 3060 2885 3059 2882 2697 3533 3221 3054 3219 3379 3051 2874 2689 2496 2295 2086 1869 1644 1411 1170  921  664  399  126
 220  489  750 1003 1248 1485 1714 1935 2148 2353 2550 2739 2920 2919 2918 2917 2916 2915 2914 2913 2912 2911 2910 2909 2908 2907 2906 2905 2904 2903 2902 2901 2900 2899 2898 2897 2896 2895 2894 2893 2892 2891 2706 3229 3389 2704 3061 2884 2883 3058 2699 2698 3056 3053 3220 3052 2875 2690 2691 2497 2296 2087 1870 1645 1412 1171  922  665  400  127
 219  488  749 1002 1247 1484 1713 1934 2147 2352 2549 2738 2737 2736 2735 2734 2733 2732 2731 2730 2729 2728 2727 2726 2725 2724 2723 2722 2721 2720 2719 2718 2717 2716 2715 2714 2713 2712 2711 2710 2709 2708 2890 2707 2515 2705 2513 2512 2701 2310 2508 2700 2694 2881 2693 2878 2876 2877 2500 2692 2499 2297 1871 1646 1413 1172  923  666  401  128
 218  487  748 1001 1246 1483 1712 1933 2146 2351 2548 2547 2546 2545 2544 2543 2542 2541 2540 2539 2538 2537 2536 2535 2534 2533 2532 2531 2530 2529 2528 2527 2526 2525 2524 2523 2522 2521 2520 2519 2518 2517 2516 2317 2514 2314 2313 2702 2510 2509 2507 2506 2880 2696 2879 2505 2503 2501 2092 2498 2089 2088 1872 1647 1414 1173  924  667  402  129
 217  486  747 1000 1245 1482 1711 1932 2145 2350 2349 2348 2347 2346 2345 2344 2343 2342 2341 2340 2339 2338 2337 2336 2335 2334 2333 2332 2331 2330 2329 2328 2327 2326 2325 2324 2323 2322 2321 2320 2319 2318 2316 2312 1893 2107 2106 2511 2311 2309 2101 2308 2307 2306 2504 2695 2304 2300 2302 2299 2298 1879 1873 1648 1415 1174  925  668  403  130
 216  485  746  999 1244 1481 1710 1931 2144 2143 2142 2141 2140 2139 2138 2137 2136 2135 2134 2133 2132 2131 2130 2129 2128 2127 2126 2125 2124 2123 2122 2121 2120 2119 2118 2117 2116 2115 2114 2113 2112 2111 2110 2315 1894 1668 2104 2105 1889 2102 1887 2100 2099 1884 2097 2305 1658 2303 1878 2094 1423 2090 1650 1874 1649 1416  926  669  404  131
 215  484  745  998 1243 1480 1709 1930 1929 1928 1927 1926 1925 1924 1923 1922 1921 1920 1919 1918 1917 1916 1915 1914 1913 1912 1911 1910 1909 1908 1907 1906 1905 1904 1903 1902 1901 1900 1899 1898 1897 1672 2109 2108 1892 1670 1891 1890 1888 2103 1886 1883 1661 1660 1659 1657 2502 2096 1424 2301 1876 2091 1417 1651 1176 1175  927  670  405  132
 214  483  744  997 1242 1479 1708 1707 1706 1705 1704 1703 1702 1701 1700 1699 1698 1697 1696 1695 1694 1693 1692 1691 1690 1689 1688 1687 1686 1685 1684 1683 1682 1681 1680 1679 1678 1677 1676 1675 1674 1896 1673 1895 1671 1438 1667 1666 1435 1665 1663 1662 1885 2098 1880 2095 1882  939 1654 1655 1877 1425 1653 1875 1182 1177  928  671  406  133
 213  482  743  996 1241 1478 1477 1476 1475 1474 1473 1472 1471 1470 1469 1468 1467 1466 1465 1464 1463 1462 1461 1460 1459 1458 1457 1456 1455 1454 1453 1452 1451 1450 1449 1448 1447 1446 1445 1444 1204 1443 1441 1440 1439 1437 1669 1436 1196 1433 1664 1432 1431 1881 1190 1189 1186 2093 1427 1187 1652 1421  934 1419 1418 1179  672  673  407  134
 212  481  742  995 1240 1239 1238 1237 1236 1235 1234 1233 1232 1231 1230 1229 1228 1227 1226 1225 1224 1223 1222 1221 1220 1219 1218 1217 1216 1215 1214 1213 1212 1211 1210 1209 1208 1207 1206 1205 1203  956 1442 1202 1201 1199 1198 1197 1195 1434 1194 1193 1192 1191  942 1428 1429  686 1185  940 1422  680 1656 1420 1180  933 1178  674  408  135
 211  480  741  994  993  992  991  990  989  988  987  986  985  984  983  982  981  980  979  978  977  976  975  974  973  972  971  970  969  968  967  966  965  964  963  962  961  960  959  958  957  955  954  953 1200  952  951  950  949  948  947  946  945 1430  944 1188  152  422  941  684 1183  935  681  678  676  929  413  677  409  136
 210  479  740  739  738  737  736  735  734  733  732  731  730  729  728  727  726  725  724  723  722  721  720  719  718  717  716  715  714  713  712  711  710  709  708  444  706  442  705  704  703  701  700  699  698  697  696  695  694  693  691  688  428  427  687 1426  943  421  936  419  420  416  418  417  679  930  414  411  412  137
 209  478  477  476  475  474  473  472  471  470  469  468  467  466  465  464  463  462  461  460  459  458  457  456  455  454  453  452  451  450  449  448  447  446  445  443  172  441  440  169  438  702  437  436  435  434  433  432  431  430  692  429  156  690  689  685  154  150  937  938 1184  683  147 1181  932  144  931  410  675  138
 208  207  206  205  204  203  202  201  200  199  198  197  196  195  194  193  192  191  190  189  188  187  186  185  184  183  182  181  180  179  178  177  176  175  174  173  171  707  170  168  439  167  166  165  164  163  162  161  160  159  158  157  426  155  151  425  153  423  424  149  148  682  146  145  143  415  142  141  140  139
