# This puzzle is unsolvable
62
 245    1    3  249    5    7    6    8    9  253   12  255   13  258  493   16  259   18   19   20   21   22   23   24   25   26   27   28   29   30   31   32   33   34   35   36   37   38   39   40   41   42   43   44   45   46   47   48   49   50   51   52   53   54   55   56   57   58   59   60   61   62
 244  481    2    4  484  248  485  250  251  252   11   10  490   15  257  495  261  496  262  263  264  265  266  267  268  269  270  271  272  273  274  275  276  277  278  279  280  281  282  283  284  285  286  287  288  289  290  291  292  293  294  295  296  297  298  299  300  301  302  303  304   63
 480  246  709  928  711  929  712  486  487  488  254   14  718  260  256  720  494  723  497  725  498  499  501  502  503  504  505  506  507  508  509  510  511  512  513  514  515  516  517  518  519  520  521  522  523  524  525  526  527  528  529  530  531  532  533  534  535  536  537  538  305   64
 243  241  479  482  247  706  932  713  714  934  715  489  491   17  492  721  722  942  724  944  726  500  728  729  730  731  732  733  734  735  736  737  738  739  740  741  742  743  744  745  746  747  748  749  750  751  752  753  754  755  756  757  758  759  760  761  762  763  764  539  306   65
 242  478  927  710  707  708 1344  933 1144 1146  716  719  717 1149  938  940  941 1355 1154  943  945  727  946  948  949  950  951  952  953  954  955  956  957  958  959  960  961  962  963  964  965  966  967  968  969  970  971  972  973  974  975  976  977  978  979  980  981  982  765  540  307   66
 240  705  704  926 1141  930  931 1143 1346 1147 1148  937 1351 1352  939 1150 1151 1152 1153 1155 1156 1157  947 1158 1159 1161 1162 1163 1164 1165 1167 1168 1369 1169 1170 1171 1172 1173 1174 1175 1176 1177 1178 1179 1180 1181 1182 1183 1184 1185 1186 1187 1188 1189 1190 1191 1192  983  766  541  308   67
 476  477  475 1140 1139  483 1142 1347 1731 1349 1541  936 1350 1547 1548 1353 1354 1356 1357 1358 1359 1360 1361 1362 1160 1364 1366 1367 1368 1750 1166 1566 1372 1567 1373 1374 1375 1376 1377 1378 1379 1380 1381 1382 1383 1384 1385 1386 1387 1388 1389 1390 1391 1392 1393 1394 1193  984  767  542  309   68
 239  237 1138  925 1137 1343 1345 1728 2080  935 1145 1348 1544 1733 1734 1549 1550 1551 1552 1553 1554 1555 1556 1363 1744 1559 1365 1561 1928 1565 1563 1370 1371 1755 1754 1569 1570 1571 1572 1573 1574 1575 1576 1577 1578 1579 1580 1581 1582 1583 1584 1585 1586 1587 1588 1395 1194  985  768  543  310   69
 236  238  703  924 1342 1540 1538 1542 1730 1543 1910 1545 1546 1732 1735 1736 1737 1738 1739 1740 1741 1742 1743 1557 1558 1747 1560 1748 1562 1564 1930 1751 1568 1933 1934 1756 1757 1758 1759 1760 1761 1762 1763 1764 1765 1766 1767 1768 1769 1770 1771 1772 1773 1774 1589 1396 1195  986  769  544  311   70
 235  474  702  923 1136 1341 1727 1539 1729 1907 1909 2081 1911 1913 1915 1916 2248 1917 1918 1919 1920 1921 1922 1923 1924 1926 1927 2097 2100 2099 1931 1929 1752 1753 2105 1935 1936 1937 1938 1939 1940 1941 1942 1943 1944 1945 1946 1947 1948 1949 1950 1951 1952 1775 1590 1397 1196  987  770  545  312   71
 472  473  701  922 1135 1340 1537 1726 1908 2079 2082 2245 1912 2084 1914 2086 2087 2088 2089 2090 2091 2092 2093 2094 2095 1745 1925 2414 1749 2263 2102 2264 1932 2104 2268 2106 2107 2108 2109 2110 2111 2112 2113 2114 2115 2116 2117 2118 2119 2120 2121 2122 1953 1776 1591 1398 1197  988  771  546  313   72
 234  471  700  921 1134 1339 1536 1725 1906 2244 2400 2399 2083 2085 2247 2251 2405 2252 2407 2253 2254 2255 2256 2257 2258 1746 2096 2260 2415 2098 2101 2568 2103 2266 2269 2572 2271 2426 2272 2273 2274 2275 2276 2277 2278 2279 2280 2281 2282 2283 2284 2123 1954 1777 1592 1399 1198  989  772  547  314   73
 233  470  699  920 1133 1337 1338 1535 1724 1905 2077 2243 2246 2403 2404 2249 2250 2406 2554 2408 2409 2411 2558 2412 2413 2259 2563 2261 2417 2262 2419 2418 2420 2267 2424 2425 2573 2270 2427 2428 2429 2430 2431 2432 2433 2434 2435 2436 2437 2438 2285 2124 1955 1778 1593 1400 1199  990  773  548  315   74
 232  469  919 1132 1534 1131 1723 1722 2078 2242 2398 2549 2401 2402 2550 2551 2552 2553 2693 2556 2557 2410 2697 2560 2700 2561 2564 2416 2565 2567 2265 2421 2569 2423 2422 2709 2710 2712 2574 2575 2576 2577 2578 2579 2580 2581 2582 2583 2584 2439 2286 2125 1956 1779 1594 1401 1200  991  774  549  316   75
 230  468  698  917  697  918 1335 1902 1901 1904 2548 2241 2547 2687 2689 2690 2691 2692 2694 2555 2695 2696 2699 2559 2955 2562 2956 2703 2702 2705 2566 2706 2707 2839 2708 2571 2570 2711 2713 2714 2715 2716 2717 2718 2719 2720 2721 2722 2585 2440 2287 2126 1957 1780 1595 1402 1201  992  775  550  317   76
 466  229  231  916 1334 1130 1336 1903 2239 2240 2073 2397 2688 2686 2820 2821 2822 2823 2824 2825 2826 2827 2698 2828 2829 2831 2832 2701 2704 2833 2835 2837 2838 2840 2841 3079 2964 2843 2844 2845 2846 2847 2848 2849 2850 2851 2852 2723 2586 2441 2288 2127 1958 1781 1596 1403 1202  993  776  551  318   77
 465  467  696  695 1129 1127 1533 1532 1721 2076 2396 2545 2546 2819 2818 2944 2945 2946 2947 2948 2949 2950 2951 2952 2830 2953 2954 3070 2834 2959 2836 2960 2961 2962 2963 3186 2842 2966 2967 2968 2969 2970 2971 2972 2973 2974 2853 2724 2587 2442 2289 2128 1959 1782 1597 1404 1203  994  777  552  319   78
 228  464  694 1128 1530 1333 1719 1531 1720 2075 2074 2395 2544 2685 2943 3060 3061 3168 3167 3062 3064 3065 3066 3067 3068 3069 3071 3177 3178 2958 3073 3074 3076 3077 3078 3187 2965 3081 3082 3083 3084 3085 3086 3087 3088 2975 2854 2725 2588 2443 2290 2129 1960 1783 1598 1405 1204  995  778  553  320   79
 227  226  914  915 1126 1529 1717 1897 1900 2072 2238 2394 2543 2684 2817 2942 3058 3059 3169 3063 3171 3172 3173 3174 3175 3176 3072 2957 3179 3180 3181 3075 3183 3184 3185 3080 3188 3189 3288 3190 3191 3192 3193 3194 3089 2976 2855 2726 2589 2444 2291 2130 1961 1784 1599 1406 1205  996  779  554  321   80
 461  463  692  462 1125 1332 1898 1718 2235 1899 2071 2393 2542 2683 2816 2941 3359 3166 3269 3170 3270 3272 3362 3364 3273 3275 3276 3277 3278 3279 3280 3182 3281 3283 3284 3285 3286 3287 3379 3289 3290 3291 3292 3195 3090 2977 2856 2727 2590 2445 2292 2131 1962 1785 1600 1407 1206  997  780  555  322   81
 224  225  691  693 1330 1331  911 1715 2069 2234 2070 2541 2540 2682 2815 3057 3055 3164 3266 3268 3445 3444 3271 3363 3274 3367 3368 3369 3452 3370 3371 3372 3282 3374 3375 3376 3377 3378 3462 3380 3381 3382 3293 3196 3091 2978 2857 2728 2591 2446 2293 2132 1963 1786 1601 1408 1207  998  781  556  323   82
 223  912  910  913 1124 1328 1329 1528 1525 2391 2237 2392 2539 2814 2939 2940 3165 3265 3360 3267 3517 3361 3446 3448 3449 3366 3450 3451 3594 3453 3455 3456 3373 3457 3458 3459 3460 3461 3463 3538 3464 3383 3294 3197 3092 2979 2858 2729 2592 2447 2294 2133 1964 1787 1602 1409 1208  999  782  557  324   83
 460  687  690 1122 1123 1526 1895 1527 1716 1714 2236 2538 2680 2813 3056 2938 3162 3054 3443 3263 3264 3520 3521 3447 3365 3524 3592 3527 3526 3528 3454 3529 3531 3532 3533 3534 3535 3536 3537 3465 3466 3384 3295 3198 3093 2980 2859 2730 2593 2448 2295 2134 1965 1788 1603 1410 1209 1000  783  558  325   84
 222  459  689  688 1121 1894 1893 1713 1896 1327 2233 2232 2387 2809 2681 2679 3159 3262 3163 3161 3519 3589 3700 3590 3522 3525 3591 3652 3593 3595 3597 3530 3598 3599 3600 3601 3602 3603 3604 3539 3385 3386 3296 3199 3094 2981 2860 2731 2594 2449 2296 2135 1966 1789 1604 1411 1210 1001  784  559  326   85
 458  686  908  685  909 1326 1712 1711 2068 2389 2067 1710 2388 2390 2811 2812 2937 2936 3355 3442 3357 3516 3441 3647 3523 3701 3651 3653 3654 3655 3596 3656 3657 3658 3659 3660 3661 3662 3605 3540 3467 3387 3297 3200 3095 2982 2861 2732 2595 2450 2297 2136 1967 1790 1605 1412 1211 1002  785  560  327   86
 221  456  906 1120 1325 1523 1524 1521 1522 2231 2066 2386 2537 2678 2675 2810 3160 3049 3260 3356 3261 3358 3582 3586 3648 3649 3742 3780 3702 3705 3706 3707 3708 3709 3710 3711 3712 3663 3606 3541 3468 3388 3298 3201 3096 2983 2862 2733 2596 2451 2298 2137 1968 1791 1606 1413 1212 1003  786  561  328   87
 457  220 1117  907 1323 1324 1708 1709 1891 2230 2065 2064 2229 2536 2935 2535 3050 2933 3352 3354 3438 3588 3699 3587 3743 3781 3741 3745 3703 3748 3749 3750 3751 3752 3753 3754 3713 3664 3607 3542 3469 3389 3299 3202 3097 2984 2863 2734 2597 2452 2299 2138 1969 1792 1607 1414 1213 1004  787  562  329   88
 455 1118  683  454 1116 1119 1520 1892 1889 1707 2228 2533 2808 2676 3051 3052 3053 3440 3439 3436 3585 3515 3518 3646 3644 3746 3650 3704 3747 3783 3784 3785 3786 3787 3788 3755 3714 3665 3608 3543 3470 3300 3301 3203 3098 2985 2864 2735 2598 2453 2300 2139 1970 1793 1608 1415 1214 1005  788  563  330   89
 684  453  905  903  682 1321 1114  904 1706 2063 2534 2385 2672 2677 2934 2806 2932 3156 3157 3353 3351 3581 3698 3583 3645 3778 3697 3808 3782 3810 3811 3812 3813 3814 3789 3756 3715 3666 3609 3544 3471 3390 3204 3099 3100 2986 2865 2736 2599 2454 2301 2140 1971 1794 1609 1416 1215 1006  789  564  331   90
 452  217  219  216 1319 1517 1888 2062 1890 2061 2384 1887 2381 2532 2807 2382 2931 3047 3158 3258 3513 3437 3584 3512 3696 3779 3744 3807 3809 3828 3830 3831 3832 3815 3790 3757 3716 3667 3610 3545 3472 3391 3302 3205 2987 2988 2866 2737 2600 2455 2302 2141 1972 1795 1610 1417 1216 1007  790  565  332   91
 218  679  451  214 1115  902 1322 1705 1516 2227 2226 2224 2674 2805 3256 2670 2930 3044 3257 3349 3350 3435 3580 3643 3694 3740 3777 3806 3827 3829 3841 3842 3833 3816 3791 3758 3717 3668 3611 3546 3473 3392 3303 3206 3102 3101 2867 2738 2601 2456 2303 2142 1973 1796 1611 1418 1217 1008  791  566  333   92
 213  680  678  901  681 1519 1515 2225 2060 2059 2380 2803 2531 2928 2673 2669 2671 3259 3048 3154 3432 3433 3641 3695 3693 3739 3776 3805 3826 3840 3839 3843 3834 3817 3792 3759 3718 3669 3612 3547 3474 3393 3304 3207 2989 2868 2869 2602 2457 2458 2304 2143 1974 1797 1612 1419 1218 1009  792  567  334   93
 450  215 1113  900 1112 1320 1514 1886 1884 1885 2221 2383 2530 2528 2802 2529 3155 3255 2926 3430 3431 3579 3511 3642 3640 3738 3775 3804 3825 3838 3837 3836 3835 3818 3793 3760 3719 3670 3613 3548 3475 3394 3305 3208 3103 2990 2740 2739 2603 2459 2305 2144 1975 1798 1613 1420 1219 1010  793  568  335   94
 212  449  899 1111 1318 2055 1703 1883 2223 1518 2058 2377 1880 2804 2927 2378 2801 3046 3254 3434 3507 3514 3578 3639 3692 3737 3774 3803 3824 3823 3822 3821 3820 3819 3794 3761 3720 3671 3614 3549 3476 3395 3306 3209 3104 2991 2870 2741 2604 2460 2306 2145 1976 1799 1614 1421 1220 1011  794  569  336   95
 211  448  677  897  898 1317 1316 1702 2057 2053 2222 2527 2799 2923 2379 3045 3153 2929 3506 3348 3347 3510 3509 3638 3691 3736 3773 3802 3801 3800 3799 3798 3797 3796 3795 3762 3721 3672 3615 3550 3477 3396 3307 3210 3105 2993 2992 2742 2606 2605 2307 2146 1977 1800 1615 1422 1221 1012  795  570  337   96
 209  210  447  676 1110 1315 1704 1701 1512 2051 2665 2056 2667 2668 3042 3041 3343 3150 3346 3253 3345 3576 3508 3637 3690 3735 3772 3771 3770 3769 3768 3767 3766 3765 3764 3763 3722 3673 3616 3551 3478 3397 3308 3211 3106 2871 2872 2744 2743 2461 2308 2147 1978 1801 1616 1423 1222 1013  796  571   97   98
 446  445  675  896 1109 1314 1513 1881 2219 2220 2376 2218 2797 2054 2800 3043 3151 3152 3248 3252 3429 3575 3577 3636 3689 3734 3733 3732 3731 3730 3729 3728 3727 3726 3725 3724 3723 3674 3617 3552 3479 3398 3309 3213 3212 3107 2994 2873 2607 2462 2309 2148 1979 1802 1617 1424 1223 1014  797  572  339  338
 208  674  895  894 1108 1313 1700 1511 2052 1882 2049 2374 2925 2375 2526 2924 2798 3250 3251 3428 3504 3505 3574 3635 3688 3687 3686 3685 3684 3683 3682 3681 3680 3679 3678 3677 3676 3675 3618 3553 3480 3399 3310 3108 2995 2996 2874 2745 2608 2310 2149 1803 2312 1805 1425 1804 1224 1015  799  798  340   99
 207  444  673  893 1107 1312 1510 1699 1698 2524 2216 2523 2521 2217 2525 2922 3038 3148 3249 3344 3342 3427 3573 3634 3633 3632 3631 3630 3629 3628 3627 3626 3625 3624 3623 3622 3621 3620 3619 3554 3481 3400 3311 3214 3110 2875 2876 2746 2465 2464 1620 2150 1980 2151 1981 1618 1225 1017 1016  573  341  100
 206  670  442  672 1106 1311 1509 1697 1877 2214 1878 2372 2373 2662 2666 3149 2796 3040 3039 3340 3426 3503 3572 3571 3570 3569 3568 3567 3566 3565 3564 3563 3562 3561 3560 3559 3558 3557 3556 3555 3482 3401 3312 3215 2997 3109 2877 2609 2747 2463 2313 1983 1428 1982 1426 1427 1227 1226  801  574  576  575
 205  892  669  443 1105 1506 1696 1508 2215 2663 2520 2517 1879 2794 2664 2522 3146 3247 3341 3339 3425 3502 3501 3500 3499 3498 3497 3496 3495 3494 3493 3492 3491 3490 3489 3488 3487 3486 3485 3484 3483 3402 3313 3216 3111 2998 2878 2612 2610 2611 2311 2152 2155 1806 1619 1229 1228  802 1018  800  578  343
 204  441  671  891 1507 1505 1310 1695 2212 2048 2368 2656 2793 2920 3035 3037 3147 3145 3245 3246 3424 3423 3422 3421 3420 3419 3418 3417 3416 3415 3414 3413 3412 3411 3410 3409 3408 3407 3406 3405 3404 3403 3314 3217 3112 2999 2879 2748 2613 2466 2467 2153 1985 2316 1429 1807 1622  804  577  342  101  102
 203  440  666 1102 1103  668 1503 1694 2050 1876 1691 2921 2519 2659 2371 3143 3036 2919 3144 3338 3337 3336 3335 3334 3333 3332 3331 3330 3329 3328 3327 3326 3325 3324 3323 3322 3321 3320 3319 3318 3317 3316 3315 3218 3113 3000 2880 2751 2749 2750 1987 1984 2314 1623 1808 1430 1019 1020 1021  346  344  345
 439  667  437  890 1309 1104 1504 1692 1873 1875 2045 2213 2369 2516 2918 2658 3034 2917 3244 3243 3242 3241 3240 3239 3238 3237 3236 3235 3234 3233 3232 3231 3230 3229 3228 3227 3226 3225 3224 3223 3222 3221 3220 3219 3114 3001 2881 2614 2468 2315 2470 1988 2318 1986 1809 1431 1230  803  805  579  105  103
 201  200  438 1101  886 1308  889 1693 1306 2211 2047 2370 2795 2660 2661 2791 2790 3142 3030 3139 3028 3138 3137 3136 3135 3134 3133 3132 3131 3130 3129 3128 3127 3126 3125 3124 3123 3122 3121 3120 3119 3118 3117 3116 3004 3115 2882 2752 2615 2469 2319 2156 1625 1624 1621 1433 1231 1022  806  347  104  106
 199  665 1305  888 1501 1307 1502 1874 2046 2208 2518 2210 2367 2657 2792 2914 2916 3141 3029 3140 2909 3027 3026 3025 3024 3023 3022 3021 3020 3019 3018 3017 3016 3015 3014 3013 3012 3011 3010 3009 3008 3007 3006 3005    0 3002 3003 2753 2616 2471 2317 1990 1810 2154 1432 1626 1232 1023  807  580  348  107
 198 1099  202 1100 1096 1687 1690 1870 1500 1871 1689 2044 2366 2788 3032 2915 3033 3031 2911 2910 2908 2781 2907 2906 2905 2904 2903 2902 2901 2900 2899 2898 2897 2896 2895 2894 2893 2892 2891 2890 2889 2888 2887 2886 2885 2884 2883 2754 2617 2472 2157 1989 1811 1812 1627 1434 1233 1024  582  581  349  108
 435  436  662  664 1303 1097  887 1869 1872 2042 2363 2365 2209 2514 2655 2653 2913 2912 2649 2648 2782 2780 2645 2779 2778 2777 2776 2775 2774 2773 2772 2771 2770 2769 2768 2767 2766 2765 2764 2763 2762 2761 2760 2759 2758 2757 2756 2755 2618 2473 2320 2158 1814 1813 1628 1435 1234 1025  808  583  350  109
 197  196  434  885 1304 1301 1498 2206 1866 2513 2043 2515 2789 2201 2358 2787 2786 2785 2650 2783 2504 2503 2646 2644 2643 2642 2641 2640 2639 2638 2637 2636 2635 2634 2633 2632 2631 2630 2629 2628 2627 2626 2625 2624 2623 2622 2621 2620 2619 2474 2321 1991 2159 1815 1629 1436 1235 1026  809  584  351  110
 194  195 1095  433  663 1098  884 1688 1867 2364 2207 2361 2362 2512 2652 2651 2357 2507 2784 2505 2647 2195 2351 2501 2500 2499 2498 2497 2496 2495 2494 2493 2492 2491 2490 2489 2488 2487 2486 2485 2484 2483 2482 2481 2480 2479 2478 2477 2476 2475 2322 2160 1993 1816 1630 1437 1236 1027  810  585  352  111
 431  432  883  882  661 2040 1499 1868 1685 2036 2205 2511 2200 2510 2654 2509 2355 2508 2506 2196 2354 2352 2350 2502 2349 2348 2347 2346 2345 2344 2343 2342 2341 2340 2339 2338 2337 2336 2335 2334 2333 2332 2331 2330 2329 2328 2327 2326 2325 2324 2323 2161 1992 2162 1631 1438 1237 1028  811  586  353  112
 659  430 1094  880 1300 1686 1302 1299 2038 2034 2039 1496 2204 2359 2033 2199 2198 1855 2356 2197 2353 2192 2025 2191 2190 2189 2188 2187 2186 2185 2184 2183 2182 2181 2180 2179 2178 2177 2176 2175 2174 2173 2172 2171 2170 2169 2168 2167 2166 2165 2164 2163 1994 1817 1632 1439 1238 1029  812  587  354  113
 660  657  881  879 1298 1497 1495 1865 1684 1287 2041 1677 2203 1859 2360 1856 2030 1853 1854 2026 2027 2193 1851 2024 2023 2022 2020 1845 2018 1843 2017 2016 2015 2014 2013 2012 2011 2010 2009 2008 2007 2006 2005 2004 2003 2002 2001 2000 1999 1998 1997 1996 1995 1818 1633 1440 1239 1030  813  588  355  114
 191  193  656 1092 1093 1494 1492 1486 1678 1864 2037 2035 1860 1858 2031 1673 2029 2028 1671 1670 2194 1850 1666 1849 1848 1846 2021 1844 2019 1842 1659 1841 1840 1839 1838 1837 1836 1835 1834 1833 1832 1831 1830 1829 1828 1827 1826 1825 1824 1823 1822 1821 1820 1819 1634 1441 1240 1031  814  589  356  115
 190  192  429  658 1490 1683 1297 1682 1493 1863 1862 2202 1489 1676 1484 1675 2032 1674 1479 1852 1279 1669 1668 1667 1665 1847 1664 1662 1661 1469 1660 1658 1657 1656 1655 1654 1653 1652 1651 1650 1649 1648 1647 1646 1645 1644 1643 1642 1641 1640 1639 1638 1637 1636 1635 1442 1241 1032  815  590  357  116
 188  655  877  878 1091 1090 1295 1491 1488 1680 1861 1681 1487 1485 1079 1483 1672 1482 1480 1478 1477 1278 1476 1475 1474 1472 1471 1273 1470 1270 1468 1467 1466 1465 1464 1463 1462 1461 1460 1459 1458 1457 1456 1455 1454 1453 1452 1451 1450 1449 1448 1447 1446 1445 1444 1443 1242 1033  816  591  358  117
 187  428  189  654  876 1296 1289 1294 1292 1291 1679  868 1288 1286 1857 1282 1077 1481 1075 1281 1072 1280 1277 1276 1274 1473 1663 1272 1063 1269 1062 1268 1267 1266 1265 1264 1263 1262 1261 1260 1259 1258 1257 1256 1255 1254 1253 1252 1251 1250 1249 1248 1247 1246 1245 1244 1243 1034  817  592  359  118
 424  427  425  875 1088 1089  872 1293 1085 1290 1081  866  864  863 1284 1283  640 1076  860 1074 1071  856 1070 1069 1068 1275  851 1066  850 1065  847 1061 1060 1059 1058 1057 1056 1055 1054 1053 1052 1051 1050 1049 1048 1047 1046 1045 1044 1043 1042 1041 1040 1039 1038 1037 1036 1035  818  593  360  119
 186  423  653  426  873 1086  871  648 1083  645  867  411  643  865  409 1078 1285  861  858 1073  857  633  855  854  398  852  158  397  849 1271  624  846  845  844  843  842  841  840  839  838  837  836  835  834  833  832  831  830  829  828  827  826  825  824  823  822  821  820  819  594  361  120
 652  422  651  650 1087  870  417  647  416  869 1084 1082 1080  642  641  862  638  637  859  635  403  634  401  853  629  630  396 1067  160  626  848  623  622  621  620  619  618  617  616  615  614  613  612  611  610  609  608  607  606  605  604  603  602  601  600  599  598  597  596  595  362  121
 185  421  420  874  418  179  649  177  646  414  413  644  172  410  408  639  407  406  636  405  164  402  632  399  159  395 1064  157  161  156  625  392  391  390  389  388  387  386  385  384  383  382  381  380  379  378  377  376  375  374  373  372  371  370  369  368  367  366  365  364  363  122
 184  183  419  182  181  180  415  178  176  175  174  412  173  171  170  169  168  167  166  404  165  163  162  400  628  631  394  627  155  154  393  153  152  151  150  149  148  147  146  145  144  143  142  141  140  139  138  137  136  135  134  133  132  131  130  129  128  127  126  125  124  123
