# This puzzle is unsolvable
32
   4  125  240  128    9    8    7  130  134  133  136   10   11  458   13   14   16   17   18   20  257  146  261   23   24   26   27   28   29   30   31   32
 126    1    2    6  355    5  248  249  625  137   12  138  632  252   15  459  364  139  141   19   22  145  368  147   25  148  150  151  152  153  154   33
 124  241  452  347  451  242  129  247  246  250  356  251  455  358  360  254  253  140  143   21  144  259  260  262  264  149  265  266  267  268  155   34
 348  350  127  349  122  131  245  352  543  244  354  132  550  135  256  255  363  461  365  258  465  366  367  370  371  470  372  373  374  269  156   35
 236  121    3  444  243  446  699  449  454  626  357  546  547  633  361  460  362  463  142  555  556  466  467  468  369  263  471  472  375  270  157   36
 123  344  346  539  445  540  353  453  450  703  548  456  628  549  707  359  551  553  554  711  464  713  557  721  469  562  559  473  376  271  158   37
 447  120  237  118  448  624  700  544  351  701  545  631  630  457  634  552  635  712  636  714  779  558  644  639  641  560  564  645  378  377  159   38
 239  235  342  238  622  542  623  702  769  771  629  830  704  773  708  775  777  637  462  780  638  783  640  716  784  561  477  563  272  160  161   39
 119  234  341  443  345  541  538  627  768  770  881  705  884  832  774  706  838  887  839  841  840  647  891  476  565  642  643  474  475  273   40  162
 232  536  233  343  621  698  696  767  828  829  831  833  962  883  837  778  834  836  781  933  893  717  715  842  718  380  646  478  379  274  381   42
 114  117  113  340  535  620  537  764  697  766  827  880  882  772  928  890  710  776  889  934  892  782  787  786  719  566  479  648  567  275  163   41
 231  116  441  442  619  618  765  826  824  879  960  924  961  709  885  970  886  966  993  932  843  722  844  788  785  720  649  382  383  276   43   44
 115  227  533  440  534  439  825  617  878  958  876  988  925  927  926  963  888  835  996  992  894  936  723  898  650  569  568  480  279  277  165  164
 337  230  530  614  226  336  532  694  695  877  923  959  922  987  965  964  931  929  968  995  935  792  790  724  900  651  570  385  483  384  280   45
 437  229  111  339  693  529  616  760  761  823  921  918  957  991 1008  930 1012  938  971  895  845  896  789  725  655  652  571  481  281  166  278   46
 109  112  110  338  438  613  763  531  762  822  955 1007 1009  989 1011  967 1010  999  997 1015  939  847  846  850  853  728  387  386  484  654  167   47
 106  108  335  615  436  526  692  691  920  821  919  875  956  990 1019 1022 1018 1014  969  973  976  974  897  857  791  794  572  482  573  282  168  169
 224  228  225  435  434  690  689  759  874  873  954 1005 1003  986 1006 1020  979 1023  994  942  941  899  848  729    0  730  852  849  485  388  283   48
 223  334  333  527  528  758  610  817  820  915  953  983  949 1017  985  980 1001 1000 1013  972  944  901  851  937  656  793  726  576  389  284  170   49
 105  107  332  431  433  611  612  686  755  984  982  871 1002  977  861 1016  863  908 1021  796  975  902  940  732  575  657  653  574  486  171   50   51
 222  221  331  523  432  813  525  688  872  819  869  952  981  917  913  950  947  978  998  855  854  658  739  800  795  577  285  390  487  287  172   52
 104  329  330  430  608  687  609  754  756  757  916  812  951 1004  912  911  909  948  946  943  945  905  581  736  391  659  578  286  173   54   53  175
 103  220  326  429  607  684  524  868  816  870  866  749  674  862  860  907  742  906  803  799  802  858  662  903  733  579  489  488  394  174  176   55
 102  217  101  427  522  753  683  679  814  601  914  865  910  810  808  864  806  805  804  664  801  667  666  738  587  660  490  580  392  288   56   57
 216   99  219  521  327  428  606  818  867  680  676  811  744  595  747  807  672  741  859  856  499  731  798  585  727  740  291  582  393  177  178  293
 100  218  215  520  605  682  685  681  599  815  677  678  596  745  673  809  743  671  591  670  668  502  592  297  737  661  663  498  290  289  180   58
 328  214   98  519  604  517  603  752  600  513  751  748  312  410  675  746  593  594  589  669  501  588  586  492  491  583  396  495   70  494  397  179
 323  325  426  425  516  422  420  602  514  750  314  511  597  510  506  198  503  409  504  307  305  497  797  904  734  496  584   61  395   60  292   59
  97  424  324  320  209  518  515  421  205  417  598  204  415  509  507   75  412  411  197  590  407   74  402  406  735   68  401  296  294  181  295   62
 212  213  322  423  210  319  318  315   85  512  200  202  201  413  313  310  508  505  308  192  304  302  193   71  500  187  400   67  398  182  184  185
  96   93   92  211  321   88   87  419  208  418  316  203  414   80  199  309   77  306  194   76  191  301  190  405  188  186  299  493  403   69   65   63
  95   94   91   90   89  207  206  317   84   86   83   82  416  311   81   79  196  408   78  195   73   72  404  303  665  300  298  189   66  399  183   64
