# This puzzle is unsolvable
36
   1    3  274    5    8    6  144  147  149   10  151   12  150   13  153  155  156   19  289   20   21   22   25  164   24  166   26   28   29   30   31   32   33   34   35   36
 138    2  142  141    4  145  146  401  279  148   11  152   14  405  154   17  409  288  413  158  160  293   23  163  296  295   27  167  168  169  170  171  172  173  174   37
 272  273  271  396  275  397    7  277  623  280  402  403  404  285   16  286  159  157  290  291  414  162  161  294  419  420  534  297  299  300  301  302  303  304  175   38
 137  139  268  395  143  721  278  516  399  283    9  282  281  284  525  523  632  287   18  411  415  292  416  417  165  641  418  298  537  422  423  425  426  305  176   39
 270  140  720  269  514  398  276  624  400  518  520  407  521  408  522  526  633  410  412  527  529  530  531  532  533  642  535  421  743  538  424  539  427  306  177   40
 136  394  512  619  719  621  622  517  723  627  725  519  629  628  822  524   15  634  635  528  636  637  638  639  830  640  643  536  742  645  541  540  428  307  178   41
 135  392  509  511  513  620  812  897  722  515  625  726  406  727  728  631  731  732  733  734  735  736  737  829  738  739  740  834  644  744  646  647  429  308  179   42
 134  510  508  393  811  507  815  814  899  626  816  817  904  820  630  730  821  823  907  824  911  826  831  988  914  741  832  833  746  543  544  542  430  309  180   43
 133  391  267  618  616  718  813  898  810  975 1041  900  818  902  819  729  905  906  981  825  982  827  986  828  989  915  918  836  835  745  916  747  431  310  181   44
 132  389  617  614  615  717  808  896  724  973  974 1102  976  978 1105  979  980 1049 1109  983  908  912  910 1053 1114  913 1054 1055  991  648  649  545  432  311  182   45
 265  390  266  613  716  809  895  893  972  894 1043 1100 1152 1042 1044  903 1155 1104 1047 1050  909 1051 1166  987  917 1206  837  990  919  651  650  546  433  312  183   46
 264  263  387  505  506  715  892 1038 1040  969  971 1153  977  901 1197 1045 1046 1204 1241 1048  985 1111 1162 1161 1113 1115 1057  992 1056  748  652  547  434  313  184   47
 131  388  504  807  714  712  713  891  806  970 1039 1194 1151 1103 1154 1199 1200 1159 1202  984 1156 1110 1163 1117 1059 1058  920  839  751  750  749  548  435  314  185   48
 130  262  502  127  804  611  967  805  968 1150 1101 1149 1196 1231 1157 1232 1158 1106 1203 1108 1052 1112 1207 1265 1116  994 1060  921  842  838  653  549  436  315  186   49
 261  260  126  385  501  503  612  890 1097 1037  966 1099 1198 1260 1280 1282 1107 1239 1160 1205 1237 1167 1263 1164 1063 1165  843  922  996  656  654  655  550  316   51  187
 125  128  384  610  499 1035  803  888 1036 1096 1098 1195 1230 1229 1234 1293 1235 1201 1268 1267 1210 1243 1240 1061  925  997  995  998  840  752  753  551  437  317   50   52
 386  257  383  609  605  711  965  964 1094 1190 1147 1148 1233 1146 1093 1261 1236 1262 1264 1285 1168 1209 1118 1119 1211  993 1062  924  923  844  552  438  439  189  188   53
 258  129  498  123  708  382  800  606 1034 1145  886 1192 1257 1279 1259 1283 1238 1291 1294 1284 1266 1208 1169 1172 1121  841 1064  926  755  754  553  554  440  318  190   54
 259  378  381  255  710  500  887  795  889 1092 1030 1193 1095 1033 1256 1277 1278 1281 1288 1269 1242 1170 1245 1120 1171  999  927 1000  756  659  441  657  320  319  193  191
 122  379  495  802  608  607  709  798  883 1032  879 1189 1228 1258 1255 1226 1290 1292 1289 1272 1270 1244 1217 1213 1212 1065 1001  760  845  660  658  321  556  192  322   55
 124  256  254  497  496  380  961  963  962 1031 1186 1191 1254 1222 1227 1218 1183 1275 1250 1287 1286 1214 1271 1122 1123  849  846 1066  758  757  661  555  443  323   56   57
 252  120  121  376  494  706  604  885  884 1028  881 1225 1224 1090 1182 1188 1221 1295 1251 1247 1248 1215 1175 1128 1068 1125 1067  761  762  850  759  662  196  444  195   58
 253  118  603  799  251  707  801  704  960 1142 1091 1144 1253 1137 1276 1179 1273 1252 1219 1249 1174 1173 1246 1072 1124  929 1003  928  930  847  558  931  664  197   59  324
 117  119  377  705  602  601  796 1143  702  959 1187 1089 1140 1086 1185 1274 1220 1133 1180 1177 1178 1130 1216 1176 1004 1069 1002  665  852  571  848  557  445  559  447  442
 250  249  375  493  492  703  880  797  794  882 1087 1138 1023 1021 1083 1184 1134 1139 1078 1132 1131 1074 1129 1073 1008  859  858 1127  562  764  932  446  666  198  194   60
 116  374  491  600  599 1027  700 1022 1025 1029  956 1088 1084  871 1223 1141 1079 1135 1181 1014 1076 1077 1011 1126 1009 1070 1007 1005  663  851  449  763  448  325  853  329
 115  248  373  490  878  701  792  877 1026  957  874 1085  949 1020 1018 1136 1017  947 1081 1013  861 1075  860 1010  938  937 1071  933  669  564  561  560  668  200  326  201
 114  247  372  489  699  698  793  955  873 1024  953  785  958  948  946 1080 1016  863 1015  945 1012  941  864  942  856  940  857  936  673  328 1006  327   62   61  451  203
 113  246  371  488  598  791  694  876  954  875  952  951  782  868 1019  867 1082  866  777  943  681  776  862  939  677  770  771  565  667  854  934  563  331  453  202   63
 112  245  369  596  597  790  697  695  788  787  786  784  687  872  686  870  869  781  865  944  580  778  774  775  678  772  935  459  766  855  450  566  567  199  765  204
 111  244  368  370  486  595  789  693  480  692  691  690  783  688  950  584  685  780  469  683  779  680  573  679  344  675  674  676  769  568  458  670  671  454  332    0
 243  367  485  487  484  594  592  591  481  589  477  588  689  476  581  471  684  578  468  350  577  576  575  773  574  342  461  570  768  457  456  452   68   64  330   67
 110  241  242  365  593  696  590  479  361  359  478  587  586  354  474  352  682  470  351  579  467  347  463  221  343  572  213  340  569  460  672  207  210  338  208  333
 109  240  366  364  483  363  482  362  233  360  358  357  356  472  582  226  583  225  475  222  349  220  465  466  464  462   78  218  341   77  211  767   69  335  206   66
 108  107  239  238  237  236  235  234   98  232  231  230  229  355  585  227  353  224  223   87  348   85  346   84  217   81  215   79  214  212  336  455   73   65   70  205
 106  105  104  103  102  101  100   99   97   96   95   94   93  228   92  473   91   90   89   88   86   83  219   82  345   80  216  339   76  334   75  337   74  209   72   71
