# This puzzle is unsolvable
69
   2    1    3    4    5    6    7    8    9   10   11   12   13   14   15   16   17   18   19   20   21   22   23   24   25   26   27   28   29   30   31   32   33   34   35   36   37   38   39   40   41   42   43   44   45   46   47   48   49   50   51   52   53   54   55   56   57   58   59   60   61   62   63   64   65   66   67   68   69
 272  273  274  275  276  277  278  279  280  281  282  283  284  285  286  287  288  289  290  291  292  293  294  295  296  297  298  299  300  301  302  303  304  305  306  307  308  309  310  311  312  313  314  315  316  317  318  319  320  321  322  323  324  325  326  327  328  329  330  331  332  333  334  335  336  337  338  339   70
 271  536  537  538  539  540  541  542  543  544  545  546  547  548  549  550  551  552  553  554  555  556  557  558  559  560  561  562  563  564  565  566  567  568  569  570  571  572  573  574  575  576  577  578  579  580  581  582  583  584  585  586  587  588  589  590  591  592  593  594  595  596  597  598  599  600  601  340   71
 270  535  792  793  794  795  796  797  798  799  800  801  802  803  804  805  806  807  808  809  810  811  812  813  814  815  816  817  818  819  820  821  822  823  824  825  826  827  828  829  830  831  832  833  834  835  836  837  838  839  840  841  842  843  844  845  846  847  848  849  850  851  852  853  854  855  602  341   72
 269  534  791 1040 1041 1042 1043 1044 1045 1046 1047 1048 1049 1050 1051 1052 1053 1054 1055 1056 1057 1058 1059 1060 1061 1062 1063 1064 1065 1066 1067 1068 1069 1070 1071 1072 1073 1074 1075 1076 1077 1078 1079 1080 1081 1082 1083 1084 1085 1086 1087 1088 1089 1090 1091 1092 1093 1094 1095 1096 1097 1098 1099 1100 1101  856  603  342   73
 268  533  790 1039 1280 1281 1282 1283 1284 1285 1286 1287 1288 1289 1290 1291 1292 1293 1294 1295 1296 1297 1298 1299 1300 1301 1302 1303 1304 1305 1306 1307 1308 1309 1310 1311 1312 1313 1314 1315 1316 1317 1318 1319 1320 1321 1322 1323 1324 1325 1326 1327 1328 1329 1330 1331 1332 1333 1334 1335 1336 1337 1338 1339 1102  857  604  343   74
 267  532  789 1038 1279 1512 1513 1514 1515 1516 1517 1518 1519 1520 1521 1522 1523 1524 1525 1526 1527 1528 1529 1530 1531 1532 1533 1534 1535 1536 1537 1538 1539 1540 1541 1542 1543 1544 1545 1546 1547 1548 1549 1550 1551 1552 1553 1554 1555 1556 1557 1558 1559 1560 1561 1562 1563 1564 1565 1566 1567 1568 1569 1340 1103  858  605  344   75
 266  531  788 1037 1278 1511 1736 1737 1738 1739 1740 1741 1742 1743 1744 1745 1746 1747 1748 1749 1750 1751 1752 1753 1754 1755 1756 1757 1758 1759 1760 1761 1762 1763 1764 1765 1766 1767 1768 1769 1770 1771 1772 1773 1774 1775 1776 1777 1778 1779 1780 1781 1782 1783 1784 1785 1786 1787 1788 1789 1790 1791 1570 1341 1104  859  606  345   76
 265  530  787 1036 1277 1510 1735 1952 1953 1954 1955 1956 1957 1958 1959 1960 1961 1962 1963 1964 1965 1966 1967 1968 1969 1970 1971 1972 1973 1974 1975 1976 1977 1978 1979 1980 1981 1982 1983 1984 1985 1986 1987 1988 1989 1990 1991 1992 1993 1994 1995 1996 1997 1998 1999 2000 2001 2002 2003 2004 2005 1792 1571 1342 1105  860  607  346   77
 264  529  786 1035 1276 1509 1734 1951 2160 2161 2162 2163 2164 2165 2166 2167 2168 2169 2170 2171 2172 2173 2174 2175 2176 2177 2178 2179 2180 2181 2182 2183 2184 2185 2186 2187 2188 2189 2190 2191 2192 2193 2194 2195 2196 2197 2198 2199 2200 2201 2202 2203 2204 2205 2206 2207 2208 2209 2210 2211 2006 1793 1572 1343 1106  861  608  347   78
 263  528  785 1034 1275 1508 1733 1950 2159 2360 2361 2362 2363 2364 2365 2366 2367 2368 2369 2370 2371 2372 2373 2374 2375 2376 2377 2378 2379 2380 2381 2382 2383 2384 2385 2386 2387 2388 2389 2390 2391 2392 2393 2394 2395 2396 2397 2398 2399 2400 2401 2402 2403 2404 2405 2406 2407 2408 2409 2212 2007 1794 1573 1344 1107  862  609  348   79
 262  527  784 1033 1274 1507 1732 1949 2158 2359 2552 2553 2554 2555 2556 2557 2558 2559 2560 2561 2562 2563 2564 2565 2566 2567 2568 2569 2570 2571 2572 2573 2574 2575 2576 2577 2578 2579 2580 2581 2582 2583 2584 2585 2586 2587 2588 2589 2590 2591 2592 2593 2594 2595 2596 2597 2598 2599 2410 2213 2008 1795 1574 1345 1108  863  610  349   80
 261  526  783 1032 1273 1506 1731 1948 2157 2358 2551 2736 2737 2738 2739 2740 2741 2742 2743 2744 2745 2746 2747 2748 2749 2750 2751 2752 2753 2754 2755 2756 2757 2758 2759 2760 2761 2762 2763 2764 2765 2766 2767 2768 2769 2770 2771 2772 2773 2774 2775 2776 2777 2778 2779 2780 2781 2600 2411 2214 2009 1796 1575 1346 1109  864  611  350   81
 260  525  782 1031 1272 1505 1730 1947 2156 2357 2550 2735 2912 2913 2914 2915 2916 2917 2918 2919 2920 2921 2922 2923 2924 2925 2926 2927 2928 2929 2930 2931 2932 2933 2934 2935 2936 2937 2938 2939 2940 2941 2942 2943 2944 2945 2946 2947 2948 2949 2950 2951 2952 2953 2954 2955 2782 2601 2412 2215 2010 1797 1576 1347 1110  865  612  351   82
 259  524  781 1030 1271 1504 1729 1946 2155 2356 2549 2734 2911 3080 3081 3082 3083 3084 3085 3086 3087 3088 3089 3090 3091 3092 3093 3094 3095 3096 3097 3098 3099 3100 3101 3102 3103 3104 3105 3106 3107 3108 3109 3110 3111 3112 3113 3114 3115 3116 3117 3118 3119 3120 3121 2956 2783 2602 2413 2216 2011 1798 1577 1348 1111  866  613  352   83
 258  523  780 1029 1270 1503 1728 1945 2154 2355 2548 2733 2910 3079 3240 3241 3242 3243 3244 3245 3246 3247 3248 3249 3250 3251 3252 3253 3254 3255 3256 3257 3258 3259 3260 3261 3262 3263 3264 3265 3266 3267 3268 3269 3270 3271 3272 3273 3274 3275 3276 3277 3278 3279 3122 2957 2784 2603 2414 2217 2012 1799 1578 1349 1112  867  614  353   84
 257  779  521 1028 1269 1502 1727 1944 2153 2354 2547 2732 2909 3078 3239 3392 3393 3394 3395 3396 3397 3398 3399 3400 3401 3402 3403 3404 3405 3406 3407 3408 3409 3410 3411 3412 3413 3414 3415 3416 3417 3418 3419 3420 3421 3422 3423 3424 3425 3426 3427 3428 3429 3280 3123 2958 2785 2604 2415 2218 2013 1800 1579 1350 1113  868  615  354   85
 522  255  778 1027 1268 1501 1726 1943 2152 2353 2546 2731 2908 3077 3238 3391 3536 3537 3538 3539 3540 3541 3542 3543 3544 3545 3546 3547 3548 3549 3550 3551 3552 3553 3554 3555 3556 3557 3558 3559 3560 3561 3562 3563 3564 3565 3566 3567 3568 3569 3570 3571 3430 3281 3124 2959 2786 2605 2416 2219 2014 1801 1580 1351 1114  869  616  355   86
 518  777 1026  776 1267 1500 1725 1942 2151 2352 2545 2730 2907 3076 3237 3390 3535 3672 3673 3674 3675 3676 3677 3678 3679 3680 3681 3682 3683 3684 3685 3686 3687 3688 3689 3690 3691 3692 3693 3694 3695 3696 3697 3698 3699 3700 3701 3702 3703 3704 3705 3572 3431 3282 3125 2960 2787 2606 2417 2220 2015 1802 1581 1352 1115  870  617  356   87
1024  520  254 1025 1265 1498 1941 1940 2150 2351 2544 2729 2906 3075 3236 3389 3534 3671 3800 3801 3802 3803 3804 3805 3806 3807 3808 3809 3810 3811 3812 3813 3814 3815 3816 3817 3818 3819 3820 3821 3822 3823 3824 3825 3826 3827 3828 3829 3830 3831 3706 3573 3432 3283 3126 2961 2788 2607 2418 2221 2016 1803 1582 1353 1116  871  618  357   88
 775  252 1266  519 1499 1724 1939 1723 2149 2350 2543 2728 2905 3074 3235 3388 3533 3670 3799 3920 3921 3922 3923 3924 3925 3926 3927 3928 3929 3930 3931 3932 3933 3934 3935 3936 3937 3938 3939 3940 3941 3942 3943 3944 3945 3946 3947 3948 3949 3832 3707 3574 3433 3284 3127 2962 2789 2608 2419 2222 2017 1804 1583 1354 1117  872  619  358   89
 516  253  256 1023 1264 1722 1938 1937 1721 2349 2542 2727 2904 3073 3234 3387 3532 3669 3798 3919 4032 4033 4034 4035 4036 4037 4038 4039 4040 4041 4042 4043 4044 4045 4046 4047 4048 4049 4050 4051 4052 4053 4054 4055 4056 4057 4058 4059 3950 3833 3708 3575 3434 3285 3128 2963 2790 2609 2420 2223 2018 1805 1584 1355 1118  873  620  359   90
 251  517  774  772 1022 1497 1263 1495 2148 2147 2540 2726 2903 3072 3233 3386 3531 3668 3797 3918 4031 4136 4137 4138 4139 4140 4141 4142 4143 4144 4145 4146 4147 4148 4149 4150 4151 4152 4153 4154 4155 4156 4157 4158 4159 4160 4161 4060 3951 3834 3709 3576 3435 3286 3129 2964 2791 2610 2421 2224 2019 1806 1585 1356 1119  874  621  360   91
 250  514  515  773 1262 1494 1720 1496 2146 2541 2539 2725 2902 3071 3232 3385 3530 3667 3796 3917 4030 4135 4232 4233 4234 4235 4236 4237 4238 4239 4240 4241 4242 4243 4244 4245 4246 4247 4248 4249 4250 4251 4252 4253 4254 4255 4162 4061 3952 3835 3710 3577 3436 3287 3130 2965 2792 2611 2422 2225 2020 1807 1586 1357 1120  875  622  361   92
 248  249  771 1021 1261 1719 1936 2145 2348 2347 2724 2723 2901 3070 3231 3384 3529 3666 3795 3916 4029 4134 4231 4320 4321 4322 4323 4324 4326 4327 4406 4328 4329 4330 4331 4332 4333 4334 4335 4336 4337 4338 4339 4340 4341 4256 4163 4062 3953 3836 3711 3578 3437 3288 3131 2966 2793 2612 2423 2226 2021 1808 1587 1358 1121  876  623  362   93
 770  769 1020 1260 1259 1493 1718 1935 2144 2346 2345 2538 2900 3069 3230 3383 3528 3665 3794 3915 4028 4133 4230 4319 4401 4399 4402 4404 4325 4405 4477 4407 4408 4409 4410 4411 4412 4413 4414 4415 4416 4417 4418 4419 4258 4342 4164 4063 3954 3837 3712 3579 3438 3289 3132 2967 2794 2613 2424 2227 2022 1809 1588 1359 1122  877  624  363   94
 247  513 1017 1491 1258 1018 1717 1934 2143 2344 2537 2722 2899 3068 3229 3382 3527 3664 3793 3914 4027 4132 4229 4318 4317 4400 4473 4403 4474 4476 4540 4478 4479 4480 4481 4482 4483 4484 4485 4486 4487 4488 4489 4420 4257 4165 4166 4064 3955 3838 3713 3580 3439 3290 3133 2968 2795 2614 2425 2228 2023 1810 1589 1360 1123  878  625  364   95
 246 1019  510  512  768 1492 1716 1933 2142 2343 2536 2721 2898 3067 3228 3381 3526 3663 3792 3913 4026 4131 4228 4316 4397 4472 4536 4537 4475 4539 4541 4596 4542 4543 4544 4545 4546 4547 4548 4549 4550 4551 4490 4421 4343 4260 4259 4065 3956 3839 3714 3581 3440 3291 3134 2969 2796 2615 2426 2229 2024 1811 1590 1361 1124  879  626  365   96
 245  511  764  767 1257 1490 1715 1932 2141 2342 2535 2720 2897 3066 3227 3380 3525 3662 3791 3912 4025 4130 4227 4398 4471 4535 4592 4591 4538 4594 4642 4597 4682 4598 4599 4600 4601 4602 4603 4604 4605 4552 4491 4422 4344 4346 4167 4066 3957 3840 3715 3582 3441 3292 3135 2970 2797 2616 2427 2230 2025 1812 1591 1362 1125  880  627  366   97
 509  243 1015 1016 1256 1489 1714 1931 2140 2341 2534 2719 2896 3065 3379 3524 3522 3523 3789 3911 4024 4129 4226 4314 4396 4470 4534 4639 4593 4595 4641 4644 4643 4645 4646 4647 4648 4649 4650 4651 4606 4553 4423 4424 4345 4261 4168 4067 3958 3841 3716 3583 3442 3293 3136 2971 2798 2617 2428 2231 2026 1813 1592 1363 1126  881  628  367   98
 244  508 1014  766 1255 1254 1711 1930 2139 2340 2533 2718 2894 2895 3226 3377 3378 3790 3787 3910 4023 4127 4128 4395 4315 4469 4532 4640 4679 4638 4680 4712 4714 4684 4685 4686 4687 4688 4689 4652 4493 4494 4492 4347 4169 4170 4171 3959 3960 3842 3717 3584 3443 3294 3137 2972 2799 2618 2429 2232 2027 1814 1593 1364 1127  882  629  368   99
 242  507  763 1487 1712 1713 1488 1929 2138 2339 2532 2717 3063 3225 3064 3659 3376 3661 3658 3788 4022 4126 4225 4313 4394 4533 4589 4588 4590 4637 4681 4713 4683 4715 4716 4717 4718 4719 4690 4653 4554 4607 4555 4425 4262 4348 4264 4069 4068 3843 3718 3587 3585 3444 3138 2973 2800 2619 2430 2233 2028 1815 1594 1365 1128  883  630  369  100
 241  505  506 1012  765 1253 1486 1928 2137 2338 2531 2893 3062 3223 3224 3375 3520 3660 3521 3909 4021 4223 4312 4224 4393 4467 4468 4587 4636 4711 4709 4737 4752 4739 4753 4740 4741 4720 4691 4654 4608 4609 4426 4349 4351 4263 4071 4072 4070 3720 3844 3586 3445 3296 3295 2974 2801 2620 2431 2234 2029 1816 1595 1366 1129  884  631  370  101
 240  761  762 1252 1484 1485 1710 1927 2136 2337 2530 2714 2716 2715 2892 3221 3657 3656 3786 3908 4124 3907 4311 4309 4392 4530 4531 4710 4676 4678 4735 4736 4760 4738 4743 4757 4756 4721 4692 4655 4557 4556 4495 4350 4265 4175 4266 4353 3961 3845 3446 3588 3297 3298 2975 3139 2802 2621 2432 2235 2030 1817 1596 1367 1130  885  632  371  102
 504 1011 1013 1009 1010 1251 1709 2135 2336 2529 2528 2891 2890 3061 3220 3222 3374 3519 3785 3906 4020 4125 4222 4310 4391 4466 4586 4529 4677 4633 4708 4733 4751 4750 4754 4746 4755 4724 4722 4656 4611 4558 4496 4427 4431 4267 4073 3962 3846 3721 3719 3447 3448 3141 3140 2976 2803 2622 2433 2236 2031 1818 1597 1368 1131  886  633  372  103
 503  760 1008 1250 1249 1483 1708 1925 2134 2335 2527 2713 2889 3060 3059 3373 3783 3518 3784 3905 4019 4018 4463 4221 4308 4464 4465 4528 4585 4634 4734 4732 4749 4747 4758 4745 4742 4695 4693 4694 4559 4610 4429 4497 4428 4354 4173 3963 3964 3847 3722 3589 3449 3299 3142 2977 2804 2623 2434 2237 2032 1819 1598 1369 1132  887  634  373  104
 239  238  502  759 1481 1480 1926 1924 2132 2133 2334 2712 3058 3371 3517 3654 3515 3655 3652 3782 3904 4123 4390 4219 4388 4389 4527 4584 4635 4674 4675 4707 4730 4759 4748 4728 4744 4696 4723 4658 4657 4612 4560 4352 4174 4176 4172 4074 3965 3848 3723 3590 3450 3300 3143 2978 2805 2624 2435 2238 2033 1820 1599 1370 1133  888  635  374  105
 237  500  236  758 1007 1707 1482 1923 2131 2333 2526 2711 2888 3219 3217 3057 3372 3516 3653 3903 4017 4220 4121 4387 4216 4462 4525 4583 4632 4673 4706 4669 4704 4702 4701 4664 4727 4659 4698 4660 4562 4500 4498 4432 4430 4269 4075 4268 3966    0 3725 3724 3451 3301 3144 2979 2806 2625 2436 2239 2034 1821 1600 1371 1134  889  636  375  106
 235  499  501 1006 1248 1479 1922 1705 1920 2332 2525 2710 3054 2887 3218 3370 3514 3781 3780 4120 4122 4016 4015 4307 4218 4461 4524 4582 4631 4672 4705 4703 4729 4667 4731 4699 4726 4725 4615 4614 4561 4613 4499 4501 4433 4270 4177 4076 3967 3849 3850 3591 3592 3302 3145 2980 2807 2626 2437 2240 2035 1822 1601 1372 1135  890  637  376  107
 233  234  757  756 1005 1702 2130 1706 2129 2331 2523 2707 2886 3056 3052 3369 3513 3651 3899 4217 3902 4215 4306 4459 4526 4386 4460 4581 4630 4671 4670 4627 4668 4623 4624 4666 4700 4663 4697 4662 4616 4563 4502 4356 4355 4271 4178 4077 3968 3851 3726 3593 3452 3303 3146 2981 2808 2627 2438 2241 2036 1823 1602 1373 1136  891  638  377  108
 231  755  498 1245 1246 1247 1701 1704 2127 2330 2884 2709 3215 2885 3216 3512 3214 3650 3778 3900 4014 3779 4119 4214 4305 4458 4523 4580 4629 4628 4576 4515 4574 4625 4572 4665 4621 4620 4618 4661 4617 4564 4503 4434 4357 4272 4179 4078 3969 3852 3727 3594 3453 3304 3147 2982 2809 2628 2439 2242 2037 1824 1603 1374 1137  892  639  378  109
 496  497  753 1004 1244 1478 1477 1476 1703 2128 2706 2708 2524 3213 3055 3364 3368 3647 3649 3901 4012 4117 4118 4384 4385 4457 4522 4579 4578 4577 4575 4573 4447 4446 4571 4511 4513 4568 4619 4567 4566 4565 4504 4435 4358 4273 4180 4079 3970 3853 3728 3595 3454 3305 3148 2983 2810 2629 2440 2243 2038 1825 1604 1375 1138  893  640  379  110
 232  754 1002 1003 1243 1475 1921 1919 1918 1916 1917 2122 3050 3049 3367 3211 3510 3648 3777 4013 3898 4011 4213 4304 4303 4383 4521 4452 4519 4450 4451 4626 4516 4622 4371 4512 4569 4570 4509 4508 4507 4506 4505 4436 4359 4274 4181 4080 3971 3854 3729 3596 3455 3306 3149 2984 2811 2630 2441 2244 2039 1826 1605 1376 1139  894  641  380  111
 230  495  752 1000 1242 1241 1473 1700 2328 2324 2125 2519 2882 3366 3212 3509 3511 3897 3896 3895 4010 4116 4301 4455 4302 4456 4454 4379 4520 4453 4518 4449 4517 4514 4197 4445 4510 4443 4442 4441 4440 4439 4438 4437 4360 4275 4182 4081 3972 3855 3730 3597 3456 3307 3150 2985 2812 2631 2442 2245 2040 1827 1606 1377 1140  895  642  381  112
 229  494  751  999 1001 1474 1472 2518 2326 2703 2329 2881 2705 2883 3051 3646 3775 3645 3776 3774 4009 4115 4300 4382 4380 4299 4296 4295 4377 4378 4375 4291 4448 4374 4198 4372 4444 4285 4367 4366 4365 4364 4363 4362 4361 4276 4183 4082 3973 3856 3731 3598 3457 3308 3151 2986 2813 2632 2443 2246 2041 1828 1607 1378 1141  896  643  382  113
 228  493  750 1240 1697 1699 1471 2124 3048 2327 2126 2522 2521 2520 3210 3365 3507 3508 3771 3772 4008 4212 4211 4207 4297 4110 4208 4205 4294 4101 4376 4200 4290 4373 4196 4370 4368 4369 4284 4283 4282 4281 4280 4279 4278 4277 4184 4083 3974 3857 3732 3599 3458 3309 3152 2987 2814 2633 2444 2247 2042 1829 1608 1379 1142  897  644  383  114
 227  492  749  998 1238 1239 1912 2325 2123 2515 2704 2701 3053 3363 2880 3362 3773 3891 3642 3893 4007 4114 4113 4210 4381 4209 3998 4203 3885 4201 4292 4199 4099 4098 4195 4287 4286 4193 4094 4192 4191 4190 4189 4188 4187 4186 4185 4084 3975 3858 3733 3600 3459 3310 3153 2988 2815 2634 2445 2248 2043 1830 1609 1380 1143  898  645  384  115
 226  491  748  997 1694 1237 1913 2322 1698 2700 1910 3209 2877 3047 3207 3361 3506 3644 4006 4112 4111 4003 3888 4107 4108 4298 4103 4293 4204 3996 3995 4100 3994 4289 4097 3990 4288 4095 3987 4093 4092 4091 4090 4089 4088 4087 4086 4085 3976 3859 3734 3601 3460 3311 3154 2989 2816 2635 2446 2249 2044 1831 1610 1381 1144  899  646  385  116
 225  490  747  996 1915 1914 1468 1470 2121 2321 2516 2702 2323 2879 3206 3360 3504 3505 4005 3894 3890 3887 3768 4001 4109 3882 4206 3997 4202 3627 4102 3756 3879 3877 3992 3991 3875 4194 3749 3986 3985 3984 3983 3982 3981 3980 3979 3978 3977 3860 3735 3602 3461 3312 3155 2990 2817 2636 2447 2250 2045 1832 1611 1382 1145  900  647  386  117
 221  224  489  993 1236 1469 1695 1696 1911 2878 2517 2514 3208 2876 3046 3358 3359 3643 3892 3638 3889 3634 3764 4002 4104 3886 4106 4105 3758 3881 3880 3754 3623 3755 3876 4096 3874 3989 3873 3871 3872 3869 3868 3867 3866 3865 3864 3863 3862 3861 3736 3603 3462 3313 3156 2991 2818 2637 2448 2251 2046 1833 1612 1383 1146  901  648  387  118
 488  995  746  992 1234 1235 1690 2120 2118 2320 2319 2512 2698 2699 3202 3502 3503 3767 3769 3641 3636 3766 4004 3492 3630 3632 4000 3883 3761 3626 3628 3878 3484 3993 3622 3752 3750 3988 3748 3747 3870 3746 3745 3744 3743 3742 3741 3740 3739 3738 3737 3604 3463 3314 3157 2992 2819 2638 2449 2252 2047 1834 1613 1384 1147  902  649  388  119
 223  220  994  745 1692 1693 1909 2119 2513 2117 2697 3043 2874 3044 2872 3357 3355 3499 3640 3498 3348 3635 3765 3345 3999 3633 3884 3760 3759 3490 3757 3487 3625 3336 3620 3753 3751 3619 3618 3617 3616 3615 3614 3613 3612 3611 3610 3609 3608 3607 3606 3605 3464 3315 3158 2993 2820 2639 2450 2253 2048 1835 1614 1385 1148  903  650  389  120
 743  487  486  485 1233 1467 1464 1907 2316 2115 1691 2510 2875 3041 3501 3045 3354 3199 3770 3637 3496 3495 3494 3762 3763 3631 3491 3629 3488 3486 3339 3485 3483 3338 3482 3621 3481 3480 3479 3478 3477 3476 3475 3474 3473 3472 3471 3470 3469 3468 3467 3466 3465 3316 3159 2994 2821 2640 2451 2254 2049 1836 1615 1386 1149  904  651  390  121
 222  991 1231 1465 1229 1689 2114 1232 1908 2506 2873 2695 2511 3356 3204 3500 3203 3038 3034 3350 3497 3195 3347 3493 3191 3489 3346 3188 3342 3341 3340 3184 3624 3337 3181 3335 3334 3014 3332 3331 3330 3329 3328 3327 3326 3325 3324 3323 3322 3321 3320 3319 3318 3317 3160 2995 2822 2641 2452 2255 2050 1837 1616 1387 1150  905  652  391  122
 482  990  219  742  741  989 1463 2509 1906 2318 2696 2868 2508 3042 3205 3201 3353 3352 3639 3197 3193 3349 3194 3029 3030 3190 3344 3189 3187 3186 3185 3021 3183 3182 3180 3179 3178 3177 3015 3176 3175 3174 3173 3172 3171 3170 3169 3168 3167 3166 3165 3164 3163 3162 3161 2996 2823 2642 2453 2256 2051 1838 1617 1388 1151  906  653  392  123
 739  744  738  988 1230 1462 2313 2116 2110 2317 2315 2692 2871 2693 2694 2683 3040 3037 2861 3351 3196 3031 2859 2858 3027 2857 3343 3026 3025 3023 3022 2850 3020 3019 3018 3017 3016 3333 3013 3012 3011 3010 3009 3008 2837 3007 3006 3005 3004 3003 3002 3001 3000 2999 2998 2997 2824 2643 2454 2257 2052 1839 1618 1389 1152  907  654  393  124
 479  483  215 1466 1460 1687 1688 2314 2691 2112 2869 3039 2870 2867 2866 2865 2099 2497 2862 3036 3035 1888 3192 2680 3028 2677 2855 2854 3024 2673 2852 2671 2849 2848 2847 2846 2845 2665 2843 2842 2841 2840 2839 2838 2836 2657 2835 2834 2833 2832 2831 2830 2829 2828 2827 2826 2825 2644 2455 2258 2053 1840 1619 1390 1153  908  655  394  125
 478  484  218  987  740 1228 1461 1905 1902 1904 2113 2503 2690 2504 2687 3200 2498 2863 3033 2682 2499 2496 2681 2493 2678 2490 2856 2675 2853 2674 2851 2672 2670 2669 2668 2667 2666 2664 2844 2477 2662 2661 2660 2659 2658 2469 2470 2655 2654 2653 2652 2651 2650 2649 2648 2647 2646 2645 2456 2259 2054 1841 1620 1391 1154  909  656  395  126
 480  216  737  986 1226 1227 1685 1686 2311 2507 2505 2502 2106 2684 2501 2686 2685 2100 3198 1887 2302 2495 2860 2679 2492 2489 2676 2488 2487 2486 2485 2484 2483 2482 2481 2480 2479 2478 2476 2663 2475 2474 2473 2472 2471 2275 2656 2468 2467 2466 2465 2464 2463 2462 2461 2460 2459 2458 2457 2260 2055 1842 1621 1392 1155  910  657  396  127
 214  481  217 1225 1459 1456 1684 1899 2312 2309 2308 2307 2105 2689 2306 2305 2864 3032 2301 1890 2097 2098 2298 2094 2491 2295 2294 2293 2292 2291 2290 2289 2288 2287 1654 2285 2284 2282 2281 2078 2280 2279 2278 2277 2276 2072 2274 2273 2272 2271 2270 2269 2268 2267 2266 2265 2264 2263 2262 2261 2056 1843 1622 1393 1156  911  658  397  128
 477  736  985  984 1457 1458 1900 1898 1903 1894 2108 1676 2104 1674 2688 1892 2500 2103 1208 1443 2300 2299 1665 1885 2095 2296 2091 2090 2089 2088 2087 2085 2084 2083 2286 2081 2080 1870 2283 2079 2077 2076 2075 2074 1862 2073 2071 2070 2069 2068 2067 2066 2065 2064 2063 2062 2061 2060 2059 2058 2057 1844 1623 1394 1157  912  659  398  129
 213  212  735  983  982 1224 1901 1681 2111 2310 1895 2107 1893 1447 1210 1891 2304 2303 2101 1883 1440 2297 2494 1884 1881 2092 1880 1879 1878 1877 1876 2086 1656 1874 1873 1872 2082 1869 1868 1867 1866 1865 1864 1863 1643 1861 1860 1859 1858 1857 1856 1855 1854 1853 1852 1851 1850 1849 1848 1847 1846 1845 1624 1395 1158  913  660  399  130
 211  476  732  734  733 1455 1683 1453 1680 2109 1896 1449 1446 1213 1673 1672 1671 1889 1668 1886 1667 2096 1882 1663 2093 1662 1661 1660 1659 1658 1657 1428 1655 1193 1653 1652 1871 1421 1423 1422 1420 1646 1182  687 1645 1415 1641 1640 1639 1638 1637 1636 1635 1634 1633 1632 1631 1630 1629 1628 1627 1626 1625 1396 1159  914  661  400  131
 210  474  979  475 1223 1219 1454 1682 1452 1451 1897 1677 1448 1675 1212 1445 2102 1669 1444 1439  960 1203 1435 1664 1436 1201 1434 1433  703 1431 1195 1875 1429  948 1424 1651 1188 1650 1648 1647 1185  943 1181 1644 1419 1417 1414 1413 1412 1411 1410 1409 1408 1407 1406 1405 1404 1403 1402 1401 1400 1399 1398 1397 1160  915  662  401  132
 208  209  731  981 1220  978  976 1679  973 1217 1216 1215  969  966  716 1678  715 1209 1670 1441 1442 1204 1438  451 1202 1437 1200 1432 1194  955 1196 1430  699 1191  698  947 1427  437 1649  944 1184 1418 1183  938 1642 1416 1179 1178 1177 1176 1175 1174 1173 1172 1171 1170 1169 1168 1167 1166 1165 1164 1163 1162 1161  916  663  402  133
 729  473  980  730  977  975  466 1218 1450  974 1214  972  719  967  970 1211  965 1207  964 1206 1205  450  961  959 1666  957 1199 1197 1198  951  440  952  700  694 1426  697 1189 1187  693 1186  691  942  941  940  937 1180  936  935  934  933  932  931  930  929  928  927  926  925  924  923  922  921  920  919  918  917  664  403  134
 472  470  728 1222 1221  468  465  725  724  723  721  720  971  718  968  458  717  714  453  963  186  962  183  707  958  706  956  705  954  176  702  953 1192  950  695 1425  949  435 1190  692  432  690  689  939  688  686  685  684  683  682  681  680  679  678  677  676  675  674  673  672  671  670  669  668  667  666  665  404  135
 207  206  471  469  200  726  201  198  463  461  722  460  459  191  457  456  189  454  187  712  710  185  448  709  452  180  447  704  444  443  701  174  173  439  171  696  946  945  168  164  165  433  430  429  428  427  426  425  424  423  422  421  420  419  418  417  416  415  414  413  412  411  410  409  408  407  406  405  136
 205  204  203  202  467  727  199  197  464  196  462  195  194  193  192  190  188  455  713  711  449  708  184  182  181  179  446  445  178  177  442  175  172  441  170  438  436  169  167  434  166  431  163  162  161  160  159  158  157  156  155  154  153  152  151  150  149  148  147  146  145  144  143  142  141  140  139  138  137
