# This puzzle is unsolvable
57
   2    1  227    3  229    5    7    8    9   10   11   12   14   15  238   16   17   18   19   20   21  245   25  463   23   27  466  250  252   30   32  255   33   34   35   36   37   38   39   40   41   42   43  269  267   46  693  271   48   50   53   54  276   56  280  277   57
 224  226    4  228  443  230  445  231  232  449  233  235   13  450  451  240  454  241  242  243  244  247   24  246   26  251   29   28  468  675  254   31  471  679  257  259  475  260  261  262  264  265  266  688   44 1082  268  484   47  274  275  491  492   51   58  699   59
 440  648  225  441  442    6  652  653  446  448  234  657  237  452  453  239  455  663  456  458  459  667   22  460  464  869  249  253  872  467  469  256  678  472  258  474  685  476  477  479  686  480  481  889  485  692  487  488   49  486  695  281  696  493   61  698   63
 223  222  438 1040  649  444  644  850  447  655  656  856  658  236  858  660  661  662  457  664  665  461  669  670  462  248  671  465  871 1064  470  680  876  473  879  681  682  683 1258  263  886  883  691  482   45  690  270  273  894  896  892  899 1087  902  494   55  279
 220  437  221  647  651  650  852  654  853  855 1046 1047 1231  857  860 1051 1053  861  863  864  666  867  868 1059 1060  870  673 1062  873  674  875  677  877 1067 1068  880 1072  885  478  684  687  887  689 1080  483 1265 1266  890   52 1084  489 1089  490  278 1269  700   60
 439  646 1225  848 1041  849 1223 1043 1045  854 1048 1405 1232  659 1049 1050 1410  862 1054  865 1239  866  668 1241 1243 1061 1063  672  874 1248  676 1425 1066  878 1069 1070  882 1432  881 1074 1260 1078  888 1081 1079 1085 1439  891  272 1442  694  893  697  282  898  497   62
 219  645  847  433  846  851 1401 1226 1042 1044 1227 1403 1230 1052 1235  859 1409 1236 1056 1055 1240 1057 1058 1417 1242 1244 1245 1246 1247 1249 1065 1424 1426 1253 1252 1071 1430 1598 1075 1073 1257 1436 1077 1262 1606 1264 1263 1083 1086 1267  703  897  895  496  495  499   65
 218  436  435  845 1039 1222 1224 1568 1221 1402 1228 1229 1404 1407 1233 1576 1578 1234 1238 1237 1412 1582 1414 1415 1418 1419 1420 1421 1423 1589 1251 1427 1250 1753 1255 1429 1254 1431 1759 1256  884 1433 1434 1437 1604 1261 1438 1441 1268 1090  900 1088  704  706  284  701  285
 217  216  642 1038 1037 1398 1728 1570 1567 1729 1571 1881 1406 1574 1408 1577 1886 1411 1579 1580 1413 1581 1416 1584 1585 1586 1587 1588 1422 1590 1750 1752 1428 1593 1594 1595 1906 1908 1259 1599 1600 1076 1603 1762 1915 1605 1440 1607 1609 1443  283 1270  901  702  498   67   64
 214  640  434  643 1036 1400 1397 1727 1399 2024 1572 1573 1733 1885 1735 1575 1734 1737 1738 1739 1740 1741 1583 1742 1743 1745 1746 1747 1748 1900 1749 1591 1592 1751 1756 1597 1596 1909 1907 1758 1912 1602 1760 1761 1763 1764 1916 1767 1444 1271 1272 1445 1448 1091 1092  288  286
 432  431  844 1220 1033  841 1566 1219 1569 1880 1882 1730 1731 1883 1884 1887 1736 1888 1889 1890 1891 1892 1893 1895 1744 1896 1897 1898 1899 2043 1901 1902 1903 1905 1755 2187 2049 1757 2315 1910 1601 2054 1913 1435 1914 2059 1769 1446 1608 1610 1273  903  503  708  705 1093  501
 641  843  215 1035  842 1395 1396 1562 1565 1879 1726 1732 2026 2027 2028 2029 2030 2031 2032 2033 2034 2035 2036 1894 2037 2038 2039 2040 2041 2042 2044 2045 2046 1904 1754 2185 2048 2050 2314 2051 2052 2316 2056 2057 1765 1768 1919 1917 1613 1611 1447 1274  906  500  502   66   68
 213  430  639  840 1034 1218 1564 1725 1876 1877 2025 2023 2161 2162 2163 2164 2165 2166 2167 2168 2169 2170 2171 2172 2173 2301 2175 2176 2177 2178 2179 2180 2182 2047 2183 2310 2186 2184 2053 1911 2189 2055 2191 2192 2058 2193 1770 1766 1921  905 1276 1094  289  707  904  287   71
 212  429  638  839 1032 1216 1217 1724 1393 1563 1878 2160 2288 2289 2290 2291 2292 2293 2294 2295 2296 2297 2298 2299 2174 2300 2302 2303 2304 2305 2306 2307 2427 2308 2430 2313 2312 2188 2434 2433 2317 2190 2318 2319 2195 1615 1918 1612 1614 1452  709 1449  907  290   70   69   72
 211  428  637  838 1031 1723 1394 2022 1722 2021 2159 2158 2287 2408 2409 2410 2411 2412 2413 2414 2415 2416 2417 2418 2419 2420 2421 2422 2423 2424 2425 2426 2538 2181 2429 2309 2311 2543 2432 2545 2438 2435 2436 2437 2194 2060 2062 1453 1616 1278 1450 1275  909  291  505  292  293
 210  427  636  837 1030 1215 1391 1392 1561 1875 2020 2157 2286 2407 2520 2521 2522 2523 2524 2525 2526 2527 2528 2529 2530 2531 2532 2533 2534 2535 2536 2537 2428 2739 2644 2431 2540 2646 2544 2648 2321 2547 1922 2322 1774 2061 2197 1771 1920 1277 1773 1095 1451  711  504  294  506
 209  426  635  836 1029 1214 1390 1560 1721 1874 2019 2156 2285 2406 2519 2624 2625 2626 2627 2628 2629 2630 2631 2632 2633 2634 2635 2636 2637 2638 2639 2640 2641 2539 2642 2542 2541 2645 2742 2647 2548 2743 2439 2649 2063 1775 1772 1924 1617 2064  908 1097  710 1096  910  507   73
 208  425  634  835 1028 1212 1213 1559 1720 1873 2018 2155 2284 2405 2518 2623 2720 2721 2722 2723 2724 2725 2726 2727 2728 2729 2730 2731 2732 2733 2734 2735 2736 2737 2643 2826 2740 2828 2830 2829 2442 2546 2549 2323 2065 2199 2066 1776 1923 1280 1279 1098 1099  713  712  295  296
 207  424  633  834 1027 1389 1388 1558 1719 1872 2017 2154 2283 2404 2517 2622 2719 2808 2809 2810 2811 2812 2813 2814 2815 2816 2817 2818 2819 2820 2821 2822 2823 2824 2738 2825 2741 2906 2744 2651 2650 2551 2325 2320 2196 2198 1925 1455 1454 1283 1284 1281  912  714  508   75   74
 206  423  632  833 1026 1211 1387 1557 1718 1871 2016 2153 2282 2403 2516 2621 2718 2807 2888 2889 2890 2891 2892 2893 2894 2895 2896 2897 2898 2899 2900 2901 2902 2974 2903 2827 2905 2907 2831 2745 2654 2552 2550 2440 2200 2069 2067 1777 1779 1282 1618  911 1100 1102  509  298  297
 205  422  631  832 1025 1210 1555 1385 1717 1870 2015 2152 2281 2402 2515 2620 2717 2806 2887 2960 2961 2962 2963 2964 2965 2966 2967 2968 2969 2970 2971 2972 2973 3037 2975 2976 2977 2908 2746 2748 2652 2326 2324 2441 2328 1928 2202 1620 1619 1927 1101 1104  716  715  510  511   76
 420  204  630  831 1024 1209 1556 1554 1386 1716 2014 2151 2280 2401 2514 2619 2716 2805 2886 2959 3024 3025 3026 3027 3028 3029 3030 3031 3032 3033 3034 3035 3092 3038 2904 3039 2909 2832 2554 2833 2653 2553 2445 2068 2444 2327 1621 1926 1456 1778 1103 1105  717  913  512   78   77
 421  629  628  830 1023 1208 1384 1714 1868 1869 2013 2150 2279 2400 2513 2618 2715 2804 2885 2958 3023 3080 3081 3082 3083 3084 3085 3086 3087 3088 3089 3090 3036 3091 3040 2979 2978 2910 2747 2655 2656 2657 2556 2203 2329 2201 1781 1780 1623 1622 1285  915  914  718  513  299  300
 203  201  419  829 1022 1207 1383 1553 1715 1867 2012 2149 2278 2399 2512 2617 2714 2803 2884 2957 3022 3079 3128 3130 3168 3131 3132 3133 3134 3135 3137 3176 3138 3094 3093 3041 2980 2911 2834 2749 2443 2555 2446 2071 2070 1929 1782 1783 1624 1457 1287 1286  916  514  301   80   79
 202  418  627  828 1020 1021 1381 1206 1713 1866 2011 2148 2277 2398 2511 2616 2713 2802 2883 2956 3021 3078 3126 3127 3129 3170 3171 3203 3172 3173 3136 3177 3139 3140 3095 2981 2912 2836 2751 2835 2750 2330 2447 2331 2204 1930 1625 1460 1459 1458 1288  917  918  719  720  302   81
 200  417  625  626 1019 1382 1550 1552 1712 1865 2010 2147 2276 2397 2510 2615 2712 2801 2882 2955 3020 3077 3125 3167 3169 3199 3224 3202 3204 3205 3174 3207 3178 3141 3096 2984 3042 2982 2752 2659 2658 2557 2206 2207 2205 2072 1932 1931 1626 1462 1461 1106  721  516  515  303   82
 199  415  416  827  826 1204 1380 1551 1711 1864 2009 2146 2275 2396 2509 2614 2711 2800 2881 2954 3019 3076 3166 3165 3201 3200 3225 3221 3227 3242 3175 3208 3210 3179 3142 3097 2983 3044 2913 2753 2559 2558 2448 2332 2074 2073 1933 1784 1627 1289 1108 1107  919  722  517  304   83
 197  198  825  824 1018 1205 1203 1549 1710 1863 2008 2144 2145 2395 2508 2613 2710 2799 2880 2953 3017 3018 3075 3124 3198 3223 3226 3243 3244 3230 3206 3229 3181 3180 3098 3043 3100 3045 2915 2837 2450 2660 2449 2333 2208 2075 1934 1785 1628 1463 1290 1109  920  723  518  305   84
 414  623  624  823 1017 1202 1379 1548 1709 1862 2006 2007 2274 2273 2507 2612 2709 2798 2879 2951 2952 3074 3123 3222 3164 3239 3237 3240 3245 3231 3241 3209 3182 3099 3145 3046 2917 2914 2838 2754 2561 2560 2451 2334 2209 2076 1935 1786 1629 1464 1291 1110  921  724  519  306   85
 196  413  622  822 1016 1201 1378 1547 1708 1861 2272 2393 2394 2506 2505 2611 2707 2708 2949 2878 3016 3073 3122 3163 3197 3218 3238 3196 3247 3216 3228 3144 3143 3101 2985 3047 3048 2839 2916 2755 2661 2662 2452 2335 2210 2077 1936 1787 1630 1465 1292 1111  922  725  520  307   86
 195  412  620  621 1015 1200 1377 1707 1860 2005 2142 2143 2392 2391 2609 2610 2606 2797 2796 2950 3015 3071 3121 3162 3195 3191 3236 3248 3232 3233 3214 3211 3183 3146 3102 2988 2986 2756 2840 2562 2664 2663 2453 2338 2336 2078 1937 1788 1631 1466 1293 1112  923  726  521  308   87
 194  411  821  820 1014 1199 1376 1546 1706 1859 2004 2141 2270 2269 2503 2608 2705 2876 2877 2874 3068 3120 3159 3161 3220 3219 3217 3154 3246 3215 3212 3234 3186 3213 3103 2987 2989 2918 2842 2757 2665 2454 2337 2455 2211 2079 1789 1790 1632 1467 1294 1113  924  727  522  309   88
 193  410  619 1013 1198 1373 1375 1545 1544 1857 1858 2003 2271 2504 2607 2706 2795 2793 2875 3072 2948 3014 3193 3160 3119 3114 3192 3188 3235 3189 3187 3106 3148 3184 3147 3049 3050 2921 2841 2843 2758 2563 2456 2214 2340 2213 2080 1938 1634 1468 1295 1114  925  728  523  310   89
 192  409  618  819 1012 1197 1374 1543 1705 1542 2002 2140 2139 2268 2390 2389 2703 2704 2873 3013 2947 3070 3117 3115 3194 3157 3190 3155 3153 3152 3108 3185 3150 3149 3104 3051 3052 2990 2920 2844 2565 2564 2339 2342 2212 1940 1941 1633 1791 1469 1296 1115  926  729  524  311   90
 191  408  617  818 1011 1196 1372 1703 1702 1704 1856 2266 2267 2138 2500 2502 2792 2794 2945 2946 3069 3012 3118 3065 3116 3113 3156 3112 3111 3110 3151 3109 3057 3105 3054 2994 2922 2919 2845 2759 2666 2667 2341 2459 2566 2215 1792 1939 1635 1470 1297 1116  927  730  525  312   91
 190  407  616  817 1010 1195 1371 1541 1701 1855 2001 2000 2388 2501 2605 2702 2791 2872 2944 3009 3011 3067 3066 3064 3158 3063 3062 3061 3060 3001 3059 2998 3107 3055 3053 2995 2992 2991 2846 2760 2668 2567 2457 2082 2083 2216 2081 2084 1636 1471 1298 1117  928  731  526  313   92
 189  406  615  816 1008 1009 1539 1194 1540 1853 2137 2387 2136 2386 2499 2604 2701 2790 2871 3010 2942 3008 3007 3006 3005 3004 2936 3003 3002 3058 3000 2999 2997 2928 2929 2993 2924 2923 2762 2761 2568 2569 2458 2460 2217 1943 1944 1942 1793 1472 1299 1118  929  732  527  314   93
 188  405  614  815 1007 1193 1700 1854 1699 2135 1999 2264 2265 2385 2498 2603 2700 2789 2870 2943 2867 2941 2939    0 2938 2937 2935 2860 2933 3056 2857 2932 2930 2854 2852 2927 2926 2925 2847 2848 2669 2570 2345 2343 2218 2086 1638 1795 1794 1473 1300 1119  930  733  528  315   94
 187  404  613  814 1192 1369 1370 1538 1852 1998 1851 2133 2134 2384 2497 2602 2699 2788 2869 2868 2866 2865 2940 2864 2863 2862 2861 2859 2934 2858 2774 2931 2856 2855 2996 2853 2851 2850 2849 2670 2763 2764 2462 2219 2461 1945 2085 1639 1637 1474 1301 1120  931  734  529  316   95
 186  403  612  813 1006 1191 1368 1537 1698 1850 1997 1996 2263 2383 2496 2601 2698 2787 2786 2785 2784 2783 2782 2781 2780 2779 2778 2776 2775 2773 2584 2583 2772 2771 2680 2769 2768 2676 2767 2765 2672 2671 2463 2221 2344 2220 1946 1796 1640 1475 1302 1121  932  735  530  317   96
 185  402  611  812 1005 1190 1367 1536 1697 1849 1995 2132 2262 2382 2495 2600 2697 2696 2695 2694 2693 2692 2691 2690 2689 2688 2687 2777 2685 2683 2582 2681 2475 2585 2679 2770 2677 2576 2468 2674 2673 2346 2350 2222 2087 1947 1798 1797 1641 1476 1303 1122  933  736  531  318   97
 184  401  610  811 1004 1189 1366 1535 1696 1848 1994 2260 2261 2381 2494 2599 2598 2597 2596 2595 2594 2593 2592 2591 2590 2589 2588 2686 2479 2684 2476 2238 2477 2105 2682 2678 2578 2577 2575 2766 2574 2571 2464 2347 2089 2088 1948 1799 1642 1477 1304 1123  934  737  532  319   98
 183  400  609  810 1003 1188 1365 1534 1695 1993 2130 2131 2259 2380 2493 2492 2491 2490 2489 2488 2487 2486 2485 2484 2483 2482 2480 2587 2478 2586 1822 2363 2474 2236 2359 2579 2471 2232 2675 2353 2467 2572 2573 2465 2223 2090 1949 1800 1643 1478 1305 1124  935  738  533  320   99
 182  399  608  809 1002 1187 1364 1533 1694 1847 1992 2129 2258 2379 2378 2377 2376 2375 2374 2373 2372 2371 2370 2369 2368 2367 2481 2241 2365 2364 2240 2360 2234 2103 2473 2356 2580 2354 2469 2470 2352 2466 2351 2348 2224 2091 1950 1801 1644 1479 1306 1125  936  739  534  321  100
 181  398  607  808 1001 1186 1363 1532 1693 1846 1991 2128 2257 2256 2255 2254 2253 2252 2251 2250 2249 2248 2247 2246 2245 2244 2366 2243 1971 2109 1969 2362 2239 2237 2235 2581 2355 2231 1961 2230 2229 2228 2227 2349 2225 2092 1951 1802 1645 1480 1307 1126  937  740  535  322  101
 180  397  606  807 1000 1185 1362 1531 1692 1845 1990 2127 2126 2125 2124 2123 2122 2121 2120 2119 2118 2117 2116 2115 2114 2113 2111 2242 2110 1970 2361 2107 1967 2358 2472 2102 2357 2101 2100 2099 2098 2097 2096 2226 2094 2093 1952 1803 1646 1481 1308 1127  938  741  536  323  102
 179  396  605  806  999 1184 1361 1530 1691 1844 1989 1988 1987 1986 1985 1984 1983 1982 1981 1980 1979 1978 1977 1976 1828 1975 2112 1973 1972 2108 1504 2106 1819 2104 1966 1964 1818 2233 1962 1960 1958 1811 1957 2095 1955 1954 1953 1804 1647 1482 1309 1128  939  742  537  324  103
 178  395  604  805  998 1183 1360 1529 1690 1843 1842 1841 1840 1839 1838 1837 1836 1835 1834 1833 1832 1831 1830 1829 1974 1827 1825 1824 1668 1823 1821 1501 1968 1965 1663 1817 1963 1815 1813 1658 1959 1810 1809 1956 1808 1807 1806 1805 1648 1483 1310 1129  940  743  538  325  104
 177  394  603  804  997 1182 1359 1528 1689 1688 1687 1686 1685 1684 1683 1682 1681 1680 1679 1678 1677 1676 1675 1674 1673 1672 1826 1670 1335 1505 1820 1503 1500 1499 1664 1662 1816 1661 1495 1812 1324 1656 1655 1654 1653 1652 1651 1650 1649 1484 1311 1130  941  744  539  326  105
 176  393  602  803  996 1181 1358 1527 1526 1525 1524 1523 1522 1521 1520 1519 1518 1517 1516 1515 1514 1512 1341 1511 1510 1508 1338 1337 1507 1506 1666 1667 1665 1330 1329 1498 1659 1496 1326 1660 1657 1493 1492 1491 1490 1489 1488 1487 1486 1485 1312 1131  942  745  540  327  106
 175  392  601  802  995 1180 1357 1356 1355 1354 1353 1352 1351 1350 1349 1348 1347 1346 1345 1344 1343 1513 1162 1340 1339 1671 1158 1509 1156 1669 1333 1152 1502 1153  964 1327 1497 1328 1814 1323 1494 1322 1321 1320 1319 1318 1317 1316 1315 1314 1313 1132  943  746  541  328  107
 174  391  600  801  994 1179 1178 1177 1176 1175 1174 1173 1172 1171 1170 1169 1168 1167 1166 1165 1164 1342  975 1161 1160 1159 1157 1334 1336  967  773 1155 1331  768  962  965 1148 1147 1325 1145 1144  956 1143 1141 1140 1139 1138 1137 1136 1135 1134 1133  944  747  542  329  108
 173  390  599  800  993  992  991  990  989  988  987  986  985  984  983  982  981  980  979  978  976 1163  780  974  973  972  971  775  970 1154  771 1332 1151  963 1150 1149  961  960 1146  957  760  559 1142  954  953  952  951  950  949  948  947  946  945  748  543  330  109
 172  389  598  799  798  797  796  795  794  793  792  791  790  789  788  787  786  785  784  783  977  781  577  575  576  778  777  776  969  570  968  966  770  566  565  767  766  764  958  763  558  762  955  759  758  757  756  755  754  753  752  751  750  749  544  331  110
 171  388  597  596  595  594  593  592  591  590  589  588  587  586  585  584  583  582  581  580  782  149  578  367  779  573  362  774  359  571  569  568  769  355  567  354  352  765  959  562  560  761  556  345  555  554  553  552  551  550  549  548  547  546  545  332  111
 170  387  386  385  384  383  382  381  380  379  378  377  376  375  374  373  372  371  370  369  368  147  365  366  363  361  141  572  140  358  357  772  137  356  135  564  350  563  561  349  129  346  128  126  344  343  342  341  340  339  338  337  336  335  334  333  112
 169  168  167  166  165  164  163  162  161  160  159  158  157  156  155  154  153  152  151  150  579  148  146  145  364  574  144  143  360  142  139  138  136  134  353  133  132  351  131  348  130  347  557  127  125  124  123  122  121  120  119  118  117  116  115  114  113
