# This puzzle is unsolvable
59
   2    1    3    4    5    6    7    8    9   10   11   12   13   14   15   16   17   18   19   20   21   22   23   24   25   26   27   28   29   30   31   32   33   34   35   36   37   38   39   40   41   42   43   44   45   46   47   48   49   50   51   52   53   54   55   56   57   58   59
 232  233  234  235  236  237  238  239  240  241  242  243  244  245  246  247  248  249  250  251  252  253  254  255  256  257  258  259  260  261  262  263  264  265  266  267  268  269  270  271  272  273  274  275  276  277  278  279  280  281  282  283  284  285  286  287  288  289   60
 231  456  457  458  459  460  461  462  463  464  465  466  467  468  469  470  471  472  473  474  475  476  477  478  479  480  481  482  483  484  485  486  487  488  489  490  491  492  493  494  495  496  497  498  499  500  501  502  503  504  505  506  507  508  509  510  511  290   61
 230  455  672  673  674  675  676  677  678  679  680  681  682  683  684  685  686  687  688  689  690  691  692  693  694  695  696  697  698  699  700  701  702  703  704  705  706  707  708  709  710  711  712  713  714  922  715  717  718  719  720  721  722  723  724  725  512  291   62
 229  454  671  880  881  882  883  884  885  886  887  888  889  890  891  892  893  894  895  896  897  898  899  900  901  902  903  904  905  906  907  908  909  910  911  912  913  914  915  916  917  918  919  920 1120  921  716 1123  924  925  926  927  928  930  931  726  513  292   63
 228  453  670  879 1080 1081 1082 1083 1084 1085 1086 1087 1088 1089 1090 1091 1092 1093 1094 1095 1096 1097 1098 1099 1100 1101 1102 1103 1104 1105 1106 1107 1108 1109 1110 1111 1112 1113 1114 1115 1116 1117 1118 1310 1119 1121  923 1122 1124 1125 1127 1128  929 1129  932  727  514  293   64
 227  452  669  878 1079 1272 1273 1274 1275 1276 1277 1278 1279 1280 1281 1282 1283 1284 1285 1286 1287 1288 1289 1290 1291 1292 1293 1294 1295 1296 1297 1298 1299 1300 1301 1302 1303 1304 1305 1489 1306 1307 1308 1493 1311 1312 1313 1314 1315 1316 1126 1318 1319 1130  933  728  515  294   65
 226  451  668  877 1078 1271 1456 1457 1458 1459 1460 1461 1462 1463 1464 1465 1466 1467 1468 1469 1470 1471 1472 1473 1474 1475 1476 1477 1478 1479 1480 1481 1482 1483 1484 1485 1486 1487 1488 1664 1490 1491 1309 1492 1494 1495 1496 1497 1498 1499 1317 1501 1320 1131  934  729  516  295   66
 225  450  667  876 1077 1270 1455 1632 1633 1634 1635 1636 1637 1638 1639 1640 1641 1642 1643 1644 1645 1646 1647 1648 1649 1650 1651 1652 1653 1654 1655 1656 1657 1658 1659 1660 1661 1662 1830 1663 1665 1666 1667 1668 1669 1670 1671 1672 1673 1674 1500 1502 1321 1132  935  730  517  296   67
 224  449  666  875 1076 1269 1454 1631 1800 1801 1802 1803 1804 1805 1806 1807 1808 1809 1810 1811 1812 1813 1814 1815 1816 1817 1818 1819 1820 1821 1822 1823 1824 1825 1826 1827 1828 1829 1989 1831 1832 1833 1834 1835 1836 1837 1838 1839 1840 1841 1675 1676 1503 1133  936  731  518  297   68
 223  448  665  874 1075 1268 1453 1630 1799 1960 1961 1962 1963 1964 1965 1966 1967 1968 1969 1970 1971 1972 1973 1974 1975 1976 1977 1978 1979 1980 1981 1982 1983 1984 1985 1986 1987 1988 2140 1990 1991 1992 1993 1994 1995 1996 1997 1998 1999 1842 1504 1677 1324 1134  937  732  519  299  298
 222  447  664  873 1074 1267 1452 1629 1798 1959 2112 2113 2114 2115 2116 2117 2118 2119 2120 2121 2122 2123 2124 2125 2126 2127 2128 2129 2130 2131 2132 2133 2134 2135 2136 2137 2281 2138 2139 2141 2142 2143 2144 2145 2146 2147 2148 2149 2000 1843 1323 1505 1322  938 1136  734  733   69   70
 221  446  663  872 1073 1266 1451 1628 1797 1958 2111 2256 2257 2258 2259 2260 2261 2262 2263 2264 2265 2266 2267 2268 2269 2270 2271 2272 2273 2274 2275 2276 2412 2277 2278 2279 2280 2282 2283 2284 2285 2286 2287 2288 2289 2290 2291 2150 2001 1844 1678 1506 1325 1135  940  939  520  300   71
 220  445  662  871 1072 1265 1450 1627 1796 1957 2110 2255 2392 2393 2394 2395 2396 2397 2398 2399 2400 2401 2402 2403 2404 2405 2406 2407 2408 2409 2410 2538 2411 2413 2414 2415 2416 2417 2418 2419 2420 2421 2422 2423 2424 2425 2292 2151 2002 1845 1680 1507 1326 1137  941  735  521  522  523
 219  444  661  870 1071 1264 1449 1626 1795 1956 2109 2254 2391 2520 2521 2522 2523 2524 2525 2526 2527 2528 2529 2530 2531 2532 2534 2652 2535 2536 2537 2657 2539 2540 2541 2542 2543 2544 2545 2546 2547 2548 2549 2550 2551 2426 2293 2152 2003 1847 1679 1681 1508 1327 1138  736  524   73  301
 218  443  660  869 1070 1263 1448 1625 1794 1955 2108 2253 2390 2519 2640 2641 2642 2643 2644 2645 2646 2647 2648 2649 2650 2651 2533 2867 2764 2655 2767 2656 2658 2659 2660 2661 2662 2663 2664 2665 2666 2667 2668 2669 2552 2427 2294 2004 2154 1682 1509 1683 1328  942  943  737  303  738   72
 217  442  659  868 1069 1262 1447 1624 1793 1954 2107 2252 2389 2518 2639 2752 2753 2754 2755 2756 2758 2760 2863 2759 2761 2762 2763 2866 2653 2654 2766 2768 2769 2770 2771 2772 2773 2774 2775 2776 2777 2778 2779 2670 2553 2428 2295 2153 2155 1846 1848 1510 1140 1139  944  739   74   75  302
 216  441  658  867 1068 1261 1446 1623 1792 1953 2106 2251 2388 2517 2638 2751 2856 2857 2858 2859 2757 2956 2861 2959 3046 2865 2961 2962 2765 2869 2870 2871 2872 2873 2874 2875 2876 2877 2878 2879 2880 2881 2780 2671 2554 2430 2429 2007 1849 2005 1684 1511 1329 1330  945 1142  525  304  305
 215  440  657  866 1067 1260 1445 1622 1791 1952 2105 2250 2387 2516 2637 2750 2855 2952 2953 2954 2860 2955 2862 2960 2958 3048 3127 2868 2964 2963 3053 2965 2967 2968 2969 2970 2971 2972 2973 2974 2975 2882 2781 2672 2555 2157 2296 2008 2298 1850 1685 1512 1332 1141  946  740  527  306   76
 214  439  656  865 1066 1259 1444 1621 1790 1951 2104 2249 2386 2515 2636 2749 2854 2951 3040 3041 3042 3044 2957 2864 3047 3125 3128 3050 3129 3051 3052 2966 3054 3055 3056 3057 3058 3059 3060 3061 2976 2883 2782 2673 2556 2299 2297 2009 2006 1851 1687 1686 1513 1143  526  528  307   78   77
 213  438  655  864 1065 1258 1443 1620 1789 1950 2103 2248 2385 2514 2635 2748 2853 2950 3039 3120 3122 3043 3123 3195 3045 3197 3049 3199 3200 3130 3203 3131 3133 3134 3135 3136 3137 3138 3139 3062 2977 2884 2783 2674 2431 2558 2158 2159 2156 1852 1688 1514 1333 1331 1144 1145  742  309   79
 212  437  654  863 1064 1257 1442 1619 1788 1949 2102 2247 2384 2513 2634 2747 2852 2949 3038 3119 3192 3255 3193 3259 3124 3263 3126 3262 3318 3264 3201 3132 3204 3205 3206 3207 3208 3209 3140 3063 2978 2885 2785 2784 2557 2303 2433 2432 2161 1335 2011 1515 1334  948 1146  741  532  529  308
 211  436  653  862 1063 1256 1441 1618 1787 1948 2101 2246 2383 2512 2633 2746 2851 2948 3037 3118 3191 3121 3256 3194 3258 3261 3198 3316 3366 3319 3317 3202 3266 3267 3269 3270 3271 3210 3141 3064 2979 2886 2675 2676 2559 2434 2436 2301 1855 2010 1854 1517  949  744  947  531  743  533   80
 210  435  652  861 1062 1255 1440 1617 1786 1947 2100 2245 2382 2511 2632 2745 2850 2947 3036 3116 3117 3190 3312 3196 3257 3315 3260 3363 3365 3404 3265 3320 3322 3268 3324 3325 3272 3211 3142 3065 2980 2887 2786 2678 2677 2305 2302 2166 2160 1689 1692 1516  951 1691  746  530  310   81   85
 209  434  651  860 1061 1254 1439 1616 1785 1946 2099 2244 2381 2510 2631 2744 2849 2945 2946 3035 3189 3254 3311 3360 3313 3361 3362 3435 3403 3364 3367 3369 3410 3371 3273 3327 3409 3212 3143 3066 2981 2888 2562 2435 2439 2560 1853 2012 2162 1856 2300 1148 1147 1336  745  747  311   82  313
 208  433  650  859 1060 1253 1438 1615 1784 1945 2098 2243 2380 2509 2630 2743 2848 2944 3034 3115 3188 3253 3310 3359 3314 3400 3402 3457 3434 3405 3321 3370 3323 3330 3373 3372 3326 3214 3213 3067 2982 2889 2790 2787 2680 1690 2304 2437 2789 2014 1518 1337 1696  952  950  953  314  312   83
 207  432  649  858 1059 1252 1437 1614 1783 1944 2097 2242 2379 2508 2629 2742 2847 3033 3114 3187 3186 3252 3309 3358 3401 3456 3432 3436 3459 3407 3368 3439 3408 3441 3275 3328 3329 3274 3144 3068 2983 2984 2016 2306 2441 2561 2017 1693 1519 1857 2015 1341 1520 1338 1149  536  534  748  535
 206  431  648  857 1058 1251 1436 1613 1782 1943 2096 2241 2378 2507 2628 2741 2846 2943 3032 3113 3185 3251 3308 3357 3399 3430 3431 3472 3476 3458 3438 3460 3440 3374 3411 3278 3276 3145 3215 2985 2891 2681 2890 2788 2163 2442 2164 2013 2679 1860 1521 1344 1150 1339  955  537   86   84  317
 205  430  647  856 1057 1250 1435 1612 1781 1942 2095 2240 2377 2506 2627 2740 2845 2942 3031 3112 3250 3307 3306 3356 3398 3433 3471 3473 3406 3437 3443 3461 3413 3331 3375 3277 3147 3281 3146 3148 3070 2792 2892 2565 2563 2438 2307 2165 1858 1695 1152 1697 1340 1342  956  315  538  751   87
 204  429  646  855 1056 1249 1434 1611 1780 1941 2094 2239 2376 2505 2626 2739 2844 2941 3030 3111 3184 3249 3355 3396 3397 3428 3455 3454 3480 3462 3474 3475 3464 3377 3376 3217 3216 3072 2986 2988 2987 2683 2893 2682 2440 2167 2564 2443 1694 1859 2168 1525 1699  954  750  753  749  316   89
 203  428  645  854 1055 1248 1433 1610 1779 1940 2093 2238 2375 2504 2625 2738 2843 2940 3029 3110 3183 3248 3305 3354 3395 3453 3429 3470 3479 3477 3442 3444 3415 3412 3220 3414 3279 3071 3150 3218 2894 2791 2685 2566 2684 2308 2309 1524 1863 1861 2019 2018 1523 1526 1151 1343 1153  539   90
 202  427  644  853 1054 1247 1432 1609 1778 1939 2092 2237 2374 2503 2624 2737 2842 2939 3028 3109 3182 3247 3304 3353 3394 3427 3452 3478 3469 3468 3467 3419 3420 3416 3417 3378 3282 3151 3280 3069 2989 2990 2794 2793 2567 2686 2311 2444 2022 1155 1862 1522  957 1527  958  752  540   88   92
 201  426  643  852 1053 1246 1431 1608 1777 1938 2091 2236 2373 2502 2623 2736 2841 2938 3027 3108 3181 3246 3303 3352 3393 3426 3450 3423 3448 3466 3447 3421 3463 3335 3380 3418 3334 3337 3149 3153 3073 2895 2896 2795 2570 2568 2569 2310 2312 2169 1698  960 1528 1158  541   91  544  755  754
 200  425  642  851 1052 1245 1430 1607 1776 1937 2090 2235 2372 2501 2622 2735 2840 2937 3026 3107 3180 3245 3302 3351 3392 3425 3424 3451 3422 3449 3386 3383 3446 3336 3382 3332 3333 3219 3074 2897 2992 2898 2796 2687 2571 2445 2023 2020 2170 2447 1700 1865 1157  759 1154  959 1345  318  319
 199  424  641  850 1051 1244 1429 1606 1775 1936 2089 2234 2371 2500 2621 2734 2839 2936 3025 3106 3179 3244 3301 3350 3391 3390 3346 3344 3389 3387 3342 3379 3287 3286 3381 3284 3285 3075 3221 3077 3076 2991 2689 2797 2688 2313 2172 2171 1864 2021 1701 1346  961   93  542  545  321  546  320
 198  423  640  849 1050 1243 1428 1605 1774 1935 2088 2233 2370 2499 2620 2733 2838 2935 3024 3105 3178 3243 3300 3349 3348 3347 3345 3294 3388 3343 3385 3384 3465 3339 3445 3159 3224 3283 3222 3152 3154 2899 2798 2691 2446 2574 2314 2024 1866 1868 1702 1867 1347 1529  760  543  758  756   95
 197  422  639  848 1049 1242 1427 1604 1773 1934 2087 2232 2369 2498 2619 2732 2837 2934 3023 3104 3177 3242 3299 3298 3238 3297 3295 3293 3234 3292 3232 3290 3340 3230 3341 3227 3156 3223 3155 3157 2993 2572 2575 2902 2450 2315 2449 2173 2025 1704 1530 1350 1156  963  962  964   94  322  324
 196  421  638  847 1048 1241 1426 1603 1772 1933 2086 2231 2368 2497 2618 2731 2836 2933 3022 3103 3176 3241 3240 3239 3170 3296 3168 3093 3167 3235 3231 3233 3289 3288 3161 3338 3158 3226 2999 3225 2799 2800 2690 2573 2801 2448 2175 2174 1870 1703 1161 1160 1348 1349  326  966  547   96  325
 195  420  637  846 1047 1240 1425 1602 1771 1932 2085 2230 2367 2496 2617 2730 2835 2932 3021 3102 3175 3099 3174 3171 3097 3237 3236 3169 2917 3291 3165 3090 3229 3088 3002 3080 3228 3079 2903 2995 3078 2900 2802 2694 2692 2576 2451 2317 1869 2027 1352 1531 1159 1162  757  761   97  323   99
 194  419  636  845 1046 1239 1424 1601 1770 1931 2084 2229 2366 2495 2616 2729 2834 2931 3020 3101 3100 3173 3098 3172 3013 3096 3095 3094 3166 3091 3089 3006 3086 3160 3085 3000 3082 3084 2908 3081 2994 2901 2803 2452 2695 2318 2028 2176 1706 1705 2026 1533 1351 1164 1353  965  967   98  327
 193  418  635  844 1045 1238 1423 1600 1769 1930 2083 2228 2365 2494 2615 2728 2833 2930 3019 3018 3017 3016 3015 2923 3014 3010 3009 3011 3092 2914 3164 3007 3162 3163 2814 3005 3001 2998 2809 2588 2997 2996 2904 2580 2320 2178 2319 2029 2177 1707 1532 1708 1163 1165  763  762  548  549  328
 192  417  634  843 1044 1237 1422 1599 1768 1929 2082 2227 2364 2493 2614 2727 2832 2929 2928 2927 2926 2925 2825 2924 2824 2918 3012 2920 2919 3008 2815 2817 3003 2913 2912 2811 2911 2808 2909 3083 2907 2693 2804 2579 2696 2453 2316 2578 2030 1873 1872 1536 1535  968  969  550  551  329  100
 191  416  633  842 1043 1236 1421 1598 1767 1928 2081 2226 2363 2492 2613 2726 2831 2830 2829 2828 2827 2826 2718 2823 2922 2822 2819 2921 2712 2916 2711 2710 3087 3004 2706 2813 2910 2702 2810 2906 2586 2905 2577 2582 2699 2454 2455 2321 2181 1709 1534 1871 1355 1354 1166  765  764  330  101
 190  415  632  841 1042 1235 1420 1597 1766 1927 2080 2225 2362 2491 2612 2725 2724 2723 2722 2721 2720 2719 2715 2717 2600 2716 2476 2602 2713 2820 2818 2595 2816 2915 2709 2592 2589 2465 2333 2703 2807 2585 2584 2806 2805 2697 2323 2322 1874 2032 1537 1538 1356  970  971  766  552  331  102
 189  414  631  840 1041 1234 1419 1596 1765 1926 2079 2224 2361 2490 2611 2610 2609 2608 2607 2606 2605 2604 2603 2478 2346 2601 2821 2596 2205 2714 2597 2593 2707 2591 2197 2336 2812 2701 2463 2332 2700 2698 2328 2583 2581 2457 2458 1877 2033 1711 1876 1359 1357 1167 1169  767  553  332  103
 188  413  630  839 1040 1233 1418 1595 1764 1925 2078 2223 2360 2489 2488 2487 2486 2485 2484 2483 2482 2350 2481 2480 2344 2207 2474 2599 2200 2203 2472 2469 2708 2468 2049 2198 2705 2704 2047 2587 2462 2460 2329 1722 2187 2456 2179 2180 2324 2031 1710 1540 1358 1168  972  554  555  333  104
 187  412  629  838 1039 1232 1417 1594 1763 1924 2077 2222 2359 2358 2357 2356 2355 2354 2353 2352 2351 2211 2349 2479 2348 2208 2204 2477 2206 2340 2342 2473 2470 2337 2471 1898 2464 2193 2195 2335 2331 2330 2461 2327 2040 2325 2186 2183 2035 2182 1712 1713 1539 1170  974  973  768  334  105
 186  411  628  837 1038 1231 1416 1593 1762 1923 2076 2221 2220 2219 2218 2217 2216 2215 2214 2213 2212 2210 2063 1907 2209 2347 2061 2057 2343 2594 2598 2201 1897 2339 2196 2466 2334 2467 2194 2192 2459 2042 2191 2190 2043 1888 2326 2184 2037 2034 1875 1714 1715  975 1171  769  556  335  106
 185  410  627  836 1037 1230 1415 1592 1761 1922 2075 2074 2073 2072 2071 2070 2069 2068 2067 2066 2065 2064 1744 2062 2060 2059 1903 2475 2202 1900 2341 2054 2199 2051 2338 1892 1895 2590 1894 1560 2046 2045 1887 2189 2188 2039 2185 1882 1884 1879 1878 1541 1360 1172  976  770  337  109  336
 184  409  626  835 1036 1229 1414 1591 1760 1921 1920 1919 1918 1917 1916 1915 1914 1913 1912 1911 1910 1909 1908 1906 1572 1905 2345 1904 2055 1738 1901 2053 2052 1899 1733 2050 1896 1194 1729 1891 1730 2044 1890 2041 2038 1883 1886 1881 2036 1716 1880 1542 1361 1175  771  977  558  557  107
 183  408  625  834 1035 1228 1413 1590 1759 1758 1757 1756 1755 1754 1753 1752 1751 1750 1749 1748 1747 1746 1745 1573 1743 1742 1741 2056 1740 2058 1736 1737 1735 1734 1561 1893 1562 1559 2048 1728 1727 1554 1726 1725 1885 1724 1720 1719 1547 1543 1717 1362 1544 1363  980 1173  338  560  108
 182  407  624  833 1034 1227 1412 1589 1588 1587 1586 1585 1584 1583 1582 1581 1580 1579 1578 1577 1397 1576 1575 1574 1571 1570 1390 1739 1902 1567 1199 1385 1565 1564 1732 1383 1195 1381 1731 1378 1889 1556 1374 1375 1553 1721 1552 1550 1549 1718 1368 1546 1176 1174 1364  772  773  339  110
 181  406  623  832 1033 1226 1411 1410 1409 1408 1407 1406 1405 1404 1403 1402 1401 1400 1399 1398 1210 1396 1395 1394 1393 1392 1569 1203 1388 1389 1387 1566 1386 1563 1384  998 1193 1557 1558 1190  995 1188 1555 1372 1723 1551 1184 1371 1548 1367 1366 1545 1365  978  979  774  559  563  113
 180  405  622  831 1032 1225 1224 1223 1222 1221 1220 1219 1218 1217 1216 1215 1214 1213 1212 1016 1211 1209 1208  809 1207 1205 1391 1008 1202 1568 1006 1200 1198 1002 1196  999  795 1382 1379 1377 1189  580 1376  788 1373 1186 1185 1370 1369 1181 1180 1179 1178 1177  775  562  342  341  340
 179  404  621  830 1031 1030 1029 1028 1027 1026 1025 1024 1023 1022 1021 1020 1019 1018 1017 1015 1014 1013 1012 1206 1011  806 1204 1009 1201 1005  802 1197 1004  370  797 1001  796 1380 1192 1191  994  993  578 1187  358  787  987  785 1182  986  985  984  982  780  981  343  561  111  114
 178  403  620  829  828  827  826  825  824  823  822  821  820  819  818  817  816  815  814  813  812  811  810  808  807  595 1010  805  592 1007  803  800 1003 1000  798  586  997  996  361  582  793  581  991  992  990  575  786 1183  988  783  782  781  983  567  348  566  777  778  115
 177  402  619  618  617  616  615  614  613  612  611  610  609  608  607  606  605  604  603  602  601  600  599  598  597  596  594  593  804  591  590  801  371  799  140  367  588  794  585  584  790  579  360  789  577  357  989  355  784  573  571  570  569  779  346  347  776  112  344
 176  401  400  399  398  397  396  395  394  393  392  391  390  389  388  387  386  385  384  383  382  381  380  379  378  377  376  375  374  373  372  589  369  587  139  138  137  366  791  583  365  362  133  359  576  131  127  128  574  572  352  351  350  568  349  120  565  564  116
 175  174  173  172  171  170  169  168  167  166  165  164  163  162  161  160  159  158  157  156  155  154  153  152  151  150  149  148  147  146  145  144  143  368  142  141  364  136  792  363  135  134    0  132  130  129  356  354  353  126  125  124  123  122  121  119  345  118  117
