# This puzzle is unsolvable
20
 79  78   2   4   7 206  83   8  85 157  10  14  87  13  15 158  17  20 216  95
  1  75   3 144 148   6  86   9  84 307  12  11 214  88  16  90  92  94  18 161
145  74  77  76   5 301 150 152 151 212 153 262 267 211  93  89  21 160  19  22
146 143 141 259 207 257 255  82 209 263 264 308   0 312 310 155  24 222 159  96
140 205 203  81  80 338 149 336 261 389 265 364 213 165  97 156 313 218 220  23
 73 256 200 204 208 299 339 147 305 340 366 154 342 317 215 162 271 163  25 103
 70 201 202 254 142 392 335 258 210 303 369 276 391 101 311  91 166 219 309  98
 72 139 199 337 253 384 297 367 260 365 266 343 396 268 221 269 100 272  27  99
 71 198 298 252 288 302 368 306 374 381 397 344 346 341 273 164 270 168 167  26
138 251  68 135 294 334 386 327 304 390 394 385 387 105 345 228 169  29  28 104
 69 331 248 137 300 359 380 393 382 314 348 363 352  31 347 349 217 275 372  30
 64 131 362 332 197 360 379 354 356 295 371 383 370 227 279 170 223 226 177 102
 63 134 291 296 196 195 188 326 240 399 333 278 388 237 353  35 274 107 111 106
244 292 190 329  66 395 126 324 323 325 355 241 398 230 378 109 108  34 231 225
 67 249  65 247 328 132 357 286 242 250 136 320 373 321 233 283 116 350 224 277
193 330 191 133 285 358 361 185 235 290 238 289 351 281 375  43 171 315  33  32
 61  62 243 246 192 377  52 184 322 293 183 182  47 174 115 172 319 229  36 232
 60 130 194 125 186 236 287 187  53 284 239  49 316 234 181 280 176  37 110  38
128  58 129 127 123  51 121  50 122 179  46 318 376 119  45 113  44 175  42  41
 56  55  59 189 245  57 124  54 180 118 120  48 114 117 282 112 178  40 173  39
