# This puzzle is unsolvable
54
   2    1    3    4    5    6    7    9  218   10  220   11   13   14   15   16   17   18  230   20   21   23  234   24   25   26  238   29   30  241   31   32   33   34   36  247  246   37   39   40   41   42  458   43   45  259   46   47   49   51  262   52   53   54
 212  213  214  215  216  217  616  421    8  424  426   12  224  225  226  227  228  229  231   19  436  435  632  235  236  441   28   27  240  242  243  446  244  245   35  249   38  250  454  649  251   44  257  456  255  256  461  462  260  261   50  263  265  264
 211  416  417  418  419  420  422  804  618  221  222  223  427  428  429  430  431  432  433  434  232   22  438  635  821  440  636  239  442  443  444  640  447  449  450  451  248  453  452  252  455  253  654 1016  839  656  842  258  657   48  465  466  266   55
 210  415  612  613  614  615  617  805  423  219  425  808  623  809  624  625  626  627  628  629  437  233  630  439  237  822  824  825  639  445  827  828  641  448  644  645  834  647 1014  648  651  838  457  254  459  460  843  655  658  463  660  467   58   56
 209  414  611  800  801  802  803  983  984  807  621  620  622  989  810  812  813  814  815  816  817  631  998  634  819  823  638  637 1004  826 1006 1007  830  643  831  833  646  835  650  836  837  840  652 1019  653  841 1022  844  464  659  847  661  267   57
 208  413  610  799  980  981  982 1154  985  619  806  987 1159  988  811  990  992  993  994  995  996  818  997  633  820  999 1001 1002 1003 1005 1178 1341  642 1009 1010  832 1183 1012 1013 1349 1017 1018 1020 1190 1021 1193 1356  846  848  845  269  470  268   59
 207  412  609  798  979 1152 1153 1155 1319  986 1156 1321 1477 1160 1161  991 1163 1164 1165 1166 1167 1168 1169 1170 1000 1173 1335 1337 1174 1175 1340 1177  829 1180 1181 1011 1182 1184 1186 1504 1015 1188 1189 1191 1354 1192 1194 1023 1024  662  663  469  270   60
 206  411  608  797  978 1151 1316 1318 1472 1474 1158 1157 1478 1324 1325 1162 1326 1327 1328 1329 1330 1331 1332 1333 1171 1334 1172 1336 1338 1176 1179 1496 1008 1343 1499 1346 1347 1185 1348 1350 1187 1352 1353 1508 1511 1510 1355 1195 1025  849  664  468  471   61
 205  410  607  796  977 1150 1315 1317 1473 1621 1320 1475 1476 1323 1480 1627 1481 1482 1483 1484 1485 1486 1487 1488 1489 1490 1492 1639 1494 1339 1495 1497 1342 1645 1345 1344 1500 1501 1502 1651 1505 1654 1506 1507 1656 1357 1196 1027 1026  850  665  472  271   62
 204  409  606  795  976 1149 1314 1471 1622 1620 1623 1322 1765 1624 1479 1894 1628 1629 1630 1631 1632 1633 1634 1635 1636 1637 1491 1640 1493 1641 1642 1643 1498 1644 1646 1647 1787 1648 1503 1650 2159 1792 1351 1925 1657 1512 1358 1197 1028  851  666  473  272   63
 203  408  605  794  975 1148 1313 1470 1761 1760 1892 1764 2016 1625 2019 1626 1767 1768 1769 1770 1771 1772 1773 1774 1775 1776 1638 1777 1779 1780 1781 1782 1783 1784 1785 1788 1790 1649 1920 1653 1794 1655 1795 1509 1793 1658 1199 1030 1198  852  667  474  273   64
 202  407  604  793  974 1147 1312 1469 1619 1618 1890 2018 1762 1896 1897 1766 1898 1899 1900 1901 1902 1903 1904 1905 1906 1908 1909 1778 2033 1911 1912 1913 1914 1915 1917 1786 1918 1919 1921 1791 1652 2045 1922 1796 1659 1360 1362 1200 1029  853  668  475  274   65
 201  406  603  792  973 1146 1311 1468 1617 1759 1757 1891 1763 1893 2133 2135 2020 2023 2138 2024 2025 2027 2142 2028 2030 1907 2031 1910 2032 2034 2035 2037 2151 2038 1916 2039 2041 2042 1923 2043 2156 1789 2046 2047 1514 1359 1361 1031  854  669  476  477  275   66
 200  405  602  791  972 1145 1310 1467 1616 1758 1889 2132 1895 2015 2342 2022 2243 2021 2140 2141 2245 2026 2248 2143 2029 2145 2146 2147 2148 2149 2150 2036 2152 2154 2155 2040 2263 2157 2158 2267 1924 2048 2044 1797 1513 1660 1515 1201 1032  855  670  478  276   67
 199  404  601  790  971 1144 1309 1466 1615 1756 1888 2014 2017 2241 2134 2341 2432 2137 2139 2343 2247 2246 2348 2250 2144 2252 2254 2353 2255 2256 2531 2257 2356 2153 2361 2535 2262 2364 2162 2264 2160 2161 1927 1798 1516 1364 1517 1363 1033  856  672  671  277   68
 198  403  600  789  970 1143 1308 1465 1614 1755 1887 2130 2240 2131 2242 2340 2433 2136 2520 2344 2346 2347 2349 2440 2350 2251 2253 2354 2445 2259 2529 2358 2260 2261 2359 2452 2362 2365 2265 2266 2165 2164 1929 1662 1664 1518 1926 1202 1203 1034  857  479  278   69
 197  402  599  788  969 1142 1307 1464 1613 1754 1886 2013 2237 2129 2238 2339 2431 2244 2434 2436 2249 2438 2596 2523 2351 2442 2352 2444 2446 2357 2355 2450 2258 2607 2533 2360 2610 2363 2163 2050 2051 1930 1932 1928 1799 1365 1205 1366 1035  858  673  480  279   70
 196  401  598  787  968 1141 1306 1463 1612 1753 2011 2012 2128 2239 2338 2516 2517 2592 2435 2519 2345 2439 2521 2524 2441 2525 2601 2528 2530 2603 2671 2448 2605 2451 2536 2609 2537 2454 2366 2268 2052 1800 2049 1663 1665 1519 1204 1206 1036 1037  674  675  280   71
 195  400  597  786  967 1140 1305 1462 1611 1752 2010 2127 2235 2236 2336 2430 2515 2593 2660 2518 2437 2594 2595 2597 2599 2443 2602 2527 2670 2672 2734 2532 2447 2608 2449 2453 2534 2456 2167 2455 2367 2166 1931 1666 1520 1367 1368 1661  860  859  482  481  281   72
 194  399  596  785  966 1139 1304 1461 1610 1751 1885 2009 2125 2234 2126 2337 2514 2591 2661 2662 2772 2663 2665 2666 2522 2526 2729 2728 2668 2732 2604 2783 2675 2674 2676 2611 2270 2368 2269 2168 2053 1933 1802 1801 1803 1521 1207 1038  677  676  862  484  483   73
 193  397  398  784  965 1138 1303 1750 1883 1881 1884 2007 2008 2335 2428 2429 2513 2590 2659 2721 2773 2852 2726 2667 2724 2600 2725 2727 2731 2730 2779 2826 2673 2612 2681 2735 2538 2271 2459 2369 2272 2055 2054 1804 1805 1667 1522 1208 1039  861 1040  283  485  488
 192  783  782  593  964 1137 1459 1609 1460 1748 1608 1882 2124 2233 2334 2427 2512 2589 2658 2720 2816 2775 2664 2817 2598 2777 2822 2778 2824 2780 2606 2680 2786 2678 2458 2540 2677 2457 2539 2371 2169 1934 1936 1935 1669 1523 1369 1370 1041  865  863  282   75   74
 191  595  962  780  963 1136 1302 1301 1607 1300 1749 2006 2123 2232 2333 2426 2511 2588 2657 2719 2718 2774 2723 2880 2854 2776 2821 2823 2669 2781 2782 2825 2785 2679 2613 2733 2614 2460 2370 2273 2274 2056 1806 1807 1668 1524 1371 1209 1042  679  486  285  678  286
 190  396  594  591  781 1134 1135 1457 1606 1747 1880 2122 2121 2231 2332 2425 2510 2587 2656 2717 2771 2770 2722 2848 2819 2883 2820 2857 2912 2904 2859 2860 2736 2784 2738 2615 2541 2461 2372 2275 2170 2057 1937 1808 1670 1526 1525 1210 1211 1043  864  680  289   76
 189  394  592  590  961 1458 1605 1456 1746 1879 2004 2005 2120 2230 2331 2508 2424 2586 2655 2716 2769 2815 2818 2853 2850 2856 2855 2885 2858 2886 2828 2827 2787 2682 2617 2616 2542 2462 2374 2373 2172 2171 2058 1938 1671 1373 1213 1372 1212 1044   77  682  290  284
 392  395  777  779 1132 1133 1299 1455 1604 1745 1878 2003 2119 2330 2423 2422 2509 2585 2654 2715 2813 2814 2851 2881 2878 2882 2903 2884 2887 2888 2861 2862 2829 2831 2618 2544 2543 2375 2463 2059 2173 1939 1810 1809 1672 1527 1375 1374  867  287   79  293  866  288
 187  188  588 1131  778 1297 1454 1298 1603 1744 1877 2002 2118 2228 2229 2329 2507 2584 2653 2714 2768 2811 2812 2900 2901 2899 2902 2905 2911 2915 2863 2790 2737 2740 2791 2685 2789 2619 2278 2376 2276 2279 1940 1811 1673 1528 1376 1214  681  684  489  490   78  487
 391  393  389  960 1129  957 1296 1453 1602 1743 1876 2001 2117 2227 2328 2421 2506 2583 2652 2713 2767 2766 2877 2849 2909 2898 2910 2913 2914 2890 2889 2864 2830 2788 2739 2547 2546 2545 2465 2377 2277 2060 2061 1812 1674 1529 1048 1217 1045  869  491   81   82  683
 390  776  586  956  585  589 1295 1451 1452 1742 1875 2000 2116 2226 2327 2420 2505 2582 2651 2712 2765 2810 2847 2876 2879 2897 2908 2907 2906 2891 2865 2832 2742 2683 2741 2621 2548 2743 2281 2280 2174 2176 1942 1941 1675 1676 1531 1216 1047  870  868  685   80  292
 186  184  185  775  958  959 1130 1128 1601 1600 1874 1999 2115 2225 2326 2419 2504 2581 2650 2711 2764 2809 2846 2875 2896 2895 2894 2893 2869 2892 2866 2833 2792 2686 2622 2552 2620 2466 2550 2464 2062 2063 1943 1814 1813 1379 1530 1046 1215  871  494  291  492  294
 183  388  587  953  774  954 1294 1293 1599 1741 1740 1873 1998 2224 2325 2418 2503 2580 2649 2710 2763 2808 2845 2874 2873 2872 2871 2870 2838 2868 2867 2834 2793 2744 2684 2549 2470 2689 2282 2175 2064 2179 2067 1944 1677 1532 1377 1049 1219  687  686  493  495   83
 182  387  584  583 1127  955 1292 1450 1598 1739 1872 1997 2114 2223 2324 2417 2502 2579 2648 2709 2762 2807 2844 2843 2842 2841 2840 2800 2839 2837 2836 2835 2795 2794 2745 2468 2687 2378 2625 2178 2066 2181 2065 1815 1816 1678 1218 1378  874  872  296  873  688   84
 181  386  771  582  772 1126 1291 1449 1448 1738 1871 1996 2113 2222 2323 2416 2501 2578 2647 2708 2761 2806 2805 2804 2756 2803 2802 2801 2799 2798 2797 2796 2746 2690 2623 2691 2551 2380 2467 2284 2283 2068 2288 1679 1536 1534 1533 1051 1050  875  691  497   86   85
 180  385  580  952  773 1290 1447 1596 1597 1737 1870 1995 2112 2221 2322 2415 2500 2577 2646 2707 2760 2759 2758 2757 2755 2754 2699 2753 2752 2751 2750 2749 2692 2747 2688 2379 2471 2469 2177 2381 2180 1947 1946 1945 1680 1381 1380 1220 1221 1054  689  877  499   87
 179  384  770  581 1124 1125 1289 1446 1595 1736 1869 1994 2111 2220 2321 2414 2499 2576 2645 2706 2705 2704 2703 2639 2702 2701 2700 2698 2697 2696 2695 2631 2748 2693 2628 2624 2472 2383 2287 2286 1948 1949 1817 1681 1537 1535 1382 1053  876 1052  690  498  496  297
 178  383  579  769  951  950 1288 1445 1594 1735 1868 1993 2110 2219 2320 2413 2498 2575 2644 2643 2642 2641 2640 2568 2638 2637 2636 2635 2634 2633 2632 2560 2694 2629 2627 2626 2553 2473 2382 2384 2285 2183 2071 1819 1682 1818 1383 1222 1223  692  500   88  298  295
 177  381  382  768 1122 1123 1287 1444 1593 1734 1867 1992 2109 2218 2319 2412 2497 2574 2573 2572 2571 2570 2569 2489 2567 2566 2565 2564 2563 2562 2561 2559 2630 2558 2555 2556 2554 2385 2289 2386 2182 2070 1820 1538 1385 1384 1386 1224 1055  878  693   89   90  300
 176  578  767  948  949 1121 1286 1443 1592 1733 1866 1991 2108 2217 2318 2411 2496 2495 2494 2493 2492 2309 2403 2307 2402 2487 2486 2485 2484 2483 2482 2481 2480 2479 2557 2478 2476 2474 2475 2387 2069 1951 2185 2072 1821 1540 1057 1226 1056  879  694  501  299   91
 175  380  577  766  947 1120 1285 1442 1591 1732 1865 1990 2107 2216 2317 2410 2409 2408 2407 2406 2310 2405 2490 2404 2488 2400 2399 2398 2397 2396 2197 2395 2392 2297 2390 2477 2294 2388 2290 2184 1950 1952 1684 1683 1539 1685 1387 1225  880  695  502  301  302   92
 174  379  576  765  946 1119 1284 1441 1590 1731 1864 1989 2106 2215 2316 2315 2314 2313 2312 2208 2311 2308 2491 2306 2401 2305 2304 2303 2302 2301 2394 2299 2393 2296 2391 2295 2293 2389 2292 2291 2186 2073 1953 1687 1822 1686 1541 1388 1058  696  882  503  303   93
 173  378  575  764  945 1118 1283 1440 1589 1730 1863 1988 2105 2214 2213 2212 2211 2210 2209 2207 2206 2095 2205 2204 2203 2202 2201 2200 2199 2198 2196 2300 2298 2195 2194 2193 2191 2190 2189 2188 2187 2074 1954 1824 1823 1542 1389 1227 1059  881  698  504   95  304
 172  377  574  763  944 1117 1282 1439 1588 1729 1862 1987 2104 2103 2102 2101 2100 2099 2098 2097 2096 1976 2093 1847 2092 2091 2089 1970 2088 2087 2086 2085 2084 2082 2081 2192 2080 2079 2078 2076 1957 1956 2075 1825 1688 1391 1543 1228 1229  883  699  505  697   94
 171  376  573  762  943 1116 1281 1438 1587 1728 1861 1986 1985 1984 1983 1982 1981 1980 1979 1978 1977 1975 1974 2094 1846 1973 2090 1415 1969 1968 1840 1967 1966 2083 1964 1962 1961 1960 1959 2077 1830 1828 1955 1826 1689 1390 1230 1061 1060  884  700  506  305   96
 170  375  572  761  942 1115 1280 1437 1586 1727 1860 1859 1858 1857 1856 1855 1854 1853 1852 1851 1715 1849 1713 1848 1972 1845 1843 1971 1841 1706 1703 1965 1408 1838 1837 1963 1834 1832 1831 1958 1694 1829 1693 1690 1545 1544 1546 1231 1062  885  701  507  306   97
 169  374  571  760  941 1114 1279 1436 1585 1726 1725 1724 1723 1722 1721 1719 1718 1717 1423 1572 1573 1716 1850 1569 1712 1711 1710 1844 1842 1088 1705 1559 1839 1702 1701 1836 1700 1699 1696 1698 1695 1551 1550 1827 1691 1393 1392 1232 1063  887  886  508  307   98
 168  373  570  759  940 1113 1278 1435 1584 1583 1582 1581 1580 1579 1578 1720 1576 1575 1571 1421 1262 1714 1570 1260 1567 1090 1414 1563 1416 1253 1562 1561 1704 1409 1556 1835 1405 1404 1555 1554 1401 1552 1398 1692 1548 1547 1394 1233 1064  888  702  509  308   99
 167  372  569  758  939 1112 1277 1434 1433 1432 1431 1430 1429 1428 1426 1577 1267 1574 1424 1263 1422 1417 1420 1568 1565 1564 1087 1708 1707 1413 1560 1084 1249 1250 1558 1833 1407 1245 1553 1697 1076 1400 1399 1549 1397 1396 1395 1234 1065  889  703  510  309  100
 166  371  568  757  938 1111 1276 1275 1274 1273 1272 1271 1270 1269 1427 1266 1425 1098 1265 1264 1261 1259 1258 1419  733 1566 1709 1085  911 1412 1251 1557  728 1083 1248 1406 1247 1074 1244 1078  717 1241 1240 1239 1238 1237 1236 1235 1066  890  511  512  310  101
 165  370  567  756  937 1110 1109 1108 1107 1106 1105 1104 1103  927 1268 1101 1100 1097  739 1096  921 1095 1094  736 1418  916 1255 1089 1086 1411  537  907  724 1410  906  721 1082 1246  903 1402  901 1077 1073 1072 1071 1070 1069 1068  891  708  704  313  102  103
 164  369  566  755  936  935  934  933  932  931  930  929  928  744 1102  925 1099  924  922  546  738 1092  737  918 1093  732  914 1256  912 1254  538 1252 1081  531  908  332 1080  905  718 1403 1075 1242  899  898  897  896  710  892 1067  705  514  311  706  104
 163  368  565  754  753  752  751  750  749  748  747  746  745  743  552  926  742  741  923  544  349  347  735  734  342  542  535  731 1257  726  340  910  335  727  904  720  723  722 1243  524  117  523  527  715  324  895  520  894  709  707  312  515  513  105
 162  367  564  563  562  561  560  559  558  557  556  555  554  553  353  551  550  740  920  548  345 1091  919  344  917  539  730  536  343  131  541  338  725  126  334  125  719  123  528  329  526  326  716  893  325  712  521  519  518  111  517  516  314  106
 161  366  365  364  363  362  361  360  359  358  357  356  355  147  354  352  351  350  348  547  346  140  545  137  543  915  134  132  729  909  533  127  337  333  532  534 1079  122  328  900  529  525  714  713  114  115  711  522  321  319  318  317  107  108
 160  159  158  157  156  155  154  153  152  151  150  149  148  146    0  145  144  143  142  549  139  141  138  136  135  133  540  341  913  339  130  129  128  336  530  327  124  330  121  331  902  120  119  118  116  323  322  320  113  112  110  316  109  315
