# This puzzle is unsolvable
11
 45  95  88  76  35   3 104  52   5  48  50
  1  97  62  43  94  40  46 111   9  14   8
 41  98   6  80 109  39  74  53   7  81 115
119  90  93  99  21 102  51  79  58  77 116
 37  28 108  44  89  75  23  18  85  10 120
110  73   2  57  65   4  27  15 100  61  71
 36  68 114 106  12  13  38  49  19 113   0
 60  32 105  34  42  92  67 103  20  47  78
101  64 107  31  33  69  63  25  83  82  11
 84  96  91  22  66  56  54  55 117  86  30
112  70  26  72 118  29  17  24  16  87  59
