# This puzzle is unsolvable
53
   2    1    3    4    5    6    7    8   10   11   12   13   14   15  222   16   18   17   19  427   21   23  230   24   26  233  981  432   29   30   31   32   33   34   35   36   37   38   39   40   41  250   42   45  252   46   47   48   49   50   51   52   53
 208  209  210  211  212  213  214  215    9  217  218  219  220  420  421  221  223  225  226   20  227   22  620  429  430   27  236  232  626  237  438  238  240  241  242  243  244  245  246  247  248  249  449   44  253  451  254  255  256  257  258  259   54
 207  408  409  410  411  412  413  414  216  417  608  418  610  419  422  224  614  423  615  426  425  229  431  804  231  234  808   28  235  436  437  239  439  440  441  442  443  635  444  446  447   43  450  251  643  453  454  645  455  456  457  260   55
 206  407  600  601  602  603  604  605  415  606  416  609  793  611  795  613  616  798  801  424  617  428  621  622   25  625  434  433  810  435  629  627  630  631  632  633  634  445  819  637  638  640  448  822  641  452  644  828  646  647  458  261   56
 205  406  599  784  785  786  787  788  789  965  607  792  967  794  796  612  797  975  974  228  799  802 1146  619  805  624  807  809  811  628  812  813  988  814  815  816  817  818  820  636  821  639  823  824  642  825  827  829  830  648  459   57   58
 204  405  598  783  960  961  962 1130  963  791  966  790  968  969  970  971 1139  973 1142  800  618 1143  977  803  623  979 1147  983  984  985  986 1154  987  989  990  991  992 1160  994  993  997 1166  998 1165 1000  826 1002  462  650  649  262  263  264
 203  404  597  782  959 1128 1129  964 1132 1133 1134 1135 1294 1136 1295 1140  972 1138 1141 1452  976 1302 1145  980  806 1149  982 1309 1150 1152 1151 1153 1155 1156 1157 1158 1159 1161 1162  995  996 1163 1164  999 1326 1001 1169 1003 1004  831  463  461  460
 202  403  596  781  958 1127 1288 1290 1131 1291 1292 1293 1446 1137 1296 1298 1301 1449 1144 1303 1454 1455  978 1305 1456 1148 1308 1460 1310 1462 1311 1313 1314 1315 1317 1467 1318 1319 1321 1472 1322 1475 1324 1323 1325 1168 1170  832  651  265   60   62   59
 201  402  595  780  957 1126 1287 1289 1440 1442 1443 1444 1445 1589 1447 1297 1592 1299 1450 1300 1451 1597 1304 1599 1306 1307 1459 1603 1461 1605 1312 1463 1464 1466 1316 1468 1469 1470 1320 1473 1474 1476 1619 1167 1477 1327 1329 1171 1006  266  652  464  267
 200  401  594  779  956 1125 1286 1584 1441 1585 1586 1588 1587 1723 1849 1591 1724 1728 1730 1595 1596 1453 1732 1598 1457 1458 1601 1602 1739 1604 1607 1608 1465 1609 1745 1610 1611 1612 1614 1615 1616 1617 1753 1621 1618 1328 1173 1005  834  833  268  269   61
 199  400  593  778  955 1124 1285 1439 1583 1720 1721 1722 1852 1850 1590 1448 1853 1855 1593 1594 1731 1733 1734 1736 1600 1735 1737 1738 1866 1740 1606 1741 1742 1743 1744 1746 1747 1613 1471 1749 1750 1752 1754 1620 1330 1331 1478 1172 1007 1008  653  835   63
 198  399  592  777  954 1123 1437 1438 1436 1848 1968 1851 2081 1971 2185 1725 1856 1727 1858 2087 1977 1859 1860 1980 2092 1862 1864 1865 1867 1986 1868 1869 1870 1871 1872 1873 1992 1995 1876 1877 1751 1879 1755 1622 1479 1332 1009  836  837  465  654  467   64
 197  398  591  776  953 1122 1284 1582 1581 1719 2080 2079 1846 2084 1726 1972 1974 1857 2086 2088 1976 2190 2090 1861 1982 1863 1983 1984 1985 2097 1987 1988 1989 1990 1991 1875 1993 1878 1748 2105 2107 1756 1481 1624 1480 1175 1174 1010  656  655  468  466   65
 196  397  590  774  775  952 1282 1435 1283 1718 1847 2082 2077 2186 1970 1854 1729 2083 2285 2372 2192 1978 2191 2089 2193 1981 2196 2198 2095 2096 2201 2099 2100 2102 2103 1994 2104 1874 2209 1996 1998 1623 1881 1757 1482 1333 1176 1011  838  657  271  270   66
 195  396  589  951  950 1121 1280 1281 1717 1580 1716 1967 1969 1966 2183 2283 2187 2085 1975 2281 2286 2091 2288 1979 2291 2094 2379 2292 2199 2098 2200 2202 2203 2101 2205 2301 2207 2106 2208 1997 1999 1880 1758 1882 1483 1334 1177 1012  839  658  469  272   67
 194  395  588  773 1120 1118 1119 1433 1434 1715 1845 1965 2078 2280 2369 1973 2449 2370 2189 2371 2287 2453 2194 2195 2093 2290 2378 2294 2380 2297 2296 2298 2299 2204 2300 2302 2206 2303 2108 2210 2109 2000 1883 1625 1759 1335 1178 1013  840  659  470  273   68
 193  394  587  772  948 1117 1279 1432 1579 1578 1844 2076 2184 1963 1964 2182 2368 2188 2450 2284 2452 2451 2375 2289 2455 2376 2377 2458 2381 2295 2462 2463 2383 2386 2388 2467 2389 2304 2211 2110 2001 1626 1884 1485 1484 1336 1179 1014  841  660  471  274   69
 192  393  586  771 1278  949 1431 1430 1713 1577 1842 1962 1843 2180 2279 2277 2282 2448 2522 2373 2525 2524 2374 2454 2529 2457 2460 2197 2530 2382 2533 2534 2385 2464 2536 2468 2390 2305 2212 2111 2002 1885 1760 1627 1486 1337 1180 1015  842  661  472  275   70
 392  391  585  770 1116 1115  946 1576 1711 1712 1714 1841 2278 2181 2366 2367 2447 2520 2585 2584 2521 2523 2643 2527 2456 2528 2293 2531 2595 2532 2384 2461 2535 2466 2387 2465 2391 2306 2213 2112 2003 1886 1761 1628 1487 1338 1181 1016  843  662  473  276   71
 190  191  584  769  947 1276 1429 1277 1575 1840 1961 2074 2075 2179 2178 2276 2446 2583 2640 2586 2642 2588 2589 2526 2590 2591 2592 2459 2649 2650 2596 2652 2653 2598 2537 2538 2392 2307 2214 2113 2004 1887 1762 1629 1488 1339 1182 1017  844  663  474  277   72
 389  188  390  768  945 1114 1274 1275 1428 1573 1710 1839 2073 2275 2364 2365 2445 2518 2519 2582 2587 2641 2690 2644 2645 2646 2733 2593 2735 2594 2597 2651 2654 2600 2539 2469 2470 2308 2215 2114 2005 1888 1763 1630 1489 1340 1183 1018  845  664  475  278   73
 189  583  943  581  582 1112 1113 1427 1574 1572 1709 1838 2272 2072 2274 2273 2363 2444 2638 2639 2687 2689 2727 2730 2693 2694 2648 2647 2695 2697 2698 2699 2602 2599 2471 2394 2393 2309 2216 2115 2006 1889 1764 1631 1490 1341 1184 1019  846  665  476  279   74
 187  388  766  767  944 1111 1273 1426 1571 1708 2070 1960 2177 2361 2174 2271 2362 2517 2516 2581 2691 2728 2729 2731 2692 2764 2734 2696 2736 2738 2737 2655 2656 2601 2540 2472 2395 2310 2217 2116 2007 1890 1765 1632 1491 1342 1185 1020  847  666  477  280   75
 579  765  580  764  941  940 1272 1425 1570 1707 1837 1958 1836 1959 2176 2442 2443 2580 2579 2635 2637 2688 2760 2761 2762 2732 2763 2765 2766 2767 2701 2700 2603 2541 2542 2473 2396 2311 2218 2117 2008 1891 1766 1633 1492 1343 1186 1021  848  667  478  281   76
 186  387  386 1107  762 1110 1271 1424 1569 1706 1956 1957 2068 2071 2360 2515 2514 2576 2578 2634 2685 2686 2759 2783 2784 2786 2808 2787 2789 2740 2770 2739 2657 2604 2543 2474 2397 2312 2219 2118 2009 1892 1767 1634 1493 1344 1187 1022  849  668  479  282   77
 384  578  577  761  763 1270 1269 1423 1568 1834 1955 2069 2175 2172 2270 2441 2440 2632 2683 2636 2684 2725 2799 2782 2758 2785 2803 2801 2768 2769 2703 2702 2658 2605 2544 2475 2398 2313 2220 2119 2010 1893 1768 1635 1494 1345 1188 1023  850  669  480  283   78
 385  184  936  942  938 1108 1109 1422 1567 1705 1835 2066 1953 2269 2358 2437 2439 2577 2513 2633 2724 2726 2757 2796 2800 2750 2781 2788 2802 2791 2741 2704 2659 2606 2545 2476 2399 2314 2221 2120 2011 1894 1769 1636 1495 1346 1189 1024  851  670  481  284   79
 182  185  383  181  937  760 1419 1565 1421 1704 1833 2171 2173 2067 2268 2359 2511 2512 2682 2631 2681 2723 2807 2780 2797 2790 2804 2775 2776 2660 2743 2609 2706 2607 2546 2477 2400 2315 2222 2121 2012 1895 1770 1637 1496 1347 1190 1025  852  671  482  285   80
 381  183  574  576  939 1267 1268 1266 1566 1563 1832 1831 1954 2170 2266 2355 2438 2356 2722 2573 2721 2755 2756 2752 2777 2798 2792 2794 2793 2705 2744 2742 2662 2661 2547 2478 2401 2316 2223 2122 2013 1896 1771 1638 1497 1348 1191 1026  853  672  483  286   81
 382  180  573  759 1105 1106 1564 1265 1702 1703 1701 1830 2354 1952 2264 2574 2509 2353 2572 2575 2510 2720 2753 2779 2795 2749 2773 2748 2772 2771 2707 2663 2664 2608 2548 2479 2402 2317 2224 2123 2014 1897 1772 1639 1498 1349 1192 1027  854  673  484  287   82
 179  575  758  935 1103 1104 1416 1264 1700 1828 1950 2435 2168 2263 2357 2169 2436 2267 2680 2630 2678 2679 2751 2754 2778 2806 2747 2713 2774 2805 2746 2745 2708 2549 2550 2480 2403 2318 2225 2124 2015 1898 1773 1640 1499 1350 1193 1028  855  674  485  288   83
 379  572  757  380  931 1417 1262 1420 1699 1829 1947 1951 2062 2064 2061 2265 2433 2508 2434 2629 2719 2676 2718 2717 2674 2715 2714 2712 2669 2710 2667 2709 2611 2610 2552 2481 2404 2319 2226 2125 2016 1899 1774 1641 1500 1351 1194 1029  856  675  486  289   84
 178  177  378  756  755 1418 1415 1827 1562 1949 1826 2063 2065 2167 2259 2352 2261 2505 2507 2627 2628 2677 2675 2623 2716 2672 2671 2670 2711 2618 2616 2612 2665 2483 2615 2482 2405 2320 2227 2126 2017 1900 1775 1642 1501 1352 1195 1030  857  676  487  290   85
 176  377  570  754  571  933 1101 1102 1695 1697 2060 1948 1825 2166 2350 2431 2351 2571 2506 2570 2626 2625 2622 2563 2673 2621 2561 2619 2668 2617 2489 2666 2613 2551 2553 2484 2406 2321 2228 2127 2018 1901 1776 1643 1502 1353 1196 1031  858  677  488  291   86
 175  375  376  569 1100  934 1561 1560 1261 1698 1559 1946 1943 1945 2163 2348 2430 2432 2504 2568 2567 2566 2624 2565 2564 2562 2494 2620 2560 2491 2558 2554 2487 2555 2488 2485 2408 2322 2229 2128 2019 1902 1777 1644 1503 1354 1197 1032  859  678  489  292   87
 174  567  753  566  932 1099 1263 1556 1260 1696 1557 1414 2262 2165 2059 2161 2162 2503 2428 2502 2501 2499 2498 2497 2496 2495 2418 2419 2559 2492 2416 2556 2490 2614 2407 2486 2324 2409 2230 2129 2020 1903 1778 1645 1504 1355 1198 1033  860  679  490  293   88
 374  373  751  568  930 1098 1097 1413 1824 1694 2057 1944 2058 2349 2258 2347 2429 2569 2346 2427 2500 2425 2423 2422 2421 2420 2333 2417 2493 2334 2414 2557 2413 2412 2411 2410 2327 2323 2231 2130 2021 1904 1779 1646 1505 1356 1199 1034  861  680  491  294   89
 173  752  565  928  929 1096 1412 1821 1823 1941 1942 1822 2257 2260 2159 2256 2253 2344 2345 2426 2342 2424 2341 2340 2244 2243 2336 2245 2040 2332 2415 2331 2330 2329 2328 2237 2326 2325 2232 2131 2022 1905 1780 1647 1506 1357 1200 1035  862  681  492  295   90
 172  372  171  750  927 1256 1411 1558 1554 1257 2164 1937 2056 2053 2156 2158 2049 2254 2153 2343 2252 2250 2249 2337 2149 2041 2247 2335 2036 2144 2241 2240 2239 2238 2236 2137 2234 2135 2233 2132 2023 1906 1781 1648 1507 1358 1201 1036  863  682  493  296   91
 170  371  749  926 1095 1258 1259 1409 1820 1693 2054 1819 2052 1817 2160 2157 2155 2154 1931 2045 1929 2251 2044 2246 2248 2148 2039 2242 2146 2143 2142 2141 2140 2139 2138 2136 2235 2028 2134 2133 2024 1907 1782 1649 1508 1359 1202 1037  864  683  494  297   92
 169  168  564  562 1093 1092 1094 1408 1410 1690 1553 1939 1691 2050 1938 1816 1680 2046 1544 1677 2152 2043 2151 2042 2339 2338 1924 2038 1923 2037 2035 2034 2033 2032 2031 2030 2029 1913 2027 2026 2025 1908 1783 1650 1509 1360 1203 1038  865  684  495  298   93
 167  924  563  746  561 1406 1255 1551 1254 1692 1552 1814 1936 2055 2255 1935 1934 1808 2047 1930 1927 1540 1807 1926 1673 2147 1925 1801 2145 1921 1920 1919 1918 1917 1916 1915 1791 1914 1912 1911 1910 1909 1784 1651 1510 1361 1204 1039  866  685  496  299   94
 369  560  370  922 1091  925  921 1550 1689 1405 1940 1685 1397 1545 1812 1813 1811 1933 1810 2150 1805 1806 1804 1534 1672 1803 1802 1799 1922 1798 1797 1796 1795 1794 1793 1661 1792 1659 1789 1788 1787 1786 1785 1652 1511 1362 1205 1040  867  686  497  300   95
 166  368  367  747 1089  748 1251 1555  923 1686 1818 1815 1243 2051 1681 2048 1541 1679 1678 1932 1809 1676 1928 1675 1674 1671 1669 1800 1668 1667 1666 1665 1664 1663 1662 1522 1790 1521 1658 1657 1656 1655 1654 1653 1512 1363 1206 1041  868  687  498  301   96
 165  365  366  559 1090 1252 1253  914 1547 1549 1400 1394 1682 1548 1684 1240 1395 1392 1391 1539 1537 1536 1535 1387 1531 1384 1670 1530 1529 1381 1528 1527 1525 1377 1524 1523 1374 1660 1519 1518 1517 1516 1515 1514 1513 1364 1207 1042  869  688  499  302   97
 556  164  742  745  743  919  920 1403 1404 1407 1688 1546 1244 1242 1398 1683 1393 1543 1538 1235 1236 1234 1386 1389 1532 1229 1230 1383 1382 1225 1526 1380 1379 1378 1376 1375 1373 1520 1372 1371 1370 1369 1368 1367 1366 1365 1208 1043  870  689  500  303   98
 162  163  558  557  744 1249 1250 1248 1247 1687 1245  910 1080 1077 1396 1239 1542 1238 1237 1073 1390 1233 1069 1232 1385 1067 1231 1227  894  893 1224 1060 1222 1059 1221 1220 1219 1218 1217 1216 1215 1214 1213 1212 1211 1210 1209 1044  871  690  501  304   99
 161  363  364  741 1088 1087 1086 1401 1402  732 1083  911 1399  908  907 1078 1076 1075 1074  901 1070  898 1533 1388 1068  896 1228 1066 1065 1226 1062 1223  889  709 1058 1057 1056 1055 1054 1053 1052 1051 1050 1049 1048 1047 1046 1045  872  691  502  305  100
 360  361  740  917  918  913  915 1085  548  736  733  545  543 1246 1079  906  541  904  903 1072  722 1071  900  899  718  895 1064  715  714 1063  891 1061  711  887    0  886  885  884  883  882  881  880  879  878  877  876  875  874  873  692  503  306  101
 159  362  555  739  738  356  737  735 1084  734  547 1081 1241 1082  727  731  538  905  724  902  723  535  721  897  720  717  529  716  526  892  890  712  888  710  708  707  706  705  704  703  702  701  700  699  698  697  696  695  694  693  504  307  102
 160  553  358  552  550  549  916  353  909  912  146  351  730  347  343  539  141  725  537  536  340  534  533  337  719  531  530  528  713  527  525  524  523  522  521  520  519  518  517  516  515  514  513  512  511  510  509  508  507  506  505  308  103
 158  155  357  554  153  151  354  150  349  546  348  542  544  729  726  344  143  345  142  341  138  339  338  336  532  335  334  333  332  331  330  329  328  327  326  325  324  323  322  321  320  319  318  317  316  315  314  313  312  311  310  309  104
 157  359  156  154  355  551  152  149  352  148  147  350  145  144  346  728  540  140  342  139  137  136  135  134  133  132  131  130  129  128  127  126  125  124  123  122  121  120  119  118  117  116  115  114  113  112  111  110  109  108  107  106  105
