# This puzzle is unsolvable
66
   2    1    3    4    5    6    7    8    9   10   11   12   13   14   15   16   17   18   19  279   20   22   23  282   24   26   27   28   29   30   31  291   32  293   34  295   36   39  299   38  551   41   43   44   45   46   47   48   49   50   51   52   53   54   55   56   57  319  317   59   60   61   62   64   65   66
 260  261  262  263  264  265  266  267  268  269  270  271  272  273  274  526  275  276  278   21  280  529  533  531   25  286  287  288  539  289  290   33  292   35  294  789  297   37  300  549   40   42  302  303  304  305  306  307  308  309  310  311  312  313  314  566  315  316  318  320  571  322   63  323  324   67
 259  512  513  514  515  516  517  518  519  520  521  522  523  524  525 1005  527  277  772  774  530  777  775 1239  285  284  537  538  783  782  541  542  543  787  544  546  296  298  791  550  794  552  553  554  556  799  557  558  559  561  804  562  563  564  565  567 1046   58  568  570  572  321  573  574  325   68
 258  511  756  757  758  759  760  761  762  763  764  765  766  767  768 1003  770  769  771 1008 1009  778 1667  283  779 1014 1241  780 1017  540 1019  785  786  788  545 1024 1254 1474  548  301  792 1030  796  798  555  800  801 1035 1036  802  560  805  806 1269  807 1041  809  812  569  813  814  815  816  575  326   69
 257  510  755  992  993  994  995  996  997  998  999 1000 1001 1229 1002 1230 1233  528 1006 1007 1236 1011 1457  281 1015  536 1010 1461  781  784 1018 1020 1021 1249 1022 1025  547 1252 1028  793  795 1257 1032  797 1033 1481 1262 1034 1037  803 1039 1488 1267 1268 1044  808  810  811 1047 1048 1049 1050  817  576  327   70
 256  509  754  991 1220 1221 1222 1223 1224 1225 1226 1227 1228 1231 1004 1659 1232 1452  773 1235 1237  532  535 1670 1460 1240 1243 1016 1244 1245 1248 1467 1247 1468 1023 1027 1029  790 1471 1470 1685 1256 1031 1479 1259 1261 1264 1693 1265 1038 1266 1040 1699 1043 1490 1271 1045 1273 1274 1275 1051 1052  818  577  328   71
 255  508  753  990 1219 1440 1441 1442 1443 1444 1445 1446 1448 1660 1450 1453 1661 1664 1234 1454 1455 1870 1012  776  534 1673 1242 1463 1676 1246 1466 1881 1250 1679 1680 1251 1473 1026 1253 1255 1686 1684 1475 1478 1260 1480 1482 1896 1263 1483 1484 1487 1491 1698 1270 1042 1701 1492 1493 1495 1494 1276  819  578  329   72
 254  507  752  989 1218 1439 1652 1653 1654 1655 1656 1657 1447 1658 1451 1864 1449 1663 1865 1665 1666 1871 1872 1672 1458 1874 2069 1462 1013 1678 1465 1879 2077 1883 1681 1469 1885 1682 1683 1891 1687 1889 1689 1258 1688 1691 1692 1694 1486 1898 1485 1697 1489 1902 1903 1700 2099 1702 1703 1704 1277 1278 1053  579  330   73
 253  506  751  988 1217 1438 1651 1856 1857 1858 1859 1860 1861 1862 2245 2058 1863 1662 1868 1869 2067 1456 1668 1873 1459 1238 1674 2070 1464 1878 1677 2074 2076 1884 2079 1886 2267 2081 1887 1476 2083 2453 1477 1892 1894 2090 1895 2092 1695 1696 1899 1900 1901 2283 1904 1905 1272 1906 1705 1496 1279 1054  820  580  331   74
 252  505  750  987 1216 1437 1650 1855 2052 2053 2054 2055 2056 2057 2595 2059 2060 2061 1866 2063 2251 2064 2066 2254 2068 1671 1875 1877 1876 2073 1675 2442 1880 2264 2266 2082 2446 1472 1888 2080 2271 2086 2085 1690 1893 2088 2277 2091 2280 1897 2281 2095 2284 2097 2096 2098 2100 1907 1497 1707 1280  822  821  581  332   75
 251  504  749  986 1215 1436 1649 1854 2051 2240 2241 2592 2242 2243 2244 2248 2247 2426 1867 2062 2250 2252 1669 2253 2255 2256 2436 2257 2072 2259 2262 2440 2075 2441 2263 2078 1882 2268 2269 2084 1890 2451 2454 2087 2275 2276 2456 2278 2279 2093 2094 2462 2634 2286 2463 2285 2101 1909 1908 1706 1498 1055 1056  823   76   77
 250  503  748  985 1214 1435 1648 1853 2050 2239 2420 2756 2421 2594 2424 2246 2598 2917 2249 2428 2602 2065 2431 2432 2434 2071 2435 2258 2438 2261 2611 2439 2776 2443 2444 2445 2447 2616 2270 2450 2272 2274 2452 2622 2788 2089 2789 2458 2791 2459 2460 2282 2464 2287 2466 2465 2288 1708 1709 1499 1281  824  583  334  333  585
 249  502  747  984 1213 1434 1647 1852 2049 2238 2419 2593 2591 2422 2423 2425 2596 2427 2600 2429 2601 2921 2767 2433 2604 2605 2607 2437 2260 2773 2610 2613 2612 2615 2265 2778 2781 2782 2618 2449 2786 2938 2943 2624 2623 2627 2455 2457 2946 2631 2632 2950 2461 2795 2467 2104 2102 2103 1500 1283 1057 1282  825   78  336  582
 248  501  746  983 1212 1433 1646 1851 2048 2237 2418 2755 2911 2757 2912 2759 2760 2915 2763 2430 2761 2765 2922 2603 2924 2768 2925 2769 2608 2609 2772 2775 3079 2777 2932 2614 2779 2935 2619 3084 2783 2621 2939 2273 2629 2625 2626 2630 2790 2793 2794 2636 2951 2952 2633 2290 1911 1910 1912 1710 1286 1058   80  584  827   79
 247  500  745  982 1211 1432 1645 1850 2047 2236 2417 2590 2913 2758 2914 2916 2918 3063 2919 2599 2764 2920 3208 2923 2606 3071 3072 3212 3073 2926 2774 3215 3217 2930 3221 2934 2780 2448 2620 2785 2784 2940 2787 2941 2942 2944 3092 2945 2628 2796 2947 2635 3096 2799 2468 2105 2106 1502 1501 1503 1285 1284  587  338  335  337
 246  499  744  981 1210 1431 1644 1849 2046 2235 2416 2589 2754 3059 2910 3200 3202 2597 3065 3205 3067 3069 2766 3068 3209 2770 2928 2771 3074 3076 2927 2929 3081 3218 3080 3351 2617 3223 3083 2936 3087 3225 3088 3227 3090 3091 3231 3093 2792 2948 2637 3095 2949 2289 2469 2291 1913 1711 1713 1712 1061 1060 1062  586  588   81
 245  498  743  980 1209 1430 1643 1848 2045 2234 2415 2909 2752 3062 3060 3061 3334 2762 3064 3066 3204 3206 3070 3338 3340 3207 3210 3213 3211 3077 3214 3075 3078 2933 3220 2931 3353 3222 2937 3085 3086 3358 3226 3089 3230 3361 3233 3094 3363 2798 3097 2953 2638 2797 2293 2471 2107 1505  828 1059 1288  830  589  826  339   82
 244  497  742  979 1208 1429 1642 1847 2044 2233 2414 2588 2586 2753 3456 3199 3201 3058 3333 3335 3336 3460 3337 3462 3339 3341 3342 3466 3343 3344 3216 3348 3219 3473 3349 3352 3082 3477 3479 3355 3354 3356 3482 3228 3484 3360 3362 3232 3235 3234 3099 3098 2800 2470 2640 2292 2108 1714 1504 1915 1287  829  831 1063  340   84
 243  496  741  978 1207 1428 1641 1846 2043 2232 2413 2751 2587 3056 2906 3057 3203 3331 3571 3457 3459 3575 3461 3577 3463 3464 3465 3581 3469 3470 3346 3585 3584 3472 3350 3476 3475 3592 3593 3224 3357 3594 3481 3359 3704 3599 3485 3486 3364 3365 3236 2639 2641 2803 2801 2294 1914 2109 1715 1507 1506 1289 1064  590   83  341
 242  495  740  977 1206 1427 1640 1845 2042 2231 2412 2585 2750 2907 3330 3197 3332 3328 3572 3458 3574 3682 3578 3683 3685 3686 3688 3579 3467 3468 3347 3691 3471 3586 3589 3474 3590 3591 3699 3478 3700 3595 3598 3229 3483 3705 3600 3487 3366 3237 2955 2954 2642 2472 2295 2296 2110 1916 1917 1716 1290 1065  832  591  342   85
 241  494  739  976 1205 1426 1639 1844 2041 2230 2411 2584 2749 2905 3198 3055 2908 3455 3573 3780 3779 3681 3576 3783 3684 3687 3580    0 3689 3583 3345 3692 3693 3587 3588 3695 3696 3697 3797 3701 3702 3803 3596 3894 3703 3706 3601 3488 3367 3238 3100 2957 2956 2802 2474 2473 2111 1918 1717 1508 1291 1066  833  592  343   86
 240  493  738  975 1204 1425 1638 1843 2040 2229 2410 2583 2748 3054 3052 3195 3329 3452 3570 3454 3781 3677 3782 4032 3786 3875 3787 3582 3788 3790 3690 3791 3792 3694 3793 3795 3887 3796 3799 3798 3890 3480 3802 3597 3804 3707 3602 3489 3368 3239 3101 3102 2804 2644 2643 2297 2112 1919 1718 1509 1292 1067  834  593  344   87
 239  492  737  974 1203 1424 1637 1842 2039 2228 2409 2582 2747 2904 3194 3196 3327 3453 3678 3778 3680 3569 3872 3784 3785 4033 3878 3879 3962 3789 3880 3882 3885 3967 3794 3886 3698 3889 3973 3800 3892 3801 3893 3805 3806 3708 3603 3490 3369 3240 3103 2958 2805 2645 2475 2298 2113 1920 1719 1510 1293 1068  835  595  594  345
 238  491  736  973 1202 1423 1636 1841 2038 2227 2408 2581 2746 3053 2903 3326 3325 3679 3567 3776 3777 3870 3874 3873 3959 3877 3876 3961 3963 3964 3881 3965 3883 3966 3884 3968 4044 3888 3971 3974 3891 3975 3976 3896 3895 3709 3604 3491 3370 3241 3104 2959 2806 2646 2476 2299 2114 1720 1511 1294 1295 1069  596  836   89   88
 237  490  735  972 1201 1422 1635 1840 2037 2226 2407 2580 2745 2902 3051 3192 3193 3451 3676 3869 3568 3871 3957 3956 3958 4035 3960 4036 4037 4038 4039 4040 4041 4042 4043 3970 3969 4046 3972 4047 4049 4051 4050 3977 3807 3710 3605 3492 3371 3242 2960 2807 2961 2477 2478 2300 2115 1921 1721 1512 1070  837  347  597  346   90
 236  489  734  971 1200 1421 1634 1839 2036 2225 2406 2579 2744 2901 3191 3190 3324 3449 3450 3566 3955 3675 4031 4030 4100 4034 4102 4103 4104 4105 4106 4107 4108 4109 4110 4111 4045 4113 4114 4048 4115 4116 3978 3897 3808 3711 3606 3493 3372 3243 3105 2962 2808 2647 2479 2301 2116 1922 1722 1513 1296 1071  839  838  348   91
 235  488  733  970 1199 1420 1633 1838 2035 2224 2405 2578 2743 2900 3050 3048 3448 3447 3565 3775 3774 3953 3954 4099 4160 4101 4161 4162 4163 4164 4165 4166 4167 4168 4169 4170 4112 4172 4173 4174 4117 4052 3979 3898 3809 3712 3607 3494 3373 3244 3106 2963 3107 2648 2302 2117 1924 1923 1723 1514 1297 1073 1072  598  349   92
 234  487  732  969 1198 1419 1632 1837 2034 2223 2404 2577 2742 2899 3188 3049 3323 3564 3673 3672 3867 3868 3952 4029 4098 4159 4212 4213 4214 4215 4216 4217 4218 4219 4220 4221 4171 4222 4223 4175 4118 4053 3980 3899 3810 3713 3608 3495 3374 3245 3108 2964 2809 2810 2480 2303 2118 1925 1724 1515 1298 1074  599  600  350   93
 233  486  731  968 1197 1418 1631 1836 2033 2222 2403 2576 2741 2898 3189 3321 3322 3445 3446 3773 3674 3866 3951 4028 4097 4158 4211 4256 4257 4258 4259 4260 4261 4298 4262 4264 4265 4266 4224 4176 4119 4054 3981 3900 3811 3714 3609 3496 3375 3246 3109 2811 2812 2482 2481 2304 2119 1926 1725 1516 1299  841  840  601  351   94
 232  485  730  967 1196 1417 1630 1835 2032 2221 2402 2575 2740 2897 3047 3046 3319 3320 3563 3671 3772 3865 3950 4027 4096 4157 4210 4255 4292 4293 4294 4295 4296 4297 4263 4299 4300 4267 4225 4177 4120 4055 3982 3901 3812 3715 3610 3497 3376 3247 3110 2965 2650 2652 2651 2305 2120 1927 1726 1517 1300 1075  842  602  352   95
 230  231  729  966 1195 1416 1629 1834 2031 2220 2401 2573 2574 3042 3045 3044 3186 3561 3562 3771 3770 3864 3949 4026 4095 4156 4209 4254 4291 4320 4321 4323 4342 4324 4325 4326 4301 4268 4226 4178 4121 4056 3983 3902 3813 3716 3611 3498 3377 3248 3111 2966 2649 2813 2483 2306 2121 1928 1727 1518 1301 1076  843  603  353   96
 484  483  964  728 1415 1193 1628 1833 2030 2219 2400 2572 2738 3185 2896 3187 3318 3444 3670 3443 3669 3863 3948 4025 4094 4155 4253 4290 4319 4340 4318 4322 4352 4345 4343 4327 4302 4269 4227 4179 4122 4057 3984 3903 3814 3717 3612 3378 3249 3112 3113 2967 2814 2653 2484 2307 2122 1929 1728 1519 1302 1077  844  604   97   98
 229  482  726  963 1194 1625 1414 1627 2029 2218 2399 2737 2739 2895 2894 3043 3183 3184 3560 3559 3769 3862 3947 4024 4093 4154 4208 4207 4316 4317 4339 4341 4351 4354 4344 4328 4303 4270 4228 4229 4123 4058 3985 3904 3815 3614 3718 3613 3499 3380 3250 2968 2815 2654 2485 2308 2123 1930 1729 1520 1303 1078  845  605  354  357
 228  481  727  965 1413 1831 1626 1832 2028 2217 2398 2571 2736 2891 2893 3182 3317 3316 3441 3668 3558 3667 3860 4023 4092 4153 4251 4252 4288 4350 4337 4355 4338 4348 4346 4329 4271 4230 4181 4180 4124 4059 3986 3905 3720 3817 3501 3379 3251 3252 3114 2969 2816 2655 2486 2309 2124 1931 1730 1521 1304 1079  606  356  355   99
 227  226  725 1192  480  962 1830 2026 2027 2216 2397 2570 2735 3041 3315 3442 3314 3556 3666 3861 3768 3859 3946 4022 4091 4152 4206 4286 4289 4287 4353 4334 4311 4349 4347 4330 4304 4272 4231 4182 4125 4061 4060 3816 3906 3719 3615 3500 3502 3381 2970 2971 2817 2656 2487 2310 2125 1932 1731 1522 1305 1080  846  847  358  102
 478  225  724  961 1191 1412 1409 2215 2214 2025 2569 2568 2734 3180 2892 3313 3438 3440 3664 3557 3767 3944 3945 4021 4090 4151 4204 4205 4283 4285 4315 4335 4312 4332 4279 4331 4305 4274 4306 4183 4128 4126 3987 3988 3818 3721 3616 3503 3382 3115 3253 3116 2818 2657 2488 2311 2126 1933 1732 1523 1306 1081  848  100  359  103
 723  722  959  960 1411 1410 1624 1828 1829 2395 2394 2396 2733 3040 2890 3038 3312 3181 3665 3555 3766 3765 3858 4020 4089 4150 4203 4250 4284 4313 4336 4310 4241 4333 4276 4308 4309 4273 4233 4184 4129 4127 3908 3907 3819 3722 3617 3504 3254 3118 3117 2820 2819 2658 2489 2312 2127 1934 1733 1524 1307 1082  850  849  607  360
 479  477  721 1189 1623 1621 1622 1827 2024 2213 2393 2567 2731 2732 3179 3439 3039 3437 3554 3663 3764 3857 3943 4019 4148 4149 4202 4249 4243 4197 4244 4281 4247 4240 4277 4275 4232 4307 4185 4065 3990 4063 4062 3909 3820 3723 3618 3507 3383 3384 2972 3255 2659 2660 2490 2313 2128 1935 1734 1525 1308 1083  610  608  101  104
 224  476  957 1408 1190 1187 1620 1826 2023 2212 2729 2566 2730 2888 2889 3178 3311 3436 3553 3662 3763 3762 3942 3941 4018 4200 4201 4246 4314 4248 4245 4282 4193 4239 4280 4135 4236 4190 4187 4186 4130 3989 3991 3910 3821 3724 3619 3385 3505 3506 2973 3120 2974 2661 2491 2314 2129 1936 1735 1526 1309 1084  609  852  361  105
 222  720  958 1188  956 1186 1406 1825 2211 2210 2563 2887 2727 3036 3037 3177 3310 3435 3552 3661 3855 3856 3940 4085 4088 4087 4086 4147 4143 4198 4141 4242 4196 4191 4278 4072 4189 4237 4132 4131 3993 4064 4066 3911 3822 3725 3620 3386 3257 3256 2823 3119 2821 2822 2492 2315 2130 1937 1736 1527 1310 1085  851  612  362  106
 223  475  474 1407  717 1185 1619 1824 2022 2209 2392 2565 2728 2886 3035 3176 3309 3434 3551 3660 3761 3854 3939 4017 4016 4146 4145 4199 4144 4142 4140 4139 4137 4195 4138 4192 4073 4238 4133 4235 3997 3919 4067 3912 3823 3726 3621 3508 3387 3258 3121 2975 2976 2662 2493 2316 2131 1938 1738 1737 1528 1086  853  363  611  107
 221  955  473  719 1182 1184 1404 1618 2020 2021 2390 2391 2885 2564 3034 3175 3308 3433 3550 3659 3760 3853 3938 4015 4084 4083 4082 4081 4080 4079 4078 4077 4076 4075 4194 4074 3834 4000 3999 4234 4188 4068 3992 3913 3824 3727 3622 3509 3388 3259 3122 2977 2825 2824 2663 2494 2132 1940 1939 1529 1311 1312 1087  854  364  108
 472  220  718  954 1403 1183 1405 1823 1822 2019 2208 2561 2562 2884 3033 3174 3307 3432 3549 3658 3759 3852 3937 4014 4013 4012 4011 4010 4009 4008 4007 4006 4005 3925 4004 4136 3740 4070 4134 3998 3831 3996 3994 3914 3825 3728 3623 3510 3390 3389 3260 3123 2978 2317 2664 2319 2496 2133 1739 1530 1313 1088  855  613  366  365
 219  218  471  716 1181 1402 1617 1821 2018 2207 2389 2388 2726 2883 3032 3173 3306 3431 3548 3657 3758 3851 3936 3935 3934 3932 3750 3931 3930 3928 3841 3927 3640 3837 3922 4003 3924 3833 4002 3918 4069 3917 3995 3915 3826 3729 3624 3511 3391 3261 3124 2979 2980 2665 2495 2134 2318 1941 1740 1531 1314 1089  616  614  615  109
 470  714  715  953  952 1615 1616 1820 2017 2206 2387 2560 2725 2882 3031 3172 3305 3430 3547 3656 3757 3850 3849 3848 3846 3933 3646 3845 3843 3929 3746 3839 3926 3838 3923 3835 3920 3921 3737 3830 4071 3829 3916 3828 3827 3730 3625 3512 3392 3262 3125 2827 2826 2666 2497 2320 2135 1942 1741 1532 1315 1090  856  857  367  110
 217  468  469  950 1180 1401 1614 1819 2016 2205 2386 2559 2724 2881 3030 3171 3304 3429 3546 3655 3756 3755 3754 3753 3847 3751 3844 3748 3645 3842 3644 3840 3744 3642 3638 3525 4001 3739 3635 3836 3832 3276 3631 3734 3733 3732 3731 3626 3513 3263 3126 2981 2828 2667 2498 2321 2136 1943 1742 1533 1316 1091  858  617  368  111
 216  467  951  713 1179 1400 1613 1818 2015 2204 2385 2558 2723 2880 3029 3170 3303 3428 3545 3654 3653 3652 3651 3650 3752 3649 3647 3749 3534 3747 3532 3743 3745 3530 3526 3741 3742 3637 3738 3633 3632 3735 3630 3519 3629 3628 3627 3514 3393 3264 3127 2982 2829 2668 2499 2322 2137 1944 1743 1534 1317 1092  859  618  369  112
 215  214  712  949 1178 1399 1612 1817 2014 2203 2384 2557 2722 2879 3028 3169 3302 3427 3544 3543 3542 3541 3540 3539 3538 3648 3416 3537 3536 3533 3285 3643 3531 3529 3148 3639 3523 3002 3634 3521 3736 3277 3520 3518 3399 3517 3516 3515 3394 3265 3128 2983 2830 2669 2500 2323 2138 1945 1744 1535 1318 1093  860  619  370  113
 213  466  711  948 1177 1398 1611 1816 2013 2202 2383 2556 2721 2878 3027 3168 3301 3426 3425 3424 3423 3422 3421 3420 3419 3418 3417 3535 3412 3415 3414 3641 3411 3409 3528 3410 3407 3406 3636 3279 3522 3403 3402 3400 3398 3397 3270 3396 3395 3266 3129 2984 2831 2670 2501 2324 2139 1946 1745 1536 1319 1094  861  620  371  114
 212  465  710  947 1176 1397 1610 1815 2012 2201 2382 2555 2720 2877 3026 3167 3300 3299 3298 3297 3296 3295 3294 3293 3292 3290 3289 3155 3287 3284 3150 3413 3149 3283 3005 3524 3001 3405 3280 3278 3404 3275 3401 3274 3272 3271 3269 3134 3268 3267 3130 2985 2832 2671 2502 2325 2140 1947 1746 1537 1320 1095  862  621  372  115
 211  464  709  946 1175 1396 1609 1814 2011 2200 2381 2554 2719 2876 3025 3166 3165 3164 3163 3162 3161 3160 3159 3158 3157 3291 3156 3153 3288 2860 3152 3151 3147 2694 3408 3527 3281 2850 3000 2847 3141 3140 3139 3273 3138 2993 3136 3135 3133 3132 3131 2986 2833 2672 2503 2326 2141 1948 1747 1538 1321 1096  863  622  373  116
 210  463  708  945 1174 1395 1608 1813 2010 2199 2380 2553 2718 2875 3024 3023 3022 3021 3020 3019 3018 3017 3016 3015 3014 2862 3013 2857 3010 3286 3008 3006 3282 2854 3004 3146 3144 3142 3143 2848 2998 2997 2996 2995 3137 2992 2991 2840 2990 2989 2988 2987 2834 2673 2504 2327 2142 1949 1748 1539 1322 1097  864  623  374  117
 209  462  707  944 1173 1394 1607 1812 2009 2198 2379 2552 2717 2874 2873 2872 2871 2870 2869 2868 2867 2866 2865 2864 2863 2861 2859 3012 3154 3009 2856 3007 2855 2695 2692 3145 2525 2849 2688 2999 2521 2846 2845 2844 2994 2843 2842 2841 2839 2838 2837 2836 2835 2674 2505 2328 2143 1950 1749 1540 1323 1098  865  624  375  118
 208  461  706  943 1172 1393 1606 1811 2008 2197 2378 2551 2716 2715 2714 2713 2712 2711 2710 2709 2708 2707 2706 2705 2704 2703 2702 2701 3011 2358 2699 2530 2527 2853 2852 2693 2526 3003 2851 2691 2690 2687 2686 2685 2684 2683 2682 2681 2680 2679 2678 2677 2676 2675 2506 2329 2144 1951 1750 1541 1324 1099  866  625  376  119
 207  460  705  942 1171 1392 1605 1810 2007 2196 2377 2550 2549 2548 2547 2546 2545 2544 2543 2542 2541 2540 2539 2538 2537 2536 2359 2534 2858 2700 2531 2697 2698 2351 2354 2168 2524 2523 2522 2347 2689 2520 2519 2518 2517 2516 2515 2514 2513 2512 2511 2510 2509 2508 2507 2330 2145 1952 1751 1542 1325 1100  867  626  377  120
 206  459  704  941 1170 1391 1604 1809 2006 2195 2376 2375 2374 2373 2372 2371 2370 2369 2368 2367 2366 2365 2364 2363 2362 2178 2535 2360 2532 2533 2356 2355 2528 2529 2696 2169 2350 1974 2348 2164 2346 2345 2344 2343 2342 2341 2340 2339 2338 2337 2336 2335 2334 2333 2332 2331 2146 1953 1752 1543 1326 1101  868  627  378  121
 205  458  703  940 1169 1390 1603 1808 2005 2194 2193 2192 2191 2190 2189 2188 2187 2186 2185 2184 2183 2182 2181 2180 2179 2177 2361 2176 2175 2357 2173 1981 2172 2353 1777 1978 2349 1976 1975 2166 2163 2162 2161 2160 2159 2158 2157 2156 2155 2154 2153 2152 2151 2150 2149 2148 2147 1954 1753 1544 1327 1102  869  628  379  122
 204  457  702  939 1168 1389 1602 1807 2004 2003 2002 2001 2000 1999 1998 1997 1996 1995 1994 1993 1992 1991 1990 1989 1988 1987 1986 1985 1984 2174 1983 1982 1781 1980 1780 1977 2352 2170 2165 1973 1972 1971 1970 1969 1968 1967 1966 1965 1964 1963 1962 1961 1960 1959 1958 1957 1956 1955 1754 1545 1328 1103  870  629  380  123
 203  456  701  938 1167 1388 1601 1806 1805 1804 1803 1802 1801 1800 1799 1798 1797 1796 1795 1794 1793 1792 1791 1790 1789 1788 1787 1786 1785 1784 1783 1782 1779 2171 1979 1778 2167 1776 1775 1774 1773 1772 1771 1770 1769 1768 1767 1766 1765 1764 1763 1762 1761 1760 1759 1758 1757 1756 1755 1546 1329 1104  871  630  381  124
 202  455  700  937 1166 1387 1600 1599 1598 1597 1596 1595 1594 1593 1592 1591 1590 1589 1588 1587 1586 1585 1584 1583 1582 1581 1580 1579 1578 1577 1576 1575 1574 1573 1572 1571 1570 1569 1568 1567 1566 1565 1564 1563 1562 1561 1560 1559 1558 1557 1556 1555 1554 1553 1552 1551 1550 1549 1548 1547 1330 1105  872  631  382  125
 201  454  699  936 1165 1386 1385 1384 1383 1382 1381 1380 1379 1378 1377 1376 1375 1374 1373 1372 1371 1370 1369 1368 1367 1366 1365 1364 1363 1362 1361 1360 1359 1358 1357 1356 1131 1132 1353 1352 1351 1350 1349 1348 1347 1346 1345 1344 1343 1342 1341 1340 1339 1338 1337 1336 1335 1334 1333 1332 1331 1106  873  632  383  126
 200  453  698  935 1164 1163 1162 1161 1160 1159 1158 1157 1156 1155 1154 1153 1152 1151 1150 1149 1148 1147 1146 1145 1144 1143 1142 1141 1140 1139 1138 1137 1136 1135 1134 1355 1133 1354 1130 1129 1128 1127 1126 1125 1124 1123 1122 1121 1120 1119 1118 1117 1116 1115 1114 1113 1112 1111 1110 1109 1108 1107  874  633  384  127
 199  452  697  934  933  932  931  930  929  928  927  926  925  924  923  922  921  920  919  918  917  916  915  914  913  912  911  910  909  908  907  906  905  904  903  902  901  900  899  898  897  896  895  894  893  892  891  890  889  888  887  886  885  884  883  882  881  880  879  878  877  876  875  634  385  128
 198  451  696  695  694  693  692  691  690  689  688  687  686  685  684  683  682  681  680  679  678  677  676  675  674  673  672  671  670  669  668  667  666  665  664  663  662  661  660  659  658  657  656  655  654  653  652  651  650  649  648  647  646  645  644  643  642  641  640  639  638  637  636  635  386  129
 197  450  449  448  447  446  445  444  443  442  441  440  439  438  437  436  435  434  433  432  431  430  429  428  427  426  425  424  423  422  421  420  419  418  417  416  415  414  413  412  411  410  409  408  407  406  405  404  403  402  401  400  399  398  397  396  395  394  393  392  391  390  389  388  387  130
 196  195  194  193  192  191  190  189  188  187  186  185  184  183  182  181  180  179  178  177  176  175  174  173  172  171  170  169  168  167  166  165  164  163  162  161  160  159  158  157  156  155  154  153  152  151  150  149  148  147  146  145  144  143  142  141  140  139  138  137  136  135  134  133  132  131
