# This puzzle is unsolvable
9
28 33  0 76 37 31 50 61 12
52 54 66 63  4  3 49 10 30
73 15 11 29  9 40 60 68 65
78 23 45  8 38 14 36  7 67
48 35 17  5  2 19 46  1 43
18  6 64 75 80 22 71 39 16
34 13 56 62 32 69 41 57 53
26 25 21 42 27 58 70 79 77
74 44 24 20 72 47 51 59 55
