# This puzzle is unsolvable
8
49 57 47 44 58  3 59 34
45 43 11 16 46 21  6 32
39  7 18 35 15 12 14  8
36 56 60 26 22 54 24 17
10  0 51 40 19 62 63  2
27  4 41 38 48 23 29  9
52 13 28  1 55 31 33 61
53  5 37 25 30 50 20 42
