# This puzzle is unsolvable
30
114   5 323 115 119   8 121  10 124 127 123  14 126  15   9  13  17  18  19 140  24 132 134  20  25  27 143 141  29  30
224   2 503 120 225 413 327   3   7 229 125 128 506 235 237  16  21 241 244 339 238  22 243 136 246 139 146  28 349 144
  1   4 118 223 499 231 227 420 422 500  12 236 650 131  11 509 133 137 240 336 135 345 245 344 247 249 350 142 145  31
113 322 117 226 326 111 122 423 577 329 230 505 426 129 239 510 427 342 514 433 589  23 138 343 347 248  26  32 251  34
222 324 415 418 328 501 644 417 331 333 233 234 424 508 583 338 340 430 130 513 242 432 436 346 438 440 149 148  35 147
325 112 116 219   6 414 497 502 707 416 425 708 332 335 586 429 428 591 516 435 431 434 518 437 594 439 253 151 348 250
110 221 218 321 228 330 498 419 646 504 709 710 507 584 654 337 588 512 341 515 661 519 351 660 520 352 255  33 256  36
319 107 109 320 496 575 495 421 232 648 581 334 652 585 714 511 587 765 656 716 524 769 517 593 522 441 442 150  37  39
220 318 217 215 576 642 705 579 580 706 647 653 649 762 651 713 766 657 655 717 763 718 659 592 521 596 257 254 154 153
108 313 572 317 412 574 571 702 703 758 837 582 802 838 761 711 841 843 712 768 590 721 719 595 526 443 252  38 354  40
216 316 573 105 493 645 643 756 578 755 800 803 760 759 867 805 808 771 844 658 767 770 662 523 597 525  45 445 353 447
106 570 567 411 494 213 639 641 640 754 757 836 839 804 888 870 764 809 811 715 722 598 663 720 527 260 444 357 152  42
214 408 491 315 409 492 700 699 704 799 798 835 801 869 897 806 845 868 810 847 666 665 664 667 599 449  43  44  41 258
212 101 210 410 403 698 405 753 701 797 860 752 840 866 887 889 872 873 871 812 773 723 528 600 603 529 355 356 261 155
104 406 208 489 569 697 750 637 751 863 865 886 833 885 807 825 842 890 877 818 725 669 601 668 602 446 259 262 156  46
314 311 490 407 211 404 568 796 794 792 861 884 876 878 894 883 898 874 846 774 772 815 848 530 359 452 360 158 157 159
103 102 312 566  99 635 487 565 749 864 828 857 882 826 879 899 880 875 814 813 817 727 605 724 448 450 364 358 361 264
100  98 402 309 795 638 791 748 832 831 862 895 896 834 881 893 850 851 892 849 728 671 533 670 532 531 451 265 362 160
209 308 207 488 632 401 636 634 747 829 859 742 856 823 855   0 816 775 852 726 776 606 672 608 534 164 263 363  48  47
 97 399 486 484 564 746 563 631 693 633 793 743 827 785 786 891 822 853 819 777 778 729 673 269 366 266 453 165 267  49
206 205 485 310 560 483 561 695 696 692 788 830 789 858 824 854 783 821 820 733 780 779 674 365 604 271 268 162 161  52
 96 204 307 306 690 559 629 744 790 689 627 687 787 740 741 784 737 684 781 734 732 612 611 609 454 456 535 166  50 270
 95 203 305 398 400 628 562 557 694 556 624 686 745 683 739 736 738 782 616 679 730 677 731 610 607 536 367 168 163  51
 94 202 397 396 480 482 555 688 691 625 620 551 622 621 547 617 681 680 546 614 544 613 676 537 455 457  55 368 272  53
 92 304 200 395 303 481 558 626 554 475 630 550 685 623 469 286 381 545 678 615 675 542 461 538 539 369 540 459 275 170
 91 201  93 393 478 301 389  84 294 473 474 552 549 548 470 619 466 735 618 465 543 464 462 373 460 541 371 167  54 274
198 199 302  90 295 394 476 477 390 472 553 386 471 384 468 287 682 382 379 380 463 374 377 376 281 458 372 169  58  56
 88  87 479 299 298 297 391 296  82 387 190 290 385 289 383 185 183 180 467 181 178 375 279  66 280 278 277 370 276  57
196  89 300 194 195 388 193  78 189 293 188 291 187  75 186 288 284  71 378  69 283  68 179  65 173 174  62 172 273 171
 86  85  81 197 192 392  79  83  80 191 292  77  76  74  73 184  72 285 182  70 282 177  67 176 175  64  63  61  60  59
