# This puzzle is unsolvable
20
145 144   5   3  78   7 149  11 152 208 151  89 265  15 156  90 158  93 161  95
  2  77 143   4  79   6  81  84 211   9  10 260  14  88  13  16  18  21  91 160
146 205   1 142  80 148 147  85 303 150 212  12 213  92 268 216 218  97  19  94
 75 204 259  76  70  82 261  83 365 267 210 157 153 159 307 217 219  25 344  17
 74 141 137 254 203 300 258   8 335  87 155 302 215 309 264 269 214  98  96  23
139 140 253 201 301 207 256 262 386 308 154 343 372  86 222 162  24 310 272 100
 73 200 257 202 299 206 338 209 366 304 339 390 266 315  29 311 273 221  20  26
336 255  68 249 333 395 341 287 337 367 397 340 305 369 370 165 220 163  27  22
 72 396 138 387 361 384 383 385 393 306 364 314 347 346 270 275 223 168 106  99
 69  71 297 295 135 250 252 355 332 323 345 349 312 388 103 263 271 166 227 101
 66 199 198 362 380 296 368 382 394 371 342 322 281  32 313 318 169 164 226 102
196 251 334  64 187 298 360 379 398 375 392 389 348 228 320 167  28 224 173 170
 65 289 294  67 248 358 363 239 324 376 381 378 399 234 225 373 374 278 107  34
197 136  63 331 134 237 350 132 293 330 377 391 356 316 229 276 115 277 104 108
194 129 189 244  61 329 185 285 353 126 357 240 283 317 109 172  30 105  39 177
131 247  57 245 291  59 290 243 359 188 181 282 319 179 232  36  31  33  35 171
133 191 246   0 242  54 127 327 195 118 183 352 321 351 280 110 230 274 117  37
190 130  62  60 193 124 123 241 184  44 180 236  42 174 178 111 233 114 231 176
 58  55 328 125  56  52 325 288 120  50  46 354 238 182 112 279 116  41 113 175
128 192  53 186  51 122 286 292 119 326 121  49  47 284  45  48  43 235  40  38
