# This puzzle is unsolvable
23
 89   1  92  90   6   5  94 176  98 249 250 180   0 177  15  17 105  20 185 106 107  21  22
168   3  91  87 172  96 171  93 362 311 309  12 178 367 100  16 252 315  19 257 109 108  24
167 169 239 170 173   4 174   9 306 363   8 251  11  99 102 104  18 187 255 259 188  25  23
 88  86 307 242 175   7 359   2 247  97  10  13 312  14 103 254 258 186 317 183 319  26 112
237  84 240 305 238 308 364 244 245 454 179 313  95 184 418 101 318 256 189 260 113 190 111
 81 163 304 165 408 241 360 310 446 523 481 415 366 314 181 368 373 316 322 110  27 261  28
166  85 164  80 235 409 449 243 246 487 182 248 370 508 413 417 375 369 323 320 253 374  29
 83 232 450 358 411 402 407 361 406 410 412 486 365 453 371 422 420 376 321 114 191 192 265
161  82 234 236 303 301 302 479 480 451 504 414 482 419 452 456 372 460 193 117  30  31 115
159  79 357 162 299 356 447 355 298 483 510 521 485 455 459 327 379 377 490 263  33 119 118
300 160 297 448 403 528 354 405 520 444 514 471 516 416 525 457 423 458 378 262 325 324  32
350 231 445 233  74 353 440 524 505 484 522 507 488 464 380 493 421 381 509 116 264 198 196
352 158  77 296 476 230 517 512 478 527 518 434 462 511 515 425 461 382 326 120 194 195  34
503  75  78 157 156 473 393 477 502 506 492 491 279 467 466 427 428 384 197 266 267  35  36
227  76 229 404 155 443 294 401 437 497 341 394 463 519 526 468 424 203 328 199 269 122 200
441 283 293 400 500 474 472 470 475 282 391 389 142  58 340 210 465 333 429 123 201 121  37
348 351 226 349  57 399 395 442 295 392 388 432 383 499 489 274 335 426 334 270 124  39  38
291  70 153 151 286 398 346 228 280 501 337 469 342 213 433 140 330 204 329 271 202 331  41
154 152 148  73 220 217 397 218 438 141 146  56 439 386 513 496 332 385 268 272  42  40 125
225  72 347 290 436 288 343 390 215 339  60 338 137 278 431 134 387 136 132 430 133 126 127
 67  65 224 287  71 292 149 344  55 284 147 277 495  54 494  51 336 209 273 275  48  47 129
223 150 396 289  61 221 222 216 435 285  59 214 138 345 211  50 208 130 276 128 205  43  44
 66  64  69  68  63 145  62 143 144 219 498 281 212 139  53 135 207  49  52 131 206  46  45
