# This puzzle is unsolvable
19
 69  77  72 136   3 138 139 195  11 198 144 252 143  87 204  88 205  19  17
  1 133 196   2   9   4 284 243   7 146  82 214 148 203 149 151  20  90  18
 75  71 135 240  74 314 242  10 199 200 347  79  81 206  15 250 153  89  92
134 239 193  73   5 194 140 209 137 316  76  16 249 152 342  91  26 208 207
241 191  70 280 311   6 197 358  12 292 245  83 288 154  86  85  21  13  23
 68 184 190  80  78 351 338 315 306 201 246 147 360  84 150 156 289  22 255
234 282   0 334 192 336 202 325 286 145   8 341 244  95 210 254  96  25  24
187 131 132 353 233 331 142 189 313 308 339 155 248 291 251 290 287 256  94
 65  67 186 309 285 182 312 238 355 320 326 340 160 253  93  14 247 159 158
 64 130 188 274 278  66 283 279 348 356 335 275 328 258 211 318  28  27 101
235  61 237 185 268 330 141 281 317 300 319 354 344 157 294 162 293 212 213
128 129 271 333 304 270 227 350 349 323 352 310 345 296 163  98 263  99 261
269 236 183 273 307 276 332 229 337 329 346 172 321  30 219 161 100 257 216
127  63  58 272 230 277 327 305 357 298 170 267 359 295 102  33 108  32  38
125 126  59  57 231 232 302 225 322 176 303 301  42 218 343 259 168 106  31
 60  62 180 124 123 224 122 223 113 297 114 265 167  34 165 169  97 260  35
 55  52  53 179 120 118 266 175 117 111 171 221 226 110 324 103 164 217  29
 56 181  48  50  49  51 177 222 174  46 262 264 112 166  39 109 104  45  40
121  54 119 178 299 115 228  47  44  43 116 173  41 220 215  36  37 107 105
