# This puzzle is unsolvable
65
   3    1    2  503    4    8  262   10    9   11  265   13  268   15   16  270   18  274  520  272   22  526  276  279   26   27  282   29   30  285   31   32   33   34   35   36   37   38   39   40   41   42   43   44   45   46   47   48   49   50   51   52   53   54   55   56   57   58   59   60   61   62   63   64   65
 258  501  259    5  264  509  260  511  750    7  266   12  269   14  516  271  761  522   23   20  278  525   24  766  277  280   25   28  284  532  286  287  288  289  290  291  292  293  294  295  296  297  298  299  300  301  302  303  304  305  306  307  308  309  310  311  312  313  314  315  316  317  318  319   66
 257  975  506  504  261  508    6  510  980  513  267  514  515  755  517  273  989 1217  992   19  762  994  527  281  993  764  769  283  531  533  534 1004  535  536  537  538  539  540  541  542  543  544  545  546  547  548  549  550  551  552  553  554  555  556  557  558  559  560  561  562  563  564  565  320   67
 255  254  505  745  747  507 1201  978  749  512  752  984  753  754  518  757  759  760  519 1216  767   21  996  995  529  999  530  770  771 1002 1003  773  774  775  776  777  778  779  780  781  782  783  784  785  786  787  788  789  790  791  792  793  794  795  796  797  798  799  800  801  802  803  566  321   68
 252  744  500  743  746 1200 1202  263 1419  985 1629  983  986 1426  756  758   17 1214  275  991  523  763 1434  765  528  768 1221 1223  772 1440 1225 1226 1005 1006 1007 1008 1009 1010 1011 1012 1013 1014 1015 1016 1017 1018 1019 1020 1021 1022 1023 1024 1025 1026 1027 1028 1029 1030 1031 1032 1033  804  567  322   69
 251  256  973  502  979 1199  748  981 1205  982 1203 2377 1208 1424 1425 1633 1213  988  990 1636 1215 1431  524 1220  998 1222 1000 1438 1224 1001 1441 1227 1228 1229 1230 1231 1232 1233 1234 1235 1236 1237 1238 1239 1240 1241 1242 1243 1244 1245 1246 1247 1248 1249 1250 1251 1252 1253 1254 1255 1034  805  568  323   70
 250  253  976 1416  977  974 1206 1417 1628  751 1420 1828 1422  987 1210 1209 1211 1428 1429  521 1432 1218 1219 1641 1435  997 1436 1645 1644 1439 1648 1442 1443 1444 1445 1446 1447 1448 1449 1450 1451 1452 1453 1454 1455 1456 1457 1458 1459 1460 1461 1462 1463 1464 1465 1466 1467 1468 1469 1256 1035  806  569  324   71
 742  741  739  971 1415 1414 1624 1826 1825 1626 1824 1421 1423 1632 1833 1634 1427 2024 1637 1430 1638 1639 1433 1640 1642 1643 1842 1437 1646 1846 1647 1649 1650 1651 1652 1653 1654 1655 1656 1657 1658 1659 1660 1661 1662 1663 1664 1665 1666 1667 1668 1669 1670 1671 1672 1673 1674 1675 1470 1257 1036  807  570  325   72
 499  249 1197  738 1819 1204 1196 1623 2200 1621 1827 1207 2203 1631 1831 2205 1212 1635 2026 2027 2028 1836 1837 1838 2033 1841 1844 2218 2036 1845 1848 2039 1849 1850 1851 1852 1853 1854 1855 1856 1857 1858 1859 1860 1861 1862 1863 1864 1865 1866 1867 1868 1869 1870 1871 1872 1873 1676 1471 1258 1037  808  571  326   73
 248  498  496  972 1409 1418 1412 1198 2016 2017 2020 2202 1630 2707 2548 2383 1832 2382 1835 2210 2025 2030 1840    0 2215 2391 2216 1843 2037 2038 2221 2222 2040 2041 2042 2043 2044 2045 2046 2047 2048 2049 2050 2051 2052 2053 2054 2055 2056 2057 2058 2059 2060 2061 2062 2063 1874 1677 1472 1259 1038  809  572  327   74
 247  737  497 1194 1193  970  740 1622 1620 2376 1829 1830 2018 2378 2022 2023 2208 2542 2209 1834 2029 2213 2031 2034 2388 2032 2390 2217 2035 1847 2219 2397 2223 2224 2225 2226 2227 2228 2229 2230 2231 2232 2233 2234 2235 2236 2237 2238 2239 2240 2241 2242 2243 2244 2245 2064 1875 1678 1473 1260 1039  810  573  328   75
 246  495  736 1411 1195 1413 1625 1822 1627 2015 1410 2019 2199 2021 2381 2207 2206 2385 2211 2212 2712 2214 1839 2555 2867 2717 2558 2392 2394 2395 2220 2396 2398 2399 2400 2401 2402 2403 2404 2405 2406 2407 2408 2409 2410 2411 2412 2413 2414 2415 2416 2417 2418 2419 2246 2065 1876 1679 1474 1261 1040  811  574  329   76
 245  494  735 1192 1408  968 1823 2196 2201 1821 2375 2204 2374 2708 2857 2379 2709 3000 2861 2553 2386 2556 2387 2715 2389 3145 2559 2393 2561 2562 2563 2564 2565 2566 2567 2568 2569 2570 2571 2572 2573 2574 2575 2576 2577 2578 2579 2580 2581 2582 2583 2584 2585 2420 2247 2066 1877 1680 1475 1262 1041  812  575  330   77
 244  493  967  969  964 1619 1614 2010 1618 2195 2014 2546 2547 2544 2705 2380 2858 2384 2545 2711 2714 2554 3269 2865 3143 2557 2718 2560 2720 2873 2721 2723 2724 2725 2726 2727 2728 2729 2730 2731 2732 2733 2734 2735 2736 2737 2738 2739 2740 2741 2742 2743 2586 2421 2248 2067 1878 1681 1476 1263 1042  813  576  331   78
 243  734  966  733 1816  965 1820 1190 2855 2197 2013 2011 2704 3002 2859 2706 2701 2550 2710 2551 2552 2716 3009 3268 3010 3146 2870 2719 2871 2872 2722 2874 2875 2876 2877 2878 2879 2880 2881 2882 2883 2884 2885 2886 2887 2888 2889 2890 2891 2892 2893 2744 2587 2422 2249 2068 1879 1682 1477 1264 1043  814  577  332   79
 242  492  491 1191 1406 1817 2541 2009 2373 2012 1818 2703 2198 3001 2543 2549 3003 3264 3138 2862 2863 3007 2864 3008 3011 3148 3274 3012 3014 3015 3016 3017 3018 3019 3020 3021 3022 3023 3024 3025 3026 3027 3028 3029 3030 3031 3032 3033 3034 3035 2894 2745 2588 2423 2250 2069 1880 1683 1478 1265 1044  815  578  333   80
 241  490  731  732  963 1189 1404 1407 2006 1615 2008 2999 2370 2854 3136 3262 3004 3266 2860 3267 3005 3140 2713 3144 3147 2868 3272 3013 3275 3150 3151 3152 3153 3154 3155 3156 3157 3158 3159 3160 3161 3162 3163 3164 3165 3166 3167 3168 3169 3036 2895 2746 2589 2424 2251 2070 1881 1684 1479 1266 1045  816  579  334   81
 240  489  730  962 1188 1405 1617 2192 1815 2540 2700 2372 2699 2702 2852 2856 3263 3137 3141 3386 3389 3006 3142 3271 2869 2866 3391 3394 3276 3277 3278 3279 3280 3281 3282 3283 3284 3285 3286 3287 3288 3289 3290 3291 3292 3293 3294 3295 3170 3037 2896 2747 2590 2425 2252 2071 1882 1685 1480 1267 1046  817  580  335   82
 239  488  729 1187 1616 1403 1813 2193 1814 2194 2371 2538 2539 2997 2998 2853 3135 3497 3265 3385 3387 3601 3390 3603 3501 3393 3149 3395 3607 3396 3397 3398 3399 3400 3401 3402 3403 3404 3405 3406 3407 3408 3409 3410 3411 3412 3413 3296 3171 3038 2897 2748 2591 2426 2253 2072 1883 1686 1481 1268 1047  818  581  336   83
 238  487  728  961 1186 1402 1611 1613 1612 2369 2007 2850 2536 2851 3133 3382 2849 3384 3139 3499 3602 3697 3388 3605 3270 3503 3502 3609 3608 3506 3508 3509 3510 3511 3512 3513 3514 3515 3516 3517 3803 3518 3520 3521 3522 3523 3414 3297 3172 3039 2898 2749 2592 2427 2254 2073 1884 1687 1482 1269 1048  819  582  337   84
 237  486  727  959 1185 1610 1401 1811 1812 2191 2368 2367 2537 2994 2996 3132 3261 3260 3383 3600 3498 3785 3695 3784 3698 3392 3702 3273 3505 3507 3611 3612 3613 3614 3615 3616 3617 3619 3620 3715 3804 3623 3805 3624 3625 3524 3415 3298 3173 3040 2899 2750 2593 2428 2255 2074 1885 1688 1483 1270 1049  820  583  338   85
 236  485  726 1184  960 1183 1810 2003 2005 2190 2366 2535 2698 2848 2696 3259 3381 3134 3494 3495 3493 3864 3781 3604 3788 3606 3701 3504 3703 3610 3706 3707 3708 3797 3709 3712 3710 3714 3618 3801 3716 3519 3622 3719 3626 3525 3416 3299 3174 3041 2900 2751 2594 2429 2256 2075 1886 1689 1484 1271 1050  821  584  339   86
 235  484  725  958 1400 1609 1809 1608 2004 2188 2847 2697 2991 2695 2992 3258 2995 3496 3131 3599 3787 3699 3783 3865 3500 3789 3704 3790 3871 3705 3792 3872 4008 3711 3875 3800 3713 3880 3802 3718 3717 3883 3621 3720 3627 3526 3417 3300 3175 3042 2901 2752 2595 2430 2257 2076 1887 1690 1485 1272 1051  822  585  340   87
 234  483  724  957 1182 1399 2002 2001 2189 2187 2533 2534 2365 2993 3130 3377 3380 3378 3598 3696 3782 3693 3786 3863 3867 3938 3869 3870 4005 4007 3795 3793 3873 3944 3948 3798 3877 3879 3951 3952 3881 3884 3806 3721 3628 3527 3418 3301 3176 3043 2902 2753 2596 2431 2258 2077 1888 1691 1486 1273 1052  823  586  341   88
 233  482  723  956 1181 1398 1607 1808 2000 1807 2363 2532 2694 2846 2531 3129 3491 3379 3490 3596 3694 3692 3780 3866 3700 4000 3868 3940 3941 3791 3945 3794 4012 3943 3874 3799 4013 4014 3950 3954 3882 3885 3807 3722 3629 3528 3419 3302 3177 3044 2903 2754 2597 2432 2259 2078 1889 1692 1487 1274 1053  824  587  342   89
 232  481  722  955 1180 1397 1999 1806 2185 2692 2186 3127 2693 2989 2990 3257 3128 3376 3256 3492 3597 3691 3862 3937 3936 3999 3939 4003 4004 4106 4006 3876 4201 4065 4063 3947 4066 3878 4016 4069 3955 3953 3808 3723 3630 3529 3420 3303 3178 3045 2904 2755 2598 2433 2260 2079 1890 1693 1488 1275 1054  825  588  343   90
 231  480  721  954 1179 1396 1606 1605 2184 2362 2690 2364 2845 2844 2987 3126 3254 3255 3593 3595 3594 3861 3860 3935 3934 4001 4055 4057 4002 4146 3942 4149 4110 4011 3949 4112 3796 4151 4114 4015 3956 3886 3809 3724 3631 3530 3421 3304 3179 3046 2905 2756 2599 2434 2261 2080 1891 1694 1489 1276 1055  826  589  344   91
 230  479  720  953 1178 1395 1604 1805 1998 2183 2530 2361 2691 2843 2988 3125 3375 3488 3489 3592 3690 3779 3859 3998 4054 4058 4059 4056 4061 4107 4108 4177 4064 3946 4111 4010 4117 4067 4017 4073 3887 3888 3810 3725 3632 3531 3422 3305 3180 3047 2906 2757 2600 2435 2262 2081 1892 1695 1490 1277 1056  827  590  345   92
 229  478  719  952 1177 1394 1603 1804 1997 2182 2359 2360 2529 2842 2986 3124 3253 3374 3487 3689 3688 3778 3933 3932 3997 4103 4144 4104 4200 4202 4060 4148 4147 4009 4150 4183 4113 4115 4068 4071 4018 3811 3726 3727 3633 3532 3423 3306 3181 3048 2907 2758 2601 2436 2263 2082 1893 1696 1491 1278 1057  828  591  346   93
 228  477  718  951 1176 1393 1602 1803 1996 2181 2358 2528 2689 2840 2841 3123 3252 3373 3486 3687 3590 3858 3931 3996 3995 4053 4102 4143 4105 4062 4222 4109 4179 4181 4182 4152 4116 4153 4070 3957 3958 3889 3813 3812 3634 3533 3424 3307 3182 3049 2908 2759 2602 2437 2264 2083 1894 1697 1492 1279 1058  829  592  347   94
 227  476  717  950 1175 1392 1601 1802 1995 2180 2357 2688 2527 2526 2984 3122 3251 3372 3485 3591 3686 3777 3857 3930 4051 4052 4145 4176 4219 4174 4199 4180 4216 4204 4186 4205 4206 4154 4072 4118 3959 3890 3814 3728 3635 3534 3425 3308 3183 3050 2909 2760 2603 2438 2265 2084 1895 1698 1493 1280 1059  830  593  348   95
 226  475  716  949 1174 1391 1600 1801 1994 2179 2356 2525 2687 2985 2839 3121 3250 3371 3484 3589 3775 3776 3856 3929 3994 4142 4101 4100 4141 4175 4178 4224 4217 4203 4185 4207 4156 4155 4019 3960 3892 4022 3891 3729 3636 3535 3426 3309 3184 3051 2910 2761 2604 2439 2266 2085 1896 1699 1494 1281 1060  831  594  349   96
 474  473  715  948 1173 1390 1599 1800 1993 2178 2355 2685 2686 2838 2983 3120 3249 3370 3483 3588 3685 3774 3855 3928 3993 4050 4099 4140 4173 4214 4215 4218 4223 4221 4184 4188 4157 4023 4074 4020 3961 3893 3815 3730 3637 3536 3427 3310 3185 3052 2911 2762 2605 2440 2267 2086 1897 1700 1495 1282 1061  832  595  350   97
 225  472  714  947 1172 1389 1598 1799 2177 2176 2354 2524 2684 2837 2982 3119 3248 3369 3482 3587 3684 3773 3854 3927 3992 4049 4098 4139 4172 4198 4213 4211 4212 4187 4208 4159 4120 4119 4075 4021 4076 3894 3816 3731 3638 3537 3428 3311 3186 3053 2912 2763 2606 2441 2268 2087 1898 1701 1496 1283 1062  833  596  351   98
 224  222  946  945 1597 1797 1596 1991 1992 2353 2522 2523 2683 2836 2981 3118 3247 3368 3481 3586 3683 3772 3853 3926 3991 4048 4097 4138 4196 4197 4193 4165 4192 4220 4209 4121 4158 4122 3963 3964 3965 3962 3817 3732 3639 3538 3429 3312 3187 3054 2913 2764 2607 2442 2269 2088 1899 1702 1497 1284 1063  834  597  352   99
 223  471  713 1171 1388 1595 1798 1990 1989 2175 2352 2521 2682 2835 2980 3117 3246 3367 3480 3585 3682 3771 3852 3925 3990 4047 4096 4137 4171 4170 4194 4191 4210 4190 4189 4162 4160 4077 4024 4025 3895 3896 3818 3733 3640 3539 3430 3313 3188 3055 2914 2765 2608 2443 2270 2089 1900 1703 1498 1285 1064  835  598  353  100
 221  712  944 1170 1169 1385 1387 1386 1796 2174 2350 2520 2681 2834 2979 3116 3245 3366 3479 3584 3681 3770 3851 3924 3989 4046 4095 4136 4169 4195 4168 4166 4130 4164 4163 4161 4123 4078 4124 4027 4079 4026 3819 3734 3641 3540 3431 3314 3189 3056 2915 2766 2609 2444 2271 2090 1901 1704 1499 1286 1065  836  599  354  101
 220  711  470  710 1168 1593 1594 1795 1988 2351 2519 2518 2680 2833 2978 3115 3244 3365 3478 3583 3680 3769 3850 3923 3988 4045 4094 4135 4134 4133 4167 4131 4087 4129 4128 4127 4126 4125 4080 4028 3966 3897 3820 3735 3642 3541 3432 3315 3190 3057 2916 2767 2610 2445 2272 2091 1902 1705 1500 1287 1066  837  600  355  102
 940  469  708  943  942 1384 1793 1794 1987 2173 2679 2348 2678 2832 2977 3114 3243 3364 3477 3582 3679 3768 3849 3922 3987 4044 4093 4092 4091 4090 4132 4089 4088 4086 4085 4084 4083 4082 4081 4029 3967 3898 3821 3736 3643 3542 3433 3316 3191 3058 2917 2768 2611 2446 2273 2092 1903 1706 1501 1288 1067  838  601  356  103
 219  217  468 1166 1163 1383 1592 1792 1986 2172 2171 2349 2831 2830 2976 3113 3242 3363 3476 3581 3678 3767 3848 3921 3986 4043 4042 4041 4040 4039 4038 4037 4036 4035 4034 4033 4032 4031 4030 3970 3969 3968 3822 3737 3644 3543 3434 3317 3192 3059 2918 2769 2612 2447 2274 2093 1904 1707 1502 1289 1068  839  602  357  104
 466  467  709 1165 1167 1382 1381 1591 1985 2170 2347 2517 2516 2677 2975 3112 3241 3362 3475 3580 3677 3766 3847 3920 3985 3984 3983 3982 3981 3980 3979 3978 3977 3976 3975 3974 3973 3972 3904 3971 3902 3899 3823 3738 3645 3544 3435 3318 3193 3060 2919 2770 2613 2448 2275 2094 1905 1708 1503 1290 1069  840  603  358  105
 218  465  941  939  707 1164 1590 1791 1984 2169 2346 2515 2676 2829 2974 3111 3240 3361 3474 3579 3676 3765 3846 3919 3918 3917 3916 3915 3914 3913 3912 3910 3835 3909 3908 3907 3906 3830 3905 3828 3903 3900 3901 3739 3646 3545 3436 3319 3194 3061 2920 2771 2614 2449 2276 2095 1906 1709 1504 1291 1070  841  604  359  106
 216  463  706  705  938 1162 1589 1790 1983 2168 2345 2514 2675 2828 2973 3110 3239 3360 3473 3578 3675 3764 3845 3844 3843 3842 3841 3840 3839 3838 3837 3836 3911 3834 3833 3832 3831 3829 3746 3745 3827 3826 3824 3740 3647 3546 3437 3320 3195 3062 2921 2772 2615 2450 2277 2096 1907 1710 1505 1292 1071  842  605  360  107
 464  215  213  936  937 1380 1379 1789 1982 2167 2344 2513 2674 2827 2972 3109 3238 3359 3472 3577 3674 3763 3762 3761 3760 3759 3758 3757 3756 3755 3754 3753 3752 3751 3750 3749 3748 3656 3747 3744 3743 3825 3742 3741 3648 3547 3438 3321 3196 3063 2922 2773 2616 2451 2278 2097 1908 1711 1506 1293 1072  843  606  361  108
 214  702  704  703 1161 1378 1588 1788 1981 2166 2343 2511 2512 2826 2971 3108 3237 3358 3471 3576 3673 3672 3671 3670 3669 3668 3667 3666 3665 3664 3564 3663 3661 3660 3659 3658 3657 3557 3655 3654 3653 3551 3652 3650 3649 3548 3439 3322 3197 3064 2923 2774 2617 2452 2279 2098 1909 1712 1507 1294 1073  844  607  362  109
 212  211  461  701 1159 1160 1587 1979 1586 2164 2165 2342 2673 2672 2970 3107 3236 3357 3470 3575 3574 3573 3572 3571 3570 3569 3568 3567 3566 3565 3457 3662 3562 3561 3560 3452 3559 3558 3556 3555 3553 3552 3651 3444 3550 3549 3440 3323 3198 3065 2924 2775 2618 2453 2280 2099 1910 1713 1508 1295 1074  845  608  363  110
 210  462  459  935 1157 1377 1585 1787 1786 1980 2341 2510 2670 2825 2671 3106 3235 3356 3469 3468 3467 3466 3465 3464 3463 3462 3461 3460 3459 3458 3342 3563 3455 3454 3338 3453 3336 3451 3449 3447 3332 3554 3446 3445 3443 3442 3441 3324 3199 3066 2925 2776 2619 2454 2281 2100 1911 1714 1509 1296 1075  846  609  364  111
 209  460  933  934 1158 1376 1584 1785 1977 1978 2163 2509 2824 2968 2969 3105 3234 3355 3354 3353 3352 3351 3350 3349 3348 3347 3346 3345 3344 3343 3456 3086 3341 3217 3340 3339 3213 3450 3335 3334 3333 3331 3330 3329 3328 3327 3326 3325 3200 3067 2926 2777 2620 2455 2282 2101 1912 1715 1510 1297 1076  847  610  365  112
 458  699  700  932 1374 1375 1583 1784 1976 2339 2340 2508 2669 2823 2967 3104 3233 3232 3231 3230 3229 3228 3227 3226 3225 3224 3223 3222 3221 3220 3218 3088 3216 3215 3214 3337 3083 3212 3210 3209 3448 3208 3207 3206 3205 3204 3203 3202 3201 3068 2927 2778 2621 2456 2283 2102 1913 1716 1511 1298 1077  848  611  366  113
 208  457  698  931 1156 1373 1582 1783 2162 2338 2507 2668 2820 2822 2821 3103 3102 3101 3100 3099 3098 3097 3096 3095 3094 3093 3092 3091 3090 3089 2949 3219 2948 3085 3084 3081 2799 2944 3211 2940 3078 3077 3076 3075 3074 3073 3072 3071 3070 3069 2928 2779 2622 2457 2284 2103 1914 1717 1512 1299 1078  849  612  367  114
 207  456  697  930 1155 1372 1581 1782 2160 2161 2337 2506 2965 2667 2966 2964 2963 2962 2961 2960 2959 2958 2957 2956 2955 2954 2953 2952 2951 2950 2802 2801 3087 2945 2798 2796 2942 2941 3079 3080 2939 2938 2937 2936 2935 2934 2933 2932 2931 2930 2929 2780 2623 2458 2285 2104 1915 1718 1513 1300 1079  850  613  368  115
 206  455  696  929 1154 1371 1580 1781 1975 1974 2336 2505 2666 2819 2818 2817 2816 2815 2814 2813 2812 2811 2810 2809 2808 2807 2806 2805 2649 2804 2803 2946 2947 2800 2797 2642 3082 2795 2638 2793 2792 2791 2790 2789 2788 2787 2786 2785 2784 2783 2782 2781 2624 2459 2286 2105 1916 1719 1514 1301 1080  851  614  369  116
 205  454  695  928 1153 1370 1579 1780 1973 2159 2335 2504 2502 2665 2664 2662 2661 2660 2659 2658 2657 2656 2655 2654 2653 2652 2650 2488 2486 2484 2646 2648 2645 2943 2482 2480 2640 2476 2794 2639 2637 2636 2635 2634 2633 2632 2631 2630 2629 2628 2627 2626 2625 2460 2287 2106 1917 1720 1515 1302 1081  852  615  370  117
 204  453  694  927 1152 1369 1578 1779 1972 2158 2157 2334 2503 2501 2663 2499 2498 2497 2496 2495 2494 2493 2492 2491 2490 2489 2651 2137 2316 2483 2313 2647 2311 2481 2308 2644 2641 2477 2305 2475 2474 2473 2472 2471 2470 2469 2468 2467 2466 2465 2464 2463 2462 2461 2288 2107 1918 1721 1516 1303 1082  853  616  371  118
 203  452  693  926 1151 1368 1577 1778 1971 2156 2333 2332 2331 2329 2500 2328 2327 2326 2325 2324 2323 2322 2321 2320 2319 2318 2317 2136 2487 2485 2312 2133 2310 2131 2309 2479 2127 2128 2307 2304 2302 2301 2300 2121 2299 2298 2297 2296 2295 2294 2293 2292 2291 2290 2289 2108 1919 1722 1517 1304 1083  854  617  372  119
 202  451  692  925 1150 1367 1576 1777 1970 2155 2154 2153 2152 2330 2151 2149 2148 2147 1958 2146 2144 2143 2142 2141 2140 2139 2138 2315 1949 2135 2314 2134 2132 1749 1943 2478 2129 2643 2306 2126 2303 1937 2123 2122 2120 2119 2118 2117 2116 2115 2114 2113 2112 2111 2110 2109 1920 1723 1518 1305 1084  855  618  373  120
 201  450  691  924 1149 1366 1575 1776 1969 1968 1967 1966 1965 1964 2150 1963 1766 1961 1960 2145 1957 1956 1955 1954 1953 1952 1951 1950 1948 1947 1946 1751 1945 1944 1942 1747 2130 1939 1938 2124 2125 1936 1740 1738 1935 1932 1931 1930 1929 1928 1927 1926 1925 1924 1923 1922 1921 1724 1519 1306 1085  856  619  374  121
 200  449  690  923 1148 1365 1574 1775 1774 1773 1772 1771 1770 1769 1768 1962 1767 1765 1959 1560 1763 1761 1760 1759 1758 1757 1756 1755 1754 1549 1752 1750 1748 1545 1334 1544 1940 1941 1745 1541 1743 1741 1934 1739 1933 1737 1736 1735 1734 1733 1732 1731 1730 1729 1728 1727 1726 1725 1520 1307 1086  857  620  375  122
 199  448  689  922 1147 1364 1573 1572 1571 1570 1569 1568 1567 1566 1565 1564 1563 1562 1764 1561 1762 1559 1557 1556 1555 1554 1553 1552 1551 1753 1550 1337 1548 1546 1336 1542 1746 1543 1330 1539 1742 1538 1536 1537 1535 1324 1533 1532 1531 1530 1529 1528 1527 1526 1525 1524 1523 1522 1521 1308 1087  858  621  376  123
 198  447  688  921 1146 1363 1362 1361 1360 1359 1358 1357 1356 1355 1354 1353 1352 1351 1349 1348 1130 1558 1346 1345 1343 1125 1342 1341 1340 1339 1547 1118 1115 1116 1332 1744 1111  650  885 1108 1540 1327 1107 1325 1105 1534 1323 1320 1319 1100 1318 1317 1316 1315 1314 1313 1312 1311 1310 1309 1088  859  622  377  124
 197  446  687  920 1145 1144 1143 1142 1141 1140 1139 1138 1137 1136 1135 1134 1133 1132 1350  667  902 1347 1128 1126 1344  662 1124 1123 1121 1120 1338  890  891  888 1114 1331 1112  406 1110  884  647  882 1328 1326 1104 1102 1322 1321 1101  873 1099 1098 1097 1096 1095 1094 1093 1092 1091 1090 1089  860  623  378  125
 196  445  686  919  918  917  916  915  914  913  912  911  910  909  908  907  906  905  904 1131  903 1129  900 1127  663  898  661  897  894  893  892 1119 1335  889 1113 1333  408  651  887 1329 1109  881  879 1106  878 1103  147  876  874  638  872  871  870  869  868  867  866  865  864  863  862  861  624  379  126
 195  444  685  684  683  682  681  680  679  678  677  676  675  674  673  672  671  670  669  668  666  901  899  665  664  419  896 1122  660  659  658  657  654 1117  655  653  648  652  155  883  649  646  880  644  643  877  642  641  640  396  637  636  635  634  633  632  631  630  629  628  627  626  625  380  127
 194  443  442  441  440  439  438  437  436  435  434  433  432  431  430  429  428  427  426  425  424  423  422  421  420  418  895  167  416  415  414  656  413  160  410  159  158  407  156  405  153  404  645  152  400  399  875  398  395  639  142  143  392  391  390  389  388  387  386  385  384  383  382  381  128
 193  192  191  190  189  188  187  186  185  184  183  182  181  180  179  178  177  176  175  174  173  172  171  170  169  168  166  417  165  164  163  162  412  161  411  409  886  157  154  403  151  150  401  402  149  148  146  145  397  394  144  393  141  140  139  138  137  136  135  134  133  132  131  130  129
