# This puzzle is unsolvable
63
   2    1    3    4    5    6    7    8    9   10   12  258   13   14   15   16   17   18   19   20   21   22   23  510   24  270  516   27   25   29  751  519   34  974  754   37   39   36   40   41  286   42   43   44   45   46   47   48   49   50   51   52   53   54   55   56   57   58   59   60   61   62   63
 248  249  250  251  252  253  254  255  256  257   11  259  260  261  262  263  264  265  266  267  507  509  269  274  511  966  513  514  277   31   32  279  521  282  523  524   38  284  753  289  287  528  290  291  292  293  294  295  296  297  298  299  300  301  302  303  304  305  306  307  308  309   64
 247  488  489  490  491  492  493  494  495  496  497  498  499  501  502  734  503  505  956  736  737  739  271  512  515   26  275  276  748   28   30 1188  283  280  281  522  520  525  285  757  526  288  529  530  531  532  533  534  535  536  537  538  539  540  541  542  543  544  545  546  547  310   65
 246  487  720  721  722  723  724  725  726  951  950  727  730  953  733  957 1768 1577  960  959  961  268  508  272  741  273  742  969  278  747  517  749 1189   35  752 1395  755  977 1193  981  980  759  760  761  762  763  764  765  766  767  768  769  770  771  772  773  774  775  776  777  548  311   66
 245  486  719  944  945  946  947  948 1164  949  729  728  731  952  954 1172  504 1382  958 1175  738  506  962  740 1179  964  744  743  745  970 1393  518  750  973 1398 1396  976  978 1195  758 1198 1196  982  984  985  986  987  988  989  990  991  992  993  994  995  996  997  998  999  778  549  312   67
 244  485  718  943 1160 1161 1163 1369 1165 1166 1167  500 1168 1169  955 1170  732  735 1176 1383 1177 1384  963 1182  965 1388  968  746 1184 1185  971 1186   33 1397 1190 1191 1192  979  756 1194  527  983 1404 1199 1408 1200 1202 1203 1204 1205 1206 1207 1208 1209 1210 1211 1212 1000 1215 1001  779  313   68
 243  484  717  942 1368 1568 1162 1370 1371 1372 1374 1764 1375 1378 1171 1379 1173 1581 1174 1582 1583 1584 1178 1386 1387 1181 1589 1390 1391 1392 1592 1595  975 1786  972 1597 1400 1598 1401 1402 1403 1605 1405 1604 1406 1201 1409 1410 1411 1412 1413 1414 1415 1416 1616 1417 1418 1419 1213  551  550  314   69
 242  483  716  941 1159 1158 1567 1367 1571 1572 1373 1763 1573 1376 1576 1769 1578 1380 1771 1955 1381 1385 2133 1585 1776 1180 1586  967 1590 1781 1591 1187 1394 1594 1785 1399 1787 1973 1600 1601 1602 1603 1197 1407 1606 1607 1608 1609 1610 1611 1612 1613 1614 1615 1807 1420 1421 1002  781  553  780 1003   70
 241  482  715  940 1157 1366 1566 1570 1569 1946 1761 2121 1575 1765 1377 1767 1952 1579 1954 1772 1773 1580 1774 1775 1587 2137 1389 1183 1588 1965 1782 1593 1969 2313 1788 1970 1596 2147 1791 1599 1792 1979 1977 1794 1795 1797 1798 1799 1800 1802 1803 1804 1805 1806 1618 1617 1214 1007 1004  554  784  315   71
 240  481  714  939 1156 1365 1759 1760 1758 2120 1944 1948 1766 1574 1949 1950 2126 1953 1770 2130 1956 2132 1777 2135 2302 1779 1778 1962 1780 1964 1783 1784 2142 2143 2145 1972 1789 2148 2317 1975 1976 1793 1978 1980 1796 1981 1982 1983 1801 1985 1986 1987 1988 1989 1808 1619  782 1216 1217  552 1005  316   72
 239  480  713  938 1155 1364 1564 1941 2119 1945 1762 1947 2122 2124 2125 2127 1951 2128 2129 2131 2300 1957 1959 1958 1961 1960 2304 1963 2139 2140 1966 2141 1967 2310 2144 1971 2146 2624 1974 1790 2149 2153 2320 2154 2155 2157 2324 2159 1984 2160 2161 2163 2330 1990 1809 1620 1422 1424 1219  556 1221  318   73
 238  479  712  937 1154 1362 1363 1942 1565 1943 2288 2289 2123 2291 2292 2293 2294 2295 2296 2297 2457 2298 2299 2459 2134 2305 2303 2464 2306 2307 2308 1968 2309 2311 2312 2472 2315 2316 2151 2150 2152 2478 2319 2321 2322 2156 2325 2158 2326 2327 2328 2164 1991 2329 1810 1621 1423  785 1218  320 1008  789  319
 237  478  711  936 1153 1361 1563 1757 1756 2118 2287 2448 2290 2450 2451 2452 2454 2604 2455 2608 2751 2458 2460 2301 2461 2138 2136 2462 2465 2466 2467 2468 2469 2470 2471 2473 2474 2314 2475 2476 2318 2628 2479 2631 2480 2323 2482 2484 2485 2486 2487 2166 2162 2331 1623 1622 1425 1813  555  788   74  557  321
 236  477  710  935 1152 1360 1562 1755 2117 2286 2285 2447 2449 2601 2602 2603 2453 2606 2884 2607 2456 2609 2610 2611 2612 2614 2463 2615 2616 2617 2618 2619 2620 2621 2622 2623 2767 2625 2626 2627 2477 2629 2630 2775 2632 2634 2483 2635 2636 2637 2488 2332 2165 1993 1811 1624 1427  317 1220  322   75  563  558
 235  476  709  934 1150 1561 1754 1939 1940 2116 2284 2446 2600 2744 2745 2746 2747 2605 2882 2750 2752 2887 2753 2754 2755 2613 2756 2757 2759 2760 2761 2762 2763 2764 2899 2765 2902 2768 2769 2905 2770 2771 2773 2481 2774 2633 2777 2778 2779 2638 2489 2333 1992 2167 1994 1812 1010 1426  786 1006  783  560   78
 234  475  708  933 1359 1151 1560 1753 1938 2115 2283 2445 2599 2743 2880 2881 3009 3128 3129 2885 2749 3012 2888 2889 2890 2891 2892 2758 3021 2894 2895 2896 2897 3026 2766 3028 2900 2903 2904 3032 2906 2907 2772 2910 3037 2776 2912 2913 2780 2639 2490 2168 1995 1814 1625 1428 1222  790 1009  559  323   76  561
 233  474  707  932 1149 1358 1559 1752 1937 2114 2282 2444 2598 2597 2741 2742 2748 2883 3010 3013 2886 3014 3015 3016 3017 3018 3019 2893 3020 3022 3023 3024 2898 3145 3027 3147 2901 3030 3150 3031 3033 2908 2909 3036 3038 2911 3039 2914 2783 2781 2491 2334 2169 1996 1815 1223 1627 1430 1011  787   79  324  325
 232  473  706  931 1148 1357 1558 1751 1936 2281 2112 2443 2596 2739 2879 3007 3008 3242 3240 3130 3132 3133 3134 3135 3136 3137 3138 3139 3140 3141 3142 3143 3025 3144 3146 3258 3029 3148 3149 3151 3263 3034 3035 3155 3156 3157 3040 3041 2782 2640 2642 2335 2170 1997 1816 1626 1224  791 1225  562   81 1012  792
 231  472  705  930 1147 1356 1557 1750 1935 2111 2113 2442 2595 2740 2877 2878 3127 3006 3011 3345 3243 3244 3245 3246 3247 3248 3249 3250 3251 3252 3253 3254 3255 3256 3257 3361 3259 3260 3261 3152 3262 3153 3154 3266 3267 3158 2916 2641 2915 2643 2492 2336 2171 1998 1817 1628 1014 1429 1226 1013  564   77   82
 230  471  704  929 1146 1355 1556 1749 1934 2110 2280 2441 2594 2738 2876 3005 3126 3239 3131 3241 3346 3347 3348 3349 3350 3351 3352 3353 3354 3355 3356 3357 3358 3359 3360 3456 3362 3363 3364 3365 3366 3367 3265 3264 3368 3159 3268 2918 2917 2644 2493 2494 2337 1999 1818 1629 1431 1432  326  565  328   83   84
 229  470  703  928 1145 1354 1555 1748 1933 2109 2279 2440 2593 2875 3004 3125 3237 3124 3344 3440 3441 3442 3443 3444 3445 3446 3447 3448 3449 3450 3451 3452 3453 3541 3454 3455 3458 3545 3459 3460 3461 3462 3465 3463 3369 3370 3269 3042 2784 2785 2786 2173 2172 2000 1819 1630 1433 1228 1227  327  795   80  329
 228  469  702  927 1144 1353 1554 1747 1932 2278 2277 2439 2592 2737 2874 3123 3003 3238 3343 3342 3528 3529 3530 3531 3532 3533 3534 3535 3536 3537 3538 3539 3540 3620 3542 3457 3543 3544 3546 3547 3549 3464 3371 3161 3160 3162 3043 2919 2646 2645 2495 2338 2496 2001 1820 1631 1434 1229  793 1015  794   85  330
 227  468  701  926 1143 1352 1553 1746 1931 2108 2276 2438 2873 2872 3001 3002 3000 3236 3438 3439 3527 3608 3609 3610 3611 3612 3613 3614 3615 3616 3617 3618 3619 3692 3691 3622 3623 3624 3625 3626 3548 3550 3466 3372 3270 3163 3044 2921 2920 2498 2497 2340 2174 2003 2002 1821 1435 1230 1016 1017  796  566   86
 226  467  700  925 1142 1351 1552 1745 1930 2107 2437 2590 2736 2734 2871 2588 3122 3235 3341 3437 3526 3607 3681 3682 3683 3684 3747 3685 3686 3687 3688 3689 3690 3621 3755 3813 3758 3696 3697 3628 3627 3467 3551 3373 3271 3046 2922 3045 2789 2647 2339 2499 2175 2176 1633 1632 1436 1231 1018  797  567  568   87
 225  466  699  924 1141 1350 1551 1744 1929 2106 2275 2434 2436 2589 2999 3121 3234 3340 3339 3436 3525 3679 3680 3744 3745 3746 3802 3748 3749 3750 3806 3751 3753 3754 3858 3695 3759 3694 3698 3629 3552 3374 3468 3375 3272 3164 3047 2788 2787 2648 2342 2177 1822 2341 2004 1634 1437 1232 1019  798  569  331  332
 224  465  698  923 1140 1349 1550 1742 1743 2105 2274 2433 2435 2735 2591 3120 3233 3338 3435 3524 3604 3606 3678 3742 3743 3848 3801 3803 3804 3805 3752 3807 3808 3810 3756 3693 3811 3812 3760 3699 3630 3553 3274 3273 3275 3165 3048 2923 2790 2649 2500 2343 2178 1824 1823 1635 1438 1233 1020  799  570  333   88
 223  464  697  922 1139 1348 1549 1926 1928 1927 2273 2587 2869 2870 2733 2998 3119 3232 3337 3434 3605 3523 3677 3800 3798 3799 3849 3852 3890 3892 3853 3855 3809 3924 3856 3860 3814 3757 3761 3700 3631 3554 3469 3377 3376 3166 3049 2924 2791 2650 2501 2344 2179 2005 1826 1825 1439 1234 1021  800  571  336  334
 222  463  696  921 1138 1347 1548 2103 2104 2272 2431 2432 2732 2730 2996 2868 3118 3231 3335 3433 3522 3603 3676 3741 3847 3889 3850 3888 3851 3891 3893 3854 3894 3898 3896 3897 3859 3764 3861 3762 3701 3555 3470 3378 3276 3167 3050 2925 2793 2651 2502 2345 2180 2006 2007 1636 1440 1235 1441  801 1023   91   89
 221  462  695  920 1137 1346 1546 1741 1740 2102 2271 2585 2586 2731 2867 2997 3117 3336 3230 3432 3521 3602 3675 3740 3797 3846 3887 3920 3921 3922 3925 3926 3895 3857 3927 3899 3815 3863 3704 3702 3632 3633 3556 3277 3278 3168 3051 2792 2926 2652 2503 2346 2181 1827 1828 1637 1022 1238  802 1024  335  573  337
 219  220  918  694 1135 1136 1345 1547 1739 1924 2101 2270 2729 2583 2866 2995 3116 3229 3334 3431 3520 3601 3674 3739 3796 3845 3886 3919 3944 3945 3946 3948 3923 3949 3929 3928 3862 3817 3816 3703 3634 3557 3471 3472 3279 3169 3052 2928 2927 2794 2504 2347 2009 2008 1639 1442 1443 1638  340 1236  574   90  572
 218  461  693  919 1344 1343 1922 1738 1925 2269 2429 2584 2430 2727 2865 2994 3115 3228 3333 3430 3519 3600 3673 3738 3795 3844 3885 3918 3943 3960 3947 3961 3950 3951 3900 3901 3864 3763 3765 3818 3558 3473 3474 3379 3280 3170 3053 2795 2653 2654 2348 2182 2184 2012 1641 2010 1829 1444 1240 1025 1026   94   96
 460  691  692  917 1134 1544 1736 1923 1545 2268 2100 2099 2728 2582 2864 2993 3114 3227 3332 3429 3518 3599 3672 3737 3794 3843 3884 3917 3942 3959 3968 3963 3964 3952 3930 3902 3819 3820 3559 3638 3639 3635 3560 3476 3380 3054 3174 2929 2796 2655 2183 2506 2011 1831 1642 1640  576 1237  805  807   93   92  339
 216  459  458  916 1133 1342 1341 1737 2098 2097 2267 2428 2581 2726 2725 2992 3113 3226 3331 3428 3517 3598 3671 3736 3793 3842 3883 3916 3941 3958 3967 3962 3954 3965 3953 3866 3768 3821 3865 3705 3710 3637 3561 3382 3171 3056 3172 2930 2656 2507 2349 2505 2185 1830 1643 1644 1445  342  577  803 1028  575  804
 457  217  690 1132 1131 1541 1542 1920 1921 2096 2266 2427 2580 2724 2863 2991 3112 3225 3330 3427 3516 3597 3670 3735 3792 3841 3882 3915 3940 3957 3956 3966 3955 3932 3931 3904 3822 3706 3767 3707 3636 3562 3475 3283 3381 3055 2931 2932 2797 2657 2014 2351 2013 2186 1833 1645 1239 1027 1029  806  338  580   95
 215  456  689  915  913 1540 1338 1735 1734 1919 2265 2426 2579 2861 2862 2990 3111 3224 3329 3426 3515 3596 3669 3734 3791 3840 3881 3914 3939 3938 3937 3936 3935 3934 3933 3868 3903 3766 3770 3640 3708 3769 3477 3282 3175 3383 3173 2800 2798 2658 2508 2352 2350 2188 1832 1448 1446 1241  808  809  581  578  341
 214  455  688  914 1130 1543 1340 1339 1918 2095 2264 2425 2578 2723 2860 2989 3110 3223 3328 3425 3514 3595 3668 3733 3790 3839 3880 3913 3912 3911 3910 3909 3908 3907 3906 3867 3905 3824 3709 3564 3478 3563 3281 3385 3285 3058 3059 2660 2799 2353 2511 2510 2187 1836 2016 1449 1243 1030 1031  810  343  579   97
 213  454  687  912 1129 1337 1539 1733 1732 2094 2263 2424 2577 2722 2859 2988 3109 3222 3327 3424 3513 3594 3667 3732 3789 3838 3879 3878 3877 3876 3875 3874 3873 3872 3871 3870 3823 3869 3771 3641 3565 3566 3384 3479 3386 3057 2933 2934 2659 2661 2354 2512 1834 2189 2015 1646 1242 1447  344  582  811   99   98
 212  453  686  911 1128 1538 1731 1916 1917 2093 2262 2423 2576 2721 2858 2987 3108 3221 3326 3423 3512 3593 3666 3731 3788 3837 3836 3835 3834 3833 3832 3831 3830 3829 3828 3827 3826 3825 3772 3711 3642 3480 3387 3286 3176 3177 3284 2935 2802 2509 2513 2355 1837 1647 1451 1835 1244 1450 1246  812  583  345  100
 211  452  685  910 1127 1336 1536 1537 1915 2092 2261 2422 2575 2720 2857 2986 3107 3220 3325 3422 3511 3592 3665 3730 3787 3786 3785 3784 3783 3782 3781 3780 3779 3778 3777 3776 3775 3774 3773 3712 3644 3481 3388 3389 3287 3178 3060 3061 2801 2803 2191 2662 2017 2190 1648 2019 1452 1032 1034 1033  346  347  101
 210  451  684  909 1126 1535 1729 1914 1730 2091 2260 2421 2574 2719 2856 2985 3106 3219 3324 3421 3510 3591 3664 3729 3728 3727 3726 3725 3724 3723 3722 3721 3720 3719 3718 3717 3716 3715 3714 3713 3567 3643 3482 3288 3179 3062 3063 2936 2804 2514 2357 2356 2192 1838 2358 2018 1453 1245 1247 1035  584  349  348
 209  450  683  908 1125 1335 1534 1728 1913 2090 2259 2420 2573 2718 2855 2984 3105 3218 3323 3420 3509 3590 3663 3662 3661 3660 3659 3658 3657 3656 3655 3654 3653 3652 3651 3650 3649 3648 3647 3646 3645 3568 3483 3390 3289 3180 3064 2805 2937 2664 2663 2515 1839 1840 2020 1649 1454 1248  813  815  585  350  102
 208  449  682  907 1124 1334 1333 1727 1912 2089 2258 2419 2572 2717 2854 2983 3104 3217 3322 3419 3508 3589 3588 3587 3586 3585 3584 3583 3582 3581 3580 3579 3578 3577 3576 3575 3574 3573 3572 3571 3570 3569 3484 3391 3290 3181 2939 2938 2806 2665 2516 2517 2193 2194 2021 1651 1652 1650 1249 1036  814  587  103
 207  448  681  906 1123 1332 1533 1726 1911 2088 2257 2418 2571 2716 2853 2982 3103 3216 3321 3418 3507 3506 3505 3504 3503 3502 3501 3500 3499 3498 3497 3496 3495 3494 3493 3492 3491 3490 3489 3488 3487 3486 3485 3392 3291 3182 3065 2940 2807 2360 2518 2359 2195 2022 1455 1037 1251 1038  816  586  106  105  104
 206  447  680  905 1122 1331 1532 1725 1910 2087 2256 2417 2570 2715 2852 2981 3102 3215 3320 3417 3416 3415 3414 3413 3412 3411 3410 3409 3408 3407 3406 3405 3404 3403 3402 3401 3400 3399 3398 3397 3396 3395 3394 3393 3292 3183 3066 2808 2667 2666 2361 2197 2196 2023 1844 1653 1457 1456 1041 1039  351  588  107
 205  446  679  904 1121 1330 1531 1724 1909 2086 2255 2416 2569 2714 2851 2980 3101 3214 3319 3318 3317 3316 3315 3314 3313 3312 3311 3310 3309 3308 3307 3306 3305 3304 3303 3302 3301 3300 3299 3298 3297 3296 3295 3294 3293 3184 3067 2941 2809 2668 2519 2362 2025 1841 2024 1843 1250  817  818  820  352 1253  108
 204  445  678  903 1120 1329 1530 1723 1908 2085 2254 2415 2568 2713 2850 2979 3100 3213 3212 3211 3210 3209 3208 3207 3206 3205 3204 3203 3202 3201 3200 3199 3198 3197 3196 3195 3194 3193 3192 3191 3190 3189 3188 3187 3186 3185 3068 2942 2810 2669 2521 2520 1459 2364 1654 1845 1460 1458 1252  589  590  109  110
 203  444  677  902 1119 1328 1529 1722 1907 2084 2253 2414 2567 2712 2849 2978 3099 3098 3097 3096 3095 3094 3093 3092 3091 3090 3089 3088 3087 3086 3085 3084 3083 3082 3081 3080 3079 3078 3077 3076 3075 3074 3073 3072 3071 3070 3069 2943 2944 2670 2522 2363 2200 2199 1655 1842 1847 1254  819 1040  353  354  111
 202  443  676  901 1118 1327 1528 1721 1906 2083 2252 2413 2566 2711 2848 2977 2976 2975 2974 2973 2972 2971 2970 2969 2968 2967 2966 2965 2964 2963 2962 2961 2960 2959 2958 2957 2956 2955 2954 2953 2952 2951 2950 2949 2948 2947 2946 2945 2811 2671 2523 2365 2198 2026 1657 1656 1461 1255 1258  821  592  591  356
 201  442  675  900 1117 1326 1527 1720 1905 2082 2251 2412 2565 2710 2847 2846 2845 2844 2843 2842 2841 2840 2839 2838 2837 2836 2835 2834 2833 2832 2831 2830 2829 2828 2827 2826 2825 2824 2823 2822 2821 2820 2819 2818 2817 2816 2815 2814 2812 2672 2366 2367 2201 1848 1846 2028 1259 1042  822 1658  593  355  112
 200  441  674  899 1116 1325 1526 1719 1904 2081 2250 2411 2564 2709 2708 2707 2706 2705 2704 2703 2702 2701 2700 2699 2698 2697 2696 2695 2694 2693 2692 2691 2690 2689 2688 2687 2686 2685 2684 2683 2682 2681 2680 2679 2678 2677 2676 2675 2813 2673 2525 2524 2027 2202 2031 1462 1659 1044 1043  823  358  357  114
 199  440  673  898 1115 1324 1525 1718 1903 2080 2249 2410 2563 2562 2561 2560 2559 2558 2557 2556 2555 2554 2553 2552 2551 2550 2549 2548 2547 2546 2545 2544 2543 2542 2541 2540 2539 2538 2537 2536 2535 2534 2533 2532 2531 2530 2529 2528 2674 2527 2526 2035 2368 1849 2029 1660 1463 1661 1045  825 1257  359  116
 198  439  672  897 1114 1323 1524 1717 1902 2079 2248 2409 2408 2407 2406 2405 2404 2403 2402 2401 2400 2399 2398 2397 2396 2395 2394 2393 2392 2391 2390 2389 2388 2387 2386 2385 2384 2383 2382 2381 2380 2379 2378 2377 2376 2375 2374 2038 2373 2371 2370 2369 2204 2203 1047 2030 1256 1464 1260  597 1046  595  360
 197  438  671  896 1113 1322 1523 1716 1901 2078 2247 2246 2245 2244 2243 2242 2241 2240 2239 2238 2237 2236 2235 2234 2233 2232 2231 2230 2229 2228 2227 2226 2225 2224 2223 2222 2221 2220 2219 2218 2217 2216 2215 2214 2213 2212 2039 1671 2211 1672 2209 2205 2206 1850 1662 1663 1465 1262  826  824  115  113  362
 196  437  670  895 1112 1321 1522 1715 1900 2077 2076 2075 2074 2073 2072 2071 2070 2069 2068 2067 2066 2065 2064 2063 2062 2061 2060 2059 2058 2057 2056 2055 2054 2053 2052 2051 2050 2049 2048 2047 2046 2045 2044 2043 2042 2041 2210 1860 2372 2207 1858 1667 1851 1855 1466 1853 1050 1048 1664  828  596  599  361
 195  436  669  894 1111 1320 1521 1714 1899 1898 1897 1896 1895 1894 1893 1892 1891 1890 1889 1888 1887 1886 1885 1884 1883 1882 1881 1880 1879 1878 1877 1876 1875 1874 1873 1872 1871 1870 1869 1868 1867 1866 1865 1864 1863 1862 2040 1673 2208 2037 2036 1856 1472 1270 2033 1854 1467  827  831 1049  829  594  118
 194  435  668  893 1110 1319 1520 1713 1712 1711 1710 1709 1708 1707 1706 1705 1704 1703 1702 1701 1700 1699 1698 1697 1696 1695 1694 1693 1692 1691 1690 1689 1688 1687 1686 1685 1684 1683 1682 1681 1680 1679 1678 1677 1676 1675 1861 1478 1477 1476 1859 1670 1666 1852 1665 2034 1263 1266 1051  363  117  598  119
 193  434  667  892 1109 1318 1519 1518 1517 1516 1515 1514 1513 1512 1511 1510 1509 1508 1507 1506 1505 1504 1503 1502 1501 1500 1499 1498 1497 1496 1495 1494 1493 1492 1491 1490 1489 1488 1487 1486 1485 1484 1483 1482 1481 1480 1479 1674 1063 1062 1474 1857 1669 1668 1473 1470 1261  830 1265  602  365  364  120
 192  433  666  891 1108 1317 1316 1315 1314 1313 1312 1311 1310 1309 1308 1307 1306 1305 1304 1303 1302 1301 1300 1299 1298 1297 1296 1295 1294 1293 1292 1291 1290 1289 1288 1287 1286 1285 1284 1283 1282 1281 1280 1279 1278 1277 1274 1275 1273  844 1475 1271  839 1058  610 1471 2032 1469  601 1052  124  603  600
 191  432  665  890 1107 1106 1105 1104 1103 1102 1101 1100 1099 1098 1097 1096 1095 1094 1093 1092 1091 1090 1089 1088 1087 1086 1085 1084 1083 1082 1081 1080 1079 1078 1077 1076 1075 1074 1073 1072 1071 1070 1069 1068 1067 1066 1276 1064 1065 1061 1272  841  611 1269 1264  376  835 1468  836 1054  833  369  367
 190  431  664  889  888  887  886  885  884  883  882  881  880  879  878  877  876  875  874  873  872  871  870  869  868  867  866  865  864  863  862  861  860  859  858  857  856  855  854  853  852  851  850  849  848  847  846  845  616  618  842  379  840 1057  123  373  131    0  608 1055  832  366  368
 189  430  663  662  661  660  659  658  657  656  655  654  653  652  651  650  649  648  647  646  645  644  643  642  641  640  639  638  637  636  635  634  633  632  631  630  629  628  627  626  625  624  623  622  621  620  619  382  843  614  617  380 1268  838 1267  607  371  130  129  837  606  127  122
 188  429  428  427  426  425  424  423  422  421  420  419  418  417  416  415  414  413  412  411  410  409  408  407  406  405  404  403  402  401  400  399  398  397  396  395  394  393  392  391  390  389  388  387  386  385  384  381  140  136  137 1060  613  377  134 1059  375  132  374  372  370  125  604
 187  186  185  184  183  182  181  180  179  178  177  176  175  174  173  172  171  170  169  168  167  166  165  164  163  162  161  160  159  158  157  156  155  154  153  152  151  150  149  148  147  146  145  144  143  142  141  383  139  615  138  612  378  135  133 1056  609  834  128 1053  126  605  121
