# This puzzle is unsolvable
55
 218  425    2  429  220    6   11   10  433  822  223  227  228   12   13   15   18  233   19   20   21   22   23   24   25   26   27   28   29   30   31   32   33   35  253  657  254   37  252   40   42  257   43   44   45   46   47   48   49   50   51   52   53   54   55
 623  215  212  221  428    7    9  222  430  432  225  434  226  230   14  438   16   17  234  235  236  237  238  239  240  241  242  243  244  245  247  248  249   36  250   34  251  848  851   38  256   41  258  259  260  261  262  263  264  265  266  267  268  269   56
 216  816  214  818    5  427  630  224    8 1005  431  435  436  229  437  636  231  441  640  442  443  444  445  446  447  448  449  450  451  452  246  453  454  656  846  461  659   39  661  255  463  464  465  466  467  468  469  470  471  472  473  474  475  270   57
 424    1    3  626  217  426    4  629 1178  820  821  632  633  825  635  637  439  232  440  641  642  643  644  645  646  647  648  649  650  651  652  653  455  457  654  459  458 1035  460  462  662  663  855  664  666  667  668  669  670  671  672  673  476  271   58
 621  627  622  423 1002  817  213  819  631 1000 1009  823  634  827  828  829  638  639  831  832  833  834  835  836  837  838  839  841 1023  842  843  845 1028  655  847  456  658 1032  660  852  854 1036  853  665  856  858  859  860  861  862  863  674  477  272   59
 421  422  624 1175 1179 1171  999  628 1003 1347  824 1008 1183 1184 1185  830  826 1013 1014 1015 1016 1017 1018 1019 1020 1021 1022  840 1199 1024 1027 1369  844 1029 1030 1031 1205  849 1373 1034 1033 1037 1038 1039  857 1041 1042 1043 1044 1045  864  675  478  273   60
 420  620  418  219  998  814 1504 1343 1004 1006 1507 1182 1007 1010 1186 1011 1012 1188 1189 1190 1191 1192 1193 1194 1195 1196 1197 1198 1025 1367 1026 1203 1204 1370 1207 1372 1531 1206  850 1686 1210 1211 1213 1214 1040 1216 1217 1218 1219 1046  865  676  479  274   61
 210  815  812  419  417 1176 1177 1344 1001 1181 1345 1348 1508 1510 1351 1352 1187 1514 1356 1357 1358 1359 1360 1361 1362 1363 1364 1365 1366 1677 1201 1368 1529 1682 1530 1209 1533 1208 1536 1379 1212 1538 1381 1382 1215 1383 1384 1385 1220 1047  866  677  480  275   62
 209  211  997 1173 1656  813  996 1346 1657 1180 1506 1349 1509 1513 1661 1353 1355 1354 1515 1516 1517 1518 1519 1520 1521 1522 1523 1525 1200 1202 1678 1527 1371 1680 1532 1684 1376 1375 1377 1537 1378 1539 1380 1540 1541 1542 1543 1386 1221 1048  867  678  481  276   63
 207  208  619  625 1340 1342 1502 1341 1505 1799 1658 1659 1350 1662 1940 1663 1512 1664 1665 1667 1668 1669 1670 1671 1672 1673 1674 1524 1676 1679 2086 1959 1822 1528 1960 1961 1685 1535 1687 1830 1688 1689 1690 1691 1692 1693 1544 1387 1222 1049  868  679  482  277   64
 206  416  617  811  618 1503 1172 1174 1800 1798 1801 1802 1805 1804 1660 1511 1806 1808 1807 1666 1811 1812 1813 1814 1815 1816 1817 1675 1818 1955 1820 1954 1957 2206 1681 1683 1374 1534 1826 1828 1831 1832 1833 1834 1835 1694 1545 1388 1223 1050  869  680  483  278   65
 415  615  809  810  995  992 1170 1655 1653 1936 1935 1937 2065 1803 1938 1942 1943 2071 1945 1810 1946 1947 1948 1949 1950 1951 1952 2199 1953 1819 1821 1526 1958 1823 2088 1962 2205 1827 1829 1965 1966 1967 1968 1969 1836 1695 1546 1389 1224 1051  870  681  484  279   66
 205  616  614  993  994  808 1339 1500 1501 1797 1654 2184 2062 1939 2067 1941 1944 1809 2070 2072 2073 2074 2075 2076 2077 2078 2080 2079 2081 2082 1956 2084 2316 1824 2208 2085 1825 1963 1964 2092 2093 2094 2095 1970 1837 1696 1547 1390 1225 1052  871  682  485  280   67
 414  413  204  806  807 1169 1338 1499 1652 1796 2064 1934 2186 2298 2187 2188 2068 2189 2190 2191 2192 2193 2194 2195 2196 2197 2309 2311 2509 2310 2083 2203 2204 2319 2209 2087 2207 2090 2091 2211 2212 2213 2096 1971 1838 1697 1548 1391 1226 1053  872  683  486  281   68
 203  412  613  804  991 1168 1337 1498 1651 1795 1933 2063 2182 2066 2181 2496 2069 2300 2301 2302 2303 2304 2305 2306 2307 2506 2308 2198 2200 2414 2201 2202 2314 2419 2420 2320 2089 2321 2210 2322 2323 2214 2097 1972 1839 1698 1549 1392 1227 1054  873  684  487  282   69
 202  201  612  990  989 1167 1336 1497 1650 2061 2183 2295 2296 2185 2297 2401 2299 2403 2404 2405 2406 2502 2407 2409 2410 2412 2508 2415 2312 2511 2418 2313 2317 2421 2318 2517 2516 2423 2424 2426 2425 2215 2098 1973 1840 1699 1550 1393 1228 1055  874  685  488  283   70
 411  200  805  611  988 1166 1335 1496 1649 1931 1794 2060 1930 2400 2584 2494 2398 2402 2498 2586 2500 2501 2408 2504 2505 2593 2596 2507 2411 2417 2512 2315 2513 2514 2602 2515 2422 2518 2519 2427 2324 2216 2099 1974 1841 1700 1551 1394 1229 1056  875  686  489  284   71
 408  199  410  409  610 1333 1165 1495 1793 1932 1929 2059 2293 2294 2495 2583 2585 2497 2499 2735 2587 2589 2591 2503 2592 2743 2413 2597 2416 2676 2599 2679 2600 2601 2681 2603 2604 2605 2521 2520 2325 2217 2218 1975 1842 1701 1552 1395 1230 1057  876  687  490  285   72
 609  802  800  608  987 1164 1334 1648 1792 1791 2057 2058 2179 2292 2180 2664 2582 2665 2736 2588 2738 2667 2590 2739 2744 2594 2672 2595 2675 2674 2510 2678 2750 2680 2752 2682 2683 2607 2606 2428 2326 2219 2100 2101 1843 1702 1553 1396 1231 1058  877  688  491  286   73
 198  607  801  407 1329  986 1163 1647 1493 1646 2178 1790 2290 2396 2399 2397 2581 2663 2737 2803 2800 2668 2670 2740 2742 2671 2807 2673 2746 2745 2914 2598 2811 2751 2815 2753 2754 2608 2522 2429 2327 2329 2102 1976 1844 1703 1554 1397 1232 1059  878  689  492  287   74
 197  406  799  803  606 1331 1332 1494 1491 1645 1928 1925 2291 2289 2395 2493 2662 2660 2734 2666 2801 2906 2669 2805 2806 2861 2808 2809 2863 2749 2677 2868 2813 2814 2686 2684 2685 2523 2609 2430 2328 2103 1978 1977 1845 1704 1555 1398 1233 1060  879  690  493  288   75
 195  196  982  985 1160 1161 1162 1492 1789 1927 2055 2056 2177 2176 2394 2492 2661 2490 2578 2799 2802 2804 2858 2741 2907 2860 2862 2910 2748 2810 2918 2812 2747 2816 2687 2819 2611 2610 2526 2524 2330 2220 2104 1979 1705 1706 1556 1399 1234 1061  880  691  494  289   76
 605  403  405  798 1330 1159 1328 1643 1490 1644 1788 1926 2054 2288 2392 2580 2491 2798 2733 2856 2854 2859 2905 2945 2908 2947 2909 2949 2911 2866 2913 2912 2915 2869 2817 2755 2689 2433 2434 2431 2222 2221 2105 1980 1846 1707 1557 1400 1235 1062  881  692  495  290   77
 193  983  604  797  984 1157 1488 1327 1489 1642 2053 2174 2175 2287 2488 2393 2576 2489 2732 2855 2904 2944 2974 2943 2946    0 2948 2980 2979 2951 2950 2952 2867 2818 2757 2756 2525 2432 2335 2435 2331 2332 1981 1848 1847 1708 1558 1401 1236 1063  882  693  496  291   78
 404  402  194  796  980  795 1158 1641 1786 1787 1924 1923 2052 2391 2390 2577 2659 2797 2731 2902 2857 2796 2851 2903 2977 3001 2978 3002 2864 2981 2983 2955 2865 2917 2870 2871 2612 2614 2437 2224 2690 2106 2107 1982 1851 1850 1849 1559 1237 1064  883  694  497  292   79
 401  192  601  981  979 1155 1325 1487 1640 1785 1922 2172 2173 2285 2389 2657 2656 2728 2727 2579 2853 2899 2901 2975 3000 2976 3003 3018 3004 2982 2956 2954 2953 3020 2759 2873 2688 2872 2527 2333 2226 2223 2225 2109 1984 1709 1560 1402 1403 1065  884  695  498  293   80
 600  602  400  603  793 1326 1156 1324 1486 1784 2050 2051 2171 2284 2486 2487 2286 2574 2793 2658 2730 2898 2852 2942 3017 3024 2999 3016 3019 2985 2986 3005 2984 2875 2820 2916 2758 2613 2615 2528 2436 2530 1983 2108 1985 1710 1561 1404 1238 1066  885  696  499  294   81
 191  599  598  792  794  977 1323 1485 1639 1638 1921 2049 2170 2283 2388 2485 2575 2897 2791 2795 2729 2896 2941 2900 2998 3014 3015 3007 3008 3006 2958 2874 2919 2821 2876 2822 2762 2760 2761 2334 2336 2227 2110 1852 1853 1711 1562 1240 1239 1067  886  697  500  295   82
 190  189  399  975  978 1154 1637 1635 1783 2046 1920 2048 2169 2282 2387 2484 2573 2655 2653 2848 2794 2850 2849 2973 2940 2997 3022 3009 3010 3021 2957 2823 2763 2617 2827 2533 2618 2531 2529 2439 2337 2228 2111 1987 1712 1563 1564 1405 1406 1068  887  698  501  296   83
 188  395  398  597  791 1153 1484 1483 1782 1919 1636 1918 2168 2281 2386 2483 2572 2726 2654 2792 2847 2937 2939 2972 2996 3023 3012 3011 2991 2921 2877 2987 2959 2923 2616 2693 2694 2824 2765 2338 2438 2229 2112 1854 1986 1713 1407 1242 1241 1069  888  699  502  297   84
 397  187  596  974  976 1152 1322 1482 1634 1781 1780 2047 2167 2280 2385 2482 2571 2652 2725 2790 2938 2846 2936 2995 2994 3013 2993 2992 2963 2988 2961 2920 2924 2989 2878 2692 2695 2691 2440 2441 2339 2230 2113 1988 1855 1714 1565 1408 1243 1070  889  700  503  298   85
 185  396  186 1149 1151 1150 1321 1320 1481 1916 1917 2045 2166 2279 2384 2481 2570 2651 2724 2789 2845 2895 2969 2971 2968 2967 2966 2965 2990 2962 2928 2926 2960 2826 2764 2922 2620 2532 2619 2442 2340 2231 2114 1989 1856 1715 1566 1409 1244 1071  890  701  504  299   86
 394  393  790  595  787  973 1319 1633 1778 1779 1915 2044 2165 2278 2383 2480 2650 2649 2723 2788 2844 2894 2935 2970 2934 2932 2930 2888 2964 2929 2927 2883 2925 2879 2825 2766 2697 2536 2696 2534 2341 2232 2115 1990 1857 1716 1567 1410 1245 1072  891  702  505  300   87
 184  593  392  789  786  971 1479 1480 1632 1777 1914 2043 2164 2277 2382 2479 2569 2567 2722 2787 2843 2893 2892 2891 2933 2890 2889 2931 2886 2885 2773 2832 2831 2881 2882 2621 2767 2698 2537 2535 2342 2234 2233 1991 1858 1717 1568 1411 1246 1073  892  703  506  301   88
 183  391  784  972  594 1318 1148 1631 1630 1776 1913 2042 2163 2276 2381 2478 2568 2648 2786 2784 2785 2842 2841 2840 2839 2838 2837 2887 2835 2776 2884 2834 2833 2880 2828 2768 2699 2622 2444 2443 2344 2116 2117 1992 1859 1718 1569 1412 1247 1074  893  704  507  302   89
 182  592  970  788 1317 1316 1478 1629 1476 1775 1912 2041 2162 2275 2380 2477 2566 2647 2721 2719 2718 2783 2782 2781 2780 2779 2778 2836 2708 2774 2775 2705 2830 2772 2829 2769 2700 2445 2447 2343 2446 2236 2118 1993 1860 1719 1570 1413 1248 1075  894  705  508  303   90
 181  390  591  969  785 1147 1315 1477 1628 1774 1911 2040 2161 2274 2379 2476 2565 2646 2720 2644 2559 2717 2715 2714 2713 2712 2711 2777 2633 2707 2632 2631 2549 2770 2771 2702 2701 2623 2538 2347 2235 2345 2119 1994 1861 1720 1571 1414 1249 1076  895  706  509  304   91
 180  967  388  590 1145 1146 1314 1474 1475 1773 1910 2160 2159 2273 2378 2474 2475 2564 2645 2642 2641 2716 2640 2639 2638 2553 2637 2709 2459 2634 2551 2629 2630 2546 2703 2544 2627 2626 2539 2540 2450 2237 2120 1995 1862 1721 1572 1415 1250 1077  896  707  510  305   92
 179  589  783  781  968  782 1142 1473 1627 1772 1909 2038 2039 2272 2377 2473 2563 2562 2560 2643 2468 2557 2465 2558 2556 2552 2554 2710 2550 2461 2457 2704 2706 2455 2545 2628 2543 2624 2452 2346 2448 2238 2121 1996 1863 1722 1573 1416 1251 1078  897  708  511  306   93
 178  389  588  780  966 1313  965 1312 1626 1771 1908 2158 2271 2270 2376 2265 2267 2470 2471 2469 2369 2561 2467 2555 2021 2464 2460 2636 2635 2458 2547 2548 2358 2356 2454 2354 2453 2625 2449 2451 2348 2239 2122 1997 1864 1723 1574 1417 1252 1079  898  709  512  307   94
 386  387  587  779 1143 1144 1310 1472 1625 1906 1770 2035 2037 2269 2375 2372 2472 2374 2370 2371 2259 2144 2143 2367 2463 2363 2362 2462 2361 2360 2251 2357 2456 2250 2355 2245 2542 2541 2350 2243 2349 2240 2123 1998 1865 1724 1575 1418 1253 1080  899  710  513  308   95
 177  383  384  385 1311 1141 1471 1624 1769 2036 1905 1907 2157 2268 2152 2030 2373 2151 2266 2263 2262 2145 2466 2365 2258 2364 2257 2255 2254 2253 2359 2252 2135 2249 2248 2247 2352 2353 2244 2351 2242 2241 2124 1999 1866 1725 1576 1419 1254 1081  900  711  514  309   96
 176  175  586  778  964  963 1309 1470 1622 1623 1768 1904 2034 2156 2153 2264 2150 2149 2024 2147 2148 2022 2023 2020 2368 2142 2256 2140 2139 2138 2137 2136 2134 2011 2133 2132 2246 2130 2129 2128 2127 2126 2125 2000 1867 1726 1577 1420 1255 1082  901  712  515  310   97
 174  584  777  776  962 1140 1139 1469 1766 1621 2033 1767 1903 1761 2029 2154 2027 1609 1894 2025 2366 2260 2146 1891 1889 2141 2018 2017 2016 2015 2014 2013 2012 2010 1879 2131 2008 2007 2006 2005 2004 2003 2002 2001 1868 1727 1578 1421 1256 1083  902  713  516  311   98
 173  382  583  961  585  960 1138 1468 1619 1620 1902 2031 1901 2032 1899 2155 1898 1757 2026 1758 1895 2261 1753 1750 2019 1888 1887 1885 1746 1884 1883 1882 1881 1594 1880 2009 1877 1876 1875 1874 1873 1872 1871 1870 1869 1728 1579 1422 1257 1084  903  714  517  312   99
 172  381  582  774  775 1307 1308 1466 1467 1765 1764 1763 1900 1762 1759 2028 1896 1756 1755 1456 1893 1752 1892 1604 1890 1749 1602 1748 1886 1597 1745 1744 1742 1595 1741 1878 1738 1737 1736 1735 1734 1733 1732 1731 1730 1729 1580 1423 1258 1085  904  715  518  313  100
 171  380  581  959 1136 1137 1306 1305 1464 1618 1617 1616 1614 1760 1295 1897 1611 1613 1608 1453 1754 1606 1448 1751 1603 1601 1600 1747 1598 1443 1596 1743 1440 1593 1740 1739 1591 1590 1589 1588 1587 1586 1585 1584 1583 1582 1581 1424 1259 1086  905  716  519  314  101
 170  379  580  773  958 1135 1304 1465 1301 1463 1462 1298 1461 1615 1458 1457 1455 1292 1610 1452 1607 1451 1450 1449 1447 1284 1445 1282 1599 1442 1280 1441 1439 1438 1275 1592 1436 1435 1434 1433 1432 1431 1430 1429 1428 1427 1426 1425 1260 1087  906  717  520  315  102
 169  378  579  772  956  957 1134 1303 1300 1299 1128 1460 1297 1125 1293 1294 1123 1612 1120 1454 1290 1288 1605 1286 1115 1285 1283 1446 1110 1444 1281 1278 1277 1276 1274 1437 1273 1272 1271 1270 1269 1268 1267 1266 1265 1264 1263 1262 1261 1088  907  718  521  316  103
 168  377  376  578 1133 1132 1302  766  951 1130 1129 1127 1126  944 1296 1459 1122 1121 1119 1118 1291 1117  937 1116 1114 1287  933  932 1112 1108 1279 1107 1106 1105 1104 1103 1102 1101 1100 1099 1098 1097 1096 1095 1094 1093 1092 1091 1090 1089  908  719  522  317  104
 166  167  771  769  577  954  569  571 1131  950  949  948  947  946 1124  757  943  942  941  940 1289  938  749  935  936 1113  746  931  930 1109  929  928  927  926  925  924  923  922  921  920  919  918  917  916  915  914  913  912  911  910  909  720  523  318  105
 165  374  375  955  767  573  953  368  952  763  762  761  760  759  945  756  561  755  754  753  939  752  751  748  553  934  744 1111  549  743  742  741  740  739  738  737  736  735  734  733  732  731  730  729  728  727  726  725  724  723  722  721  524  319  106
 575  164  161  770  768  572  157  366  765  764  567  566  564  563  758  562  358  560  559  558  557  555  750  554  747  552  745  551  346  548  547  546  545  544  543  542  541  540  539  538  537  536  535  534  533  532  531  530  529  528  527  526  525  320  107
 163  576  372  574  159  369  570  367  568  365  364  362  565  361  360  359  357  356  355  144  353  556  352  351  350  349  136  550  347  345  344  343  342  341  340  339  338  337  336  335  334  333  332  331  330  329  328  327  326  325  324  323  322  321  108
 373  162  371  160  158  370  156  154  155  153  152  363  151  150  149  148  147  146  145  143  354  142  141  140  139  138  348  137  135  134  133  132  131  130  129  128  127  126  125  124  123  122  121  120  119  118  117  116  115  114  113  112  111  110  109
