# This puzzle is unsolvable
30
  4   1   2   6 119   8   9  11 124 125 126 128  14  15 130  16 132  19 133  20 138  21  23 140 139 142 141  27  29 143
226 225 117 324   3 328   7 123  10 127 129 234  12 236 240 131  18 239  17 137 243  22 136  25  24 248  26 145 144  30
116 114 223   5 228 323 122 230 231 232 332 335  13 336 237 512 337 135 341 241 342 134 244 345 245 249 348  28  33  31
115 118 222 500 325 326 418 329 331 423 334 333 233 510 425 589 429 338 430 434 517 344 520 437 247 347 438 250 251  32
113 112 221 121 224 327 229 422 503 330 504 505 424 509 427 653 584 340 516 242 518 246 435 436 439 349 252 147 146  34
413 111 417 120 416 415 576 419 579 421 506 508 235 651 511 590 339 238 588 514 343 594 593 519 521 346 350 253 148  35
106 220 411 320 501 227 642 502 420 580 648 426 583 761 585 428 587 711 431 515 661 591 522 526 524 440 351 254 149  36
218 321 110 499 322 575 574 643 578 646 582 507 805 713 762 652 513 655 658 432 433 596 592 595 597 352 255 441 150  37
108 219 109 316 644 412 498 647 756 706 707 581 760 650 710 763 716 718 654 767 659 717 660 664 662 442 443 256 151  38
409 319 414 410 497 703 705 645 758 755 800 709 804 803 714 766 656 808 809 721 586 722 768 523 525 445 353 354 152  39
214 494 315 216 640 573 577 704 702 757 649 759 839 708 841 712 765 657 812 720 844 715 598 663 665 356 355 257 153  40
317 318 105 493 572 699 641 701 754 798 801 838 885 802 764 807 806 843 810 769 771 719 448 599 602 260 258 259 262  41
107 212 406 571 217 569 570 752 700 835 799 836 837 867 866 887 898 842 770 600 813 772 671 723 666 359 444 155 261  42
495 104 313 213 408 751 639 637 636 833 832 834 863 883 840 869 871 845 846 811 870 775 601 668 529 530 357 358 154  43
103 101 489 488 496 407 698 753 797 749 748 865 862 884 896 868 889 872 814 848 815 447 724   0 773 528 361 263 446  44
210 314 311 310 568 209 567 696 565 796 750 864 861 897 874 888 886 847 816 726 725 728 603 527 450 533 449 156 157  45
312 100 403 633 492 635 638 831 697 829 857 795 793 824 890 895 852 818 819 817 727 774 605 604 532 265 363 360 264  46
484 309 102 490 404 564 491 632 634 859 794 860 830 882 879 854 822 891 849 734 777 776 667 362 454 537 451 162 158 160
208 204 211 563 215 405 487 695 693 828 858 790 899 856 892 877 878 823 851 853 607 873 778 531 672 453 364 452 159  47
 97 205 400 402 307 308 694 566 747 746 827 687 893 894 826 821 855 783 736 876 676 678 669 609 670 729 266 161  49  48
207  98 398  99  94 399 690 743 562 791 786 788 741 738 880 785 735 677 875 850 820 673 606 608 458 534 365 164 268  50
203  86  96 194 401 745 485 792 789 740 387 787 688 553 683 682 825 737 779 780 732 543 610 457 535 366 267 166  51 163
 93 558 631 305 306 629 630 560 626 742 625 739 881 620 621 784 681 733 680 546 674 679 675 613 611 612 455 536 269  52
481  95 561 206 483  85 486 556 691 475 744 624 685 684 550 619 616 781 782 381 544 462 731 542 540 172 367 270 165  53
395 202 298 301 195 692 628 627 477 555 554 623 292 686 472 468 618 545 465 378 615 614 730 374 538 456 368 169  57  55
397 201 392 394 200 482 689 476 479 388 474 551  74 471 470 548 383 549 617 466 282 379 467 541 375 539 170 459  54 275
303 196  91 396 557 393  81 191  78 295 291 552 473 185 622 547 184 377 380 283 469 280 176 371 373 370 167 369  58  56
 90  92 199 302 478 391 300 480 559 389 187 186 290 289 385 182 382 463 284 180 281 171 464 372 173  65 271 272 168  61
 89 299 296  87  82 390 304  80 294  79 188 293  75 288 384 287 285  71 179 178  69  67 279 175 174 273 277  63 276  59
 88 198  84 297 197  83 192 190 193 189  76  77 386  73  72 183  70 286 181  68 177 376  66 278 461 460  64  62  60 274
