# This puzzle is unsolvable
23
 88   1 240   3  92 174  97 175   9 314  99 176 313  12 185  16  19 183 318 188  23 110  24
 89   6   2   5 241 171  95   8 249  10 482 315  14  13 100 104 370  17 105 109 107 111  21
168  93 167 170 238 245 304  91 363   7 312 310 180 103 317 181 182 254 184  18 187 112  22
 85  84 243 307 162 311  94 407 246 309 179  98  11 102 253 108 106  15 373 257 189  25  26
361 166 354 169  90 359 308 247 248 305 411 177 306 414 316 418 255 256  20 258 260 186 191
236 237 356 163  86 173  96 452 251 408 178 365 367 454 487 417 374 252 259 193  27  30 114
172  87 477 358   4 244 164 410 480 449 368 364 101 453 458 486 372 419 376 190 113  29  32
 83  82  80 302 239 404 303 242 412 524 521 508 451 421 416 320 523 322 115 192 319 194 375
298 362 447 234 360 357 500 301 406 505 520 369 455 456 513 378 371 420 326 121  28 119   0
299  81 161 165 235 445 446 409 450 503 250 468 366 488 459 321 422 481 197 118 196 263  33
 79  77 233 355 479 504 444 448 353 415 506 483 509 491 490 325 379 117 323 377 457  31 262
 76 160 156 232 403 405 442 502 436 518 507 478 522 423 484 460 424 461 427 426  36 116  37
230  78 296 227 231 402 470 475 526 527 519 413 492 489 510 515 511 381 380 266  34  35 261
226 157 158 297 295 159 443 517 501 473 495 512 514 498 528 428 464 328 425 268 195 265 120
155 398 351 352 300 476 348 396 474 525 516 469 467 433 462 382 324 327 385 199 122 264  39
 74 150 350 293 441 401 485 229 282 438 391 437 494 432 463 383 198 386 271 270 200  38 267
153 228 291 399 154 294 439 499 497 344 341 435 493 389 335 429 465 272 387 329 125 201 124
 75 224 225 346 349 400 472 286 345 395 390 340 215 277 430 337 208 332 278 269 273 123  40
 71  73 147  72  70 290 289 142 343 496 216 283 342 211 431 384 210 206 330 331 202 126  41
 69 149 152 145 440 287 347 218 393 217 471 394 280 279 135 466 209 338 275 274 131 203  42
288  67 151 397  62 144 285  63  60  57 141 138 213 388  53 336 136 333 207 132 204 127  43
148  66  65 220  64 219 292  59 139 284  56 434  54 276 212  52 134 133  49  47 205 128  44
 68 146 223 221 222 143  61 140 392  58 281 214  55 339 334 137  51  50  48 130  46 129  45
