# This puzzle is unsolvable
16
  2 111   1 115   4 112 162  65  69  71  78   8  13  74  17  76
  6  61 221  63 197 117 167 226   9 160 118  12 123 199  15 124
 59 156 192  62   5 218 158 244 165 246 200 120  70  75 202  16
 55 194 155 159 243 251 107  68  64 238 227 201 128 127   0 122
 58 114  60 108  10  57 193 235  14  66   7  22  77  72 166  19
109 153  54   3 222 237 225 126 164 168 133  26 215  21 121 171
214  56 247 220 241 223  79 228 151 195 216 224  11  20  73 125
185 161  50 239 184 106 113 163 110 198  34  80  18 169  23  25
157 249 191 250  95 116 204 240 217 254 203 119 205 206 132  81
154 187  53 253 219 105 211 230 129  67 170 252  27 131  83  82
148 152  49 149 188 186 196 232 207 245 130 174 141  39 135  24
 46 190 242 104 147 144 255 208 210 212 231 134  84  29 177 172
 51 248 150  99 145 143 234  45 229  91 136  33 209 233  87 175
 44  48  40  97 102 146 179 138 181 142 183  32 180  36  90 137
100 182  47 139 101 189 236 213  98  37  88  93  92  28  85  30
103  43  52  42  96  38  41  35 173  94 176 140  89 178  31  86
