# This puzzle is unsolvable
40
   2    1    3    4    5    6    7    8    9  165   10  168   11   13   14  169   16   18   19   20   21   22   24  327   26  183   28  471  469  185  187   31   35   34   33   37  192   38  339   39
 156  157  158  159  160  308  161  162  163  312  167  584   12  314  171  318   17  172  173  321  322  177   23   25  465  182  330  334  472  186  727  475  184  189  476   36  193  190   41   42
 155  304  305  306  307  309  448  164  311  451  166  313  585  315  170   15  319  320  460  174  175  324  178  179  181  180  467   30   29  726  468   32  473  188  728  610  196  478   40  194
 154  303  444  445  446  447  579  310  450  453  583  706  316  456  587  458  459  590  591  461  323  176  325  464  463  466  721  722  601   27  336  841  333  335  608  343  606  341  340  198
 153  302  443  576  577  578  580  449  582  452  707  822  455  454  317  457  589  713  715  593  716  592  462  835  597  326  725  946  600  328  949  331  602  191  337  479  195  344  342   45
 152  301  442  575  700  701  702  703  581  927  705  708  930  586  588  710  712  830  829  714  937  718  594  717 1130  329  596  470  723 1046  474  332  948  731  604  480  338  200   43   44
 151  300  441  699  816  817  818  819  704  926  820  823 1029  824  709  932 1035  826  827 1127  595  720 1039 1042  719  598 1040  603  599  724  843  848  845  607  734  477  730  609  197   46
 150  299  440  574  698  815  924  925 1025  821  928  929 1120  825  711  934  935 1283  938 1036 1037  940  833 1131  942  836 1043  945  838  839  605  952  844  483 1045  612  611  729   47  202
 149  298  439  573  697  814  923 1024 1117 1116 1030 1027 1028 1033  931 1123  933  831 1211 1038  939  832 1129 1133 1216  837  943  944  834 1136 1050 1047  846  842  481  732  346  199  482  345
 148  297  438  572  696  813  922 1023 1115 1026 1200 1119 1122 1031 1121 1207 1208 1128  828 1209  936 1212 1213 1132 1041 1134 1215 1135  947 1138  954  840  951  733  847  736  204  347   48  201
 147  296  437  571  695  812  921 1022 1114 1277 1199 1118 1201 1204 1279 1206 1032 1349 1124 1286  941 1126 1210 1287 1292 1361 1044 1220 1218 1137 1222  950 1217  956 1049  484  615  613  203   49
 146  295  436  570  569  811  920 1021 1113 1197 1276 1275 1345 1205 1203 1350 1034 1408 1285 1125 1353 1354 1288 1214 1290 1293 1219 1362 1139 1140 1294  955  953 1048  619  849  348  735  206   50
 145  294  435  568  694  810  919 1020 1110 1198 1196 1278 1280 1202 1458 1282 1348 1409 1281 1352 1284 1355 1356 1416 1359 1417 1291 1295 1052 1221 1142 1141 1051  850  616  349  614  485   52   51
 144  293  434  567  693  809  918 1111 1017 1112 1404 1344 1343 1346 1459 1498 1347 1504 1351 1410 1411 1412 1415 1465 1414 1358 1360 1418  957 1299 1296 1054 1143  852  490  488  351  205   53   54
 143  292  433  691  565  692  808  917 1019 1274 1195 1403 1405 1500 1456 1499 1406 1407 1502 1462 1413 1463 1357 1289 1467 1468 1466 1225 1469 1146  958 1057 1053  851  737  738  487  486  350  352
 142  291  432  566  690  806  807  916 1271 1194 1341 1272 1193 1402 1497 1536 1460 1503 1538 1540 1506 1464 1507 1543 1508 1511 1420 1510 1421 1363 1224  959  962  740  618  743  739  209  207   55
 141  290  431  563  564  689  915 1018 1016 1273 1108 1400 1269 1401 1457 1501 1539 1461 1567 1505 1541 1588 1545 1544 1470 1512 1419 1366 1297 1055 1145 1144  853 1058  741  491  353  208  356   56
 140  430  429  562  688  805  914 1015 1014 1109 1342 1340 1453 1398 1455 1537 1565 1562 1584 1585 1569 1509 1542 1570 1423 1546 1422 1298 1365 1223 1227 1056  489  854  617  355  492  354   57  211
 138  139  289  560  687  804  913 1013 1192 1338 1191 1270 1452 1399 1454 1534 1535 1564 1582 1566 1568 1586 1587 1571 1513 1472 1471 1229 1147 1301  855 1226  960 1148  744  961  856   60   61  210
 286  137  287  428  561  686  803  912 1190 1104 1451 1337 1339 1397 1496 1563 1560 1583 1596 1597 1589 1590 1572 1547 1514 1424 1426 1364 1368 1300 1230  963  858  857  742  212   58  215   59  217
 135  288  801  427  685  909 1011  911 1105 1267 1336 1268 1335 1450 1558 1532 1533 1559 1594 1595 1592 1593 1574 1573 1425 1473 1476 1367  859 1228 1149 1305 1060  965  746  622  620  493  359   62
 284  559  683  558  684 1010 1012  802 1106 1107 1395 1394 1449 1494 1495 1528 1530 1561 1581 1599 1591 1598 1548 1549 1515 1477 1516 1303 1302 1231 1150 1061 1063  623  621  624  496  494  357  213
 283  136  285  422  425  908  910  798 1396 1333 1266 1188 1334 1448 1493 1529 1531 1580 1555 1579 1575 1552 1550 1517 1475 1474 1427 1304 1370 1371 1059    0  625 1062  861  628  747  497  214  362
 134  424  426  680  800 1103  557 1009  799 1189 1264 1265 1447 1393 1446 1491 1492 1525 1577 1554 1553 1576 1521 1551 1518 1478 1428 1369 1306 1232 1153  748 1152  966  495  862  360  498  745  629
 133  282  556  682  681  797  907 1101 1102 1263 1331 1332 1392 1390 1445 1557 1489 1485 1556 1486 1483 1522 1482 1520 1519 1479 1429 1372 1307 1234 1233 1064 1236  626  964  967  358  218   63  361
 132  281  555  423  679  906 1008 1100 1187 1186 1185 1261 1391 1490 1441 1440 1442 1527 1438 1384 1523 1484 1437 1481 1377 1431 1430 1373 1308 1154 1151  969  860  863  627  751  631  219  501  216
 131  280  421  554  678  796  905 1007 1099 1183 1184 1330 1444 1443 1389 1488 1387 1383 1487 1578 1526 1435 1381 1432 1379 1433 1375 1309 1310 1235 1155 1065  749  968  502  500  363   65   67   64
 130  279  420  795 1005 1006  903 1096 1098 1260 1327 1262 1328 1255 1253 1388 1524 1385 1436 1382 1249 1247 1434 1378 1313 1480 1376 1237 1240 1238 1066  970  864  750  503  866  752  365  499  220
 129  278  419  553  675  794  904 1003 1004 1182 1259 1326 1257 1329 1325 1173 1323 1252 1321 1248 1439 1320 1318 1315 1314 1164 1242 1311 1157 1156 1067  971 1070  753  504  364   66  222  630   68
 127  128  550  677  552  793  902 1095 1181 1097 1256  996 1090 1086 1254 1251 1250 1324 1386 1169 1317 1246 1319 1245 1316 1244 1312 1161 1158 1239 1068 1159  754  865  972  367  366  221  223   69
 275  276  274  277  792  676  901 1002 1001 1094 1258 1179 1176 1089  990 1088 1174 1171 1170 1084  986 1380 1167 1166 1243 1165 1241 1374 1074 1162 1072  976  867  756  755  632  634  505  369   71
 126  549  551  418  674  791  899  900 1178 1180  997  994  891  892 1175  993 1087 1322 1172  989  987 1082 1080 1079 1078 1077 1163 1075 1160 1071  975  973 1069  868  633  869  506  368   70  224
 415  413  416  414  548  673  790 1000  999 1091 1093  995  893  890  779  991 1085  886  885 1083  884 1168  985  984  983  982 1076  981  978 1073  874  872  870  871  757  635  372  370  371   72
 125  124  417  273  672  789  787  897  786 1092  894  781 1177  661  889  992  888  775  988  656  773 1081  882  881  880  879  878  875  977  873  974  761  643  762  758  759  636  508  507  226
 123  272  546  671  547  898  788  785  896  998  664  783  534  660  658  777  776  657  887  655  774  883  653  769  768  766  877  979  876  763  516  517  760  509  514  637  373  510  227   73
 122  271  412  545  670  669  667  666  784  895  665  663  782  662  778  397  659  528  529  527  250  651  772  770  650  648  767  647  765  645  764  515  642  638  640  639  374  511  225   75
 121  270  411  544  543  407  405  542  404  539  538  401  536  398  780  533  531  393  394  532  771  654  390  524  523  649  522  646  980  518  644  382  380  513  378  641  512  228   74   76
 120  269  410  409  408  263  540  668  541  403  537  402  535  400  399  396  530  392   98  248  525  391  526  389  388  386  521  520  519  239   87  240  381  237  377  376  375  229  232   77
 119  268  267  266  265  406  264  262  260  259  108  258  257  256  254  253  395  252  251  100  652  249   95  245  244   94   92   93  383  384  385   88  238  379  235  234  233  231  230   78
 118  117  116  115  114  113  112  261  111  110  109  107  106  105  255  104  103  102  101   99   97   96  246  247  387   91  242  243  241   90   89   86   85  236   84   83   82   81   80   79
