# This puzzle is unsolvable
21
214   3  80  81 155 154  85  88 159   7   9  11 160 228  14  17 168  16  19  20  21
 79 153  83 218  87   4  89 158  10 325 161 164  92  91  15  95  96  97  98 100  22
  1 149 217 319  82 220   6 222 363  12   8 224 165 330  93 166  13  99 169  23  24
 77  78   2 215  84   5 395 221 322  90 280 397 367 163 227 329  18 286 170 102 101
152 318 323 392 219 273 393 284  86 366 277 225  94 283 326 285 331 167 231 230  25
151 150  74 213  76 272 278 156 275 434 162 400 279 420 287 229 282 232 171 103  26
 75 357 212 210 216 362 157 274 324 394 226 431 402 290 401 370 288 172 233 106 104
317 148 270 320 359 276 321 358 364 327 368 396 223 438 334 369 105 335 173 235  27
147 315 268 271 269 390 360 365   0 419 426 328 336 371 180 333 339 234 237  28  29
204 145  73 356 389 415 355 391 440 413 425 332 373 281 176 289 292 241 174 107 177
 68 146  66 198 361 209 409 432 414 421 418 378 398 435 424 337 342 110 291 236 178
208  71 211 267 316 314 405 430 428 423 417 175 416 346 338 439 345 238  31 108  30
144 265 143 201 386 313 381 349 307 300 352 407 422 433 374 301 242  34  32 111  33
263  67  69  72 312 266 383 429 436 207 408 412 252 437 399 247 240 239 109 181 293
140 311 353 388 199 310 142 196 302 380 403 193 341 427 372 375 404 185 112 183  35
 70 141 264 206 256 354 131 384 126 411 406 197 377 343 299 340 303 376 182 115 114
305 351 205 350  61 348 309 203 382 379 248  50 344 304 127 125 295 246 294  37 184
308 136 258 137 259 387 257 410 192 194  52 128 190 186 298 297 296 244  36 113  43
 59 138  65  60 133 132  57 347 253  54 254 123 243 249 189  46 245  45 116  39  40
 55  63  62  64 260 262  56 200  49 139 250 124 251  51 122 121 179 119 118  38  41
202 135  58 306 261 134 129 255 195 130 385  53  48 191 120  47 188  44 117  42 187
