# This puzzle is unsolvable
22
 85   2  84   3   4 163 170  10  90  11  93 169 173  16 172  15 104  99  18 105  24  22
 83   1 290  87  86  91   6 235 234 236  94  92  98 239  97  17 238 101 176  21 179 103
 88 287 161   7   5 229   9 343 168   8 347  95 425 302 298 303 100  20  19 180  23 106
157 159 160 162 158 228 233 292 167 297  13 390 352  96 348 243 102 174 242 181  25 177
225 288 341 289 384 230  89 420 232 345 171  12  14 240 426 301 244 246 353 247 178 109
 78  79 166 227 342 339 377 391 294 291 338 346 393 349 296 354 248 304 107 175  26  27
 82 223  77 286 164 387 337 450 293 468 451 392 424 427 300 350 355 241  29 245 182 249
 81 156 224 417 165 421 340 344 237 299 389 382 452 428 307  35 187 351 305 394  28 111
 76 155 153 418 381 383 295 423 386 444 283 388 430 397 479 473 251 454  30 396 110 250
149  80 284 152 478 447 285 455 231 442 416 385 306 481 422 119 431 398 108 435 113 188
282  74 222 154 414 380 470 449 443   0 480 467 472 399 434 456 309 356 252 184 185 192
335 220 379 226 336 280 378 465 419 281 471 483 308 432 429 458 310 358 189 112 186 183
 72  75 218  73 446 331 333 463 445 464 477 409 482 475 453 253 395 114 360  31 115  34
334 221 278 279 151 277 448 439 466 405 268 476 368 400 401 457 433 362 190 116  33  32
216 215  69 146 332 375 410 370 413 412 474 129 469 462 406 357 198 361 193 311 359 117
143 150  71 276 212 376 271  59 441 411 319 437 202 459 366 263 404 312 255 120  40  36
 67  70 147 219 327 140 374 371 440 322 461 438 436 460 407 402 403  38 254  41  42  39
145 217 148 328 373 326 275 323 330 130 266 204 408 200 363 128 257 259 122 194 313  37
144 209 214 213 274 137 325  57 207 372 318 201 365 321 131 315 256 123 118 191 260 125
 68  66 211 270 269 415 324  60 267  56 136 265  52 367 264 364  50 262 258  44  43 121
329  64 272 273  63  61 205 133 208 206 138 320 203 127 316 261 369 314  48  47  46 195
 65 139  62 141 142 210 135  55  54  58 134  53 132  51 199 317  49 197 196 124 126  45
