# This puzzle is unsolvable
47
   3  362  188  363  185    5   11  192   10  536  538  370  197   14   15  200  375   16   19   20  205   21   22   24  208   26   27   28   29   30   31   32   33   34   35   36   37   38   39   40   41   42   43   44   45   46   47
 357  360    2    4    6  190  367    9  196  194  369  198   13  846  195   17  376   18  202  203   23  382   25  207  384  383  210  211  212  213  214  215  216  217  218  219  220  221  222  223  224  225  226  227  228  229   48
 361  528  686  186    7  365    8  689  985  191  845  373  994  695   12  991  539  201  377  378  204  379  206  548  209  551  385  386  387  388  389  390  391  392  393  394  395  396  397  398  399  400  401  402  403  230   49
 688  181  184  183    1  187  692  368  366  537 1123  372 1124  699  541  374  199  542  545  706  707  380  381 1002  710  549  552  553  554  555  556  557  558  559  560  561  562  563  564  565  566  567  568  569  404  231   50
 182  179  364  189  531  840  533  988  849  534  698  535  371  847  540  543 1129  702  544  705  546  550  547  709  862 1138  712  713  864  714  715  716  717  718  719  720  721  722  723  724  725  726  727  570  405  232   51
 525  839  356  358  842  687  532  690  694  193 1122  697  848  993  701  700  852  854  703  704  857  708  860  861 1137 1005  711  863 1004  865  866  867  868  869  870  871  872  873  874  875  876  877  728  571  406  233   52
 180  359  836  529  838  837  986  843  693 1121 1586 1482  696 1253  851 1130  853  996  998 1000 1135  856 1001 1136 1265 1139 1140 1006 1007 1008 1009 1010 1011 1012 1013 1014 1015 1016 1017 1018 1019  878  729  572  407  234   53
 352  353  841  530  355 1118  527 1117 1251  987  990  989 1126 1254 1487 1257 1132 1259 1131  855 1133  999 1134  859 1384  858 1003 1141 1142 1143 1144 1145 1146 1147 1148 1149 1150 1151 1152 1153 1020  879  730  573  408  235   54
 176  684  526 1249 1120 1248  524  844  979 1119 1369  983  992 1252  995 1127 1375 1258  997 1260 1261 1262 1263 1264 1385 1267 1386 1268 1269 1270 1271 1272 1273 1274 1275 1276 1277 1278 1279 1154 1021  880  731  574  409  236   55
 354  177  685  835  834  691 1243  984 1367 1373 1583 1483 1247  850 1255 1484 1378 1488 1489 1379 1380 1381 1382 1494 1496 1266 1497 1387 1388 1389 1390 1391 1392 1393 1394 1395 1396 1397 1280 1155 1022  881  732  575  410  237   56
 175  519  683 1116  178  978  982 1479 1372 1246 1368 1125 1370 1585 1128 1371 1256 1377 1490 1491 1492 1595 1493 1495 1598 1383 1498 1601 1499 1500 1501 1502 1503 1504 1505 1506 1507 1398 1281 1156 1023  882  733  576  411  238   57
 351  174  173  523  980 1115 1366 1245 1250 1680 1480 1584 1587 1588 1486 1591 1685 1376 1772 1774 1592 1594 1596 1597 1693 1599 1600 1602 1603 1604 1605 1700 1606 1607 1608 1609 1508 1399 1282 1157 1024  883  734  577  412  239   58
 522  349  521  682  681  831  977  832 1481 1581 1679 1582 1849 1374 1485 1771 1589 1773 1687 1593 1688 1690 1691 1692 1780 1694 1695 1784 1697 1698 1699 1787 1701 1702 1703 1610 1401 1509 1283 1158 1025  884  735  578  413  240   59
 170  172  350  679  517 1114 1113 1365 1364 1478 1768 1766 1770 1682 1674 1848 1854 1590 1924 1775 1776 1778 1856 1858 1779 1781 1782 1696 1863 1783 1785 1786 1788 1704 1611 1510 1400 1402 1284 1159 1026  885  736  579  414  241   60
 348  680  520  981  830  829  833 1244 1363 1681 1477 1769 1847 1686 1921 1850 1683 1684 1851 1689 1855 1777 1928 1857 1859 1860 1861 1862 1934 1864 1866 1867 1790 1789 1705 1612 1511 1403 1160 1286 1027  886  737  580  415  242   61
 346  169  516  518  677 1362  976  975 1475 1580 1767 1678 1677 1764 1676 1984 1923 1853 1925 1926 1988 1927 1991 1929 1930 1931 1932 1933 1935 1936 1865 1937 1868 1791 1706 1613 1513 1512 1285 1161 1028  738  581  582  416  243   62
 347  514  171  676  974 1111 1112  827 1239 1361 1476 1242 1765 1579 1919 1983 1852 1922 1986 1987 1989 1990 1992 1993 2048 1994 1995 1996 1997 1998 1999 1938 1869 1792 1707 1614 1404 1287 1288 1029  888  887  739  583  417  244   63
 678  345  510  515 1109  973 1240 1241 1472 1474 1673 1578 1844 1846 1918 1920 1985 2040 2041 2043 2044 2045 2046 2094 2047 2049 2050 2051 2052 2053 2000 1939 1870 1793 1708 1615 1514 1405 1163 1162 1030  889  741  740  418  245   64
 167  675  673  674  828 1110 1107 1359 1473 1360 1576 1675 1763 1845 1917 1982 2039 2088 2042 2090 2091 2092 2132 2093 2095 2096 2097 2098 2099 2054 2001 1940 1871 1794 1709 1616 1515 1406 1289 1166 1164 1031  584  742  891  247   65
 166  168  672  343  826  512  971 1238  972 1577 1470 1672 1761 1762 1916 1981 2038 2087 2089 2129 2130 2162 2131 2133 2134 2135 2136 2137 2100 2055 2002 1941 1872 1795 1710 1617 1516 1165  892 1292  890  743  419  585  246  420   66
 513  344  341  825  342 1235  969 1468 1237 1356 1471 1671 1760 1843 1842 1915 1980 2086 2128 2127 2184 2161 2163 2165 2188 2166 2167 2138 2101 2056 2004 2003 1873 1797 1796 1711 1618 1407 1291 1033 1290 1032  744  589  586  421  249
 823  340  165  163  509  970 1108 1358 1105 1357 1575 1670 1759 1841 1914 1913 2037 2085 2126 2159 2160 2185 2186 2164 2168 2139 2169 2140 2141 2102 2057 1942 1874 1712 1713 1619 1517 1408 1518 1168  893  895  894  587  423  248   69
 511  164  508  160  668  968 1106  967 1354 1469 1574 1668 1758 1840 1978 1979 2036 2035 2084 2158 2183 2200 2201 2187 2203 2189 2191 2104 2103 2005 1944 1875 1943 1798 1714 1519 1520 1409 1034 1522 1167  588  250  422   67  252  251
 161  339  821  822 1104 1233 1232 1236  966 1355 1234 1572 1669 1839 1912 1977 2124 2082 2125 2083 2157 2199 2207 2208 2204 2190 2170 2142 2059 2058 2006 2060 1876 1799 1621 1521 1294 1169 1293  896 1035  746  745  747  424  426  425
 162  505  338  671  824  507 1103 1465 1573 1230 1467 1466 1757 1838 1911 1976 2034 2033 2123 2156 2182 2181 2198 2206 2192 2202 2172 2171 2105 2007 2008 1945 1946 1878 1715 1620 1623 1413 1295 1036 1170 1039 1038 1037   71   70   68
 157  159  820  670 1231  669 1352 1102 1353 1351 1571 1667 1756 1837 1910 1975 2032 2081 2122 2155 2180 2197 2196 2195 2194 2205 2173 2143 2106 2061 2009 1877 1800 1622 1717 1523 1624 1410 1411  897 1040  901  898  593  590   72  253
 667  504  337  819  506  965 1101 1229 1464 1570 1569 1666 1755 1836 1909 1974 2031 2080 2121 2154 2179 2178 2177 2176 2175 2193 2174 2144 2107 2062 1948 1947 1879 1716 1801 1625 1414 1415 1296 1412 1298  592 1172  591  749  254   74
 503  335  158  817  963  964 1100 1228 1350 1463 1568 1665 1754 1835 1908 1973 2030 2079 2120 2153 2152 2151 2150 2149 2148 2147 2146 2145 2108 2063 2010 1949 1950 1880 1803 1718 1524 1416 1299  899 1297 1173  748  259   73  428  427
 336  333  664  502  666  961  818 1227 1349 1462 1567 1664 1753 1834 1907 1972 2029 2078 2119 2118 2117 2116 2115 2114 2113 2112 2111 2110 2109 2064 2011 1881 1802 1804 1719 1626 1525 1417 1174 1041 1171  596  595  256   76  255   75
 665  500  334  815  960 1096 1099  958 1348 1461 1566 1663 1752 1833 1906 1971 2028 2077 2076 2075 2074 2073 2072 2071 2070 2069 2068 2067 2066 2065 2012 1951 1882 1805 1720 1627 1526 1418 1175 1042  753  751  900  433  750  594  257
 662  663  332  499  816  814 1226 1098 1347 1460 1565 1662 1751 1832 1905 1970 2027 2026 2025 2024 2023 2022 2021 2020 2019 2018 2017 2016 1956 2015 2013 1952 1883 1806 1721 1628 1527 1301 1300 1176 1044  903  431 1178   77  429   79
 156 1097  661  660  959  962 1095 1225 1346 1459 1564 1661 1750 1831 1904 1969 1968 1967 1966 1965 1964 1963 1962 1961 1960 1959 1958 1957 1889 2014 1954 1953 1884 1807 1722 1629 1528 1419 1302 1177  905  754 1043  432  902  430   78
 155  154  331  501  810  813  957 1224 1345 1458 1563 1660 1749 1830 1903 1902 1901 1900 1899 1898 1897 1896 1895 1894 1893 1892 1891 1890 1814 1888 1955 1887 1885 1808 1723 1630 1529 1420 1303 1179  756  904  597  435    0   80  258
 153  152  330  329  659  812 1094 1223 1344 1457 1562 1659 1748 1829 1828 1827 1826 1825 1824 1823 1822 1821 1820 1819 1818 1734 1817 1732 1815 1811 1813 1886 1810 1809 1631 1531 1530 1421 1304 1046 1045  755  908  260  261  263   81
 151  328  497  498  811  956 1093 1222 1343 1456 1561 1658 1747 1746 1745 1744 1743 1742 1741 1740 1739 1738 1737 1736 1735 1816 1642 1541 1731 1730 1637 1812 1727 1726 1725 1724 1633 1180 1632 1422 1306  757  600  752  598  262   82
 150  327  496  658  809  955 1092 1221 1342 1455 1560 1657 1656 1655 1654 1653 1652 1651 1650 1649 1648 1647 1646 1645 1644 1643 1641 1640 1733 1540 1728 1537 1636 1536 1535 1635 1634 1305 1047  906  759  910  599  907  601  264  436
 149  326  656  657  954  953 1091 1220 1341 1454 1559 1558 1557 1556 1555 1554 1553 1552 1551 1550 1549 1548 1547 1546 1545 1544 1542 1435 1638 1432 1729 1539 1538 1429 1425 1534 1532 1423 1049 1048 1183 1181  602  758  434  266  265
 148  325  495  655  807  808 1090 1219 1340 1453 1452 1451 1450 1449 1448 1447 1446 1445 1444 1443 1442 1441 1440 1439 1438 1437 1543 1321 1434 1433 1639 1431 1315 1430 1427 1533 1424 1307 1426 1182  909  911  760  603  437  438   83
 147  324  494  493  654  952 1089 1218 1339 1338 1337 1336 1335 1334 1333 1332 1331 1330 1329 1328 1327 1326 1325 1324 1323 1322 1436 1320 1194 1318  924 1317 1192 1313 1428 1312 1310 1186 1308 1055  912 1184  761  604  439   85   84
 146  323  492  653  806  951 1088 1217 1216 1215 1214 1213 1212 1211 1210 1209 1208 1207 1206 1205 1204 1203 1202 1201 1200 1199 1066 1197 1319 1196 1316 1061 1191 1190 1189 1057 1309 1311  769 1056 1050  440  762  606  605  268   86
 145  322  491  652  805  950 1087 1086 1085 1084 1083 1082 1081 1080 1079 1078  938 1077  936 1075 1074  933 1071 1070  930 1069 1198  780  927 1195 1063 1193  922 1314  921 1058 1059  916  771 1187 1185  765  917  766  442   87  267
 144  321  490  651  804  949  948  947  946  945  944  943  942  941  940  791  939 1076  789  935 1072 1073  932  931  783 1068 1067  929 1064  925  777 1062  775  920  772 1060  616  919  918  768 1051 1052  445  441  269  444   88
 143  320  489  650  803  802  801  800  799  798  797  796  795  794  793  635  937  636  790  788  934  787  629  467  784  781  926  928 1065  779  778  776  774  923  619  773  454  915  615  450 1054 1053  607  767  608  763  270
 142  319  488  649  648  647  646  645  644  643  642  641  640  639  638  792  637  472  634  633  632  786  631  785  628  782  626  625  624  623  622  458  621  620  770  617  281  452  614  914 1188  913  276  764  609  443   89
 141  318  487  486  485  484  483  482  481  480  479  478  477  476  475  474  473  301  471  470  469  468  630  465  293  627  463  462  461  460  459  457  456  285  618  453  282  451   99  612  610  274  611   90  272  271   94
 140  317  316  315  314  313  312  311  310  309  308  307  306  305  304  303  123  302  300  298  297  295  296  466  464  292  113  291  290  289  288  287  286  106  455  101  283  446  448  279  100   98  280  447  273   91   93
 139  138  137  136  135  134  133  132  131  130  129  128  127  126  125  124  122  121  120  299  119  118  117  116  115  114  294  112  111  110  109  108  107  105  284  104  278  449  103  102  613  277   97   92   95   96  275
