# This puzzle is unsolvable
8
56 60 62 11 14  7  4 29
54  9  5 12  0 28 19 53
21 16 51 55 59 36 22  8
35 45 30 49 25 39 40 23
20 50  2 34 57 13 63 15
52 32 58 24 33 44  6 41
43 46 38 17  3  1 31 48
37 18 61 42 27 47 26 10
