# This puzzle is unsolvable
22
161   1   2   5   6  90   7   8 232 233  94 169  14  96 100  16 179  21 242  22  27  18
 83  84  86   3 163  93  89   9  91 168  92 235  11 171 174  15 102  17 177  19 105  23
 85 228  88   4 230 166 236 448  10  12 297  13 237 241 238 428 178  24 303 175 108  25
227  82  81 162 165 164 287 342 291 296 239 170 454  97 172  99  98 247 352 109 107  26
 80 160 229  87 226 231 234 380 290 294 345 295  95 298 299 349 301 101 104 176 302 106
157 222 224 156 288 339 284 344 470 387 388 390 351 348 392 173 350 244  20 180  29  31
 79 158 159 382 293 292 167 391 423 482 347 389 472 353 481 300 249 305 240 103  28 245
 78 155 286 225 338 289 445 386 422 420 453 426 425 397 398 304 432 182 181 112 113 184
220 153  76 341 154 343 281 421 450 466 404 430 465 427 455 358 111 246 248 189 243 252
223  77 337 282 467 285 336 335 385 383 424 463 400 369 306 457 399 395 396 183 355 308
151 152 283 419 381 447 417 449 469 407 340 460 468 429 456 186 393 110 354 312 362  30
219 149 221 334 413 444 415 414 475 384 476 480 451 406 251 479 402 431 262 185 187  33
 74 333 418 150 332 377 378 477 372 264 446 483 452 440 357  34 458 122 394 250 114  32
 73  75  72 279 379 376 478 462 416 474 346 322 401 321 437 403 405 356  38  35 310 253
 71 280 278 329 330 412 277 464 461 410 433 365 471 435 317 190 359 307 360 255 316 254
 70 147 218 276 217 326 408 438 443 442 370 267 439 313 203 193 115  37 361  36 258 363
 69 146 215 216 331 272 373 371 324 459 325 436 473 319 314 309 434 118 311 315 195 256
 68 145 214 148 441 375 273 409 208  55 367 266 366 197 130 188 261 119 116 192 257 191
 67 144 213 327 211 328 411 374 269 323 207  51 265 263 364 194 260 318 121 120  41 117
 66 143 212 140 274 209  57 270 137 134  53 129 131 202 368 259 200 199  40  39  45 123
 65 142 141 210 275 139 271 132 136  56 268 133  54 204  49 125  48 196 124  47 126  42
 64  63  62  61  60 138  59 135  58  50 201  52 205 198 206 128 320 127   0  44  46  43
