# This puzzle is unsolvable
41
 160  157    3  164  165  459    7    6    9  319   11   13  323  172   16   14  175   18   19   20   22  181   25  183  184  186   29  338  187   31  189   32  485  192   33   34  196  198   42   36   40
 312    1  162    5  166  594  318  599  316   10  464  170  601  171  173  176   17  177  469  178  180   21   23   24  613   27   26   28  339  188  190   30  191  487  194  347   35   41  491  197  199
 457    2  313  163    4  168  167  169  320    8  598  603   12  325  466   15  327  471  329  332  736  331  182  476  336  185  337  481  340  482  484  341  621  344  867  348  625  345  200   39   43
 311  454  310  315  317  722  593  460  463  842  322  467  465  729  174  850  328  468  474  179  610  735  334  335  738  479  480  616  745  483  342  343  486  751   38  195   37  350  352   44   45
 155  161  592  456  159  314  595  461  723  321  597  600  728  731  604  732  605  606  472  608  854  475  609  333  477  614  615  617  618  746  748  620  622  193  346  623  202  489  351  349   46
 455  158  458  305  720  953  840  956  596 1153  843  845  958  326  733  852 1065  470  473  330  734  737  478  740  612  741  742  743  619  974  747  978  866  624  868  488  493  492  201  203  204
 590  718  719  715  591  954  841  724 1057  847  727 1154  730  602  849  324  851  853  963  607  967  969  611  970  858 1072  859  861  863  744  864  870  750  872  626  754  627  752  353  205   47
 154  452  306  713  453  721  839 1056 1058  462  725  957  959  848  960  962 1066  961  964  855  966  856  857  739  860  971  973  862  975 1078  976  865  977  979  749  490  753  628  495  354   48
 308  304  836  587  588  838  949 1152 1151  846  726  955 1060 1062 1063 1064 1160 1161 1068  965 1069 1070  968 1073 1074 1075  972 1076 1077 1079 1174 1080 1081  869  980  871  629  494  496   50  206
 156  307  950  152  837  451  584  952  844  951 1059 1241 1061 1157 1158 1246 1159 1249 1067 1163 1164 1165 1071 1167 1168 1256 1169 1170 1172 1173 1175 1082  981  874  982  631  756  497  355  356   49
 301  303  450  585  309  948 1053  717  716 1054 1321 1242 1156 1244 1245 1325 1247 1248 1250 1162 1251 1252 1166 1254 1255 1257 1336 1171 1259 1260 1261 1176 1084 1083  755  873  630  498  357  207   51
 586  153  582 1055  835  712 1149 1240 1148 1236 1150 1155 1243 1323 1324 1397 1326 1398 1327 1329 1331 1465 1253 1333 1334 1335 1407 1258 1338 1339 1262 1178 1177  983  875  757  632  499  358  208   52
 150  151  449  589  714  446 1052 1239 1238 1050 1389 1322 1319 1458 1393 1394 1461 1459 1328 1399 1330 1403 1332 1404 1468 1405 1469 1337 1410 1409 1264 1263 1085  984  758  760  500  501  210  209   53
 149  302  447  448  583  833  834  947 1320 1237 1391 1318 1457 1392 1317 1396 1462 1516 1564 1463 1401 1402 1520 1467 1523 1470 1406 1408 1471 1340 1341 1179 1086  985  876  634  633  360  359  211   54
 148  147  445  711  832  945  946 1147 1051 1145 1233 1235 1456 1561 1390 1395 1514 1517 1565 1400 1518 1519 1466 1522 1568 1524 1525 1472 1342 1343 1265 1180 1088 1087  986  635  759  878  503  212   55
 145  299  146  581  709  831 1049 1234 1048 1146 1316    0 1454 1512 1560 1511 1460 1599 1605 1602 1464 1567 1608 1521 1569 1571 1526 1473 1411 1267 1344 1266 1181  877  989  987  638  361  502  362   56
 298  710  300  442  580  943  944 1144 1143 1232 1388 1455 1453 1600 1510 1632 1562 1558 1603 1604 1637 1636 1607 1572 1570 1573 1527 1474 1412 1413 1182 1089  988  879  990  637  880  762  216  636   57
 297  443  143  579  708  942  941 1046 1047 1313 1314 1451 1559 1601 1557 1515 1563 1513 1634 1635 1566 1606 1639 1610 1609 1574 1528 1475 1414 1345 1268 1183 1090  881  639  504  505  761  366  213   58
 142  444  144  829  440  830 1142 1231 1309 1044 1315 1452 1386 1509 1508 1597 1631 1657 1671 1633 1659 1660 1638 1641 1640 1611 1529 1476 1415 1346 1269 1184 1091  882  883  640  506  363  364  365   59
 296  139  439  707  828  438  940 1230 1138 1140 1045 1385 1384 1507 1556 1630 1598 1655 1672 1658 1680 1662 1661 1613 1612 1575 1530 1477 1416 1347 1270 1094 1185  991  885  766  764  507  214  765  217
 441  294  295  705  706  825  937 1141 1311 1042 1312 1383 1387 1229 1594 1596 1595 1652 1654 1670 1676 1673 1642 1614 1643 1576 1531 1478 1417 1348 1093 1092  994  993  641  509  642  215  218   61   60
 138  291  437  141  827  826 1041 1043 1139  939 1310 1228 1449 1555 1450 1554 1553 1669 1679 1647 1629 1663 1675 1615 1578 1577 1532 1479 1349 1272 1186 1271 1188  886  767  992  510  367  763  219   62
 140  578  574  573  575  824  703 1039 1040 1448 1308 1381 1505 1506 1503 1653 1552 1678 1621 1664 1674 1677 1617 1619 1533 1362 1534 1480 1418 1350 1273 1189 1187 1095  643  884  369  508  368  220   63
 576  435  436  293  577  700  822  935 1227 1137 1382 1447 1504 1592 1551 1628 1593 1622 1656 1623 1665 1618 1666 1646 1616 1490 1481 1482 1419 1420 1274 1096  995  769  770  768  645  644  511  221   64
 137  292  290  704  701  938  823 1136 1135 1501 1380 1446 1379 1444 1625 1624 1649 1668 1650 1588 1620 1584 1667 1493 1582 1535 1579 1483 1352 1351 1275 1190 1098  996  889  887  646  512  370  222   65
 289  432  433  434  572  934  570  821 1037  936 1224 1304 1497 1445 1442 1547 1591 1651 1543 1648 1586 1431 1429 1585 1491 1580 1536 1423 1421 1422 1353 1276 1191  997  888 1097  771  513  371  223   66
 136  431  288  571  818  702  699 1038  931 1306 1226 1225 1307 1378 1550 1439 1627 1502 1498 1587 1492 1487 1542 1645 1538 1430 1489 1537 1484 1354 1277 1193  999 1099  998  772  647  514  372  224   67
 135  285  569  286  698  933  820 1036 1134 1377 1305 1443 1303 1441 1440 1589 1546 1548 1626 1544 1436 1434 1432 1540 1644 1485 1581 1426 1424 1355 1101 1100 1195 1192  890  515  649  516  373  225   68
 287  134  568  567  819  932 1133 1131 1035 1223 1302 1376 1499 1549 1293 1495 1590 1496 1494 1545 1367 1433 1541 1583 1428 1486 1360 1427 1358 1425 1278 1279 1194 1000  773  648  650  517  374  226   69
 133  430  566  814  695 1034 1222 1132 1221 1374 1300 1216 1299 1297 1372 1438 1371 1437 1435 1368 1366 1365 1289 1363 1286 1539 1488 1359 1283 1356 1357 1280 1001  891  776  893  775  376  518  227   70
 131  132  429  696  815  697  817  930  929 1033 1220 1217 1500 1373 1298 1296 1211 1370 1210 1294 1291 1016 1364 1290 1288 1361 1285 1284 1282 1199 1281 1103 1102 1002  892  777  651  519  375  228   71
 283  284  428  565  692  694  928 1130 1219 1218 1301 1126 1375 1215 1214 1213 1295 1212 1369 1209 1292 1207 1116 1017 1287 1203 1202 1201 1108 1200 1198 1196 1197 1104  894  653  774  378  379  377  229
 130  282  427  564  813  693 1032  926 1128 1029 1127 1026 1125 1124 1123 1122 1121 1021 1120 1019 1018 1118 1206 1205 1113 1112 1111 1109 1011 1010 1106 1004 1007 1003  895  654  652  520  380  230   72
 129  128  425  562  563 1031  810  816  924 1028 1027 1025  804  918 1024 1023 1022 1119 1208  911 1020 1117 1114 1014 1204 1013 1012  790  787 1107 1009  898 1006 1005  779  778  521  522  232   74   73
 127  281  426  561  691  686  927 1129 1030  922  921  920  803  919  679  917  916  913  912  796 1115 1015  909  908  907  906 1110  902  788  899  786 1008  900  897  896  780  655  381  233   76  382
 126  812  560  424  811  925  923  689  550  555  806  805  682  802  800  677  914  799  675  797  795  910  794  793  792  791  666  905  785  903  901 1105  784  782  659  781  657  656  231   75  234
 124  280  277  419  557  690  809  687  807  683  268  801  547  681  678  407  915  676  544  674  673  672  671  670  669  668  904  667  535  665  663  662  660  783  658  526  524  525  523  383   77
 123  279  421  278  688  418  558  416  685  684  808  412  262  410  549  259  546  408  261  543  542  541  540  539  538  537  536  789   94  664  533  532  531  529  528  240  387  384  235  385   79
 276  422  423  273  559  420  556  417  414  552  554  265  680  263  406  107  545  798  405  404  403  402  401  400  399  398  397  396  534  395  393  392  661  527   86   87  389  386   83  238   80
 122  125  275  274  118  271  270  269  415  551  553  112  411  264  109  409  260  105  258  257  256  255  254  253  252  251  250   93  249  394  246   89  530  244  391  390  242   85  239   78   81
 121  120  119  117  272  116  115  113  114  413  266  267  111  548  110  108  106  104  103  102  101  100   99   98   97   96   95  247  248   92   91  245   90  243   88  388  241   84  236  237   82
