# This puzzle is unsolvable
40
   2    1  159    3    5    7  163  162    8   10   11   12   13   15   16  171   18   19  174   24  462  176  178  325   27   25   26   29  185  183  188  335  189   33   32   34   36   37   39   40
 155  158  305    4  307  160    6  309  310  164  166  167  168   14  170   17  169   20  460  459   23  324   22  179  327  182   28  184  330   31  186  474  334  336  191   35  193   38  194   41
 153  154  156  306  308  447  311  161    9  165  312  313  315  316  590  317  319  173   21  322  321  594  465  180  597  326  328  469  331   30  187  475  333  476  338  190  339  192  340   43
 302  157  303  444  446  578  448  449  450  451  452  314  454  455  585  710  318  714  591  177  175  832  323  596  466  181  329  470  601  602  726  603  472  606  337  477  478  341   42  196
 152  304  443  445  701  577  579  581  704  582  583  453  584  821  587  456  461  172  589  716  938  717  595  464  719  467  468  599  332  727  725  728  843  473  607  479  342  197   44  195
 151  301  442  576  699  815  818  819  702  705  707  709  588  823 1032  457  826  320  713  831  937  835  463  942  598  600  838  840  723  724  841  604  605  729  730  608  609  343  198   45
 300  441  700  574  575 1024  703  580  820  928  706  708  586 1030  711  934  458  592  830 1127  593  940  720  718  833  943  722  471  837  947  948  842  844  845  731  610  480  344  199   46
 150  299  440  573  816  817  925  926 1025  927  929  822  930 1123 1121  824  712  829 1034  715  935  836  941 1133 1041 1043  944  945  946  839  949 1048  950  612  734  732  481  345  200   48
 149  298  439  572  698  697  923  924 1026 1028 1029 1120  827 1031  932 1122  933 1125 1124 1210 1126 1130 1040 1038 1216  721 1042 1044 1045 1135 1046 1138  951  846  611  613  483   49   47   50
 148  297  438  571  696  814  922 1022 1023 1116 1027 1119  931 1279 1205 1033  828  825 1208  936 1036  939 1213  834 1132 1215 1291 1218 1294 1047 1139 1049  847  733  735  614  484  346  202  482
 147  296  437  570  695  813  812 1115  920 1198 1118 1202 1204 1203 1345 1284 1283 1350 1352 1285 1037 1355 1289 1131 1358 1292 1217 1134 1136 1051 1140 1050  952  953  848  486  485  347  204  203
 146  295  436  569  694  811 1021  919 1112 1200 1199 1201 1277 1278 1206 1280 1207 1348 1459 1410 1129 1353 1039 1214 1290 1357 1418 1219 1295 1359 1220  954  849  736  737  615  349  348   51  201
 145  294  435  692  693  808  810 1117 1114 1020 1197 1344 1403 1404 1349 1405 1209 1503 1282 1462 1128 1211 1287 1035 1356 1417 1467 1360 1361 1221 1222 1052  955  850  616  617  487  350  205   52
 144  293  434  568  809  807  918 1019  921 1275 1276 1274 1456 1342 1460 1346 1407 1411 1286 1413 1464 1288 1212 1354 1510 1293 1416 1224 1362 1137 1223 1142 1053  851  738  489  488  351   53  206
 143  292  433  567  691  917 1111 1018 1195 1113 1273 1343 1347 1457 1406 1281 1408 1458 1409 1565 1351 1507 1463 1415 1508 1468 1422 1297 1419 1296 1141 1054  956  957  739  618  490  352   54   55
 142  291  432  566  565  690  916 1109 1196 1272 1341 1402 1455 1536 1502 1501 1504 1567 1539 1505 1412 1542 1543 1466 1509 1423 1420 1365 1225 1143 1144 1055  958  852  741  619  354  353  208  207
 141  290  431  564  689  806 1016 1017 1110 1194 1271 1340 1454 1400 1500 1497 1537 1540 1584 1506 1538 1588 1414 1465 1470 1469 1364 1300 1363 1145 1056 1057  959  960  740  742  491  492   56   57
 140  289  430  563  688  805  915 1015 1192 1108 1270 1339 1401 1453 1535 1562 1583 1585 1564 1596 1568 1541 1471 1421 1472 1544 1511 1366 1298 1226 1146  962  621  856  853  620  355  357  356  209
 139  288  429  562  687  914 1013  913 1014 1193 1269 1338 1399 1452 1496 1499 1498 1563 1599 1461 1569 1586 1545 1552 1473 1425 1427 1301 1299 1227 1147 1058  963  961  743  744  494  622  210  493
 138  287  428  561  686  804  803  912 1107 1191 1268 1337 1398 1451 1495 1534 1566 1561 1582 1548 1577 1546 1590 1572 1515 1368 1475 1302 1367 1228 1231 1150  857  855  623  495  496  213   59  212
 137  286  427  560  685  802  911 1105 1106 1190 1267 1336 1397 1450 1532 1531 1533 1587 1589 1598 1593 1514 1571 1597 1513 1426 1476 1062 1063 1149 1424 1059 1060  858  854  745  361   58  211   61
 136  285  426  559  684  801  910 1012 1103 1104 1189 1335 1396 1449 1494 1560 1581 1594 1580 1576 1547 1591 1570 1516 1474 1369 1573 1148 1428 1154 1307 1061  859  966  746  497  359   60  360  214
 135  425  558  557  683  800  909 1011 1010 1188 1266 1334 1395 1448 1493 1530 1558 1595 1579 1578 1592 1553 1575 1551 1549 1230 1512 1304  749 1229 1232 1153  750  748  860  965  625  624  358   62
 134  284  682  681  680  799  908 1102 1187 1264 1265 1333 1394 1447 1492 1529 1559 1557 1556 1555 1523 1522 1521 1574 1303 1477 1371 1518 1430 1151 1155  628  964  971  747  626  863  216  215   63
 132  133  423  798  679  797  907 1009 1101 1186 1263 1331 1393 1491 1489 1528 1487 1526 1525 1524 1436 1482 1379 1483 1517 1519 1233 1370 1152 1305  969 1234  861  630  498  499  362  753  363   64
 283  421  424  552  555  906 1100 1008 1099 1185 1330 1332 1261 1446 1443 1442 1445 1527 1486 1440 1554 1434 1520 1550 1480 1429 1373 1372 1479 1374  970 1065 1064  629  627  752  501  500  217   65
 553  281  422  556  905  420 1007  796 1006 1184 1262 1444 1389 1388 1392 1488 1490 1385 1439 1484 1438 1381 1435 1481 1433 1309 1376 1306 1310 1159 1478  862  972  864 1068  221  632    0  218   66
 282  419  279  280  678  795  904 1005 1098 1183 1260 1329 1391 1325 1386 1253 1387 1384 1485 1383 1437 1246 1380 1314 1316 1377 1432 1375 1308 1236 1237 1235  968  866 1066  865  219  503  364  222
 418  131  130  551  677  794  903 1004 1097 1182 1259 1328 1390 1327 1441 1254 1323 1322 1171 1321 1248 1320 1382 1317 1431 1313 1242 1241 1312 1156 1157 1070  756  967  631  751  502  368   67   70
 278  276  554  675  676  793 1003 1096 1181 1093 1180 1257 1326 1255 1324 1251 1250 1084 1170 1319 1249 1247 1244 1245 1163 1378 1243 1162 1311 1238 1158  869  867 1067  754  636  366  367   69  220
 277  128  127  549  673  792  902  900 1094 1258 1178 1177 1175 1256 1090 1173 1252  992  987  990  988 1166 1318 1315 1164  981 1077 1161 1239  978  974 1160  868  758  506  755  505  504   68  223
 275  129  417  550  548  674 1002 1095  999 1092 1179  895  994 1176  890 1089 1172 1087 1085 1083 1169  986 1082 1167 1168 1076 1165 1075 1074  873 1071 1240  976  634  633  870  508  365   71  224
 126  274  414  416  415  898  791  901  998  786 1001 1091  995  781 1088 1174  993  777  885 1086  989  773 1080 1078  983  982  879  979  876 1073 1072 1069  872  757  637  507  509  226  635  227
 124  125  547  546  672  899  897 1000  896  893  997  892  660  780  891  888  991  658  655  884  985  772 1079 1081  768  770  980  766  877  875  977  762  973  871  513  510  640  225  369   73
 123  272  413  545  671  789  790  787  669  667  664  662  996  536  889  656  659  776  883  886  882  651  984  652  880  650  767  765  519  763  644  874  761  975  759  370  371  372   72   75
 411  273  410  412  670  542  788  404  785  665  783  784  535  532  778  779  531  775  530  654  774  527  522  881  649  524  878  648  645  764  517  643  641  760  379  639  512  374   74  228
 271  121  544  409  543  407  405  668  261  401  403  894  105  663  661  256  657  396  529  887  392  248  525  653  390  769  387  647  520  518  382  516  236  511  514  234  638  373   77  229
 122  119  265  269  408  541  406  540  539  537  402  666  399  255  534  398  253  395  394  526  391  389  528  523  521  771  388  646  386  383  239  381  642  515  378  376  232  230  231   76
 270  120  266  117  114  264  263  262  110  538  260  782  400  257  533  104  397  251   99  393   97   98  247   94  245  244   92  243  385  384  240  238  380   85  233   83  235  375   78   79
 118  116  268  267  115  113  112  111  109  108  107  259  258  106  103  254  102  252  101  100  250   96  249  246   95   93   91  241  242   90   89   88   87   86  237   84   82  377   81   80
