# This puzzle is unsolvable
9
30 57 59 44 48 79 23 61 18
25 38 51  5 32 60 33 43 74
11 68  9 45  6 80 78 71 66
58 56 54 77 29 50 53 19  8
 3 65 36 27 67 75 35 46 64
39 20 13 70 55 52 24 37 72
26  4 62 42 14 73  7 47 15
34 41 10 28  2 63 69 17 76
12 31 40  1 22 16  0 49 21
