# This puzzle is unsolvable
10
 84  38  10   1   8   4  70  14  85  45
 37  36  65  88  61  42  74  97  13  56
 67  21  89  52  69  51   9  40  91  15
 29  48  12   2  35  60   6  90  34  63
 95  81  31  30  68   5  39  32  86  71
 64  33  46  18   0  78  79  16  43  92
 41  76  27  66  24  20  77  83  72  53
 82  57  75  44  55  25  98  94  19  62
 28  58  96  59   3  87  23   7  11  17
 73  26  47  22  80  49  54  93  50  99
