# This puzzle is unsolvable
21
 81  80   1  83   2   7   3   4   9  10  11  12  92 164  14  15  17  18  20  21  22
 78  79  82 221   6  86 157   8  87 224 159  89  93  94  13  96 100 166  19  97  99
152 149 153 151 156 155 223 362  84 158  88  90  91 165  95  16 168 230 285 233 170
 77 217   5  85 273 218 220 276 278 161 327 226 163 227 228 284 169 172  23 232  98
271 215 154 358 209 393 219 323 277 395 160 162 280 282 283 167 231 104 171 103  25
150 216 268 274 213 275 317 392 222 363 398 325 328 281 229 369 288 330 174  24 101
148 272 211  76 270 269 259 361 322 324 397 225 326 366 236 332 399 286 175 331 173
144  73 321 214 357 318 415 319 364 429 279 422 367 421 287 234  28 335 370 105  31
 71  74 206 210 391 396 267 413 408 431 435 420 329 368 371 180  26 333  27 106 102
 75 314 147  72 146 430 416 207 432 418 365 390 376 423 434 400 237 176 108 238  29
265 316  70 360 320 204 389 417 359 424 301 372 433 290 337 110 334 183 177 181  35
143  69 145 266 388 385 355 440 414 394 436 409 419 336 291 117 289 375  33  30 112
315  67 264 405 313 212 254 304 425 438 426 401 343 402 294 111 242 378 239  37 179
 66  68 308 260 205 356 411 387 407 255 437 194 377 191 338   0 292  36 235 114  34
139 262 208 261 136 141 380 303 345 344 312 379 403 406 339 293 374 178 373 240 107
307 263 203 305 386 341 384 410 382 427 346 311 412 342 249 404 125 243 296 113 109
138 132  62  65 198 348 310 251 195 302 347  51  48 123 299 300  32 247 182 120  39
 64 309 351 353 135 140  58 381 128 253 193 250  49 246  46 190 189 115 124 241  40
200 142 256 137  57  60  54 383 306 192  53 252 298 188 122  43  47 340 186 295 245
 61  63 257 133 201 354 130 349 428 350  56 196 248 197  45 297 116  44 118  38 187
134 131 199 352 202 258  59  55 129 126  52  50 127 439 119 121 244 185  41  42 184
