# This puzzle is unsolvable
24
  1  92   2  93  95   5   8  10  97 100 261 104 260  18 334 188 108 190  20 113 194  24  23  28
  3  94   4 179   6  96  99 182 183   9  11 101 187 262 266  14  16 111 109 331  25 337 110 115
 90 176 252 251 255 433 180 319 323 185 328 103 436  17  19 189  21 193 335 196  27 117 200 114
 89  91 173 320 321 256  98   7 181 326 186 106 258 105 265 107 390 191 270  22 336 112 201 119
 87 248 254 175 380 431 257 479 382  13 480 325  15 332 438 442 269 393 341 271  26 192 198 268
249 174 177 178 430 475 476 324 512 435 387 102 259 485 563 263  12 264 394 444 116  30 199 197
171 317 253 378 250 381 432 322 385 327 329 184 388 330 487 447 520 522 397 396 273 274 123 272
 86 172 379  85 376 372 377 474 437 478 541 386 389 516 484 440 333 340 488 445 443 339  31  33
 88 318  84 315 508 472 511 434 477 384 514 383 519 564 392   0 267 391 398 338 195  29 202 395
167  81 169 429 170 473 471 513 510 482 481 439 399 562 545 517 441 454 448 277 486 276 204 120
314  83 168 245 426 312 428 540 539 542 561 515 483 518 550 446 449 450 523 452 125 203  32 118
311 246 375 247 244 373 572 573 555 427 557 543 549 570 547 565 489 401 278 345 400 205 275 121
166  82  79 316 425 507 506 538 575 537 569 558 544 524 546 548 490 526 521 280 122 126 342  36
165 370 241 310 374 470 423 469 509 559 568 501 553 574 528 493 491 451 494 346 347 124  34  38
164 313 243 424 242 369 464 468 536 531 554 560 556 551 552 404 408 409 283 281 343 207  37  35
 78  80 240 237 368 309 504 505 465 416 462 532 567 499 525 356 457 492 455  41 279 285 209 208
 77 163  75 371 421 308 239 534 417 535 359 497 571 460 459 566 405 402 495 348 206 130  40 127
238 161  73 236 302 301 229 503 362 530 463 533 225 529 496 461 210 351 282 403  39 129 344 212
 76 304 160  74 307 467 466 420 502 223 363 414 361 358 412 458 407 406 353 290 132 211 350 128
159 305 231 306 162 150 419 365 418 415 298 143 498 360 147 222 284 352 286 411 354 213  43 131
158 233 235 303 422 364 300 228 149 357 299 145 294 527 141 221 291 456 216 217 288 133  44  42
156  68 153 367 154 232 413  64 297 295 151 296 500 355 293 220 410 139 218 138 349 214 135  45
 72  71 234  67 157  59  60 152 227  61 224  57 144  58 453 289  52 140  51 215 137 287  46 136
 70 155  69 230  66 366  65  62 146  63 226 148 292 142  56  54 219  55  53  49 134  50  48  47
