# This puzzle is unsolvable
8
62 40  9 34 52 30 37 48
16 11 10 33 45 57 38 17
19  6 36 28 12 42 44 46
13 47 60 14 61 50  0 29
 8 24 63  4 22  1 15 53
58 41  2 18 23 54 32 20
55 21 49 51  3 59  5 35
 7 27 25 26 43 39 31 56
