# This puzzle is unsolvable
65
   2    1    3    4    5    6    7    8    9   10   11   12   13   14   15   16   17   18   19   20   21   22   23   24   25   26   27   28   29   30   31   32   33   34   35   36   37   38   39   40   41   42   43   44   45   46   47   48   49   50   51   52   53   54   55   56   57   58   59   60   61   62   63   64   65
 256  257  258  259  260  261  262  263  264  265  266  267  268  269  270  271  272  273  274  275  276  277  278  279  280  281  282  283  284  285  286  287  288  289  290  291  292  293  294  295  296  297  298  299  300  301  302  303  304  305  306  307  308  309  310  311  312  313  314  315  316  317  318  319   66
 255  504  505  506  507  508  509  510  511  512  513  514  515  516  517  518  519  520  521  522  523  524  525  526  527  528  529  530  531  532  533  534  535  536  537  538  539  540  541  542  543  544  545  546  547  548  549  550  551  552  553  554  555  556  557  558  559  560  561  562  563  564  565  320   67
 254  503  744  745  746  747  748  749  750  751  752  753  754  755  756  757  990  758  759  761  762  763  764  765  766  767  768  769  770  771  772  773  774  775  776  777  778  779  780  781  782  783  784  785  786  787  788  789  790  791  792  793  794  795  796  797  798  799  800  801  802  803  566  321   68
 253  502  743  976  977  978  979  980  981  982  983  984  985  986  987  989 1212  991  760  992  993  994  995  996  997  998  999 1000 1001 1002 1003 1004 1005 1006 1007 1008 1009 1010 1011 1012 1013 1014 1015 1016 1017 1018 1019 1020 1021 1022 1023 1024 1025 1026 1027 1028 1029 1030 1031 1032 1033  804  567  322   69
 252  501  742  975 1200 1201 1202 1203 1204 1420 1205 1207 1423 1208 1209 1426  988 1213 1214 1215 1216 1217 1218 1219 1220 1221 1222 1223 1224 1225 1226 1227 1228 1229 1230 1231 1232 1233 1234 1235 1236 1237 1238 1239 1240 1241 1242 1243 1244 1245 1246 1247 1248 1249 1250 1251 1252 1253 1254 1255 1034  805  568  323   70
 251  500  741  974 1199 1416 1417 1418 1419 1627 1206 1421 1422 1424 1211 1210 1427 1428 1429 1430 1431 1432 1433 1434 1435 1436 1437 1438 1439 1440 1441 1442 1443 1444 1445 1446 1447 1448 1449 1450 1451 1452 1453 1454 1455 1456 1457 1458 1459 1460 1461 1462 1463 1464 1465 1466 1467 1468 1469 1256 1035  806  569  324   71
 250  499  740  973 1198 1415 1624 1625 1626 1827 1828 1829 1425 1831 1632 1633 1634 1635 1636 1637 1638 1639 1640 1641 1642 1643 1644 1645 1646 1647 1648 1649 1650 1651 1652 1653 1654 1655 1656 1657 1658 1659 1660 1661 1662 1663 1664 1665 1666 1667 1668 1669 1670 1671 1672 1673 1674 1675 1470 1257 1036  807  570  325   72
 249  498  739  972 1197 1414 1623 1824 2016 1825 2018 1629 1631 1630 2022 1832 1833 1834 1835 1836 1837 1838 1839 1840 1841 1842 1843 1844 1845 1846 1847 1848 1849 1850 1851 1852 1853 1854 1855 1856 1857 1858 1859 1860 1861 1862 1863 1864 1865 1866 1867 1868 1869 1870 1871 1872 1873 1676 1471 1258 1037  808  571  326   73
 248  497  737  738  971 1621 1413 1622 1823 1826 2376 2019 2020 1830 2547 2380 2023 2025 2026 2027 2028 2029 2030 2031 2032 2033 2034 2035 2036 2037 2038 2039 2040 2041 2042 2043 2044 2045 2046 2047 2048 2049 2050 2051 2052 2053 2054 2055 2056 2057 2058 2059 2060 2061 2062 2063 1874 1677 1472 1259 1038  809  572  327   74
 247  496  736  970 1196 1195 2015 2200 1628 2201 2017 2202 2021 2205 2204 2024 2206 2208 2209 2210 2211 2212 2213 2214 2215 2216 2217 2218 2219 2220 2221 2222 2223 2224 2225 2226 2227 2228 2229 2230 2231 2232 2233 2234 2235 2236 2237 2238 2239 2240 2241 2242 2243 2244 2245 2064 1875 1678 1473 1260 1039  810  573  328   75
 246  495  969 1411 1412 1410 1822 2014 1620 1821 2199 2377 2203 2379 2546 2381 2207 2383 2384 2385 2386 2387 2388 2389 2390 2391 2392 2393 2394 2395 2396 2397 2398 2399 2400 2401 2402 2403 2404 2405 2406 2407 2408 2409 2410 2411 2412 2413 2414 2415 2416 2417 2418 2419 2246 2065 1876 1679 1474 1261 1040  811  574  329   76
 245  494  735  968 1194 1619    0 1820 2013 2198 2375 2543 2378 2545 2548 2382 2549 2550 2551 2552 2553 2554 2555 2556 2557 2558 2559 2560 2561 2562 2563 2564 2565 2566 2567 2568 2569 2570 2571 2572 2573 2574 2575 2576 2577 2578 2579 2580 2581 2582 2583 2584 2585 2420 2247 2066 1877 1680 1475 1262 1041  812  575  330   77
 244  493  966  967 1193 1409 1618 2010 2012 2197 2542 2704 2544 2705 2706 2707 2708 2709 2710 2711 2712 2713 2714 2715 2716 2717 2718 2719 2720 2721 2722 2723 2724 2725 2726 2727 2728 2729 2730 2731 2732 2733 2734 2735 2736 2737 2738 2739 2740 2741 2742 2743 2586 2421 2248 2067 1878 1681 1476 1263 1042  813  576  331   78
 243  733  734  965 1192 1191 1617 1819 1616 1817 2374 2373 2703 2856 2857 2858 2859 2860 2861 2862 2863 2864 2865 2866 2867 2868 2869 2870 2871 2872 2873 2874 2875 2876 2877 2878 2879 2880 2881 2882 2883 2884 2885 2886 2887 2888 2889 2890 2891 2892 2893 2744 2587 2422 2249 2068 1879 1682 1477 1264 1043  814  577  332   79
 241  492  731  732 1190 1408 1818 1407 2196 2011 2195 2541 2702 2855 3000 3001 3002 3003 3004 3005 3006 3007 3008 3009 3010 3011 3012 3013 3014 3015 3016 3017 3018 3019 3020 3021 3022 3023 3024 3025 3026 3027 3028 3029 3030 3031 3032 3033 3034 3035 2894 2745 2588 2423 2250 2069 1880 1683 1478 1265 1044  815  578  333   80
 491  242  490  964 1189 1406 1615 1614 2009 2194 2372 2540 2701 2854 2999 3136 3137 3138 3139 3140 3141 3142 3143 3144 3145 3146 3147 3148 3149 3150 3151 3152 3153 3154 3155 3156 3157 3158 3159 3160 3161 3162 3163 3164 3165 3166 3167 3168 3169 3036 2895 2746 2589 2424 2251 2070 1881 1684 1479 1266 1045  816  579  334   81
 240  489  730  963 1188 1813 1815 1816 2008 2369 2371 2370 2539 2853 2998 3135 3264 3265 3266 3267 3268 3269 3270 3271 3272 3273 3274 3275 3276 3277 3278 3279 3280 3281 3282 3283 3284 3285 3286 3287 3288 3289 3290 3291 3292 3293 3294 3295 3170 3037 2896 2747 2590 2425 2252 2071 1882 1685 1480 1267 1046  817  580  335   82
 239  488  729  962 1187 1405 1404 1814 2007 2193 2192 2538 2700 2852 2997 3134 3263 3384 3385 3386 3387 3388 3389 3390 3391 3392 3393 3394 3395 3396 3397 3398 3399 3400 3401 3402 3403 3404 3405 3406 3407 3408 3409 3410 3411 3412 3414 3413 3171 3038 2897 2748 2591 2426 2253 2072 1883 1686 1481 1268 1047  818  581  336   83
 238  487  728  961 1186 1403 1613 1612 2006 2191 2368 2537 2699 2698 2996 3133 3262 3383 3496 3497 3498 3499 3500 3501 3502 3503 3504 3505 3506 3507 3508 3509 3510 3511 3512 3513 3514 3515 3516 3517 3518 3519 3719 3520 3522 3523 3415 3296 3039 3040 2898 2749 2592 2427 2254 2073 1884 1687 1482 1269 1048  819  582  337   84
 237  486  727  960 1185 1402 1611 1812 2005 2190 2367 2536 2697 2851 2995 3132 3261 3382 3495 3600 3601 3602 3603 3604 3605 3606 3607 3608 3609 3610 3611 3612 3613 3614 3615 3616 3617 3618 3619 3620 3621 3622 3624 3521 3625 3524 3416 3297 3298 3172 2899 2750 2593 2428 2255 2074 1885 1688 1483 1270 1049  820  583  338   85
 236  485  726  959 1184 1401 1610 1811 2004 2189 2366 2535 2849 2850 2994 3131 3260 3381 3494 3599 3696 3697 3698 3699 3700 3701 3702 3703 3704 3705 3706 3707 3708 3709 3710 3711 3712 3713 3714 3715 3717 3804 3623 3720 3626 3525 3417 3175 3173 3041 2900 2751 2594 2429 2256 2075 1886 1689 1484 1271 1050  821  584  339   86
 235  484  725  958 1183 1400 1609 1810 2003 2188 2365 2695 2696 2848 2993 3130 3259 3380 3493 3598 3695 3784 3785 3786 3787 3788 3789 3790 3791 3792 3793 3794 3795 3796 3797 3798 3878 3799 3801 3802 3716 3805 3885 3627 3527 3628 3526 3174 3299 3042 2901 2752 2595 2430 2257 2076 1887 1690 1485 1272 1051  822  585  340   87
 234  483  724  957 1182 1399 1608 1809 2002 2187 2364 2534 2694 2847 2992 3129 3258 3379 3492 3597 3694 3783 3864 3865 3866 3867 3868 3869 3870 3871 3872 3873 3945 3874 3875 3876 3948 3800 3881 3952 3803 3884 3806 3721 3528 3722 3301 3629 3176 3043 2903 2902 2753 2431 2258 2077 1888 1691 1486 1273 1052  823  586  341   88
 233  482  723  956 1181 1398 1607 1808 2001 2186 2363 2533 2693 2846 2991 3128 3257 3378 3491 3596 3693 3782 3863 3936 3937 3938 3939 3940 3941 3942 3943 3944 3946 4009 4010 3877 3949 3950 4068 3879 3882 3954 3883 3807 3718 3303 3178 3300 3177 3044 2904 2754 2596 2597 2432 2078 1889 1692 1487 1274 1053  824  587  342   89
 232  481  722  955 1180 1397 1606 1807 2000 2185 2362 2532 2531 2692 2845 2990 3256 3377 3490 3595 3692 3781 3862 3935 4000 4001 4002 4003 4004 4005 4006 4007 4008 4065 4112 3947 4011 4013 3951 3953 3886 4014 3808 3809 3530 3630 3418 3302 3180 3046 3529 2755 2598 2433 2259 2079 1890 1693 1488 1275 1054  825  588  343   90
 231  480  721  954 1179 1396 1605 1806 1999 2184 2361 2530 2691 2844 2989 3127 3255 3376 3489 3594 3691 3780 3861 3934 3999 4056 4057 4058 4059 4060 4061 4062 4063 4111 4064 4067 4012 4069 3880 3955 3724 4017 3887 3811 3725 3723 3419 3420 3304 3045 2905 2600 2434 2261 2260 2080 1891 1694 1489 1276 1055  826  589  344   91
 230  479  720  953 1178 1395 1604 1805 1998 2183 2360 2529 2690 2843 2988 3126 3122 3125 3488 3593 3690 3779 3860 3933 3998 4055 4104 4105 4106 4107 4108 4109 4110 4150 4066 4113 4114 4116 4115 4015 3956 4070 3888 3632 3422 3631 3179 3307 3305 3047 2906 2599 2756 2435 2262 2081 1892 1695 1490 1277 1056  827  590  345   92
 229  478  719  952 1177 1394 1603 1804 1997 2182 2359 2528 2689 2842 2986 3124 2987 3254 3253 3487 3592 3688 3859 3932 3997 4054 4103 4144 4145 4146 4147 4148 4149 4205 4151 4152 3957 4071 4118 4016 4018 3810 3813 3812 3727 3423 3532 3421 3048 2907 2758 2757 2601 2436 2263 2082 1893 1696 1491 1278 1057  828  591  346   93
 228  718  717  951 1176 1393 1602 1803 1996 2181 2358 2526 2527 2841 3121 3371 3375 3252 3374 3591 3687 3689 3777 3931 4053 4052 4102 4143 4176 4177 4178 4179 4181 4182 4185 4183 4153 4154 4117 4073 3958 3889 3890 3534 3533 3531 3306 3182 3181 3183 2908 2759 2602 2266 2437 2083 1894 1697 1492 1279 1058  829  592  347   94
 227  477  950 1175  949 1391 1392 1601 1802 2180 2357 2688 2839 2686 2985 3373 3123 3250 3486 3590 3858 3778 3930 3995 4051 3994 4101 4142 4175 4200 4201 4202 4180 4203 4204 4184 4155 4074 4019 4072 4021 3726 3891 3729 3634 3633 3424 3308 3050 3049 2760 2603 2439 2265 2264 2084 1895 1698 1493 1280 1059  830  593  348   95
 226  476  716  948 1174 1390 1600 1801 1995 2179 2356 2525 2685 2687 2840 3251 3249 3370 3372 3589 3776 3775 3855 3857 3856 3996 4100 4141 4174 4199 4216 4217 4218 4206 4156 4157 4120 4020 3815 3960 3730 3959 3814 3635 3728 3636 3425 3309 3184 3051 2909 2910 2763 2267 2438 2086 1896 1897 1494 1281 1060  831  594  349   96
 225  475  474  715  947 1599 1598 1800 1994 2353 1993 2355 2684 2983 2984 3248 3369 3481 3485 3685 3686 3588 3774 3929 3993 4050 4099 4140 4172 4173 4198 4215 4220 4219 4186 4187 4075 4119 4022 3961 3731 3963 3892 3893 3426 3535 3427 3310 3185 2911 2762 2761 2440 2085 2268 1700 1898 1702 1495 1283 1061  832  595  350   97
 224  473  714 1172 1173 1389 1799 1991 2175 2177 2354 2524 2837 2838 2982 3120 3119 3482 3587 3484 3483 3854 3927 3928 3992 4049 4138 4136 4139 4197 4214 4224 4223 4222 4221 4207 4158 4159 4121 4023 4077 3964 3816 3732 3537 3428 3536 3311 3186 3052 3053 2764 2604 2605 1701 2269 1899 1497 1282  834 1284 1063  596  351   98
 223  472  713  946 1171 1388 1798 1992 2523 1989 2682 2681 2683 2836 2981 3118 3368 3247 3683 3586 3771 3684 3852 3991 3990 4048 4098 4096 4196 4195 4193 4213 4211 4210 4208 4209 4122 4076 4025 4024 4124 3894 3733 3817 3637 3640 3429 3312 3187 3055 3054 2607 2606 2441 2608 2442 1498 2087 1062 1496  833  597  598  352   99
 222  471  712  945 1170 1387 1597 1797 2178 2350 2176 2351 2522 2835 2980 3117 3246 3367 3480 3682 3770 3853 3773 4095 4047 4137 3925 4094 4171 4097 4194 4212 4192 4032 4190 4160 4079 4126 4078 4123 3896 3962 3818 3638 3431 3639 3539 3188 3189 3056 2913 2915 2914 2271 2765 2089 1900 1704 2088 1703 1064  837  836  353  100
 221  470  711  944 1169 1386 1596 1595 1796 2174 2521 2352 2520 2834 2978 2979 3116 3585 3584 3366 3849 3772 3850 3926 4042 3987 4045 4170 4135 4167 4132 4166 4130 4191 4125 4189 4128 4127 3974 4026 3966 3895 3819 3644 3538 3735 3542 3313 3057 2916 2917 2609 2912 2444 2270 2092 2443 1705 1902 1285 1501 1699  599  354  101
 220  469  710  943 1168 1385 1594 1795 1990 1988 2349 2680 2679 2833 3115 3114 3245 3478 3769 3583 3678 3479 3768 3851 3923 3984 4046 4044 4168 4093 4089 4131 4164 4165 4162 4033 4030 4080 3899 3965 4028 3897 3736 3432 3433 3734 3314 3540 3191 2766 2769 2272 2767 2274 2273 2090 2091 1499 1901  835 1286 1067  601  355  102
 219  468  709  942 1167 1384 1593 1794 1987 2173 2172 2518 2678 2831 2832 3113 3244 3364 3681 3365 3680 3679 3922 3924 3986 3920 4090 4092 4169 4038 4133 4088 4087 4035 4129 4083 4161 3971 4188 4027 3967 3898 3541 3317 3543 3648 3641 3642 3058 2768 2614 3059 2611 2610 2446 1903 1707 1502 1706 1500  600 1066  603  838  103
 218  467  708  941 1166 1383 1592 1793 1986 2171 2348 2519 2517 2677 2977 3112 3242 3243 3477 3677 3582 3767 3988 3848 3921 4040 3989 4041 4134 4039 3912 4036 3977 4085 4086 4084 4081 3968 3970 3828 3823 3820 3900 3821 3430 3434 3435 3315 3063 3192 2918 2448 2612 2445 2094 2093 1904 1708 1065 1068 1287 1288  839  356  106
 217  466  707  940 1165 1382 1591 1792 1985 2170 2347 2516 2676 2976 2974 3241 3239 3363 3476 3475 3581 3766 3847 3843 3918 3985 3913 3983 4091 3981 3978 4037 3976 3975 4163 4034 4082 3972 3822 3905 3651 3737 3903 3649 3646 3316 3545 3190 3319 2922 2920 2919 2772 2449 2771 2095 1905 1290  602 1291  105  840  604  104  108
 216  465  706  939 1164 1381 1590 1791 1984 2169 2346 2514 2830 2829 2972 3110 2975 3362 3580 3579 3676 3764 3765 3919 3916 3759 4043 3982 3914 3979 3980 3911 3909 3833 3831 3907 3973 3747 3830 4029 3969 3824 3739 3647 3645 3643 3544 3318 3194 3195 2451 2770 2450 2613 2276 2096 1906 1709 1503 1069 1289  359  357  362  605
 215  464  705  938 1163 1380 1589 1790 1983 2344 2345 2675 2515 2828 2973 3240 3111 3361 3238 3473 3578 3762 3845 3844 3917 3842 3841 3915 3840 3839 3838 3837 3910 3659 3908 3750 4031 3748 3745 3827 3902 3742 3826 3738 3547 3438 3436 3320 3193 2275 2923 3061 2615 2447 2277 2097 1907 1710 1292 1073 1070  110  358  608  843
 214  463  704  937 1162 1379 1588 1789 1982 2168 2167 2513 2674 2827 3109 3108 3360 3474 3359 3674 3675 3846 3763 3761 3760 3758 3669 3757 3665 3756 3754 3836 3661 3834 3751 3906 3832 3452 3746 3904 3901 3654 3650 3741 3740 3548 3546 3321 3060 3437 3197 2618 2616 2775 2278 1909 1293 1504 1506 1071 1505 1294  363  842  361
 213  462  703  936 1161 1378 1587 1788 1981 2166 2343 2512 2673 2826 2971 3107 3358 3237 3472 3471 3672 3574 3671 3670 3570 3666 3667 3567 3755 3564 3664 3662 3835 3753 3660 3749 3658 3560 3655 3744 3829 3743 3653 3552 3825 3550 3551 3064 3196 3198 2617 3065 2921 2279 2099 2280 1908 1910 1711 1507 1072  845  360  841  107
 212  461  702  935 1160 1377 1586 1787 1980 2165 2342 2511 2672 2825 2969 2970 3236 3357 3470 3577 3575 3673 3573 3572 3571 3668 3568 3565 3458 3457 3663 3563 3752 3561 3559 3557 3656 3657 3449 3556 3446 3652 3553 3549 3442 3440 3322 3323 3062 2619 2773 2924 2454 2455 2452 2098 1911 1508 1295 1075 1074  846  109  365  364
 211  460  701  934 1159 1376 1585 1786 1979 2164 2341 2510 2671 2824 3106 3235 3356 3469 3468 3576 3467 3466 3465 3464 3463 3569 3566 3460 3459 3343 3341 3342 3562 3339 3454 3453 3451 3558 3450 3555 3554 3445 3330 3444 3443 3441 3439 3201 2925 3200 3067 2774 2926 2453 2281 2100 1715 1912 1296 1712 1716  847  607  612  844
 210  459  700  933 1158 1375 1584 1785 1978 2163 2340 2509 2670 2823 2968 3105 3234 3355 3354 3353 3352 3351 3350 3349 3348 3462 3461 3345 3344 3220 3456 3218 3455 3340 3338 3337 3336 3335 3334 3447 3448 3332 3331 3329 3328 3327 3326 3199 3066 3324 2927 2776 2620 2777 2282 2101 1714 1297 1510 1509 1076  848  606  609  111
 209  458  699  932 1157 1374 1583 1784 1977 2162 2339 2508 2669 2822 2967 3104 3233 3232 3231 3230 3229 3228 3227 3226 3224 3223 3346 3222 3090 3221 3088 3219 3217 3216 3215 3214 3213 3212 2940 3333 3210 3208 3207 3206 3205 3204 3203 3070 3202 3068 2928 2778 2621 2456 2283 2102 1511 1713 1512 1077  611  849  366  112  610
 208  457  698  931 1156 1373 1582 1783 1976 2161 2338 2507 2668 2821 2966 3103 3102 3101 3100 3099 3098 3097 3096 3094 3093 3347 2953 3092 3091 3089 2949 3087 3086 3084 2797 3083 2943 3081 3211 2939 3209 3078 3077 3076 3075 3074 3073 3325 3071 3069 2929 2779 2622 2457 2284 1914 1913 1718 1300 1298 1299 1079  367  613  113
 207  456  697  930 1155 1372 1581 1782 1975 2337 2506 2667 2336 2820 2965 2964 2963 2815 2962 2960 2959 2958 2956 3095 3225 2955 2954 2952 2951 2950 2802 2948 2946 3085 2944 2796 2639 2942 3080 2941 2792 2938 2937 2936 2935 2934 2932 3072 2931 2930 2780 2463 2458 2459 2285 2103 2104 1916 1513 1514 1717 1080  852  368  114
 206  455  696  929 1154 1371 1580 1781 2159 2160 2665 2666 2819 2501 2818 2817 2816 2961 2814 2813 2812 2811 2957 2809 2808 2807 2806 2805 2804 2803 2647 2801 2799 2798 2640 2945 2644 2479 2794 2638 2791 2790 2635 2789 2788 2787 2933 2785 2784 2783 2782 2623 2460 2624 2286 2105 1719 1915 1301 1302  369 1078  117  614  115
 205  454  695 1153 1370 1369 1579 1973 1974 2158 2335 2505 2664 2663 2500 2662 2661 2660 2659 2495 2658 2655 2810 2654 2653 2652 2651 2650 2649 2648 2484 2646 2483 2947 2645 3082 2641 2642 2476 2637 2636 2472 2474 2634 2633 2632 2786 2630 2629 2628 2627 2626 2287 2462 2106 2107 1917 1515 1516 1517 1083  850  118  371  116
 204  453  694  928 1152 1578 1780 1779 2157 2156 2334 2504 2503 2330 2328 2499 2498 2497 2496 2657 2493 2656 2492 2491 2490 2489 2488 2487 2485 2315 2313 2312 2800 2643 2309 2306 2308 2795 2305 2475 2303 2793 3079 2473 2471 2299 2631 2468 2467 2465 2464 2292 2625 2781 2461 1919 1721 1720 1518 1303 1082  853  851  615  370
 203  452  691  927 1149 1151 1368 1971 1972 2155 2333 2332 2502 2331 2150 2149 2327 2326 2325 2323 2494 2322 2321 2320 2319 2318 2317 2316 2486 2134 2135 2311 2482 2481 2480 1941 2478 2307 1939 2304 2124 2301 2302 2470 2120 2469 2297 2294 2466 2295 2115 2293 2113 2289 2288 1918 2108 1519 1304  617 1081  616  854  119  373
 451  692  926 1150  693 1367 1576 1778 1777 1968 2154 2153 2152 1965 2151 2329 2148 2147 2146 2324 2145 2144 2142 2141 2140 2139 2138 2137 2136 2314 2133 1946 2131 2310 2130 1748 1943 2127 1938 1742 2125 2123 2122 2300 2121 2298 2118 2296 2116 1927 2114 2112 2291 1924 2290 2109 1920 1722 1723 1305 1084  618  372  620  120
 202  450  690  925 1148 1575 1577 1776 1970 1966 1773 1357 1568 1770 1964 1962 1961 1960 1959 1958 1957 2143 1956 1955 1953 1952 1951 1950 1949 1948 1947 1945 2132 1547 1940 1747 1543 1746 2126 2128 1936 1935 1934 1738 1737 1933 1932 1931 2117 1928 1732 1926 2111 1925 2110 1922 1921 1725 1724 1306  855  619  375  857  374
 201  449  199  924 1365 1366 1574 1775 1969 1772 1967 1358 1771 1769 1963 1768 1767 1765 1764 1763 1762 1761 1760 1954 1759 1757 1554 1755 1754 1753 1752 1751 1944 1545 2129 1544 1333 2477 1743 1540 1538 1937 1740 1535 2119 1533 1736 1320 1929 1530 1733 1730 1923 1728 1729 1727 1726 1520 1307 1085  856 1308  621  122  121
 200  447  689  923 1147 1364 1362 1361 1573 1572 1360 1571 1567 1565 1564 1353 1766 1562 1561 1560 1559 1558 1557 1556 1758 1756 1344 1553 1552 1551 1548 1546 1750 1749 1334 1942 1113 1745 1744 1541 1539 1741 1739 1536 1534 1323 1532 1734 1930 1531 1731 1529 1317 1527 1315 1525 1523 1522 1521 1309  858  859  623  377  376
 920  445  688  448  921 1146 1363 1570 1141 1359 1774 1569 1355 1566 1354 1352 1563 1351 1350 1349 1348 1347 1346 1345 1343 1555 1342  661 1340 1549 1550 1337 1336 1116 1332 1331 1542 1111 1330 1329 1327 1326 1537 1325 1324 1104 1322 1735 1321 1319 1318 1098 1528 1526 1314 1524 1313 1311 1310  622 1087 1086  861  378  123
 198  446  687  922 1145 1144 1143 1142 1140 1139 1138  911 1356 1137 1136 1135 1134 1132 1131 1130 1129 1128 1127 1126 1125 1124 1341  893 1122 1121 1118  891 1335 1117 1115  888 1114 1112 1110 1328 1109 1108 1107 1106 1105  877 1103 1102 1101 1100  872 1099  869 1316 1096 1093 1312 1092  865 1090  625  624  384 1089  126
 197  444  686  919  918  917  916  915  914  913  912  910  674  909  908  907 1133  906  905  903  902  901  900  899  898  896  894 1123 1120 1338  892 1119  890  889  887  654  886  885  884  883  882  645  880  879  643  878  876  875  874  873  637  871 1097  870 1094  867  631  629  866  860  864  125  127 1088  124
 196  195  685  684  683  682  681  680  679  678  677  676  432  673  430  428  429  671  904  669  668  667  422  423  421  897  660  659  657 1339  415  656  411  655  412  652  651  650  649  648  647  881  646  644  400  642  641  640  639  638  392  141  634  868 1095  633  632  630 1091  627  863  130  383  382  862
 194  443  442  441  440  439  438  437  436  435  434  433  675  180  431  672  177  670  425  172  666  173  665  169  663  168  167  416  895  417  165  414  413  653  159  410  409  157  406  405  153  404  403  402  401  148  398  397  396  395  394  635  142  391  390  389  388  137  387  386  129  131  628  381  379
 193  192  191  190  189  188  187  186  185  184  183  182  181  179  178  426  427  176  174  175  424  171  170  419  420  664  418  662  166  164  658  163  161  162  160  158  407  408  156  155  154  152  151  150  399  149  147  146  145  144  143  636  393  140  139  138  136  135  134  133  132  626  385  128  380
