# This puzzle is unsolvable
67
   2    1  266    4    5    6    7    8    9  273   10   11   13   14   15   16   17   18   20  284  283   22   23   24   25   26   27   28   29   30   31   32   33   34   35   36   38  301   39   41  304   42   43   44   45   46   47   48   49   50   51   52   53   54   55   56   57   58   59   60   61   62   63   64   65   66   67
 264  265  267    3  268  270  526  271  272   12  274  777  778  278  279 1020  280   19  281  282  538  539  286  287  288  289  290  291  292  293  295  550  296  552  298  299   37  302  557  303   40  305  306  307  308  309  310  311  312  313  314  315  316  317  318  319  320  321  322  323  324  325  326  327  328  329   68
 263  520  521  522  523  269  772  524  525  528  530  532  275  276  277  782  534  537  785  784   21  541  788  542  543  544  545  546  547  549  796  294  297  798  553  554  300  556  558  559  560  807  561  562  563  564  565  566  567  568  569  570  571  572  573  574  575  576  577  578  579  580  581  582  583  330   69
 262  519  768  769  770  771 1011  773  775  776 1016  531  780  781 1019  533  783  535  536  285  540  786  787  789  790  791  793 1031  795  548 1266  797  799  800  801  802  555  803  804 1276  805  806 1046  809  810  811  812  813  814  815  816  817  818  819  820  821  822  823  824  825  826  827  828  829  584  331   70
 261  518  767 1008 1009 1010 1012 1013  527 1014  529 1246  779 1472 1248 1896 1021 1023 1254 1024 1025 1026 1027 1028 1029 1030  792 1034  794 1264 1035 1036  551 1038 1039 1040 1041 1273 1042 1274 1043 1278 1045 1048 1049 1050 1051 1052 1053 1054 1055 1056 1057 1058 1059 1060 1061 1062 1063 1064 1065 1066 1067  830  585  332   71
 260  517  766 1007 1240 1241 1242  774 1243 1244 1015 1245 1470 1017 1474 1250 1252 1251 1022 1477 1256 1257 1695 1259 1260 1261 1485 1032 1263 1033 1489 1267 1037 1268 1493 1270 1272 1496 1044 1277 1275  808 1501 1047 1279 1504 1282 1283 1284 1285 1286 1287 1288 1289 1290 1291 1292 1293 1294 1295 1296 1297 1068  831  586  333   72
 259  516  765 1006 1239 1464 1465 1466 1467 1468 1469 1247 1471 1249 1018 1689 1253 1476 1478 1479 1480 1258 1694 1481 1699 1483 1484 1262 1701 1487 1704 1490 1491 1269 1708 1271 1709 1495 1497 1713 1499 1502 1500 1503 1718 1280 1505 1506 1507 1508 1509 1510 1511 1512 1513 1514 1515 1516 1517 1518 1519 1298 1069  832  587  334   73
 258  515  764 1005 1238 1463 1680 1681 1682 1684 1685 1891 1686 1687 1473 1475 1691 1692 1255 1693 1696 1903 1697 2102 1698 1906 1700 2483 1486 1265 1488 1705 1706 1492 1707 1710 1494 1711 1712 1714 1498 1715 1716 1717 1719 1281 1720 1721 1722 1723 1724 1725 1726 1727 1728 1729 1730 1731 1732 1733 1520 1299 1070  833  588  335   74
 257  514  763 1004 1237 1462 1679 1888 1889 1683 1890 1892 1688 2092 1893 1897 1690 1898 1899 1900 1901 1902 1904 1482 1905 1907 2108 2107 1703 1702 1910 1912 1913 1914 1915 1916 1917 1918 1919 1920 1921 1922 1923 1924 1925 1926 1927 1928 1929 1930 1931 1932 1933 1934 1935 1936 1937 1938 1939 1734 1521 1300 1071  834  589  336   75
 256  513  762 1003 1236 1461 1678 1887 2088 2089 2090 2091 1894 2094 1895 2095 2096 2097 2472 2098 2100 2292 2101 2477 2105 2479 2297 1908 2109 1909 1911 2111 2112 2113 2114 2115 2116 2117 2118 2119 2120 2121 2122 2123 2124 2125 2126 2127 2128 2129 2130 2131 2132 2133 2134 2135 2136 2137 1940 1735 1522 1301 1072  835  590  337   76
 255  512  761 1002 1235 1460 1677 1886 2087 2280 2464 2281 2283 2093 2284 2469 2645 2286 2290 2288 2289 2293 2476 2295 2294 2103 2298 2656 2299 2300 2301 2302 2303 2304 2305 2306 2307 2308 2309 2310 2311 2312 2313 2314 2315 2316 2317 2318 2319 2320 2321 2322 2323 2324 2325 2326 2327 2138 1941 1736 1523 1302 1073  836  591  338   77
 254  511  760 1001 1234 1459 1676 1885 2086 2279 2282 2640 2465 2468 2467 2470 2287 2647 2646 2099 2651 2291 2473 2478 2104 2654 2106 2296 2480 2983 2110 2485 2486 2487 2488 2489 2490 2491 2492 2493 2494 2495 2496 2497 2498 2499 2500 2501 2502 2503 2504 2505 2506 2507 2508 2509 2328 2139 1942 1737 1524 1303 1074  837  592  339   78
 253  510  759 1000 1233 1458 1675 1884 2085 2278 2463 2466 2808 2285 2811 2643 2812 2644 2471 2648 2815 2474    0 2817 2652 2653 2482 2823 2655 2484 2481 2659 2826 2662 2663 2664 2665 2666 2834 2667 2836 2669 2670 2671 2672 2673 2675 2676 2677 2678 2679 2680 2681 2682 2683 2510 2329 2140 1943 1738 1525 1304 1075  838  593  340   79
 252  509  758  999 1232 1457 1674 1883 2084 2277 2462 2639 2642 2641 2809 2810 2813 2972 2814 2816 2649 2650 2475 2820 2978 2821 2822 2824 2658 2657 2825 2827 2661 2829 2830 2831 2832 2992 2833 2668 2995 2837 2838 2839 2840 2674 2842 2843 2844 2845 2846 2847 2848 2849 2684 2511 2330 2141 1944 1739 1526 1305 1076  839  594  341   80
 251  508  757  998 1231 1456 1673 1882 2083 2276 2460 2461 2806 2807 2968 2969 2970 2971 2973 2974 3127 2976 3129 3130 2977 2980 3132 2981 2982 2984 3135 2660 2828 2988 2989 3141 2990 2991 2993 2835 2994 2996 2997 2998 2999 2841 3001 3002 3003 3004 3005 3006 3007 2850 2685 2512 2331 2142 1945 1740 1527 1306 1077  840  595  342   81
 250  507  756  997 1230 1455 1672 1881 2082 2275 2638 2636 2637 2967 3120 3121 3122 3401 3123 3125 2975 3269 3270 2819 2979 3131 3275 3134 3277 3278 2985 3414 2987 2986 3138 3284 3142 3143 3144 3145 3146 3147 3148 3149 3150 3000 3152 3153 3154 3155 3156 3157 3008 2851 2686 2513 2332 2143 1946 1741 1528 1307 1078  841  596  343   82
 249  506  755  996 1229 1454 1671 1880 2081 2274 2459 2805 2804 2966 3119 3264 3265 3124 3267 3266 3126 3405 3271 2818 3272 3273 3274 3133 3539 3412 3658 3136 3281 3283 3140 3419 3285 3286 3287 3288 3289 3290 3291 3292 3293 3151 3295 3296 3297 3298 3299 3158 3009 2852 2687 2514 2333 2144 1947 1742 1529 1308 1079  842  597  344   83
 248  505  754  995 1228 1453 1670 1879 2080 2273 2458 2965 2634 2964 3118 3263 3528 3529 3403 3400 3268 3404 3128 3407 3408 3409 3276 3411 3657 3540 3279 3137 3416 3139 3417 3546 3420 3421 3422 3423 3424 3425 3426 3427 3428 3294 3429 3431 3432 3433 3300 3159 3010 2853 2688 2515 2334 2145 1948 1743 1530 1309 1080  843  598  345   84
 247  504  753  994 1227 1452 1669 1878 2079 2272 2457 2631 2635 2802 3262 3399 3402 3527 3648 3530 3531 3532 3406 3534 3535 3410 3537 3659 3413 3538 3280 3544 3664 3282 3418 3545 3547 3548 3549 3550 3551 3552 3554 3555 3674 3556 3430 3558 3559 3434 3301 3160 3011 2854 2689 2516 2335 2146 1949 1744 1531 1310 1081  844  599  346   85
 246  503  752  993 1226 1451 1668 1877 2078 2271 2456 2633 2963 2803 3117 3261 3396 3398 3647 3649 3650 3651 3533 3652 3654 3536 3655 3871 3771 3773 3660 3541 3415 3662 3663 3665 3666 3667 3668 3669 3670 3672 3553 3673 3675 3676 3557 3677 3560 3435 3302 3161 3012 2855 2690 2517 2336 2147 1950 1745 1532 1311 1082  845  600  347   86
 245  502  751  992 1225 1450 1667 1876 2077 2269 2270 2455 2632 3116 3397 3259 3260 3526 3759 3760 3761 3762 3763 3653 3765 3766 3656 3767 4053 3770 3542 3543 3661 3877 3775 3776 3777 3778 3779 3780 3782 3671 3783 3784 3785 3786 3787 3678 3561 3436 3303 3162 3013 2856 2691 2518 2337 2148 1951 1746 1533 1312 1083  846  601  348   87
 244  501  750  991 1224 1449 1666 1875 2076 2454 2630 2962 3115 2961 2960 2959 3524 3646 3645 3758 3864 3865 3867 3764 3868 3870 4054 3872 3768 3772 3769 3969 3774 3875 3973 3879 3880 3881 3883 3884 3781 3885 3886 3887 3888 3889 3788 3679 3562 3437 3304 3163 3014 2857 2692 2519 2338 2149 1952 1747 1534 1313 1084  847  602  349   88
 243  500  749  990 1223 1448 1665 1874 2075 2268 2453 2629 2801 2799 3394 3113 3525 3395 3863 3756 3862 3960 3866 3962 3963 4051 3869 3966 3967 4056 3874 3971 3876 4058 3972 3974 3975 3976 3882 3977 4066 3979 3980 4069 3983 3890 3789 3680 3563 3438 3305 3164 3015 2858 2693 2520 2339 2150 1953 1748 1535 1314 1085  848  603  350   89
 242  499  748  989 1222 1664 1446 1873 2074 2451 2452 2628 2800 3112 3257 3256 3114 3393 3644 3755 3757 3959 3961 4049 4050 3965 4052 3873 4055 4134 4057 3970 4059 3878 4060 4061 4062 4063 4064 3978 4065 4147 4068 3982 4070 3891 3790 3681 3564 3439 3306 3165 3016 2859 2694 2521 2340 2151 1954 1749 1536 1315 1086  849  604  351   90
 241  498  747  988 1221 1447 1872 2073 2266 2267 2450 2627 2798 2956 2957 3258 3111 3523 3643 3859 3861 3958 4048 4128 4129 3964 4130 4131 4132 4133 3968 4136 4137 4138 4139 4140 4141 4142 4143 4144 4145 3981 4067 3985 4071 3984 3791 3682 3565 3440 3307 3166 3017 2860 2695 2522 2341 2152 1955 1750 1537 1316 1087  850  605  352   91
 240  497  746  987 1220 1662 1663 1871 2072 2625 2265 2448 2797 2958 3255 3392 3254 3522 3641 3754 3957 4046 4127 4047 4200 4201 4202 4203 4204 4205 4135 4206 4208 4209 4210 4211 4212 4213 4214 4215 4218 4149 4217 3986 3987 3892 3792 3683 3566 3441 3308 3167 3018 2861 2696 2523 2342 2153 1956 1751 1538 1317 1088  851  606  353   92
 239  496  745  986 1219 1445 1661 1870 2449 2264 2447 2795 2796 3252 3110 3109 3391 3521 3753 3860 3642 3956 4045 4126 4264 4263 4265 4266 4268 4269 4270 4207 4271 4272 4273 4274 4275 4276 4278 4279 4146 4216 4219 4072 3894 3893 3793 3684 3567 3442 3309 3168 3019 2862 2697 2524 2343 2154 1957 1752 1539 1318 1089  852  607  354   93
 238  495  744  985 1218 1444 1443 1659 2071 2069 2262 2626 2955 3253 3250 3390 3520 3639 3517 3518 3752 3955 4044 4198 4043 4199 4320 4321 4267 4323 4324 4325 4326 4327 4328 4329 4330 4332 4277 4333 4280 4074 4150 4152 4148 3895 3794 3685 3568 3443 3310 3169 3020 2863 2698 2525 2344 2155 1958 1753 1540 1319 1090  853  608  355   94
 237  494  743  984 1217 1441 1442 1868 2263 2070 2446 2624 2794 3108 3107 3251 3519 3640 3636 3751 3858 3857 3954 4125 4197 4262 4319 4368 4322 4370 4371 4372 4373 4374 4375 4376 4377 4331 4379 4334 4281 4221 3988 4073 3990 3896 3795 3686 3569 3444 3311 3170 3021 2864 2699 2526 2345 2156 1959 1754 1541 1320 1091  854  609  356   95
 236  493  742  983 1216 1658 1867 1660 2068 2261 2445 2793 2623 2954 3106 3388 3387 3389 3749 3638 3856 3953 4042 4124 4318 4123 4196 4317 4369 4409 4410 4411 4412 4413 4414 4415 4417 4378 4380 4335 4282 4222 4220 4151 4075 3897 3796 3687 3570 3445 3312 3171 3022 2865 2700 2527 2346 2157 1960 1755 1542 1321 1092  855  610  357   96
 235  492  741  982 1215 1440 1657 1869 2067 2260 2444 2622 2792 2953 2951 3249 3105 3386 3750 3748 3855 3952 4041 4194 4261 4366 4367 4365 4408 4407 4441 4442 4443 4444 4445 4446 4416 4418 4381 4337 4336 4283 3989 4076 3991 3898 3797 3688 3571 3446 3313 3172 3023 2866 2701 2528 2347 2158 1961 1756 1543 1322 1093  856  611  358   97
 234  491  740  981 1214 1439 1656 1866 1865 2065 2259 2621 2791 2790 2952 3103 3514 3515 3854 3853 3951 4040 4121 4120 4122 4260 4316 4406 4439 4440 4464 4465 4466 4467 4468 4469 4447 4419 4382 4338 4284 4154 4153 4077 3992 3899 3798 3689 3572 3447 3314 3173 3024 2867 2702 2529 2348 2159 1962 1757 1544 1323 1094  857  612  359   98
 233  490  739  980 1213 1438 1655 1864 2258 2066 2257 2620 2789 3104 3102 2950 3516 3385 3637 3950 3747 3949 4038 4258 4195 4314 4259 4364 4405 4438 4463 4480 4481 4482 4483 4470 4448 4449 4420 4285 4224 4223 4155 4078 3993 3900 3799 3690 3573 3448 3315 3174 3026 3025 2868 2531 2349 2160 1963 1758 1545 1324 1095  858  613  360   99
 232  489  738  979 1212 1437 1654 1863 2064 2442 2443 2619 2788 2948 2949 3248 3246 3247 3635 3634 3852 4119 4117 3948 4039 4193 4315 4363 4404 4437 4462 4479 4488 4486 4484 4471 4450 4421 4383 4339 4286 4225 4156 4079 3994 3901 3800 3691 3574 3449 3316 3027 3175 2869 2530 2703 2350 2161 1964 1759 1546 1325 1096  859  614  361  100
 231  488  737  978 1211 1436 1653 1862 2063 2256 2441 2617 2618 2947 3100 3101 3383 3384 3513 3633 3851 3947 4036 4037 4118 4312 4256 4313 4435 4434 4436 4461 4478 4475 4485 4472 4451 4422 4384 4385 4287 4226 4157 4081 4080 3902 3801 3692 3450 3317 3176 2870 3028 2706 2534 2532 2351 1965 1760 1547 1326 1097 1328  860  615  362  101
 230  487  736  977 1210 1435 1652 1861 2062 2255 2439 2440 2787 2946 3245 3382 3512 3632 3511 3746 3745 3850 4035 4116 4257 4253 4255 4361 4403 4460 4477 4458 4487 4455 4473 4452 4423 4386 4341 4340 4288 4227 4158 4082 3995 3903 3802 3693 3575 3451 3318 3177 3029 2704 2533 2871 2352 2162 1966 1761 1548 1327  861  616  617  363  102
 229  486  735  976 1209 1434 1651 1860 2061 2253 2254 2616 2786 2785 3099 3244 3510 3509 3631 3744 3849 3946 4034 4191 4362 4252 4360 4254 4311 4402 4401 4459 4476 4456 4474 4429 4453 4424 4387 4342 4289 4228 4160 4159 3996 3803 3905 3694 3576 3577 3452 3178 2872 2705 2707 2353 2354 2163 1967 1762 1549 1329 1098  863  862  364  103
 228  485  734  975 1208 1433 1649 1650 2060 2252 2438 2615 2784 2945 3098 3381 3243 3380 3630 3743 3848 3945 4188 4115 4192 4310 4187 4359 4400 4433 4432 4431 4351 4395 4428 4454 4426 4425 4388 4343 4290 4229 4083 4084 3997 3998 3904 3804 3578 3453 3319 3321 3030 2873 2708 2535 2165 2164 1968 1763 1550 1330 1099  864  618  365  104
 227  484  733  974 1207 1431 1432 1859 1858 2059 2437 2614 2783 2944 3097 3242 3379 3508 3629 3742 3847 3944 4033 4114 4189 4190 4358 4357 4399 4398 4397 4353 4352 4457 4394 4427 4350 4348 4389 4344 4291 4231 4230 3999 4085 3805 3696 3695 3454 3179 3320 3031 2874 2875 2709 2537 2536 2166 1969 1764 1551 1101 1100  865  619  366  105
 226  483  732  973 1205 1206 1648 1857 2058 2251 2436 2613 2782 2943 3096 3241 3378 3507 3628 3741 3846 3943 4032 4113 4186 4309 4251 4308 4356 4355 4354 4392 4396 4349 4300 4391 4393 4390 4347 4346 4345 4292 4161 4162 3906 4000 3807 3806 3579 3322 3323 3181 3032 2877 2710 2711 2355 2356 1970 1765 1552 1331 1102  866  620  367  106
 225  482  731 1430  971 1429 1647 1856 2057 2250 2435 2612 2781 2942 3095 3240 3377 3506 3627 3740 3845 3942 4031 4112 4185 4250 4307 4306 4305 4303 4245 4302 4301 4430 4299 4298 4297 4296 4295 4294 4293 4232 4163 4086 4001 3907 3908 3699 3455 3456 3182 3180 3033 3034 2876 2538 2168 2167 1971 1766 1553 1332 1104 1103  621  368  107
 223  224  481  730  972 1204 1646 1855 2056 2249 2434 2611 2780 2941 3094 3239 3376 3505 3626 3739 3844 3941 4030 4111 4184 4249 4248 4247 4246 4304 4177 4244 4242 4241 4240 4239 4238 4237 4236 4235 4234 4233 4164 4087 4002 3909 3808 3697 3580 3458 3324 3457 3184 3183 2712 2539 2357 2358 1972 1767 1554 1555 1333  867  622  369  108
 222  480  729  970 1203 1428 1645 1854 2055 2248 2433 2610 2779 2940 3093 3238 3375 3504 3625 3738 3843 3940 4029 4110 4183 4182 4181 4180 4179 4178 4243 4101 4176 4174 4172 4097 4171 4170 4169 4168 4167 4166 4165 4088 3910 3912 3700 3809 3582 3698 3581 3325 3035 2878 2540 2361 2359 2169 1973 1768 1556 1334 1105  624  868  370  109
 221  479  728  969 1202 1427 1644 1853 2054 2247 2432 2609 2778 2939 3092 3237 3374 3503 3624 3737 3842 3939 4028 4109 4108 4107 4106 4105 4104 4103 4102 4175 4099 4098 4015 4173 4096 4095 4010 4094 4092 4091 4090 4089 4003 4004 3810 3701 3583 3584 3326 3185 3036 2879 2713 2715 2360 2170 1975 1770  871 1335 1769 1106  623  371  110
 220  478  727  967  968 1201 1426 1852 2053 2246 2431 2608 2777 2938 3091 3236 3373 3502 3623 3736 3841 3938 4027 4026 4025 4024 4023 4022 4021 4020 3928 4017 4100 4016 3924 4014 4013 4012 4093 3920 4009 3917 4007 4006 3913 3911 3811 3702 3585 3459 3460 3186 3328 2880 2714 2541 2542 2171 1976 1557 1974 1336 1109  869  625  112  372
 219  477  726 1199 1200 1642 1643 1851 2052 2245 2430 2607 2776 2937 3090 3235 3372 3501 3622 3735 3840 3937 3936 3935 3934 3933 3932 3931 3930 3830 4018 3929 4019 3926 3925 3923 3922 3921 4011 3820 4008 3919 3916 3816 4005 3914 3812 3703 3586 3461 3327 3038 3037 2881 2716 2543 2173 2172 1979 1977 1771 1108  627 1107  870  373  111
 476  725  724  966 1424 1425 1641 1850 2051 2244 2429 2606 2775 2936 3089 3234 3371 3500 3621 3734 3839 3838 3837 3836 3835 3834 3833 3832 3831 3724 3723 3927 3829 3826 3825 3824 3823 3822 3714 3821 3918 3819 3817 3815 3915 3814 3813 3704 3587 3462 3329 3189 3188 3039 2882 2544 2362 2363 2174 1978 1558 1560 1337  628  626  374  113
 218  475  965  964 1198 1423 1640 1849 2050 2243 2428 2605 2774 2935 3088 3233 3370 3499 3620 3733 3732 3731 3730 3729 3728 3727 3726 3725 3609 3722 3606 3828 3827 3719 3721 3717 3716 3715 3713 3712 3597 3711 3818 3710 3709 3707 3706 3705 3588 3463 3330 3190 3187 3040 2717 2545 2364 1772 2175 1774 1559 1338 1339  872  629  375  114
 217  474  723  963 1421 1197 1639 1848 2049 2242 2427 2604 2773 2934 3087 3232 3369 3498 3619 3618 3617 3616 3615 3614 3613 3612 3488 3487 3611 3486 3608 3482 3720 3481 3718 3604 3601 3600 3599 3598 3596 3595 3594 3593 3708 3592 3591 3590 3589 3464 3331 3041 2719 2883 2718 2720 2546 2365 2176 1561 1562 1773 1112  873 1111  630  115
 216  472  473  962 1196 1422 1638 1847 2048 2241 2426 2603 2772 2933 3086 3231 3368 3497 3496 3495 3494 3493 3492 3491 3490 3489 3610 3357 3607 3483 3605 3351 3350 3603 3210 3602 3348 3478 3343 3475 3476 3473 3472 3471 3470 3469 3468 3467 3466 3465 3332 3191 3042 2884 2547 2885 2366 2177 1980 1775  875 1340 1113 1110  377  376  116
 215  471  722 1195 1420 1419 1637 1846 2047 2240 2425 2602 2932 2770 3085 3230 3367 3366 3365 3364 3363 3362 3361 3360 3359 3358 3218 3217 3355 3215 3353 3211 3349 3480 3065 3208 3479 3346 3477 3345 3474 3204 3342 3340 3339 3338 3337 3336 3335 3334 3333 3192 3043 2886 2721 2548 2367 2178 1981 1776 1563 1341  876  874  631  378  117
 960  470  469  717  721 1418 1636 1845 2046 2239 2424 2600 2601 2771 2931 3229 3228 3227 3226 3225 3224 3223 3222 3221 3220 3219 3071 3070 3485 3484 3214 3352 3213 3064 3062 2908 3207 3061 3205 3344 3057 3202 3341 3201 3200 3199 3198 3197 3196 3195 3194 3193 3044 2887 2722 2549 2368 2179 1982 1777 1343 1342 1114  877  632  379  118
 718  719 1192  720 1194 1635 1844 1843 2045 2238 2423 2769 2767 3082 3084 3081 2926 3080 3079 3078 3077 3076 3075 3074 3073 2917 3072 3356 3069 3354 2911 3067 3212 2575 3209 2907 3347 3059 3206 3058 3056 3203 3055 3054 3053 3052 3051 3050 3049 3048 3047 3046 3045 2888 2723 2550 2369 2180 1983 1565 1564 1344 1115  878  633  380  119
 468  212  213  957 1191  961 1634 1842 2044 2237 2422 2768 2929 2928 2930 2927 3083 2591 2924 2923 2922 2921 2920 2919 2755 2918 2914 2915 2751 3216 2913 2750 3068 3066 2909 2743 2905 3060 2904 2903 2902 2901 2900 2899 2898 2897 2896 2895 2894 2893 2892 2891 2890 2889 2724 2551 2370 2181 1984 1778 1779 1345  634 1119  381  382  120
 208  214  959 1190 1415 1633 1840 2042 1841 2236 2421 2599 2596 2766 2764 2592 2925 2761 2590 2760 2759 2758 2757 2756 2584 2754 2916 2581 2910 2580 2579 2749 2747 2746 2745 3063 2742 2906 2741 2740 2739 2738 2737 2736 2735 2734 2733 2732 2731 2730 2729 2728 2727 2726 2725 2552 2371 2182 1985 1348 1566 1347 1116  881  880  636  121
 716  211  210  714 1413 1417 1631 2043 2041 2235 2420 2598 2416 2417 2765 2225 2762 2226 2589 2588 2587 2408 2586 2585 2217 2404 2753 2582 2401 2752 2912 2577 2398 2211 2396 2573 2572 2571 2570 2569 2568 2567 2566 2386 2565 2564 2562 2561 2560 2559 2558 2557 2556 2555 2554 2372 2183 1986 1781 1780 1568 1349 1567 1569  635  122  385
 465 1193  958  715  712 1838  956 1632 1837 2040 2234 2597 2230 2595 2229 2594 2414 2763 2224 2411 2409 2410 2407 2406 2403 2216 2405 2583 2215 2400 2212 2576 2578 2209 2395 2574 2744 2392 2391 2390 2389 2388 2387 2198 2385 2563 2384 2382 2194 2379 2378 2377 2190 2376 2375 2553 2374 2373 1987 1783 1782 1351 1346  879  383 1118  123
 207 1189 1416  954 1187 1414 1183 1629 2232 2233 2231 2038 2419 2228 2593 2415 2227 2413 1825 2030 2223 2220 2025 2221 2022 1818 2020 2214 2402 2213 2399 2397 2210 2748 1811 2393 2206 2205 2204 2203 2202 2201 2005 2200 2003 2197 2383 2195 2380 2381 2192 2191 1995 2189 2188 1789 2185 2184 1988 1571 1350 1117 1570  882  883  638  124
 466  209  464 1188  955  953 1839 2037 2039 1835 1833 2036 2418 2035 2034 1830 2032 2412 1614 1823 2222 2027 2024 2218 2023 2021 1607 1817 2019 2018 2017 1812 2016 2015 2394 2208 2012 2010 2011 1593 2008 1591 2007 2199 2002 2001 2196 2000 1998 2193 1997 1996 1792 1994 1993 2186 2187 1991 1990 1784 1785 1353 1121 1120  388  637  639
 952  206 1411  204 1630 1628 1412 1625  944 1626 1623 1834 1832 1620 1829 2031 1618 1828 1826 1827 1395 2026 1821 1611 1389 1819 1606 1608 1815 1384 1603 1814 1813 1810 2207 1809 1808 1595 1803 1375 1806 2006 1590 2004 1800 1799 1798 1797 1999 1795 1794 1793 1581 1791 1790 1788 1992 1787 1989 1786 1572 1123  640  885  386  384  641
 711  713  950  951 1184 1186 1627 1836 1404 1177 1624 1621 1400 1175 1831 1617 1616 2033 2028 1393 1612 2029 1822 2219 1163 1820 1609 1816 1605 1382 2014 1380 1601 1597 1378 1598 1807 1376 2009 1147 1805 1801 1592 1802 1589 1588 1586 1585 1796 1584 1583 1582 1362 1580 1579 1359 1578 1577 1576 1575 1574  884 1352  642  387  389  125
 467  462  201 1408 1185 1410 1182 1180  945 1405 1403 1402 1174 1401 1172 1399 1398 1397 1166 1615 1613 1168  932 1392 1390 1388  925 1387 1385 1158 1602 1604 1157 2013 1381 1152 1377 1596 1594 1374 1804 1373 1372 1371 1370 1369 1587 1368 1366 1365 1364 1136 1363 1361 1360 1132 1358 1357 1355 1128 1122  886  887 1124  390  127  126
 463  459  461  460  710  947 1407 1409 1179  698  942 1622  700  696 1619 1173 1171 1169 1167 1824  931  929 1391 1165  930 1162 1161 1386 1159  923 1383 1156 1599 1600  919 1379 1151  915 1148 1150  912 1146 1145 1144 1143 1142 1141 1367 1139  903 1138  900  659 1134 1133  896 1130 1129 1356 1127  649 1354 1573 1125  128  888  391
 203  205  709  457  702 1406 1181  701  943 1178 1176  447  940  939  938  185 1170  935  439 1394  689  438  926 1610  927  432  924  683 1160  921  922  920 1154  676  917 1153  916  914 1149  670  913  911  910  909  908  663  907 1140  661  902  901 1135  899  658  898  897 1131  895  893 1126  648  892  889  644  130  643  129
 707  708  200  949  454  704  946  451  191  449  446  448  941  936  694  937  692  934  440  688 1396  690  687  686 1164  684  433  681  682  679  678  677 1155  675  918  674  673  672  671  669  418  668  415  414  664  906  153  905  660  904  409 1137  657  655  404  654  653  652  894  650  398  891  890  647  645  392  131
 458  202  197  948  705  195  452  192  703  190  193  697  443  186  695  184  441  182  933  180  437  436  435  434  928  174  173  431  429  680  428  427  426  425  424  423  422  421  420  419  417  416  666  665  667  413  152  662  150  410  408  147  146  405  145  403  402  401  651  399  397  396  395  646  394  393  132
 199  198  196  706  456  453  455  194  450  699  189  188  187  444  445  183  442  693  691  181  179  178  177  176  685  175  172  171  430  170  169  168  167  166  165  164  163  162  161  160  159  158  157  156  155  154  412  411  151  149  406  407  656  148  144  143  142  141  400  140  139  138  137  136  135  134  133
