# This puzzle is unsolvable
50
   1  196    2  198    5  201  388    7    9   10   11   12   13  210   14   16   17   18   19   20   21   22   23   24   25   26   27   28   29  225  227  228   30   34   36  599   35  232  420   39   40  237   41   43  242   47  244   49   50   51
 197  564    3  199  387    6    8  204  206  394  393  573  207  209   15  211  212  213  214  215  216  217  218  219  220  221  222  223  224  412  413   32   33   31  229  418   37  422  421  771  236  235  423  603  238   45  430   46  607  243
 195  384  383    4  202  200  739  391  902  203  743  574  395  208  396  398  399  400  401  402  403  404  405  406  407  408  409  410  590  592  411  764  415  414  231  595   38  417  600  233  772  234  424  604  605  426  429   48  245  433
 194  382  386  737  389  567  900  205  568  571 1061  744  572  575  397  576  749  578  580  581  582  583  584  585  586  587  588  589  760  761  594  226  593  416  596  230  419  601  770  935  940  425  602   44  775   42  428  427  609  247
 192  193  565  385  561 1055  901  566  742  570  905  392  745  746  748  577  910  579  750  751  753  754  755  756  757  758  759  922  923  591  762  927  765  766  767  597  768  598  769  931  773  938  239  777  241  939  240  778  246   52
 734  560  380  562  563  899  736  903  569  904  390  907  908  747 1064  912 1214  913  914  752  916 1072  917  919  920 1076  921 1078  924  925  763  926 1084 1083  929  930 1087  933 1090  936 1240 1094  606  941  431 1093   55  779  608   53
 190  381  733  732  735 1058 1060  740  741 1347 1208 1062 1209 1063  909 1065  911 1068 1070  915 1071 1219  918 1073 1074 1223 1077 1225 1079 1080 1081 1082  928 1233 1232 1086  934  932 1088 1091  937  774  942 1239  249  780  781  610   54  432
 378  189  557  898 1056  738 1059 1205 1057 1346  906 1348 1349 1211 1481 1067 1066 1216 1215 1217 1218 1358 1220 1221 1075 1222 1224 1226 1366 1365 1228 1229 1230 1231 1373 1371 1089 1235 1236 1376 1092 1238  434 1096  776  611   58  436   56  435
 559  191  896  897 1203 1202 1204 1344 1476 1345 1479 1210 1350 1351 1212 1213 1353 1069 1354 1355 1357 1359 1490 1614 1360 1361 1362 1363 1364 1227 1367 1368 1369 1370 1085 1505 1234 1629 1237 1509 1630 1241 1095 1098  944  613  614  785   59   57
 379  188 1053  730  731 1054 1343 1207 1475 1206 1477 1478 1603 1482 1352 1484 1483 1485 1486 1356 1488 1489 1491 1492 1615 1493 1494 1618 1495 1497 1498 1622 1499 1501 1502 1372 1374 1503 1375 1507 1377 1380  782  943  248 1099  612  439  437  250
 376  558  729  377  895 1201 1342 1341 1474 1600 1601 1602 1719 1480 1606 1607 1722 1608 1609 1487 1611 1612 1613 1836 1729 1616 1617 1734 1496 1619 1621 1737 1500 1739 1624 1625 1626 1627 1628 1508 1382 1378 1097  786 1244  783  946  255   60  251
 187  556  374  728  894 1052 1200 1199 1340 1599 1716 1717 1718 1826 1604 1720 1721 1830 1723 1610 1726 1727 1933 1728 1730 1731 1732 1733 1735 1620 1942 1843 1623 1738 1741 1848 1742 1504 1506 1379 1744 1510 1383  949 1242  945   62  253   63  252
 186  185  555  372  893 1050 1051 1471 1473 1598 1715 1824 1825 1827 1605 1828 1829 1724 1832 1833 2021 2022 2024 1834 1835 1838 1840 1939 1841 1842 1943 1844 1846 1847 1740 1948 1849 1743 1745 1631 1511 1247 1243 1245  615  947  618  784  438  441
 373  554  727  726  892 1049 1197 1198 1339 1714 1823 1822 1924 1925 1926 1927 1928 1930 1831 1725 2026 2025 1932 1934 1837 1936 1839 2030 1940 1941 1944 1736 1845 1945 2037 2038 1747 1850 1746 1512 1246 1385 1634  788  789  257  616   61  258  254
 184  375  553  725  891 1047 1196 1338 1470 1597 1713 1923 2014 2016 2017 2018 2019 2102 1929 2104 2106 1931 2027 2109 2028 2110 2111 1938 2031 2032 2033 2034 2035 2120 2036 1946 1748 1853 1851 1102 1384  948 1100 1101 1381  440  621  443  787  617
 183  371  552  551 1048  890 1337 1595 1472 1596 1712 1820 1821 2015 2100 2101 2176 2020 2105 2023 2181 2107 1935 2108 2184 2029 2112 2114 2115 2190 2116 2117 2118 2119 2039 1947 1635 1854 1632 1852 1513 1514 1104  951  442  790  950  619   64  256
 182  181  370  724 1046 1195 1194 1336 1469 1594 1711 1922 1920 2013 2098 1921 2244 2103 2247 2179 2180 2182 2183 2186 2185 1937 2187 2188 2189 2258 2192 2193 2194 2122 2040 1950 1951 1749 1633 1515 1637 1387 1248 1103  620  791  445  444  259   65
 180  369  550  723 1044 1045 1193 1335 1468 1593 1710 1819 2096 1918 2099 2177 2178 2246 2172 2357 2245 2249 2250 2252 2253 2314 2255 2256 2113 2259 2191 2318 2260 2195 2123 2121 1949 1855 1750 1386 1636 1249 1516 1105  622  793  792  260   67   66
 178  179  549  722  889  886 1043 1334 1467 1709 1708 1818 1817 1919 2012 2242 2097 2358 2302 2401 2306 2248 2309 2251 2310 2312 2313 2408 2254 2315 2257 2319 2261 2197 2041 2042 1952 1953 1856 1638 1518 1517 1388 1107 1250  624  447  623  261   68
 368  548  366  721  888 1191  887 1333 1466 1592 1590 1816 1917 2174 2240 2175 2305 2304 2438 2359 2307 2360 2311 2405 2361 2367 2364 2407 2366 2410 2368 2317 2198 2124 2196 2043 1954 1857 1751 1752 1640 1252 1106 1251  953  952  625  446  262   69
 177  367  720  546 1041  885 1192 1332 1465 1589 1591 2011 1707 2009 2010 2241 2173 2303 2399 2356 2355 2308 2402 2465 2404 2365 2362 2411 2409 2371 2316 2262 2320 2263 2125 2044 1955 1858 1753 1519 1639 1389 1390  954  955  794  448  263  264   70
 364  365  547  884 1042 1039 1190 1331 1463 1464 1706 1815 1916 2008 2094 2171 2354 2243 2301 2400 2440 2437 2403 2467 2441 2363 2445 2442 2370 2444 2412 2369 2265 2199 2126 2045 1957 1956 1754 1641 1520 1253 1254 1108  956  795  626  449  265   71
 176  362  545  716  544  718 1040 1189 1462 1587 1588 1814 1915 2093 2095 2170 2238 2300 2239 2436 2398 2435 2439 2484 2497 2466 2470 2443 2447 2476 2321 2264 2200 2127 2046 2047 1958 1859 1755 1643 1642 1391 1255 1109  957  796  627  450   72   73
 543  719  173  363 1038 1187 1330 1328 1329 1461 1705 1813 1914 2007 2092 2169 2299 2352 2353 2397 2464 2462 2485 2486 2468 2406 2471 2416 2450 2414 2323 2322 2266 2201 2128 1959 2048 1860 1756 1644 1521 1392 1256 1110 1111  799  958  628  451  266
 175  881  714  882  880 1188  883 1327 1586 1703 1704 1812 1913 2006 2091 2168 2237 2298 2351 2396 2434 2461 2483 2460 2469 2488 2490 2472 2415 2372 2413 2373 2324 2202 2129 1960 1861 1862 1757 1522 1394 1393 1257 1113  959  960  798  452  267   74
 172  361  715  174 1037  717 1186 1326 1460 1585 1702 1811 1912 2004 2005 2167 2236 2350 2349 2395 2433 2479 2496 2487 2463 2498 2489 2448 2374 2325 2375 2268 2267 2203 2130 2049 1863 1758 1645 1646 1523 1396 1395 1258  797 1112  629  453  268   76
 171  541  542  359  879 1185 1184 1459 1584 1701 1700 1808 1810 1910 2090 2166 2235 2296 2297 2431 2432 2458 2494 2456 2492 2495 2475 2499 2446 2473 2418 2326 2269 2204 2132 2131 1962 1961 1864 1759 1526 1524 1259 1114  961  800  454  631   75   78
 170  360  540  539  878 1036 1325 1324 1458 1809 1582 1699 2003 1911 2089 2234 2295 2232 2348 2430 2482 2480 2459 2493 2491 2422 2454 2449 2417 2377 2376 2327 2270 2205 2133 2050 2051 1865 1760 1525 1647 1397 1260 1115  962  632  630  455   77  269
 169  358  538  713 1034 1033 1035 1323 1457 1698 1581 1806 1909 2088 2164 2165 2294 2392 2393 2394 2427 2457 2428 2425 2477 2424 2474 2453 2452 2451 2378 2328 2271 2206 2134 2052 1963 1964 1761 1648 1527 1398 1261 1116  963  801  802  456  270  271
 168  712  357  876  877 1183 1181 1182 1455 1456 1583 1807 2001 2002 2086 2163 2233 2347 2346 2391 2429 2388 2481 2455 2478 2384 2423 2421 2381 2420 2419 2329 2272 2135 2053 2054 1867 1866 1762 1649 1528 1399 1262 1117  804  964  633  272   80   79
 167  356  710  711  875 1032 1322 1454 1578 1580 1907 1908 2000 2085 2087 2162 2231 2292 2291 2293 2390 2387 2426 2386 2385 2337 2383 2382 2334 2380 2379 2330 2273 2209 2207 2208 1965 1868 1763 1650 1529 1400 1118  965  806  966  635  803  274  273
 355  536  537  709  874 1031 1030 1320 1579 1696 1697 1805 1905 2161 1998 2160 2228 2230 2343 2345 2389 2342 2341 2340 2220 2338 2281 2336 2335 2333 2332 2331 2274 2210 2136 2055 1966 1869 1764 1651 1530 1401 1264 1263 1119  805  636  457  634  458
 166  354  535  708  873 1179 1321 1180 1319 1453 1695 1999 2084 1903 2083 2159 2081 2289 2227 2287 2344 2286 2285 2339 2284 2283 2282 2280 2279 2278 2277 2276 2275 2137 2138 2056 1967 1870 1765 1652 1531 1402 1265  967  637  460  638  459  276   81
 165  353  534  707  872 1029 1178 1577 1452 1576 1694 1800 1803 1906 2079 2082 2229 2290 2155 2288 2224 2223 2151 2222 2221 2219 2218 2217 2216 2215 2214 2212 2211 2139 2140 2057 1968 1871 1766 1653 1532 1403 1266 1121  968 1120  808  461   83  275
 164  352  533  706  871 1028 1177 1318 1450 1451 1802 1692 1993 1804 1995 2158 2157 2156 2076 2226 2153 2152 2072 2150 2149 2148 2147 2146 2145 2144 2143 2213 2062 2141 1974 2058 1969 1872 1767 1654 1533 1404 1267 1122  969  807  639  462   82  277
 163  162  351  705  870 1027 1176 1317 1691 1449 1574 1801 1904 1900 1996 2080 1991 2078 2154 2225 2075 2074 2073 2071 2070 2069 2068 2067 2066 2064 1976 2142 2063 1973 2061 2059 1970 1873 1768 1655 1534 1405 1268 1123  971  970  809  463  278   84
 161  350  532  531  869 1025 1026 1175 1693 1690 1575 1798 1902 1901 1997 1992 1990 1989 2077 1988 1987 1986 1985 1984 1983 1982 1981 1980 1979 2065 1978 1977 1975 1879 2060 1972 1971 1874 1769 1656 1535 1406 1269 1125 1124  810  640  464   86   85
 160  349  530  704  703 1024 1174 1316 1573 1447 1572 1796 1799 1795 1794 1565 1896 1895 1894 1893 1892 1891 1890 1889 1888 1887 1886 1885 1884 1883 1882 1881 1880 1776 1878 1877 1876 1875 1770 1657 1536 1407 1270  972  811  641  465  466  279  280
 159  348  529  702  868  867 1173 1315 1314 1688 1689 1797 1684 1440 1897 1994 1793 1792 1791 1790 1789 1788 1787 1786 1555 1673 1784 1782 1781 1780 1779 1778 1777 1665 1775 1774 1773 1772 1771 1658 1537 1408 1271 1126  973  812  642  281  282   87
 158  347  528  701  866 1023 1312 1313 1448 1446 1687 1566 1686 1898 1899 1682 1562 1299 1680 1679 1678 1677 1676 1675 1785 1674 1553 1783 1670 1669 1668 1667 1547 1666 1664 1663 1662 1661 1660 1659 1538 1409 1272 1127  974  813  643  467   89   88
 157  346  527  700  865 1022 1172 1311 1445 1571 1570 1685 1438 1568 1303 1300 1683 1681 1434 1560 1558 1296 1431 1557 1556 1292 1424 1672 1551 1550 1549 1548 1546 1545 1418 1544 1543 1542 1541 1540 1539 1410 1273 1128  975  814  644  283  468   92
 156  345  526  699  864 1170 1171 1310 1444 1442 1306 1441 1305 1569 1437 1301 1564 1436 1561 1433 1559 1430 1429 1291 1294 1150 1554 1671 1425 1423 1421 1420 1285 1419 1283 1417 1416 1414 1279 1413 1412 1411 1274 1129  976  815  646  645   90   91
 155  344  525  698  863 1021 1169 1309 1308 1443 1307 1163 1304 1439 1567 1302 1563 1157 1435 1154 1432 1297 1295 1153 1428 1148 1427 1552 1289 1287 1422 1286 1142 1284 1282 1139 1281 1415 1278 1135 1277 1276 1275 1130  977  816  647  469  285  286
 154  343  524  697  862 1020 1019 1168 1166 1165 1012  853 1162 1161 1160 1159 1158 1006 1156 1155 1298 1151 1000 1149 1293  998    0 1426 1145 1288  994 1143 1141 1140  829 1138  988 1280 1137  984 1134 1133 1132 1131  978  817  648  470   93   94
 153  342  523  696  861 1018 1017 1016 1167 1014 1013 1164 1011 1010 1009 1008 1007 1005  679  846 1004  843  501  838  840  671 1147 1290  995  993 1144  992  991  990  989  830  828  987  985 1136  983  982  981  980  979  818  649  471  284  472
 152  341  522  695  860  859  858  857 1015  856  855  687  854  851  850  849  848  847  845 1003  844 1152 1001  999  839  997  837  996 1146  668  835  833  832  831  663  661  986  111  826  825  824  823  822  821  820  650  473  288  287   95
 151  340  521  694  693  692  691  690  689  688  686  685  852  684  683  682  681  680  678  504  676  318  674 1002  499  669  670  672  836  834  667  666  665  664  488  486  485  302  660  659  658  656  655  654  653  819  651  474  289   96
 150  339  520  519  518  517  516  515  514  513  512  511  510  509  508  507  323  506  505  677  503  502  842  315  841  316  122  311  495  493  492  491  490  487  114  662  827  110  484  301  483  657  481  479  477  652  476  475  290   97
 149  338  337  336  335  334  333  332  331  330  329  328  327  326  325  324  132  322  319  320  317  500  126  675  314  673  496  313  121  310  118  309  308  306  116  305  304  303  482  108  298  106  297  296  478  294  293  292  291   98
 148  147  146  145  144  143  142  141  140  139  138  137  136  135  134  133  131  130  321  129  128  127  125  124  498  497  123  494  312  120  119  117  307  115  489  113  112  299  300  109  107  104  105  480  295  103  102  101  100   99
