# This puzzle is unsolvable
55
 624    4  217  425  628    7    9  224  225   11  435  436   15   12  635  231   17   18   19   20   21   22   23   24   25   26   27   28   29   30   31   32   33   34   35   36   37   38   39   40   41   42   43   44   45   46   47   48   49   50   51   52   53   54   55
   1  423  623  215  221    3  428  430  222  226  433  227   16  437   13  230  232  233  234  235  236  237  238  239  240  241  242  243  244  245  246  247  248  249  250  251  252  253  254  255  256  257  258  259  260  261  262  263  264  265  266  267  268  269   56
 424  218  422    5  429    6  817  223   10    8  434  634  229  826  438  439  638  440  441  442  443  444  445  446  447  448  449  450  451  452  453  454  455  456  457  458  459  460  461  462  463  464  465  466  467  468  469  470  471  472  473  474  475  270   57
 213  216  626  219  220  427  627  431 1001  432  228  632  824 1010  825   14  829  639  640  641  642  643  644  645  646  647  648  649  650  651  652  653  654  655  656  657  658  659  660  661  662  663  664  665  666  667  668  669  670  671  672  673  476  271   58
 212  214  625    2  426  818 1002  821  630  631  822 1008 1182  828  636  637 1012 1013  832  833  834  835 1018  836  837  838  839  840  841  842  843  844  845  846  847  848  849  850  851  852  853  854  855  856  857  858  859  860  861  862  863  674  477  272   59
 210  211  816  813  418  999 1003  819  823  633 1180  827  820 1184 1009 1011 1014 1189  831  830 1016 1017 1192 1019 1020 1021 1022 1023 1024 1025 1026 1027 1028 1029 1030 1031 1032 1033 1034 1035 1036 1037 1038 1039 1040 1041 1042 1043 1044 1045  864  675  478  273   60
 419  621  622  420 1175 1000 1178 1179  629 1004 1181 1005 1006 1185 1352 1186 1353 1357 1187 1515 1015 1358 1194 1361 1195 1196 1365 1197 1199 1200 1201 1202 1203 1204 1205 1206 1207 1208 1209 1210 1211 1212 1213 1214 1215 1216 1217 1218 1219 1046  865  676  479  274   61
 421  209  620  814  998 1343  997 1504 1346 1347 1348 1350 1007 1660 1351 1355 1512 1665 1354 1517 1190 1191 1193 1362 1521 1363 1364 1198 1366 1367 1368 1369 1370 1371 1372 1373 1374 1375 1376 1377 1378 1379 1380 1381 1382 1383 1384 1385 1220 1047  866  677  480  275   62
 815  417 1176 1174 1172 1344 1345 1177 1505 1800 1508 1507 1183 1349 1662 1511 1356 1188 1516 1666 1518 1669 1360 1520 1522 1523 1524 1525 1526 1677 1527 1528 1529 1530 1531 1683 1532 1534 1535 1536 1537 1538 1539 1540 1541 1542 1543 1386 1221 1048  867  678  481  276   63
 416  207  619  811  996 1171 1341 1503 1656 1658 1506 1659 1803 1509 1664 1510 1514 1513 1943 1667 1668 1813 1359 1670 1671 1816 1674 1675 1676 1820 1678 1679 1680 1681 1826 1825 1533 1685 1686 1687 1688 1689 1690 1691 1692 1693 1544 1387 1222 1049  868  679  482  277   64
 208  415  812  617 1170  810 1173 1342 1799 1657 1802 1801 1804 1806 1661 1808 1807 1810 1809 1946 1812 1814 1519 1815 1672 1817 1673 1818 1819 1955 1821 1822 1823 1824 1961 1682 1684 1828 1829 1830 1831 1832 1833 1834 1835 1694 1545 1388 1223 1050  869  680  483   65   66
 206  616  618  808 1501  995 1500 1798 1655 1169 1937 2064 1805 1939 1940 1663 1941 1945 1944 1948 1811 2073 2075 1949 1950 1951 1952 2080 1953 1956 2083 1957 1958 1959 1960 2089 1827 1963 1964 1965 1966 1967 1968 1969 1836 1695 1546 1389 1224 1051  870  681  484  278   67
 205  414  993  809  615 1339 1653 1502 1936 1652 1935 2065 1938 2066 2067 2068 2069 1942 2070 2190 2072 1947 2074 2076 2077 2078 2079 2082 1954 2313 2201 2084 2085 2086 1962 2088 2087 2091 2210 2092 2093 2094 2095 1970 1837 1696 1547 1390 1225 1052  682  485  280  279   68
 204  413  614  807  992  994 1340 1168 1797 1654 1934 2063 2184 2185 2186 2187 2188 2189 2191 2071 2192 2193 2194 2195 2196 2197 2198 2081 2200 2312 2202 2203 2204 2205 2317 2206 2090 2319 2208 2211 2212 2213 2096 1971 1838 1697 1548 1391 1226 1053  871  683  486  281   69
 203  412  613  806  991 1167 1499 1338 1651 1796 1933 2062 2183 2296 2298 2299 2300 2402 2301 2406 2405 2303 2305 2306 2307 2308 2309 2199 2310 2414 2314 2417 2315 2316 2318 2320 2207 2422 2321 2424 2322 2323 2214 1972 1839 1698 1549 1227 1054  873  872  684  487  282   70
 202  411  612  805  990 1335 1337 1498 1336 1497 1932 2061 2182 2295 2297 2496 2401 2403 2302 2404 2407 2304 2408 2409 2410 2411 2412 2413 2311 2415 2511 2416 2418 2514 2419 2420 2421 2518 2423 2325 2324 2215 2097 1973 1840 1700 1699 1392 1228 1055  874  685  488  283   71
 201  410  611  803  804  989 1496 1649 1650 1795 1931 2060 2181 2294 2400 2399 2497 2498 2499 2500 2501 2589 2503 2504 2505 2507 2593 2506 2509 2510 2598 2512 2513 2601 2515 2209 2519 2604 2425 2099 2427 2217 2098 1842 1701 1974 1394 1550 1229 1056  875  686  687  490  284
 200  409  610 1165 1166 1333 1164 1495 1648 1794 1793 1930 2180 2293 2398 2495 2584 2585 2586 2587 2502 2588 2592 2671 2590 2673 2595 2508 2596 2676 2597 2599 2600 2679 2680 2516 2682 2517 2522 2520 2426 2218 2100 1841 1553 1552 1395 1393 1230 1057  876  688  286  489  285
 199  408  609  802  987 1334 1494 1493 1647 1792 2058 2059 2179 2292 2397 2494 2583 2664 2665 2666 2667 2668 2669 2670 2806 2743 2594 2674 2746 2747 2677 2750 2749 2752 2603 2684 2681 2521 2605 2216 2326 2101 2102 1975 1843 1703 1551 1396 1231 1059 1058  878   74   75   72
 608  197  607  986  984  988 1332 1646 1645 1928 1929 2057 2178 2291 2396 2493 2582 2734 2662 2736 2738 2739 2740 2741 2591 2742 2744 2675 2745 2865 2748 2812 2678 2751 2602 2753 2606 2608 2428 2327 2429 2329 1977 1976 1844 1554 1702 1397 1233  689 1060  879  287  289   73
 198  407  405  801  800 1163 1331 1492 1790 1791 1927 2056 2177 2290 2395 2492 2581 2799 2663 2737 2801 2858 2802 2804 2672 2807 2862 2808 2809 2866 2810 2811 2813 2814 2815 2683 2523 2609 2607 2430 2219 2328 2103 1978 1845 1705 1398 1232 1061 1555  492  877  491  494  288
 196  406  606  985 1162  799 1330 1491 1644 1789 1926 2055 2176 2289 2394 2491 2661 2578 2735 2800 2857 2903 2860 2803 2859 2861 2863 2949 2912 2864 2954 2914 2915 2868 2686 2754 2685 2524 2610 2431 2330 2221 2104 1979 1846 1556 1704 1399 1234  690  881  880  493  495  290
 404  604  798  797 1160 1161 1329 1490 1643 1788 1925 2054 2175 2288 2393 2490 2580 2579 2732 2733 2902 2999 2976 2805 2906 2946 2907 2910 2909 2911 2871 2948 2953 2870 2869 2687 2755 2611 2525 2432 2220 2331 2105 1980 1847 1706 1557 1400 1235 1062  692   77  496  691   76
 195  605  403  982  983 1159 1328 1489 1642 1787 1924 2053 2174 2287 2392 2489 2660 2659 2797 2855 2856 2905 2798 2904 2978 2947 2980 2908 3004 2952 2982 2913 2955 2817 2816 2758 2756 2612 2333 2434 2433 2222 2223 1981 1848 1707 1558 1401 1236 1063  882  693  497  291   78
 194  193  402  796  981 1158 1327 1488 1641 1786 1923 2052 2173 2286 2391 2488 2577 2731 2796 2854 2852 2942 2944 2945 2975 2979 2981 3002 2916 2950 2867 2951 2984 2818 2689 2690 2688 2613 2527 2526 2332 2226 2106 1982 1849 1708 1559 1402 1237 1064  883  694  498  292   79
 192  401  603  795  980 1157 1326 1487 1640 1785 1922 2051 2172 2285 2390 2487 2657 2656 2729 2730 2901 2943 2899 3000 3017 2940 3015 3003 2918 2985 3006 2820 2874 2873 2819 2757 2692 2691 2436 2435 2108 2224 2107 1983 1850 1709 1560 1403 1238 1065  884  695  499  293   80
 191  400  602  794  979 1156 1325 1486 1639 1784 1921 2050 2171 2284 2389 2575 2576 2793 2795 2726 2794 2898 2974 2851 2977 3016 3001 3018 2956 2872 2983 2917 2957 2875 2919 2760 2822 2529 2528 2437 2225 2334 2109 1984 1851 1710 1561 1404 1239  885  696  500   81   82  296
 190  399  601  793  978 1155 1324 1485 1637 1638 2049 2048 2170 2387 2485 2486 2574 2655 2658 2939 2847 2846 2938 2973 3014 2998 3024 3022 3019 3020 2921 2922 2877 2821 2920 2761 2693 2614 2530 2336 2335 2227 2111 2110 1985 1852 1711 1562 1405 1066  886  697  501  294   83
 189  599  600  792  977 1154 1322 1323 1484 1783 1782 1920 2169 2388 2283 2484 2573 2654 2791 2849    0 2727 2994 2848 2792 3021 3023 2992 3005 3007 2986 3008 2876 2763 2823 2759 2694 2615 2616 2438 2337 2228 1986 1987 1853 1712 1563 1406 1240 1241 1068  887  698  295   84
 188  398  397  791  976 1153 1321 1483 1636 1918 1919 2047 2168 2282 2386 2483 2572 2653 2725 2728 2853 2936 2896 2900 2995 2997 3012 3013 3011 2987 2958 2959 2879 2923 2762 2617 2618 2533 2531 2532 2339 2338 2229 2112 1713 1714 1564 1407 1242 1067  888  699  502  297   85
 187  598  789  975 1151 1481  974 1482 1780 1781 1917 2046 2167 2281 2385 2482 2571 2652 2790 2850 2892 2941 2972 2891 2996 2991 2966 2963 2990 2929 2926 2962 2960 2824 2880 2765 2764 2439 2441 2340 2341 2114 1988 1854 1855 1715 1565 1408  891 1069  889  701  700  504  298
 186  790  788  597  972 1152 1320 1635 1633 1779 1916 2045 2166 2280 2384 2481 2570 2651 2724 2937 2788 2715 2971 2842 2839 2935 2932 2967 2930 3009 2885 2988 2883 2882 2989 2825 2697 2695 2696 2620 2231 2230 2113 1989 1716 1990 1566 1409 1243 1070 1072  890   87  503   86
 595  396  395  394 1150  973 1319 1634 1778 1777 1915 2165 2278 2279 2382 2383 2569 2650 2722 2789 2723 2897 2844 2970 2968 2934 2895 3010 2993 2927 2964 2925 2831 2826 2878 2827 2619 2698 2535 2440 2534 2232 2116 2115 1857 1856 1568 1410 1245 1244 1071  702  505  299  301
 185  393  596  594 1149 1148 1913 1480 1632 1631 1914 2044 2043 2276 2277 2480 2478 2568 2649 2845 2721 2893 2969 2840 2931 2889 2933 2635 2834 2928 2884 2832 2830 2961 2768 2767 2766 2621 2536 2443 2442 2233 2236 1858 1720 1567 1717 1411 1246 1073  892  703  506   88  300
 184  183  593  971  787 1318 1314 1479 1316 1630 1317 2042 2164 2163 2381 2477 2479 2720 2787 2843 2894 2784 2841 2782 2965 2890 2887 2886 2836 2708 2835 2833 2828 2771 2924 2829 2699 2623 2622 2344 2342 2343 2117 2118 1718 1992 1412 1863 1859 1075 1074  705  507  302   89
 182  392  592  786  785 1147 1476 1773 1478 1912 1629 2041 2040 2162 2380 2476 2567 2648 2647 2785 2716 2783 2781 2713 2714 2711 2837 2777 2776 2774 2709 2772 2773 2769 2881 2702 2701 2700 2444 2537 2235 2234 1993 1991 1569 1719 1413 1247 1414  895  704  893  508  303   90
 181  391  591  784  970 1146 1477 1313 1628 1776 1774 2161 1911 2275 2274 2379 2566 2646 2719 2786 2642 2717 2637 2712 2636 2552 2463 2779 2706 2775 2705 2628 2630 2704 2770 2627 2624 2540 2538 2445 2237 2120 2345 1994 1861 1571 1570 1248 1077 1249  509  706  510   92   91
 180  390  389  783  969 1144  968 1145 1475 1775 1909 2037 2160 2273 2378 2475 2564 2645 2644 2718 2641 2558 2838 2554 2638 2462 2555 2888 2710 2458 2549 2360 2547 2703 2629 2625 2626 2539 2448 2446 2447 1995 1998 1862 1721 1415 1573 1572 1250 1076  894  896  707  304  305
 179  388  590  589  967 1143 1315 1474 1627 1910 1772 2039 2272 2377 2474 2473 2565 2562 2560 2643 2467 2557 2556 2465 2257 2363 2634 2460 2639 2778 2707 2631 2548 2546 2545 2544 2543 2542 2541 2449 2346 2119 1864 1997 1722 1860 1574 1416 1251 1078  897  708  511  306   93
 178  387  781  782  965  966 1312 1472 1473 1626 2038 1908 2271 2157 2376 2472 2563 2471 2561 2468 2559 2371 2466 2367 2464 2780 2640 2553 2459 2550 2457 2358 2456 2455 2454 2453 2452 2451 2450 2350 2348 2347 2239 1996 2238 1723 1417 1418 1252 1079  898  709  512  307   94
 177  587  588  385  780 1142 1311 1471 1625 1907 1906 2035 2154 2159 2270 2266 2374 2373 2370 2469 2369 2262 2259 2145 2365 2364 2551 2361 2359 2632 2633 2357 2356 2249 2355 2354 2353 2352 2244 2351 2349 2121 2240 2123 2122 1724 1575 1419 1253 1080  899  710  513  308   95
 176  386  778  779  964 1141 1310 1769 1770 1771 1905 2158 2269 2031 2375 2268 2265 2372 2470 2025 2150 2263 2144 2260 2366 2258 2255 2461 2254 2253 2252 2251 2135 2250 2248 2247 2246 2245 2129 2243 2242 2241 1999 1865 1866 1725 1576 1420 1254 1081  900  711  514  309   96
 175  384  586  777  963 1140 1309 1623 1624 1768 2034 2032 2036 2156 2030 2267 2151 2264 2027 2149 2148 2022 2368 2146 2143 2142 2256 2362 2140 1887 2137 2136 2012 2134 2133 2132 2131 2130 2006 2127 2004 2126 2124 2000 2001 1867 1578 1577 1255 1082  901  712  515  310   97
 174  383  583  584  962 1139 1308 1470 1622 1767 1763 2155 1904 1900 2152 2153 2028 2026 1756 1895 2147 2024 2261 2021 2020 2019 2017 2141 2138 2016 2014 2013 1881 2011 1879 2009 2008 2007 2005 2128 2003 1872 2125 2002 1726 1727 1579 1421 1256 1083  902  713  516  311   98
 173  585  382  774  776 1138 1307 1469 1468 1621 1766 2033 1903 1761 1899 2029 1897 1757 1896 1754 1892 2023 1891 1890 1889 1888 2018 2139 1886 1884 1883 1882 2010 1741 1880 1878 1877 1876 1875 1874 1734 1873 1871 1869 1868 1730 1422 1423 1257  903  904  714  517  312   99
 170  381  775  773  961 1137 1305 1467 1620 1765 1902 1762 1760 1901 1613 1898 1759 1758 1755 1893 1894 1753 1752 1751 1750 1749 1748 1747 1598 2015 1745 1743 1742 1275 1740 1739 1591 1738 1737 1588 1735 1733 1731 1870 1729 1728 1580 1258 1260 1259  905  715  518  313  100
 171  172  580  582  960 1136 1466 1306 1619 1617 1462 1616 1764 1615 1458 1612 1610 1455 1609 1608 1607 1606 1605 1604 1603 1602 1601 1600 1885 1746 1744 1597 1596 1438 1593 1437 1592 1590 1736 1589 1587 1585 1732 1584 1583 1582 1581 1087 1425 1084 1085  716  519  314  101
 581  380  578  958  959 1135 1304 1464 1463 1618 1299 1614 1461 1459 1457 1456 1611 1292 1454 1453 1452 1451 1450 1449 1448 1447 1446 1445 1599 1444 1443 1441 1439 1594 1104 1274 1436 1435 1270 1271 1431 1586 1430 1429 1428 1427 1263 1426 1424 1086  906  907  520  315  102
 379  169  166  772  956  957 1302 1465 1132 1300 1298 1460 1297 1295 1125 1294 1122 1293 1291 1290 1289 1288 1287 1286 1285 1284 1283 1282 1281 1279 1442 1107 1278 1440 1277  925 1273 1434 1272 1433 1099 1268 1095 1267 1265  914 1264 1091 1261 1088  718  717  521  316  103
 377  579  378  771 1134  953 1303 1301 1129  950 1128 1127 1126  946 1296 1123  943 1121 1120 1119 1118 1117 1116 1115 1114 1113 1112 1111 1109 1280  929 1108 1595 1106  926 1103 1102 1101 1100 1098 1432 1269 1097 1266  915 1094 1262 1093 1090 1089  908  719  522  317  104
 168  376  574  576  955 1133  952  954 1130 1131  949  948  760  947 1124  757  944  942  941  940  939  938  937  936  935  934  933  932 1110  930  742  928  927 1276  738  924  923  922  921  920  919  732 1096  917  916  913  726 1092  911  910  909  720  523  318  105
 575  375  577  768  767  572  766  765  951  763  567  762  761  759  945  758  756  755  754  753  752  751  750  749  748  747  746  550  931  743  547  741  740 1105  739  737  736  539  734  733  731  918  730  729  728  727  725  912  724  723  722  721  524  319  106
 167  374  769  371  158  368  369  571  764  569  568  566  565  564  563  562  561  560  559  558  557  556  555  554  553  552  551  744  745  548  546  545  544  543  340  542  540  735  336  538  537  536  535  534  533  532  531  530  529  528  527  526  525  320  107
 163  164  373  573  770  370  157  367  570  366  364  363  362  361  360  359  358  357  356  355  354  353  352  351  350  349  348  347  549  346  344  343  342  341  129  339  541  338  337  335  334  333  332  331  330  329  328  327  326  325  324  323  322  321  108
 162  165  372  161  160  159  156  155  154  365  153  152  151  150  149  148  147  146  145  144  143  142  141  140  139  138  137  136  135  345  134  133  132  131  130  128  127  126  125  124  123  122  121  120  119  118  117  116  115  114  113  112  111  110  109
