# This puzzle is unsolvable
57
   2    1    3    4    5    6    7    8    9   10   11   12   13   14   15   16   17   18   19   20   21   22   23   24   25   26   27   28   29   30   31   32   33   34   35   36   37   38   39   40   41   42   43   44   45  269   46   48   50  272  274   51   54   55   56  279   57
 224  225  226  227  228  229  230  231  232  233  234  235  236  237  238  239  240  241  242  243  244  245  246  247  248  249  250  251  252  253  254  255  256  257  258  259  260  261  262  263  264  265  266  267  268  484   47  270  271  275   49  488  491  276  278   59   58
 223  440  441  442  443  444  445  446  447  448  449  450  451  452  453  454  455  456  457  458  459  460  461  462  463  464  465  466  467  468  469  470  471  472  473  474  475  476  477  478  479  480  481  689  482  483  485  486  487  273   52   53  489  277  492  493   61
 222  439  648  649  650  651  652  653  654  655  656  657  658  659  660  661  662  663  664  665  666  667  668  669  670  671  672  673  674  675  676  677  678  679  680  681  682  683  684  685  686  687  688  690  889  691  692  693  694  695  696  490  697  898  699  281  495
 221  438  647  848  849  850  851  852  853  854  855  856  857  858  859  860  861  862  863  865  866  867  868 1059  869  870  871  872  873  874  875  876  877  878  879  880  881  882  883  884  885  886 1078  887  888 1081  892 1083 1084  893  895  897  698  700  284  280   60
 220  437  646  847 1040 1041 1042 1043 1044 1045 1046 1048 1049 1232 1233 1050 1051 1053 1055  864 1239 1057 1058 1242 1060 1061 1062 1063 1064 1065 1066 1067 1068 1069 1070 1071 1072 1073 1074 1075 1076 1077 1261 1079  890 1080  891 1267  894 1085 1086  896  702  496  703   62  282
 219  436  645  846 1039 1224 1225 1226 1227 1228 1229 1047 1406 1231 1408 1234 1052 1411 1054 1056 1238 1240 1241 1417 1243 1244 1245 1246 1247 1248 1249 1250 1251 1252 1253 1254 1255 1256 1257 1258 1259 1260 1436 1262 1264 1438 1082 1266 1442 1268 1269 1087 1088  701  497  494  283
 218  435  644  845 1038 1223 1400 1401 1402 1403 1404 1230 1574 1407 1575 1409 1412 1236 1237 1413 1414 1415 1416 1584 1418 1419 1420 1421 1422 1423 1424 1425 1426 1427 1428 1429 1430 1431 1432 1433 1434 1435 1437 1604 1263 1606 1265 1440 1609 1443 1270  900  901  899  285   63   64
 217  434  643  844 1037 1222 1399 1568 1569 1570 1571 1405 1572 1573 1735 1410 1235 1578 1579 1580 1581 1582 1583 1743 1585 1586 1587 1588 1589 1590 1591 1592 1593 1594 1595 1596 1597 1598 1599 1600 1601 1602 1603 1763 1605 1765 1439 1441 1608 1271 1090 1091 1089  704  498  286   65
 216  433  642  843 1036 1221 1398 1567 1728 1729 1730 1731 1732 1733 1734 1577 1736 1737 1738 1739 1740 1741 1742 1744 1895 1745 1746 1747 1748 1749 1750 1751 1752 1753 1754 1755 1756 1757 1758 1759 1760 1761 1762 1764 1915 1767 1766 1607 1610 1444 1445 1092  902  705  499  287   66
 215  432  641  842 1035 1220 1397 1566 1727 1880 1881 1882 1883 1885 1886 1576 1887 1888 1889 1890 1891 1892 1893 1894 2038 1896 1897 1898 1899 1900 1901 1902 1903 1904 1905 1906 1907 1908 1909 1910 1911 1912 1913 1914 1916 2059 1917 1768 1446 1612 1272  903  706  501  500  288   67
 214  431  640  841 1034 1219 1396 1565 1726 1879 2024 2026 2027 1884 2028 2029 2030 2031 2032 2033 2034 2035 2036 2172 2037 2039 2041 2042 2177 2043 2044 2045 2046 2047 2048 2049 2050 2051 2052 2053 2054 2055 2056 2057 2058 1918 1919 1769 1611 1447 1273 1093  904  707  502  289   68
 213  430  639  840 1033 1218 1395 1564 1725 1878 2023 2025 2160 2162 2163 2164 2165 2166 2167 2168 2169 2170 2298 2171 2174 2175 2040 2176 2304 2178 2179 2181 2308 2182 2183 2184 2185 2186 2187 2188 2189 2190 2191 2192 2193 2060 1920 1770 1613 1275 1274 1094  905  708  503  290   69
 212  429  638  839 1032 1217 1394 1563 1724 1877 2022 2159 2161 2289 2290 2291 2292 2293 2295 2414 2296 2297 2529 2418 2173 2300 2421 2303 2423 2306 2307 2426 2180 2309 2310 2311 2312 2313 2314 2315 2316 2317 2318 2319 2194 2061 1771 1772 1614 1448 1276 1095  906  709  504  291   70
 211  428  637  838 1031 1216 1393 1562 1723 1876 2021 2158 2288 2287 2409 2410 2412 2524 2294 2628 2415 2528 2416 2299 2419 2302 2301 2422 2424 2305 2425 2427 2538 2428 2429 2430 2431 2432 2433 2434 2436 2437 2195 2062 2063 1922 1921 1773 1615 1449 1277 1096  907  710  505  292   71
 210  427  636  837 1030 1215 1392 1561 1722 1875 2020 2286 2407 2408 2520 2521 2411 2523 2413 2627 2725 2526 2631 2417 2530 2420 2532 2533 2534 2535 2536 2641 2640 2539 2540 2541 2542 2543 2544 2545 2435 2320 2438 2548 2196 2197 2064 1774 1616 1450 1278 1097  908  711  506  293   72
 209  426  635  836 1029 1214 1391 1560 1721 1874 2019 2157 2156 2285 2519 2624 2522 2626 2525 2810 2629 2726 2633 2728 2632 2531 2635 2636 2637 2732 2639 2735 2537 2736 2643 2644 2645 2646 2647 2648 2546 2547 2322 2439 2198 2065 1923 1775 1617 1279 1280 1098  909  712  507   73   74
 208  425  634  835 1028 1213 1390 1559 1720 1873 2018 2155 2405 2406 2518 2623 2720 2625 2722 2888 2724 2527 2630 2814 2634 2729 2730 2731 2733 2638 2734 2822 2737 2823 2642 2739 2740 2741 2742 2743 2649 2549 2321 2441 2323 2066 1924 1618 1619 1451 1281 1099  910  713  508  295  294
 207  424  633  834 1027 1212 1389 1558 1719 1872 2017 2154 2284 2404 2517 2622 2721 2808 2723 2811 2727 3026 2961 2813 2815 2816 2818 2898 2819 2900 2899 2821 2902 2824 2738 2826 2827 2828 2744 2745 2650 2550 2440 2199 2325 2067 1925 1776 1620 1452 1454 1100  911  714  296   76  297
 206  423  632  833 1026 1211 1388 1557 1718 1871 2016 2153 2283 2282 2516 2621 2719 2807 2887 2809 2889 2891 2959 2893 2895 2965 2817 2967 2968 2897 2820 2972 2973 2825 2903 2906 2978 2977 2829 2651 2652 2551 2442 2324 2201 2200 1778 1926 1621 1453 1455 1101  912  715  509  718   75
 205  422  631  832 1025 1210 1387 1556 1717 1870 2015 2152 2402 2403 2513 2514 2620 2717 2718 3023 2812 2890 2892 2894 2964 2896 3030 2966 3031 2970 2901 2971 3036 2904 2905 3038 2976 2830 2831 2746 2653 2443 2444 2326 2068 2069 1927 1777 1622 1282 1283 1102  913  298  511  510   77
 204  421  630  831 1024 1209 1386 1555 1716 1869 2014 2151 2281 2400 2401 2512 2715 2805 2806 2958 2960 3081 2962 3029 3028 3084 3085 2969 3087 3033 3034 3035 2975 2974 3037 3039 2832 2907 2834 2654 2748 2554 2328 2445 2202 1928 1929 1779 1457 1456 1284 1103  914  716  717   78  300
 203  420  629  830 1023 1208 1385 1554 1715 1868 2150 2149 2280 2279 3019 2515 2716 2618 2803 2885 3025 3027 3078 2963 3082 3083 3086 3134 3032 3088 3089 3090 3091 3093 2979 2909 2980 2908 2833 2747 2203 2329 2655 2331 2330 2204 1930 2327 2070 1623 1285 1104  915  512  301  513  299
 202  419  628  829 1022 1207 1384 1553 1714 1867 2013 2148 2399 2511 2277 2617 2713 2802 2883 3024 2884 2956 3079 3129 3130 3131 3132 3133 3173 3135 3136 3137 3138 3092 3094 3041 2981 2912 2750 2835 2749 2553 2206 2555 2205 2071 1780 1624 1458 1459 1287 1286  916  719  514   80   81
 201  418  627  828 1206 1383 1551 1382 1713 1865 1866 2144 2398 2278 2616 2955 2273 2714 2886 2882 3077 2957 3200 3080 3166 3170 3202 3171 3204 3174 3175 3176 3177 3139 3042 2982 3043 2911 2657 2910 2556 2656 2448 2207 2447 2072 1782 1781 1625 1460 1107 1105  720  721  515   79  302
 417  199  626  827 1021 1205 1552 1548 1550 2011 2276 2395 2615 2012 2510 2801 2804 2619 2614 3022 2881 3021 3169 3198 3127 3199 3172 3225 3203 3205 3206 3207 3178 3140 3095 3044 2983 3040 2836 2659 2751 2446 2660 2552 2073 1932 1931    0 1626 1461 1288 1106  917  516  517  303   82
 200  416  624  625 1020  826 1381 1549 1380 1710 2147 2397 2145 2146 2711 2613 2709 3075 2710 3076 2954 3123 3125 3168 3201 3239 3222 3226 3227 3228 3208 3209 3142 3141 3096 3097 2984 2913 2661 2837 2658 2752 2449 2557 2074 2075 1933 1783 1627 1628 1289 1108  919  918  722  304   83
 198  415  825  623  824 1019 1203 1708 2009 1863 1862 1712 2143 2010 2507 2611 2797 2612 2800 3122 3128 2952 3017 3074 3165 3224 3223 3240 3243 3230 3229 3210 3179 3143 3144 3045 2986 2914 2558 2838 2985 2753 2332 2208 2334 2209 1934 1784 1462 1785  920  921  723  724  518  305   84
 197  414  622 1018  823 1204 1379 1547 1861 1864 1709 2008 2270 2508 2272 2275 2798 2708 2795 2879 3016 2877 3126 3167 3197 3221 3248 3242 3241 3244 3231 3211 3180 3098 3099 3046 2840 2917 2915 2662 2560 2333 2450 2335 2210 1787 2076 1465 1629 1109 1290 1291  725  922  519  306   85
 196  413  621 1016 1201 1202 1378 1546 1711 2007 2006 2141 2509 2608 2880 2392 2794 3020 2953 2796 3011 3072 3073 3121 3163 3220 3238 3247 3246 3245 3212 3181 3182 3146 3145 2987 2916 2918 2663 2841 2451 2561 2559 1935 2336 1936 1786 2077 1788 1463 1292 1110  923  520  521  307   86
 195  412  822  821 1017 1200 1377 1545 1707 1860 2004 2142 2394 2274 2396 2610 2876 2949 2712 3018 2951 3120 3118 3164 3196 3195 3217 3237 3235 3214 3232 3233 3183 3100 3047 3101 2988 2842 2919 2755 2562 2212 2337 2754 2453 2211 2079 1631 1464 1630 1293 1111 1294  726  522  308   87
 194  411  620 1014 1015 1199 1376 1544 1858 1857 2005 2391 2503 2393 2609 2506 2505 2878 3124 2707 3015 3071 3161 3162 3193 3156 3219 3236 3216 3234 3188 3186 3185 3184 3102 3048 3050 3049 2839 2664 2666 2563 2452 2078 2213 2082 1937 1938 1789 1466 1632 1112 1113  728  727  309   88
 193  410  619  820 1013 1198 1375 1704 1706 2003 1703 2140 2269 2271 2504 2607 2706 2793 2799 2948 2950 3159 3012 3013 3194 3218 3157 3191 3190 3215 3148 3187 3213 3147 3104 2989 2920 2843 2760 2844 2757 2564 2457 2339 2454 1939 2081 2083 1633 1468 1467 1295 1114  924  523  310   89
 192  409  618  819 1012 1197 1374 1543 1705 1859 2002 2268 2390 2389 2502 2704 2705 2874 2875 2947 3014 3070 3119 3192 3158 3115 3160 3112 3059 3111 3110 3152 3150 3103 3149 3051 2990 2921 2758 2756 2759 2665 2565 2340 2341 1940 1791 1790 1634 1297 1116 1469  927  729  524  311   90
 191  408  617  818 1011 1196 1373 1542 1856 2001 2138 2139 2267 2388 2501 2606 2703 2792 2873 2946 3068 3117 3069 3066 3114 3063 3113 3061 3189 3109 3058 3153 3108 3107 3106 3052 2991 2922 2845 2667 2566 2338 2455 2080 2214 2215 1942 1635 1793 1115 1471  925  926  730  525  312   91
 190  407  616  817 1010 1195 1372 1541 1702 1855 2000 2137 2266 2387 2500 2605 2702 2791 2872 2945 3009 2944 3067 3116 3064 3062 3003 3002 3154 3001 2998 3151 3056 3054 3105 3053 2992 2923 2846 2761 2668 2567 2342 2456 2084 2216 2217 1472 1470 1636 1296 1298  928  731  526  313   92
 189  406  615  816 1009 1194 1371 1540 1701 1854 1999 2136 2265 2386 2499 2604 2701 2790 2870 2943 3010 3008 3065 3006 3005 2863 3004 3060 3155 2934 2933 3057 2996 3055 2995 2994 2993 2924 2847 2762 2669 2568 2458 2459 2218 2085 1637 1792 1941 1299 1118 1119 1117  733  732  527  314
 188  405  614  815 1008 1193 1370 1539 1700 1853 1998 2135 2264 2385 2498 2603 2700 2789 2942 2871 2867 2941 3007 2937 2938 2862 3000 2935 2685 2856 2773 2997 2930 2929 2928 2927 2926 2925 2848 2763 2670 2569 2460 2343 2219 1943 1945 1794 1638 1639 1301 1300  929  930  528  315   93
 187  404  613  814 1007 1192 1369 1538 1699 1852 1997 2134 2263 2384 2497 2602 2699 2788 2868 2695 2866 2865 2939 2864 2780 2687 2936 2779 2999 2931 2858 2857 2855 2854 2853 2852 2851 2850 2849 2671 2765 2570 2461 2344 2086 2087 1796 1795 1640 1473 1474 1120  734  931  933  529   94
 186  403  612  813 1006 1191 1368 1537 1698 1851 1996 2133 2262 2383 2496 2601 2698 2787 2869 2693 2784 2783 2940 2782 2781 2861 2778 2860 2686 2775 2932 2683 2772 2771 2770 2769 2768 2767 2766 2764 2572 2574 2571 2345 2220 1944 1797 1475 1641 1476 1302 1122  735 1121  317  316   95
 185  402  611  812 1005 1190 1367 1536 1697 1850 1995 2132 2261 2382 2495 2600 2598 2696 2785 2786 2694 2692 2691 2690 2689 2688 2777 2480 2584 2859 2583 2774 2681 2680 2679 2678 2677 2577 2676 2675 2672 2573 2464 2346 2088 1946 1800 1948 1798 1477 1303  934  932  737  530  532   96
 184  401  610  811 1004 1189 1366 1535 1696 1849 1994 2131 2260 2381 2494 2599 2596 2697 2595 2488 2594 2593 2592 2590 2588 2589 2587 2482 2585 2776 2684 2682 2582 2581 2580 2579 2471 2355 2578 2575 2463 2673 2465 2221 2089 2090 1947 1642 1643 1801 1478 1125 1123  318  736  319   97
 183  400  609  810 1003 1188 1365 1534 1695 1848 1993 2130 2259 2380 2493 2492 2597 2490 2374 2489 2487 2486 2485 2591 2484 2481 2483 2586 2479 2478 2477 2476 2475 2474 2473 2357 2472 2470 2352 2674 2466 2462 2348 2226 2350 2222 1951 1644 1949 1480 1304 1479  739 1305  935  320   98
 182  399  608  809 1002 1187 1364 1533 1694 1847 1992 2129 2258 2379 2378 2375 2491 2251 2120 2373 2372 2371 2370 2369 2368 2367 2366 2365 2242 2363 2362 2361 2360 2236 2235 2234 2356 2469 2468 2576 2353 2347 2467 2351 2223 2224 1799 1646 2091 1307 1802 1306  534  738  531  100   99
 181  398  607  808 1001 1186 1363 1532 1693 1846 1991 2128 2257 2256 2253 2377 2122 2376 2252 2250 2249 2248 2247 2246 2245 2244 2243 2241 2364 2239 2238 2237 1967 2106 2359 2358 2233 2354 2232 2231 2229 2349 2228 2227 2094 1952 2092 1481 1804 1124 1309  939  740  535  533  321  741
 180  397  606  807 1000 1185 1362 1531 1692 1845 1990 2127 2126 2124 2255 2254 1983 2121 1981 1980 2119 2118 2117 2114 1975 2112 1972 2111 2240 2109 2108 2107 1968 2105 2104 2103 2102 2101 2099 2230 2098 2097 2096 2225 1955 2095 1803 1645 1954 1950  941 1126 1310  938  323  101  539
 179  396  605  806  999 1184 1361 1530 1691 1844 1989 1988 1987 2125 1986 1984 2123 1982 1834 1833 1979 1978 2116 2115 1827 2113 1974 1973 2110 1823 1970 1969 1821 1966 1965 1964 1963 1962 2100 1960 1959 1958 1957 1654 1956 2093 1648 1647 1482 1311 1130  940  537  936 1128  322  102
 178  395  604  805  998 1183 1360 1529 1690 1843 1842 1841 1840 1839 1985 1838 1836 1835 1681 1344 1832 1831 1512 1976 1829 1826 1671 1670 1971 1824 1822 1820 1819 1664 1818 1817 1816 1815 1961 1813 1812 1811 1810 1809 1650 1806 1807 1805 1652 1649  937 1308 1129 1127  324  536  104
 177  394  603  804  997 1182 1359 1528 1689 1688 1687 1686 1685 1684 1682 1837 1346 1518 1680 1678 1515 1677 1977 1675 1674 1828 1672 1506 1825 1668 1667 1666 1501 1331 1663 1662 1661 1659 1814 1658 1657 1656 1655 1653 1808 1490 1488 1953 1483 1315  744 1131 1132  106  743  103  538
 176  393  602  803  996 1181 1358 1527 1526 1525 1524 1523 1522 1350 1683 1521 1520 1517 1679 1516 1514 1676 1830 1341 1673 1510 1509 1669 1507 1505 1504 1503 1665 1500 1499 1328 1497 1660 1496 1495 1494 1322 1493 1492 1491 1651 1489 1314 1316 1484  747 1485  945  330  745  742  327
 175  392  601  802  995 1180 1357 1356 1355 1354 1353 1352 1351 1171 1348 1519 1347 1167 1345 1165 1342 1513 1511 1159 1338  972 1508 1336 1335 1334 1333 1332 1330 1502 1329 1327 1498 1326 1325 1145 1324 1323 1321 1141 1320 1319 1487 1317 1486 1313  942 1312  746  544  108  107  105
 174  391  600  801  994 1179 1178 1177 1176 1175 1174 1173 1172 1349  983 1170  981 1168  979 1164 1343 1163 1161 1160 1339 1340 1337 1157 1156 1155 1154 1153 1152 1151 1150 1149 1148 1147  958  959 1144 1143 1142  954 1140 1318 1138 1137 1136 1134 1135  947  946 1133  326  541  325
 173  390  599  800  993  992  991  990  989  988  987  791  986  984  788 1169  982 1166  784  978  976  975 1162  974  973  777 1158  775  968  773  967  769  966  965  963  962  961  960  957  763  560  955  758  759  757 1139  952  950  949  948  328  944  943  748  540  749  329
 172  389  598  799  798  797  796  795  793  792  985  587  376  790  789  787  786  980  785  783  977  781  780  779  778  776  971  969  774  772  569  771  768  964  767  564  766  765 1146  349  956  762  760  556  953  951  553  754  551  752  750  542  751  545  331  546  109
 171  388  597  596  595  165  593  592  794  591  590  589  377  586  585  584  583  581  151  782  580  578  577  576  575  574  572  573  571  359  570  770  568  566  354  565  563  562  764  559  348  761  558  554  344  341  124  340  550  753  339  548  335  547  111  543  110
 170  387  386  385  384  164  381  382  161  162  159  378  375  156  374  373  371  582  152  369  579  368  367  366  364  143  970  363  360  140  358  357  567  356  355  353  352  132  351  130  350  347  346  555  756  345  343  549  755  337  338  118  117  115  336  116  112
 169  168  167  166  163  383  594  380  160  379  588  158  157  155  154  153  372  370  150  149  148  147  365  146  145  361  144  362  142  141  139  138  137  136  135  134  133  561  131  129  128  127  557  126  125  342  122  123  121  552  120  119  334  114  333  332  113
