# This puzzle is unsolvable
72
   2    1    3    4    5    6    7    8  293    9  294   11   13   14   16  299   17   18   21  847   22  305   23   25  308   26   27   28   29   31  589   32   33   34   35   36   37   38  322   39   40  325  327   43   46  329   48  331   49  609   52  338  336   55  613   56   57   58   59   60   61   62   63   64   65   66   67   68   69   70   71   72
 284  285  286  287  288  289  290  291  292  568   10  295  296  572   15  300  301   19  577  303   20  579  306   24  583  585  586  309  311  312   30  315  316  317  318  319  320  321  598  864   41   42  324  326  328   45  873  606  607   51  876   50  334   53  880  339  340  341  342  343  344  345  346  347  348  349  350  351  352  353  354   73
 283  560  561  562  563  564  566  832  567  836  570   12  571 1098  839  574  575  576  302 1105  580  846  304  307  584  851  310  852  587  314  856  590  591  592  593  594  595  596  597  323  599  600   44  603  330   47  332  875  874 1135 1137  335  610   54 1139  614  615  616  617  618  619  620  621  622  623  624  625  626  627  628  355   74
 282  559  828  829  830  831  565  833  834  569  835  837  297  840  298 1099  841  842 1354 1106 1107 1356  578  845  581  849  854  853  855  313  588  857  858  859  860  861 1120  862  865  866  867  868  601  869 1128  602  605  872  608 1134  333 1389  612  611  882  883 1141 1142  884  885  886  887  888  889  890  891  892  893  894  629  356   75
 281  558  827 1088 1342 1090 1091 1092 1093 1094 1095 1096  838  573 1350 1100 1101  843  844 1355 1104 1358 1108  582  850 1110 1111 1112 1113 1114 1115 1116 1117 1118 1370 1119 1373  863 1124 1375 1125 1126 1129  871  870  604 1861 1131 1133 1626  877  878  337 1388  881 1140 1393 1143 1636 1144 1145 1146 1147 1148 1149 1150 1151 1152  895  630  357   76
 280  557  826 1087 1089 1340 1343 1344 1345 1346 1347 1591 1097 1590 1351 1594 1352 1102 1598 1599 2060  848 1357 1359 1109 1361 1362 1363 1364 1365 1366 1367 1368 1369 1371 1372 1121 1617 1122 1376 1377 1378 1127 1379 1381 1130 1132 2088 1383 1628 1629 1138 1865 1631 1391 1390 1635 1392 1394 1395 1396 1397 1398 1399 1400 1401 1402 1153  896  631  358   77
 279  556  825 1086 1339 1341 1585 1586 1587 1588 1589 1825 1592 1349 1827 1593 1596 1353 1831 1103 1833 1600 2063 1837 1360 1604 1605 1606 1607 1608 1609 1610 1611 1612 1613 1614 1615 1374 1123 1618 1619 1856 1621 1622 1380 1625 1859 1860 1862 1384 1386 1385 1630 2314 1870 1633 1637 1871 1872 1638 1639 1640 1641 1642 1643 1644 1403 1154  897  632  359   78
 278  555  824 1085 1338 1584 1820 1821 1822 1823 1824 1826 1348 2275 2274 1595 2056 2057 1597 2058 1836 1601 1602 1834 1603 1839 1840 1841 1842 1843 1844 1845 1846 2293 1849 1850 2077 1616 2078 1852 1853 1620 1855 1857 1624 1382 2087 1864 1136 1627 2090 1866 2093 1632  879 2095 2097 1634 2099 1873 1874 1875 1876 1877 1878 1645 1404 1155  898  633  360   79
 277  823 1084 1083 1582 1583 1819 2048 2049 2050 2051 2052 2053 2054 1828 2487 1829 1830 2279 1832 1835 2061 2062 2064 1838 2066 2285 2067 2069 2071 2072 2073 2075 1848 1847 2076 2295 2509 2712 2297 2299 1854 2303 2083 1623 1858 2307 2089 2518 1863 2091 1387 2092 1868 2096 1869 1867 2318 2100 2319 2101 2102 2103 2104 1879 1646 1405 1156  899  634  361   80
 553  275  554 1336 1337 1581 1818 2047 2268 2270 2482 2273 2271 2483 2485 2055 2486 2277 2059 2278 2280 2281 2282 2284 2065 2068 2287 2288 2289 2070 2290 2291 2292 2294 2507 2506 2508 1851 2080 2511 2079 2081 2302 2084 2085 2304 2086 2305 2306 2308 2310 2311 2312 2094 2316 2315 2526 2098 2530 2320 2532 2321 2322 2105 1880 1647 1406 1157  900  635  362   81
 276  821  820 1082 1335 1580 1817 2046 2267 2269 2481 2687 2272 3071 2688 2689 2276 2488 2489 2490 2491 2493 2494 2283 2496 2497 2286 2498 2702 2500 2502 2705 2503 2074 2708 3270 2710 2711 2296 2298 2082 2301 2513 2514 2515 2516 2517 2519 2520 2723 2521 2522 2523 2313 2728 2527 2730 2317 2732 2529 2531 2533 2323 2106 1881 1648 1407 1158  901  636  363   82
 274  552  822  819 1081 1579 1816 2045 2265 2480 2479 2683 2684 2484 2690 2883 2885 2691 2694 2889 2695 2492 2891 2696 2495 2699 2700 2499 2701 2703 2501 2704 2706 2504 2505 2907 2713 2906 2300 2714 2512 2716 2717 2912 2718 2720 2915 2721 2724 2918 2919 2725 2726 2525 2923 2524 2729 2528 2731 2733 2734 2324 2325 1882 1884 1649 1408 1159  902  637  364   83
 273  551  818  817 1334 1080 1578 2263 2044 2266 2880 2879 2686 3067 3070 2884 2887 2886 3075 3074 2888 3078 2890 2697 2698 2894 3083 2896 2898 2899 3087 2900 2707 2901 2902 2903 2905 3273 3093 2715 2510 2910 2911 2913 2914 3101 2719 2916 2309 3104 2920 2921 2922 2727 3110 2924 2925 2926 2927 2735 2930 2534 2108 2107 1885 1650 1409 1160  903  638  365   84
 272  550  549 1333 1332 1577 1815 2042 2043 2478 2682 2685 2882 3068 3069 3421 3073 3251 2693 3076 3077 3257 2892 2893 3080 2895 3082 3262 2897 3084 3267 3088 3266 3440 3090 3091 2904 3272 3095 2908 2909 3097 3098 3099 3280 3279 3102 3103 2722 3284 3106 3107 3108 3288 3109 3461 3290 3292 2736 2928 2536 2929 2327 2326 1883 1651 1410 1161  904  640  639   85
 548 1078 1079  815 1331 1576 2041 1813 2474 2476 2264 3065 3583 2881 3422 3250 2692 3424 3256 3255 3427 3254 3079 3259 3081 3260 3432 3261 3263 3085 3086 3265 3438 3269 3089 3274 2709 3443 3094 3275 3096 3276 3277 3278 3100 3281 3282 3283 3454 3773 3105 3285 3287 3459 3289 3113 3462 3115 3114 3116 2931 2535 2110 2109 1886 1652 1411 1162  905  641  366   86
 814  546 1076 1575  816 1812 1814 2262 2475 2473 2477 2878 2877 3249 3066 3584 3072 3253 3423 3425 3743 3426 3258 3429 3430 3594 3431 3434 3435 3264 3436 3437 3439 3268 3441 3442 3092 3606 3444 3445 3446 3610 3447 3612 3450 3451 3452 3453 3772 3456 3619 3286 3457 3458 3460 3464 3111 3112 3293 2737 2738 2328 2537 2112 2111 1653 1412 1163  906  642  367   87
 547  271 1330 1077 1328 1574 1811 2040 2678 2679 2681 3246 3248 2680 3247 3420 3252 3586 3741 3587 3745 3588 3428 3590 3748 3747 3749 3595 3433 3598 3599 3601 3756 3602 3603 3605 3271 3607 3762 3608 3766 4051 3764 3614 3448 3770 3616 3455 2917 3618 3620 3621 3622 3623 3624 3463 3291 3295 3118 3294 2740 2538 2741 1888 2329 1654 1655 1165  907   89  371  369
 270  813  267 1075 1573 1329 1810 2260 2261 2472 2677 2876 2874 3064 3245 3417 3740 3585 3890 3891 3742 3589 3746 3592 3893 3750 3593 3596 3597 3754 3755 3902 3757 4043 3759 3604 3760 3907 3908 3763 3912 3609 4053 3449 3613 3617 3916 3918 3615 3771 3774 3923 3777 3924 3117 3625 3465 3119 2932 2742 2934 2330 2115 1887 1413 1656 1166 1414  908  643  370  368
 266  268 1072 1074 1326 1327 2038 2039 2259 2471 2676 2875 3419 3418 3582 3244 3739 3888 4029 4030 3744 3591 3892 4033 3895 3896 3897 3751 3752 3753 3901 3900 3903 3600 3758 3906 4046 3761 3910 3765 3911 3913 4052 3767 3768 3769 3914 3915 3919 3920 3776 3922 3775 3779 3778 3626 3297 3296 2933 2935 2739 2331 2539 2113 1889 1415 1164  909  644  645   90   88
 545  269  544  543 1572 1808 1809 2037 2258 2675 2872 3063 3242 3581 3415 3416 3738 3887 3889 4161 4160 4031 4032 3894 4034 4035 4036 4038 3898 3899 4040 4041 3904 4042 3905 4045 4047 4178 4048 4180 3909 4049 3611 4183 4054 4055 3917 4057 4058 4059 4191 4061 3926 3925 3780 3627 3466 3120 3121 2540 2114 2334 2116 2332 1891 1657 1416 1167  647  910  372   91
 540  542  812  811 1073 1571 1807 2036 2256 2257 2470 2873 3062 3243 3241 3580 3737 3886 4028 4027 4284 4162 4163 4164 4165 4166 4167 4168 4037 4407 4039 4172 4173 4174 4044 4176 4177 4302 4303 4181 4182 4050 4306 4184 4185 4187 4056 4188 4189 4314 4192 4060 3921 4062 3781 3628 3467 3299 3123 3298 2541 2542 2335 2333 1658 1417 1168 1169  646  911  373   92
 541  810 1071 1070 1325 1570 1806 2035 2255 2469 2674 2871 3061 3060 3414 3579 3736 3885 4025 4026 4283 4285 4286 4287 4288 4289 4514 4515 4292 4405 4170 4171 4294 4298 4175 4299 4300 4301 4179 4417 4419 4304 4305 4307 4308 4186 4310 4311 4312 4190 4313 4193 4065 3927 3782 3629 3468 3300 3122 2743 2936 2117 1890 2543 1892 1659 1418 1170  912  648  374   93
 265  263  808 1323 1324 1569 1568 2034 2254 2468 2673 2870 3059 3240 3413 3578 3735 3884 4024 4159 4158 4400 4402 4609 4403 4290 4513 4404 4169 4408 4409 4410 4296 4297 4412 4413 4414 4522 4415 4418 4526 4420 4421 4422 4423 4309 4425 4426 4427 4428 4315 4063 4064 3928 3784 3783 3630 3469 3301 2939 2938 2546 2544 2118 1893 1660 1171 1420  913  649  375   94
 264  539 1069  809 1322 1567 1805 2467 2466 2253 2672 2869 3058 3239 3412 3577 3734 3883 4157 4282 4399 4398 4401 4509 4861 4607 4406 4706 4291 4790 4516 4295 4616 4517 4709 4519 4521 4520 4416 4525 4625 4527 4528 4529 4530 4424 4532 4533 4534 4429 4316 4195 4194 4066 3929 3631 3470 3124 2744 3125 2545 2745 2336 2119 1894 1661 1421 1419  914  650  376   95
 262  538  807 1068 1321 1566 1804 2033 2032 2465 2671 2868 3057 3238 3411 3576 3733 3882 4023 4156 4281 4507 4508 4510 4610 4512 4614 4511 4707 4704 4705 4791 4411 4864 4933 4523 4620 4524 4622 4624 4799 4626 4627 4628 4629 4531 4631 4632 4535 4430 4317 4196 3930 4068 3785 3632 3471 3302 2937 2747 2746 2548 2337 2120 1896 1895 1662 1172  915  651  377   96
 261  537  806 1067 1320 1564 1803 2031 2252 2464 2670 2867 3056 3237 3410 3575 3732 3881 4022 4155 4280 4397 4506 4608 4700 4611 4703 4787 4293 4612 4786 4617 4615 4710 4867 4618 4619 4713 4623 4715 4716 4875 4718 4720 4721 4630 4722 4633 4536 4431 4198 4319 4197 3931 3786 3633 3472 3126 3304 2942 2941 2748 2547 2338 2121 1663 1422 1173  916  378  379   97
 260  259  805 1066 1319 1801 1565 2030 2251 2463 2669 2866 3055 3236 3409 3574 3731 3880 4021 4154 4279 4396 4505 4785 4783 4860 4701 4784 4862 4613 4789 4793 4708 4518 4621 4797 4711 4795 4796 4873 4798 4800 4717 4801 4719 4723 4803 4724 4538 4537 4432 4318 4070 3932 3787 3634 3473 3128 3305 3127 2940 2749 2339 2122 1897 1664 1423 1174  917  652   98   99
 258  536  535 1065 1318 1802 1800 1799 2028 2029 2668 2865 3054 3235 3408 3573 3730 3879 4020 4153 4278 4395 4504 4605 4606 4698 4858 4788 4702 4929 4931 4865 4866 4792 4869 4868 4870 4937 4712 4872 4874 4942 4876 4804 4802 4806 4634 4635 4434 4199 4435 4323 4067 3933 3788 3635 3306 3475 3303 2943 2750 2549 2340 2123 1898 1665 1424 1175  918  653  381  380
 257  803  804 1064 1317 1563 1798 1562 2250 2249 2667 2864 3053 3234 3407 3572 3729 3878 4019 4152 4277 4394 4503 4604 4696 4699 4930 4926 4859 4928 4863 4990 4932 4934 4994 4938 4995 4794 4714 4940 4941 5002 4945 4877 4879 4944 4805 4878 4726 4433 4320 4202 4069 3934 3790 3789 3636 3474 3129 2944 2751 2550 2341 2124 1899 1666 1425 1176  919  654  382  100
 256  534  533  802 1063 1316 1561 2248 2461 2462 2666 2863 3052 3233 3406 3571 3728 3877 4018 4151 4276 4393 4502 4602 4603 4782 4697 4781 4988 5040 4989 4991 4992 4993 4935 4936 4998 4871 4939 4999 5000 5001 4943 4947 4725 4807 4638 4637 4636 4322 4321 4071 4200 4201 3935 3637 3476 3307 3130 2945 2752 2551 2342 2125 1900 1667 1426 1177  920  655  101  102
 255  532  801 1062 1315 1560 1797 2027 2026 2247 2664 2665 3051 3232 3405 3570 3727 3876 4017 4150 4275 4392 4501 4695 4780 4779 4857 4927 4987 4986 5041 5042 5043 5046 5045 5047 4996 4997 5048 5050 5052 5053 5003 4880 4727 4731 4808 4539 4540 4639 4436 4074 4072 3936 3791 3638 3477 3308 3131 2946 2753 2552 2343 2126 1901 1668 1427 1178  921  657  656  383
 254  531  800 1061 1314 1559 1796 2025 2246 2460 2663 2862 3050 3231 3404 3569 3726 3875 4016 4149 4274 4391 4500 4601 4694 4856 4923 4855 5039 5038 5084 5083 5087 5044 5088 5124 5089 5092 5128 5049 5051 5005 4946 4882 4809 4883 4810 4640 4541 4325 4324 4437 4073 3938 3792 3478 3479 3309 3132 2947 2754 2553 2344 2127 1902 1669 1428 1179  922  658  384  103
 253  530  799 1060 1313 1558 1795 2024 2245 2459 2458 2861 2860 3049 3403 3568 3725 3874 4015 4148 4273 4390 4499 4600 4693 4778 4854 4925 4985 5086 5121 5085 5122 5150 5123 5149 5171 5126 5093 5094 5095 5054 5006 5055 5004 4881 4728 4544 4439 4542 4204 4203 3937 4075 3639 3640 3311 3310 3134 2948 2755 2554 2345 2128 1903 1670 1429 1181 1180  923  659  104
 252  529  798 1059 1312 1557 1794 2023 2244 2457 2662 3048 3229 3230 3402 3567 3724 3873 4014 4147 4272 4389 4498 4599 4691 4692 4924 4777 4922 4984 5081 5082 5120 5148 5180 5090 5091 5154 5127 5129 5007 4948 4949 4729 4884 4812 4543 4641 4545 4438 4326 4205 4076 3939 3794 3481 3793 3133 3312 2950 2949 2756 2346 2129 1904 1430 1672  925  924  386  385  107
 251  528  797 1058 1311 1556 1793 2022 2243 2456 2661 2859 2858 3047 3228 3566 3723 3872 4013 4146 4271 4388 4497 4597 4598 4776 4853 4983 5036 5037 5080 5119 5147 5168 5146 5169 5125 5153 5155 5096 5131 5097 4953 4950 4730 4952 4885 4643 4546 4440 4327 4206 4077 3940 3795 3641 3642 3135 2758 2556 2757 2555 2130 1906 1905 1671 1431 1182  661  660  105  387
 250  527  796 1057 1310 1555 1792 2021 2242 2455 2660 2857 3046 3399 3224 3565 3722 3871 4012 4145 4270 4387 4496 4596 4690 4775 4852 4921 4982 5035 5079 5118 5117 5145 5179 5170 5151 5157 5130 5174 5098 5056 5057 4813 4951 4811 4642 4732 4441 4547 4328 4207 4078 3941 3643 3482 3480 3313 3136 2952 2557 2559 2348 2347 1673 1186 1434 1432 1184  106  389  388
 249  526  795 1056 1309 1554 1791 2020 2241 2454 2659 2856 3045 3400 3401 3227 3564 3870 4011 4144 4269 4386 4495 4595 4689 4774 4851 4920 5034 4980 5078 5116 5167 5182 5162 5172 5152 5175 5156 5178 5100 5099 5009 5008 5010 4886 4733 4887 4442 4444 4329 4079 3797 3798 3796 3644 3483 3314 2759 2951 2351 2953 2131 1675 1907 2132 1674  926 1183  662  109  390
 248  525  794 1055 1308 1553 1790 2019 2240 2453 2658 2855 3044 3226 3719 3225 3721 3720 3869 4143 4268 4385 4494 4594 4688 4773 4850 4919 4981 5032 5033 5115 5166 5164 5181 5139 5173 5160 5158 5132 5101 5058 5060 4954 4814 4734 4888 4644 4815 4735 4330 4209 4080 4082 3942 3645 3484 3139 3315 3138 2350 2349 2560 1909 2133 1908 1435  927 1433 1185  663  108
 247  524  793 1054 1307 1552 1789 2018 2239 2452 2657 2854 3043 3223 3868 3398 3718 3561 4010 4142 4267 4384 4493 4593 4687 4772 4849 4918 5030 5077 5143 5163 5177 5141 5165 5183 5176 5137 5159 5133 5134 5059 5061 5011 4889 4816 4645 4550 4549 4445 4208 4212 4443 3943 3944 3646 3316 3317 3137 2558 2954 2561 2760 2135 2352 1910 1677  929  930  928  110  393
 246  523  792 1053 1306 1551 1788 2017 2238 2451 2656 2853 3042 3222 3562 3563 3397 4009 4008 4141 4266 4383 4491 4492 4771 4770 4848 4917 4979 5075 5031 5114 5076 5071 5108 5109 5161 5138 5136 5135 5102 5012 5013 4891 4955 4817 4736 4647 4646 4548 4446 4332 4334 4083 3799 3647 3486 3485 3140 2955 2761 2563 2134 2137 1911 1676 1188 1436  392  664  391  111
 245  522  791 1052 1305 1550 1787 2016 2237 2450 2655 2852 3041 3395 3396 3559 3717 3867 3866 4140 4264 4265 4381 4382 4685 4686 4847 4916 4978 4977 5113 5112 5144 5142 5140 5069 5107 5106 5105 5104 5062 5014 4958 5015 4890 4818 4737 4648 4551 4210 4333 4211 4081 3802 3945 3801 3648 3318 3141 2956 2762 2763 2354 1912 2136 1187 1437  665  932  666  394  112
 244  521  790 1051 1304 1549 1786 2015 2236 2449 2654 2851 3040 3221 3394 3716 3560 3865 4007 4138 4139 4263 4380 4592 4684 4769 4846 4915 4976 5029 5074 5073 5111 5072 5110 5022 5068 5067 5066 5065 5103 5064 4960 5063 4956 4819 4738 4649 4552 4448 4447 4331 4085 4084 3803 3649 3142 3319 2958 3143 2957 2765 2355 2353 1678 1682 1679  931 1190  667  395  113
 243  520  789 1050 1303 1548 1785 2014 2235 2448 2653 2850 3039 3220 3393 3558 3715 3864 4006 4005 4489 4488 4490 4591 4683 4768 4845 4914 4975 5028 5027 5026 5025 5024 5070 4967 5021 5020 5019 5018 5017 5016 4957 4892 4893 4820 4739 4650 4553 4335 4213 3800 4337 3946 3947 3650 3487 3488 3489 3144 2764 2564 2562 1914 1681 1913 1189  933  934  114  669  115
 242  519  788 1049 1302 1547 1784 2013 2234 2447 2652 2849 3038 3219 3392 3557 3714 3863 4004 4137 4262 4379 4589 4590 4682 4767 4844 4913 4974 4973 4972 4971 4969 4905 5023 4968 4966 4965 4964 4963 4962 4961 4959 4894 4895 4821 4740 4651 4449 4336 4215 4088 4214 3804 3948 3651 3490 3320 3321 3145 2959 2768 2356 1680 2138 1438 1441 1439  670  396  671  116
 241  518  787 1048 1301 1546 1783 2012 2233 2446 2651 2848 3037 3218 3391 3556 3713 3862 4003 4136 4261 4378 4487 4588 4681 4766 4843 4912 4911 4910 4909 4908 4970 4835 4906 4904 4903 4902 4901 4900 4899 4898 4897 4825 4896 4822 4741 4652 4554 4555 4450 4217 3949 3950 3806 3805 3652 3492 3491 3322 2769 2566 2357 2565 1915 1916 1683 1440  935  668  398  397
 240  517  786 1047 1300 1545 1782 2011 2232 2445 2650 2847 3036 3217 3390 3555 3712 3861 4002 4135 4260 4377 4486 4587 4680 4765 4842 4841 4840 4839 4838 4837 4907 4836 4834 4833 4832 4831 4830 4829 4828 4827 4826 4746 4824 4823 4742 4653 4556 4451 4452 4216 4087 4086 3951 3653 3493 3654 3146 2960 2766 2767 2567 2359 2358 1684 1443 1191  937 1193  117  118
 239  516  785 1046 1299 1544 1781 2010 2231 2444 2649 2846 3035 3216 3389 3554 3711 3860 4001 4134 4259 4376 4485 4586 4679 4764 4763 4762 4761 4760 4759 4758 4757 4756 4755 4754 4753 4752 4751 4750 4749 4748 4747    0 4745 4744 4743 4654 4557 4339 4218 4338 4089 3952 3807 3495 3324 3323 2963 2961 2770 2142 2360 2139 2140 1444 1685 1192 1194  936  672  399
 238  515  784 1045 1298 1543 1780 2009 2230 2443 2648 2845 3034 3215 3388 3553 3710 3859 4000 4133 4258 4375 4484 4585 4678 4677 4676 4675 4674 4673 4672 4671 4670 4669 4668 4667 4666 4665 4664 4663 4662 4661 4660 4659 4658 4657 4656 4655 4558 4453 4340 4219 4090 3953 3808 3494 3655 3149 3147 2771 2569 2568 2141 1919 2143 1918 1442 1195  938  674  400  119
 237  514  783 1044 1297 1542 1779 2008 2229 2442 2647 2844 3033 3214 3387 3552 3709 3858 3999 4132 4257 4374 4483 4584 4583 4582 4581 4580 4579 4578 4577 4576 4575 4574 4573 4572 4571 4570 4569 4568 4567 4566 4565 4564 4563 4562 4561 4560 4559 4454 4341 4220 4091 3954 3809 3325 2962 3148 2965 2964 2570 2361 2362 1920 1917 1686 1445 1196  939  401  673  120
 236  513  782 1043 1296 1541 1778 2007 2228 2441 2646 2843 3032 3213 3386 3551 3708 3857 3998 4131 4256 4373 4482 4481 4480 4479 4478 4477 4476 4475 4474 4473 4472 4471 4470 4469 4468 4467 4466 4465 4464 4463 4462 4461 4460 4459 4458 4457 4456 4455 4342 4221 4092 3955 3810 3656 3326 3150 3328 2966 2772 2571 2145 2146 2144 1687 1446 1197  940  675  402  121
 235  512  781 1042 1295 1540 1777 2006 2227 2440 2645 2842 3031 3212 3385 3550 3707 3856 3997 4130 4255 4372 4371 4370 4369 4368 4367 4366 4365 4364 4363 4362 4361 4360 4359 4358 4357 4356 4355 4354 4353 4352 4351 4350 4349 4348 4347 4346 4345 4344 4343 4222 4093 3956 3811 3327 3657 3497 3496 3151 2773 2572 2363 2147 1921 1688 1447 1198  941  676  403  122
 234  511  780 1041 1294 1539 1776 2005 2226 2439 2644 2841 3030 3211 3384 3549 3706 3855 3996 4129 4254 4253 4252 4251 4250 4249 4248 4247 4246 4245 4244 4243 4242 4241 4240 4239 4238 4237 4236 4235 4234 4233 4232 4231 4230 4229 4228 4227 4226 4225 4224 4223 4094 3957 3812 3658 3659 3329 3152 2967 2774 2573 2365 2364 1922 1689 1448 1199  942  677  404  123
 233  510  779 1040 1293 1538 1775 2004 2225 2438 2643 2840 3029 3210 3383 3548 3705 3854 3995 4128 4127 4126 4125 4124 4123 4122 4121 4120 4119 4118 4117 4116 4115 4114 4113 4112 4111 4110 4109 4108 4107 4106 4105 4104 4103 4102 4101 4100 4099 4098 4097 4096 4095 3958 3813 3660 3498 3330 3153 2968 2775 2574 2366 2148 1923 1690 1449 1200  943  678  405  124
 232  509  778 1039 1292 1537 1774 2003 2224 2437 2642 2839 3028 3209 3382 3547 3704 3853 3994 3993 3992 3991 3990 3989 3988 3987 3986 3985 3984 3983 3982 3981 3980 3979 3978 3977 3976 3975 3974 3973 3972 3971 3970 3969 3968 3967 3966 3965 3964 3963 3962 3961 3960 3959 3814 3661 3499 3500 3154 2969 2776 2575 2367 2149 1924 1691 1450 1201  944  679  406  125
 231  508  777 1038 1291 1536 1773 2002 2223 2436 2641 2838 3027 3208 3381 3546 3703 3852 3851 3850 3849 3848 3847 3846 3845 3844 3843 3842 3841 3840 3839 3838 3837 3836 3835 3834 3833 3832 3831 3830 3829 3828 3827 3826 3825 3824 3823 3822 3821 3820 3819 3818 3817 3816 3815 3662 3501 3331 3155 2971 2970 2576 2151 2368 1925 1692 1451 1202  945  680  407  126
 230  507  776 1037 1290 1535 1772 2001 2222 2435 2640 2837 3026 3207 3380 3545 3702 3701 3700 3699 3698 3697 3696 3695 3694 3693 3692 3691 3690 3689 3688 3687 3686 3685 3684 3683 3682 3681 3680 3679 3678 3677 3676 3675 3674 3673 3672 3671 3670 3669 3668 3667 3666 3665 3664 3663 3502 3332 3333 3156 2777 2778 2577 2150 2152 1693 1452 1203  946  681  408  127
 229  506  775 1036 1289 1534 1771 2000 2221 2434 2639 2836 3025 3206 3379 3544 3543 3542 3541 3540 3539 3538 3537 3536 3535 3534 3533 3532 3531 3530 3529 3528 3527 3526 3525 3524 3523 3522 3521 3520 3519 3518 3517 3516 3515 3514 3513 3512 3511 3510 3509 3508 3507 3506 3505 3504 3503 3334 3157 2972 2779 2578 2369 1927 1926 1694 1453 1204  947  682  409  128
 228  505  774 1035 1288 1533 1770 1999 2220 2433 2638 2835 3024 3205 3378 3377 3376 3375 3374 3373 3372 3371 3370 3369 3368 3367 3366 3365 3364 3363 3362 3361 3360 3359 3358 3357 3356 3355 3354 3353 3352 3351 3350 3349 3348 3347 3346 3345 3344 3343 3342 3341 3340 3339 3338 3337 3336 3335 3158 2973 2780 2579 2370 2153 1928 1695 1454 1205  948  683  410  129
 227  504  773 1034 1287 1532 1769 1998 2219 2432 2637 2834 3023 3204 3203 3202 3201 3200 3199 3198 3197 3196 3195 3194 3193 3192 3191 3190 3189 3188 3187 3186 3185 3184 3183 3182 3181 3180 3179 3178 3177 3176 3175 3174 3173 3172 3171 3170 3169 3168 3167 3166 3165 3164 3163 3162 3161 3160 3159 2974 2781 2580 2371 2154 1929 1696 1455 1206  949  684  411  130
 226  503  772 1033 1286 1531 1768 1997 2218 2431 2636 2833 3022 3021 3020 3019 3018 3017 3016 3015 3014 3013 3012 3011 3010 3009 3008 3007 3006 3005 3004 3003 3002 3001 3000 2999 2998 2997 2996 2995 2994 2993 2992 2991 2990 2989 2988 2987 2986 2985 2984 2983 2982 2981 2980 2979 2978 2977 2976 2975 2782 2581 2372 2155 1930 1697 1456 1207  950  685  412  131
 225  502  771 1032 1285 1530 1767 1996 2217 2430 2635 2832 2831 2830 2829 2828 2827 2826 2825 2824 2823 2822 2821 2820 2819 2818 2817 2816 2815 2814 2813 2812 2811 2810 2809 2808 2807 2806 2805 2804 2803 2802 2801 2800 2799 2798 2797 2796 2795 2794 2793 2792 2791 2790 2789 2788 2787 2786 2785 2784 2783 2582 2373 2156 1931 1698 1457 1208  951  686  413  132
 224  501  770 1031 1284 1529 1766 1995 2216 2429 2634 2633 2632 2631 2630 2629 2628 2627 2626 2625 2624 2623 2622 2621 2620 2619 2618 2617 2616 2615 2614 2613 2612 2611 2610 2609 2608 2607 2606 2605 2604 2603 2602 2601 2600 2599 2598 2597 2596 2595 2594 2593 2592 2591 2590 2589 2588 2587 2586 2585 2584 2583 2374 2157 1932 1699 1458 1209  952  687  414  133
 223  500  769 1030 1283 1528 1765 1994 2215 2428 2427 2426 2425 2424 2423 2422 2421 2420 2419 2418 2417 2416 2415 2414 2413 2412 2411 2410 2409 2408 2407 2406 2405 2404 2403 2402 2401 2400 2399 2398 2397 2396 2395 2394 2393 2392 2391 2390 2389 2388 2387 2386 2385 2384 2383 2382 2381 2380 2379 2378 2377 2376 2375 2158 1933 1700 1459 1210  953  688  415  134
 222  499  768 1029 1282 1527 1764 1993 2214 2213 2212 2211 2210 2209 2208 2207 2206 2205 2204 2203 2202 2201 2200 2199 2198 2197 2196 2195 2194 2193 2192 2191 2190 2189 2188 2187 2186 2185 2184 2183 2182 2181 2180 2179 2178 2177 2176 2175 2174 2173 2172 2171 2170 2169 2168 2167 2166 2165 2164 2163 2162 2161 2160 2159 1934 1701 1460 1211  954  689  416  135
 221  498  767 1028 1281 1526 1763 1992 1991 1990 1989 1988 1987 1986 1985 1984 1983 1982 1981 1980 1979 1978 1977 1976 1975 1974 1973 1972 1971 1970 1969 1968 1967 1966 1965 1964 1963 1962 1961 1960 1959 1958 1957 1956 1955 1954 1953 1952 1951 1950 1949 1948 1947 1946 1945 1944 1943 1942 1941 1940 1939 1938 1937 1936 1935 1702 1461 1212  955  690  417  136
 220  497  766 1027 1280 1525 1762 1761 1760 1759 1758 1757 1756 1755 1754 1753 1752 1751 1750 1749 1748 1747 1746 1745 1744 1743 1742 1741 1740 1739 1738 1737 1736 1735 1734 1733 1732 1731 1730 1729 1728 1727 1726 1725 1724 1723 1722 1721 1720 1719 1718 1717 1716 1715 1714 1713 1712 1711 1710 1709 1708 1707 1706 1705 1704 1703 1462 1213  956  691  418  137
 219  496  765 1026 1279 1524 1523 1522 1521 1520 1519 1518 1517 1516 1515 1514 1513 1512 1511 1510 1509 1508 1507 1506 1505 1504 1503 1502 1501 1500 1499 1498 1497 1496 1495 1494 1493 1492 1491 1490 1489 1488 1487 1486 1485 1484 1483 1482 1481 1480 1479 1478 1477 1476 1475 1474 1473 1472 1471 1470 1469 1468 1467 1466 1465 1464 1463 1214  957  692  419  138
 218  495  764 1025 1278 1277 1276 1275 1274 1273 1272 1271 1270 1269 1268 1267 1266 1265 1264 1263 1262 1261 1260 1259 1258 1257 1256 1255 1254 1253 1252 1251 1250 1249 1248 1247 1246 1245 1244 1243 1242 1241 1240 1239 1238 1237 1236 1235 1234 1233 1232 1231 1230 1229 1228 1227 1226 1225 1224 1223 1222 1221 1220 1219 1218 1217 1216 1215  958  693  420  139
 217  494  763 1024 1023 1022 1021 1020 1019 1018 1017 1016 1015 1014 1013 1012 1011 1010 1009 1008 1007 1006 1005 1004 1003 1002 1001 1000  999  998  997  996  995  994  993  992  991  990  989  988  987  986  985  984  983  982  981  980  979  978  977  976  975  974  973  972  971  970  969  968  967  966  965  964  963  962  961  960  959  694  421  140
 216  493  762  761  760  759  758  757  756  755  754  753  752  751  750  749  748  747  746  745  744  743  742  741  740  739  738  737  736  735  734  733  732  731  730  729  728  727  726  725  724  723  722  721  720  719  718  717  716  715  714  713  712  711  710  709  708  707  706  705  704  703  702  701  700  699  698  697  696  695  422  141
 215  492  491  490  489  488  487  486  485  484  483  482  481  480  479  478  477  476  475  474  473  472  471  470  469  468  467  466  465  464  463  462  461  460  459  458  457  456  455  454  453  452  451  450  449  448  447  446  445  444  443  442  441  440  439  438  437  436  435  434  433  432  431  430  429  428  427  426  425  424  423  142
 214  213  212  211  210  209  208  207  206  205  204  203  202  201  200  199  198  197  196  195  194  193  192  191  190  189  188  187  186  185  184  183  182  181  180  179  178  177  176  175  174  173  172  171  170  169  168  167  166  165  164  163  162  161  160  159  158  157  156  155  154  153  152  151  150  149  148  147  146  145  144  143
