# This puzzle is unsolvable
62
   2    1    3    4    5    6    7    8    9   10   11   12   13   14   15   16   17   18   19   20   21   22   23   24   25   26   27   28   29   30   31   32   33   34   35   36   37   38   39   40   41   42   43   44   45   46   47   48   49   50   51   52   53   54   55   56   57   58   59   60   61   62
 244  245  246  247  248  249  250  251  252  253  254  255  256  257  258  259  260  261  262  263  264  265  266  267  268  269  270  271  272  273  274  275  276  277  278  279  280  281  282  283  284  285  286  287  288  289  290  291  292  293  294  295  296  297  298  299  300  301  302  303  304   63
 243  480  481  482  483  484  485  486  487  488  489  490  491  492  493  494  495  496  497  498  499  500  501  502  503  504  505  506  507  508  509  510  511  512  513  514  515  516  517  518  519  520  521  522  523  524  525  526  527  528  529  530  531  532  533  534  535  536  537  538  305   64
 242  479  708  709  710  711  712  713  714  715  716  717  718  719  720  721  722  723  724  725  726  727  728  729  730  731  732  733  734  735  736  737  738  739  740  741  742  743  744  745  746  747  748  749  750  751  752  753  754  755  756  757  758  759  760  761  762  763  764  539  306   65
 241  478  707  928  929  930  931  932  933  934  935  936  937  938  939  940  941  942  943  944  945  946  947  948  949  950  951  952  953  954  955  956  957  958  959  960  961  962  963  964  965  966  967  968  969  970  971  972  973  974  975  976  977  978  979  980  981  982  765  540  307   66
 240  477  706  927 1140 1141 1142 1143 1144 1145 1146 1147 1148 1149 1150 1151 1152 1153 1154 1155 1156 1157 1158 1159 1160 1161 1162 1163 1164 1165 1166 1167 1168 1169 1170 1171 1172 1173 1174 1175 1176 1177 1178 1179 1180 1181 1182 1183 1184 1185 1186 1187 1188 1189 1190 1191 1192  983  766  541  308   67
 239  476  705  926 1139 1344 1345 1346 1347 1348 1349 1350 1351 1352 1353 1354 1355 1356 1357 1358 1359 1360 1361 1362 1363 1364 1365 1366 1367 1368 1369 1370 1371 1372 1373 1374 1375 1376 1377 1378 1379 1380 1381 1382 1383 1384 1385 1386 1387 1388 1389 1390 1391 1392 1393 1394 1193  984  767  542  309   68
 238  475  704  925 1138 1343 1540 1541 1542 1543 1544 1545 1546 1547 1548 1549 1550 1551 1552 1553 1554 1555 1556 1557 1558 1559 1560 1561 1562 1563 1564 1565 1566 1567 1568 1569 1570 1571 1572 1573 1574 1575 1576 1577 1578 1579 1580 1581 1582 1583 1584 1585 1586 1587 1588 1395 1194  985  768  543  310   69
 237  474  703  924 1137 1342 1539 1728 1729 1730 1731 1732 1733 1734 1735 1736 1737 1738 1739 1740 1741 1742 1743 1744 1745 1746 1747 1748 1749 1750 1751 1752 1753 1754 1755 1756 1757 1758 1759 1760 1761 1762 1763 1764 1765 1766 1767 1768 1769 1770 1771 1772 1773 1774 1589 1396 1195  986  769  544  311   70
 236  473  702  923 1136 1341 1538 1727 1908 1909 1910 1911 1912 1913 1914 1915 1916 1917 1918 1919 1920 1921 1922 1923 1924 1925 1926 1927 1928 1929 1930 1931 1932 1933 1934 1935 1936 1937 1938 1939 1940 1941 1942 1943 1944 1945 1946 1947 1948 1949 1950 1951 1952 1775 1590 1397 1196  987  770  545  312   71
 235  472  701  922 1135 1340 1537 1726 1907 2080 2081 2082 2083 2084 2085 2086 2087 2088 2089 2090 2091 2092 2093 2094 2095 2096 2097 2098 2099 2100 2101 2102 2103 2104 2105 2106 2107 2108 2109 2110 2111 2112 2113 2114 2115 2116 2117 2118 2119 2120 2121 2122 1953 1776 1591 1398 1197  988  771  546  313   72
 234  471  700  921 1134 1339 1536 1725 1906 2079 2244 2245 2246 2247 2248 2249 2250 2251 2252 2253 2254 2255 2256 2257 2258 2259 2260 2261 2262 2263 2264 2265 2266 2267 2268 2269 2270 2271 2272 2273 2274 2275 2276 2277 2278 2279 2280 2281 2282 2283 2284 2123 1954 1777 1592 1399 1198  989  772  547  314   73
 233  470  699  920 1133 1338 1535 1724 1905 2078 2243 2400 2401 2402 2403 2404 2405 2406 2407 2408 2409 2410 2411 2412 2413 2414 2415 2416 2417 2418 2419 2420 2421 2422 2423 2424 2425 2426 2427 2428 2429 2430 2431 2432 2433 2434 2435 2436 2437 2438 2285 2124 1955 1778 1593 1400 1199  990  773  548  315   74
 232  469  698  919 1132 1337 1534 1723 1904 2077 2242 2399 2548 2549 2550 2551 2552 2553 2554 2555 2556 2557 2558 2559 2560 2561 2562 2563 2564 2565 2566 2567 2568 2569 2570 2571 2572 2573 2574 2575 2576 2577 2578 2579 2580 2581 2582 2583 2584 2439 2286 2125 1956 1779 1594 1401 1200  991  774  549  316   75
 231  468  697  918 1131 1336 1533 1722 1903 2076 2241 2398 2547 2688 2689 2690 2691 2692 2693 2694 2695 2696 2697 2698 2699 2700 2701 2702 2703 2704 2705 2706 2707 2708 2709 2710 2711 2712 2713 2714 2715 2716 2717 2718 2719 2720 2721 2722 2585 2440 2287 2126 1957 1780 1595 1402 1201  992  775  550  317   76
 230  467  696  917 1130 1335 1532 1721 1902 2075 2240 2397 2546 2687 2820 2821 2822 2823 2824 2825 2826 2827 2828 2829 2830 2831 2832 2833 2834 2835 2836 2837 2838 2839 2840 2841 2842 2843 2844 2845 2846 2847 2848 2849 2850 2851 2852 2723 2586 2441 2288 2127 1958 1781 1596 1403 1202  993  776  551  318   77
 229  466  695  916 1129 1334 1531 1720 1901 2074 2239 2396 2545 2686 2819 2944 2945 2946 2947 2948 2949 2950 2951 2952 2953 2954 2955 2956 2957 2958 2959 2961 3076 2962 2963 2964 2965 2966 2967 2968 2969 2970 2971 2972 2973 2974 2853 2724 2587 2442 2289 2128 1959 1782 1597 1404 1203  994  777  552  319   78
 228  465  694  915 1128 1333 1530 1719 1900 2073 2238 2395 2544 2685 2818 2943 3060 3061 3062 3063 3064 3065 3066 3067 3068 3069 3070 3071 3072 3073 3074 2960 3077 3078 3079 3186 3080 3081 3082 3083 3084 3085 3086 3087 3088 2975 2854 2725 2588 2443 2290 2129 1960 1783 1598 1405 1204  995  778  553  320   79
 227  464  693  914 1127 1332 1529 1718 1899 2072 2237 2394 2543 2684 2817 2942 3059 3168 3169 3170 3171 3172 3173 3174 3175 3176 3177 3178 3180 3181 3182 3075 3183 3283 3184 3185 3187 3188 3189 3190 3191 3192 3193 3194 3089 2976 2855 2726 2589 2444 2291 2130 1961 1784 1599 1406 1205  996  779  554  321   80
 226  463  692  913 1126 1331 1528 1717 1898 2071 2236 2393 2542 2683 2816 2941 3058 3167 3268 3269 3270 3271 3272 3273 3274 3275 3276 3278 3179 3279 3280 3281 3372 3373 3284 3285 3286 3287 3288 3289 3290 3291 3292 3195 3090 2977 2856 2727 2590 2445 2292 2131 1786 1962 1785 1407 1206  997  780  555  322   81
 225  462  691  912 1125 1330 1527 1716 1897 2070 2235 2392 2541 2682 2815 2940 3057 3166 3267 3360 3361 3362 3363 3364 3365 3366 3367 3277 3369 3454 3371 3531 3455 3282 3374 3375 3376 3378 3379 3380 3381 3382 3293 3196 3091 2978 2857 2728 2591 2446 2294 2293 1964 1787 1600 1207 1208  998  781  556  323   82
 224  461  690  911 1124 1329 1526 1715 1896 2069 2234 2391 2540 2681 2814 2939 3056 3165 3266 3359 3444 3445 3446 3447 3448 3449 3450 3452 3527 3370 3530 3657 3456 3458 3457 3460 3377 3461 3462 3463 3464 3383 3294 3197 3092 2979 2858 2729 2592 2447 2133 2295 2132 1963 1601 1408 1209  999  782  557  324   83
 223  460  689  910 1123 1328 1525 1714 1895 2068 2233 2390 2539 2680 2813 2938 3055 3164 3265 3358 3443 3520 3521 3522 3523 3524 3526 3368 3593 3595 3528 3655 3453 3532 3459 3601 3602 3536 3537 3538 3465 3384 3295 3198 3093 2980 2860 2859 2730 2593 2448 1788 1789 1603 1409 1602 1604 1000  783  558  325   84
 222  459  688  909 1122 1327 1524 1713 1894 2067 2232 2389 2538 2679 2812 2937 3054 3163 3264 3357 3442 3519 3588 3589 3590 3591 3525 3451 3653 3594 3529 3597 3598 3599 3535 3534 3661 3603 3604 3539 3466 3385 3296 3199 3094 2981 2861 2733 2594 2296 2450 1965 1967 1966 1605 1410 1411 1210 1001  559  326   85
 221  458  687  908 1121 1326 1523 1712 1893 2066 2231 2388 2537 2678 2811 2936 3053 3162 3263 3356 3441 3518 3587 3648 3649 3650 3592 3652 3654 3705 3706 3596 3658 3711 3533 3660 3659 3662 3605 3540 3467 3386 3297 3200 3095 2982 2862 2595 2596 2449 2136 2134 2137 2135 1606 1211 1002  785  784  560  327   86
 220  457  686  907 1120 1325 1522 1711 1892 2065 2230 2387 2536 2677 2810 2935 3052 3161 3262 3355 3440 3517 3586 3647 3700 3701 3651 3703 3704 3748 3750 3656 3708 3600 3709 3710 3712 3663 3606 3541 3468 3387 3298 3201 3096 2983 2732 2863 2451 2299 2298 1968 2138 1413 1790 1412 1212 1003  786  561  328   87
 219  456  685  906 1119 1324 1521 1710 1891 2064 2229 2386 2535 2676 2809 2934 3051 3160 3261 3354 3439 3516 3585 3646 3699 3744 3702 3745 3746 3749 3751 3812 3707 3752 3753 3754 3713 3664 3607 3542 3469 3388 3299 3202 3097 2984 2864 2731 2597 2297 2300 2452 1791 1792 1607 1414 1213 1004  787  562  329   88
 218  455  684  905 1118 1323 1520 1709 1890 2063 2228 2385 2534 2675 2808 2933 3050 3159 3260 3353 3438 3515 3584 3645 3698 3743 3780 3781 3782 3783 3747 3784 3786 3787 3788 3755 3714 3665 3608 3543 3470 3389 3300 3203 3098 2865 2986 2734 2598 2453 2301 2139 2140 1793 1971 1415 1214 1005  788  563  330   89
 217  454  683  904 1117 1322 1519 1708 1889 2062 2227 2384 2533 2674 2807 2932 3049 3158 3259 3352 3437 3514 3583 3644 3697 3742 3779 3808 3809 3785 3811 3831 3813 3814 3789 3756 3715 3666 3609 3544 3471 3390 3301 3204 3099 2985 2735 2737 2454 2455 2141 1969 1970 1794 1608 1609 1416 1006  789  564  331   90
 216  453  682  903 1116 1321 1518 1707 1888 2061 2226 2383 2532 2673 2806 2931 3048 3157 3258 3351 3436 3513 3582 3643 3696 3741 3778 3807 3840 3829 3828 3842 3815 3790 3791 3757 3716 3667 3610 3545 3472 3391 3205 3100 3206 2987 2866 2736 2600 2599 2302 2142 1972 1795 1610 1417 1215 1007  790  565  332   91
 215  452  681  902 1115 1320 1517 1706 1887 2060 2225 2382 2531 2672 2805 2930 3047 3156 3257 3350 3435 3511 3512 3581 3695 3740 3777 3806 3827 3810 3833 3832 3843 3816 3792 3758 3717 3668 3611 3546 3473 3392 3302 3303 2988 3101 2867 2990 2738 2456 2303 1797 1611 1612 1419 1418 1216 1009  791  566  333   92
 214  451  680  901 1114 1319 1516 1705 1886 2059 2224 2381 2530 2671 2804 2929 3046 3155 3256 3349 3434 3580 3579 3642 3641 3738 3739 3774 3805 3839 3841 3830 3821 3817 3819 3760 3669 3612 3613 3547 3474 3393 3304 3207 2604 2603 2989 2739 2601 2457 2143 1974 1973 1798 1613 1008 1217 1219  793  567  334   93
 213  450  679  900 1113 1318 1515 1704 1885 2057 2058 2380 2529 2670 2803 2928 3045 3154 3255 3348 3433 3510 3640 3639 3694 3693 3776 3773 3775 3838 3822 3837 3834 3820 3835 3793 3759 3670 3548 3475 3549 3394 3305 3208 2991 3103 3102 2869 2870 2304 2306 1796 1977 1799 1975 1420  792 1218 1010  568  335   94
 212  449  678  899 1112 1317 1514 1703 1884 2223 2222 2379 2528 2669 2802 2927 3044 3153 3254 3347 3432 3509 3578 3692 3638 3771 3737 3803 3823 3824 3767 3769 3836 3797 3818 3718 3722 3762 3719 3614 3550 3476 3308 3104 2742 2458 2868 2740 2602 2459 2305 2144 1976 1800 1614 1421 1220 1011  570  569  336   95
 211  448  677  898 1111 1316 1513 1702 1883 2056 2377 2221 2527 2801 2800 2926 3043 3152 3253 3346 3431 3508 3577 3637 3736 3691 3772 3804 3826 3825 3800 3799 3798 3794 3723 3761 3671 3720 3672 3615 3478 3477 3395 3309 3209 2992 3106 2741 2606 2743 2460 2145 2146 1978 1615 1422 1221 1012  794  795  337   96
 210  447  676  897 1110 1315 1512 1701 1882 2378 2376 2220 2668 2526 2667 2925 3042 3151 3252 3345 3430 3507 3576 3636 3690 3735 3802 3732 3685 3801 3770 3728 3766 3796 3724 3765 3795 3673 3617 3479 3552 3396 3307 3105 3306 2871 2993 2872 2607 2605 2307 2308 1979 1801 1616 1423 1222  797  796  571  338   97
 209  446  675  896 1109 1314 1511 1700 1881 2055 2054 2375 2525 2665 2666 2924 3041 3150 3344 3429 3506 3575 3572 3689 3688 3734 3686 3733 3731 3730 3768 3727 3726 3725 3721 3678 3619 3677 3553 3616 3480 3398 3212 3210 3211 3213 2994 2873 2462 2461 2309 2147 1980 1802 1617 1424 1014 1013  572  573  339   98
 208  445  674  895 1108 1313 1510 1699 1880 2053 2219 2217 2524 2799 2797 2798 2923 3149 3251 3343 3427 3428 3505 3574 3635 3568    0 3630 3628 3683 3729 3682 3680 3622 3764 3618 3675 3676 3763 3551 3397 3310 3311 3214 3108 2995 2745 2744 2609 2746 2310 2148 2150 1803 1618 1425 1223 1224 1015  574  340   99
 207  444  673  894 1107 1312 1509 1698 1879 2052 2218 2373 2523 2663 2664 3039 3148 3147 3250 3342 3504 3340 3501 3573 3570 3633 3687 3566 3629 3684 3493 3681 3562 3679 3624 3559 3621 3557 3674 3554 3481 3399 3109 3215 3110 3107 2874 2464 2463 2608 2311 1981 2149 1804 1619 1426 1225 1016  798  575  341  100
 206  443  672  893 1106 1311 1505 2050 2051 2048 2216 2521 2917 2922 2921 2662 2794 2920 3249 3341 3426 3339 3422 3634 3571 3632 3569 3567 3565 3494 3564 3627 3492 3625 3563 3560 3558 3620 3485 3555 3312 3482 3400 3313 2997 2996 2747 2878 2610 2465 2313 2312 1983 1982 1620 1427 1226 1017  799  342  343  101
 205  442  671  892 1105 1507 1697 1877 1508 2374 1878 2215 2793 2795 2657 2919 3040 3245 3246 3335 3146 3503 3421 3423 3499 3498 3497 3631 3495 3415 3414 3490 3626 3489 3561 3407 3487 3320 3556 3405 3483 3401 3402 3216 3111 2748 2876 2875 2611 2466 2314 2151 2152 1805 1806 1428 1227 1018  800  576  344  102
 204  441  670  891 1506 1695 1694 1504 2049 1876 2522 2658 2372 2370 2214 3036 3247 3242 3144 3248 3502 3336 3424 3500 3420 3418 3417 3496 3416 3232 3412 3325 3623 3411 3409 3488 3484 3406 3319 3318 3404 3403 3314 3112 2999 2877 2998 2750 2749 2154 2316 2315 1984 1807 1621 1429 1228 1019  801  802  577  103
 203  440  669  890 1104 1310 1103 1309 1696 2369 1875 2516 2792 2661 2796 2659 3035 2918 3034 3425 3338 3334 3136 3333 3239 3419 3331 3235 3329 3328 3129 3491 3413 3324 3410 3323 3408 3486 3224 3223 3317 3316 3315 3003 3000 3001 2879 2751 2467 2612 2613 2153 1985 1808 1622 1430 1229 1020  803  578  345  104
 202  439  668  889 1102 1308 1693 2047 1874 2046 2660 2371 2520 2518 3038 2790 2916 3145 3244 3241 3243 3138 3240 3238 3236 3332 3330 3133 3234 3233 3327 3231 3229 3228 3227 3322 3226 3321 3225 3120 3222 3221 3220 3113 3217 3114 2881 2880 2614 2468 2469 2155 1986 1810 1623 1432 1431 1230 1021  804  346  105
 201  438  666  667 1306 1307 1503 1692 2045 1872 2211 3037 2213 2519 2791 2656 2914 3142 2915 3033 3140 3027 3025 3137 3237 3134 3022 3132 3131 3130 3018 3230 3326 3015 3125 3124 3123 3122 3121 3008 2890 3119 3219 3218 3004 3116 2753 3002 2615 2470 2317 2156 1987 1624 1809 1625 1022  805  806  579  347  106
 200  436  437 1101  888 1099 1502 1873 1691 2212 2367 2368 2517 2514 2208 3032 2785 2910 3337 2912 3139 2906 2908 3024 3135 3023 3021 2903 3020 3019 3127 3128 3126 3017 3014 3012 2893 2892 3011 2889 3009 3007 2885 3118 3117 2752 2883 3115 2616 2471 2318 2157 1988 1811 1233 1435 1231 1023  581  580  348  107
 199  887  665  886 1305 1100 1304 1690 1689 1871 2044 2366 2210 2515 2788 2913 2784 3030 3031 3029 3143 2909 3028 2904 2905 2776 2902 2640 2901 2772 2340 2896 3016 2635 2894 3013 2766 2764 3010 2629 2891 2888 3006 2886 2882 2757 2884 2754 2617 2472 2319 2158 1989 1627 1434 1433 1232 1024  807  582  349  108
 198  435  664  885 1098 1303 1501 1500 2043 2209 2363 2365 2512 2654 2652 2789 2911 2650 2649 2783 2193 2781 2780 3026 2778 2777 2642 2639 2773 2900 2898 2899 2771 2634 2895 2632 2765 2631 2630 2763 2626 2887 3005 2759 2758 2622 2756 2755 2618 2473 2320 2159 1990 1812 1626 1631 1234 1025  808  583  350  109
 197  434  663  884 1097 1302 1499 1688 1870 2042 2364 2207 2203 2787 2786 2651 3141 2506 2355 2646 2782 2647 2907 2501 2499 1274 2349 2775 2497 2636 2774 2897 2770 2767 2015 2491 2768 2488 2627 2483 2762 2761 2625 2170 2623 2479 2621 2620 2619 2474 2321 2160 1991 1629 1628 1436 1235 1026  809  584  351  110
 196  433  662  883 1096 1301 1498 1687 1869 1868 2041 2362 2206 2509 2653 2357 2199 2508 2648 2505 2645 2503 2643 2779 2350 2348 2351 2641 2638 2495 2496 2341 2183 2339 2769 2633 2337 2489 2628 2487 2482 2760 2481 2480 2328 2329 2477 2166 2326 2475 2161 1992 1814 1813 1437 1630 1236 1027  810  585  352  111
 195  432  660  661  882 1300 1497 1867 2040 2205 2513 2511 2360 2510 2655 2358 2356 2507 2354 2353 2504 2500 2191 2644 2190 2498 2023 2346 2347 2184 2637 2494 2493 2180 2490 2011 2008 2333 2336 2486 2484 2174 2331 2624 2330 2478 2167 2168 2476 2322 2325 2162 1815 2324 1438 1632 1237 1028  811  586  353  112
 194  431  881 1095 1094 1496 1685 1686 1866 2039 2037 2038 2361 2201 2359 2031 2032 2197 2196 2195 2192 2502 2352 2189 1849 1848 1273 2021 2344 2345 2342 2181 2014 2013 1842 2335 2338 2334 1832 2175 2173 2332 2172 2002 2003 2169 2001 1999 1825 2165 2323 1997 2163 1993 1994 1816 1029 1031  812  587  354  113
 193  430  659  880 1093 1299 1298 1684 1863 1680 1862 1860 2204 1859 2033 2198 2030 2029 2028 2194 1851 2027 2024 1473 1847 1845 1846 2017 2186 2182 2492 2185 1660 1839 1838 2178 2179 2177 2009 2485 1833 2006 2004 2171 1644 1827 2327 2000 1447 1998 2164 1820 1996 1817 1633 1239 1238 1030 1440  355  813  114
 192  429  658  879 1092 1296 1495 1683 1865 1679 1487 2202 1861 1676 2034 1857 1856 1855 1854 1853 1850 1667 2022 2026 1477 1666 1472 2020 1658 2187 2343 1844 2012 1837 1836 2010 2176 1834 1651 1650 2007 1831 2005 1455 1829 1645 1826 1641 1824 1640 1822 1995 1818 1634 1442 1242 1240  814  591  815  588  115
 191  428  657  878 1091 1494 1297 1681 1490 1864 1488 2036 1677 2035 2200 1858 1673 1481 1672 1670 1277 1852 1669 1665 1664 1663 1662 2188 2018 2019 1466 1841 1467 1840 1465 1058 1652 1462 1835 1653 1649 1259 1647 1830 1646 1453 1643 1252 1642 1823 1448 1821 1637 1819 1245 1441 1444 1439 1032  589  360  117
 190  427  656  877 1090 1295 1493 1492 1682 1491 1678 1287 1486 1675 1484 1674 1483 1671 1480 1280 1479 1668 2025 1474 1067 1272 1471 1271 1843  846 1661 1266 1659 2016  843  844 1263 1656 1055 1261 1052 1648 1257 1456 1828 1452 1451 1449 1450 1042 1250 1638 1446 1246 1636 1241 1243 1033 1244  358  356  590
 189  426  655  876 1089 1294 1085 1084 1292 1291 1489 1290 1288 1286 1285 1284 1076 1482 1281 1072 1478 1279 1070 1475 1476  851 1068 1065 1469 1062  845  847 1657 1655 1464 1265 1654 1459 1460 1260 1053 1458 1258 1256 1454 1255 1046 1251  829 1043  825 1639 1248 1247 1445 1443 1635 1036  362  593  116  359
 188  425  654  875 1088 1087 1293  870 1086 1083 1289 1081 1079 1485 1078 1077 1282 1283 1074  405  859 1278  855  628 1276 1069 1066 1064 1470  849 1270 1063 1060 1463 1059 1057 1056 1262 1461 1054 1457  836 1050 1049 1048 1253 1047  830  608 1044 1040 1249  826  823  600 1038  594  822  817 1034  119  357
 187  424  653  874  873  648  871  646  869  867  645  866  865  864  863  862  861 1075  860 1073  635  403 1275  633  631  629  852 1269 1468  625  626 1268  623  621  842 1264  619  840  839 1051  838  837  835  834  833 1254  832 1045  831 1041  828  603 1039  133  128  370  598 1035  596  821  819  592
 186  423  652  651  649  872  417  647  175 1082  868  174 1080  410  641  408  639  638  636  637  858  856 1071  400  853  630  399  627  624  396  153  394  622  389  151  618  841  386  616  615  614  613  612  611  610  377  138  375  607  371  606  824  602  599  818 1037  368  595  361  816  118  124
 185  422  421  420  650  418  178  416  415  643  644  411  642  172  640  409  407  406  165  857  164  162  402  397  159  854  158  398  157  395  848 1061  152  391  620  388  617  387  385  384  144  143  141  142  378  140  135  609  134  604  136  373  601  369  129  367  820  126  364  123  363  122
 184  183  182  181  419  180  179  177  176  413  414  412  171  173  170  169  168  167  166  163  404  634  161  401  850  160  632  156  155  393  392  390  154 1267  150  149  148  147  146  145  382  381  383  379  139  380  374  137  376  605  827  132  372  131  130  597  127  366  365  125  120  121
