# This puzzle is unsolvable
73
   2    1    3    4    5    6    7    8    9   10   11   12   13   14   15   16   17   18   19   20   21   22   23   24   25   26   27   28   29   30   31   32   33   34   35   36   37   38   39   40   41   42   43   44   45   46   47   48   49   50  339   51   52   53   54   57  344  623   58   59  628   60   63  349   64   65   67   68  358  356   70   74   72
 288  289  290  291  292  293  294  295  296  297  298  299  300  301  302  303  304  305  306  307  308  309  310  311  312  313  314  315  316  317  318  319  320  321  322  323  324  325  326  327  328  329  331  330  332  333  334  335  336  337  338  340  341  342   55  343  345  624  346   61   62  899  352  630  353   66 1165  633  636  354   71   75  360
 287  568  569  570  571  572  573  574  575  576  577  578  579  580  581  582  583  584  585  586  587  588  589  590  591  592  593  594  595  596  597  598  599  600  601  602  603  604  876  605  608  609  880  611  610  613  884  614  886  615  617  618  619  620  621   56  622  625  626  347  897  348  350 1164  631  632  903 1169  638  355  359   73   76
 286  567  840  841  842  843  844  845  846  847  848  849  850  851  852  853  854  855  856  857  858  859  860  861  862  863  864  865  866  867  868  869  870  871  872  873  874 1138  875  606  878 1143  879  881  883 1146 1401  612 1150  616  888  889  890  891  892  893  894  895  898  627 1160 1162  629  901  351  635 1170  905  357   69  639  361  637
 285  566  839 1104 1105 1106 1107 1108 1109 1110 1111 1112 1113 1114 1115 1116 1117 1118 1119 1120 1121 1122 1123 1124 1125 1126 1127 1128 1129 1130 1131 1132 1133 1134 1135 1136 1137 1393  877 1396 1141  607 1398 1142 1144 1147  885 1404 1148  887 1151 1152 1153 1154 1155 1156 1412 1157  896 1414 1159 1163  900 1167 1419 1168  904  902 1670  634  908  362   77
 284  565  838 1103 1360 1361 1362 1363 1364 1365 1366 1367 1368 1369 1370 1371 1372 1373 1374 1375 1376 1377 1378 1379 1380 1381 1382 1383 1384 1385 1386 1387 1388 1389 1390 1391 1392 1140 1394 1139 1395 1397 1645 1399 1646  882 1400 1403 1149 1405 1406 1407 1408 1409 1410 1411 1413 1899 1158 1660 1161 1417 1418 1420 1166 1421 1668 1422  909 1424  640  363   78
 283  564  837 1102 1359 1608 1609 1610 1611 1612 1613 1614 1615 1616 1617 1618 1619 1620 1621 1622 1623 1624 1625 1626 1627 1628 1629 1630 1631 1632 1633 1634 1635 1636 1637 1638 1639 1640 1641 1642 1643 1644 1885 1647 2117 1145 1648 1650 1651 1652 1653 1654 1655 1656 1657 1658 1659 1662 1415 1901 1664 1416 1665 1666 1667 1907 1423  906  907  910  642  364   79
 282  563  836 1101 1358 1607 1848 1849 1850 1851 1852 1853 1854 1855 1856 1857 1858 1859 1860 1861 1862 1863 1864 1865 1866 1867 1868 1869 1870 1871 1872 1873 1874 1875 1876 1877 1878 1879 1880 1881 1882 1883 1884 1886 2118 1649 1402 1889 1890 1891 1892 1893 1894 1895 1896 1897 1898 1900 1661 1902 1663 1903 1904 1905 2137 1669 1171 1425  911  641  365  366   80
 281  562  835 1100 1357 1606 1847 2080 2081 2082 2083 2084 2085 2086 2087 2088 2089 2090 2091 2092 2093 2094 2095 2096 2097 2098 2099 2100 2101 2102 2103 2104 2105 2106 2107 2108 2109 2110 2111 2112 2113 2114 2115 2116 1887 2341 1888 2119 2121 2122 2123 2124 2125 2126 2127 2128 2129 2130 2131 2132 2133 2134 2135 1906 2136 1908 1671 1172 1173  912  643  367   81
 280  561  834 1099 1356 1605 1846 2079 2304 2305 2306 2307 2308 2309 2310 2311 2312 2313 2314 2315 2316 2317 2318 2319 2320 2321 2322 2323 2324 2325 2326 2327 2328 2329 2330 2331 2332 2333 2334 2336 2551 2337 2338 2339 2340 2342 2557 2120 2343 2344 2345 2346 2348 2349 2350 2351 2352 2353 2354 2355 2356 2357 2358 2359 2138 1909 1672 1426 1174  913  644  645   82
 279  560  833 1098 1355 1604 1845 2078 2303 2520 2521 2522 2523 2524 2525 2526 2527 2528 2529 2530 2531 2532 2533 2534 2535 2536 2537 2538 2539 2540 2541 2542 2543 2544 2545 2546 2547 2549 2550 2335 2758 2552 2553 2554 2555 2763 2556 2558 2559 2767 2560 2347 2563 2564 2565 2566 2567 2568 2569 2570 2571 2572 2573 2360 2139 1910 1673 1427 1428 1175  914  646   83
 278  559  832 1097 1354 1603 1844 2077 2302 2519 2728 2729 2730 2731 2732 2733 2734 2735 2736 2737 2738 2739 2740 2741 2742 2743 2744 2745 2746 2747 2748 2749 2750 2751 2752 2952 2753 2754 2756 2757 2759 2957 2760 2761 2961 2762 2963 2764 2765 2766 2561 2562 2769 2771 2772 2773 2774 2775 2776 2777 2778 2779 2574 2361 2140 1911 1674 1429 1176  915  647  368   84
 277  558  831 1096 1353 1602 1843 2076 2301 2518 2727 2928 2929 2930 2931 2932 2933 2934 2935 2936 2937 2938 2939 2940 2941 2942 2943 2944 2945 2946 2947 2948 2949 2950 2951 3143 2953 2548 2755 2955 3148 2956 2958 2959 2960 3153 3154 2964 2965 2966 2768 2968 2770 2970 2971 2972 2973 2974 2975 2976 2977 2781 2780 2575 2141 1912 1675 1430 1177  916  648  369   85
 276  557  830 1095 1352 1601 1842 2075 2300 2517 2726 2927 3120 3121 3122 3123 3124 3125 3126 3127 3128 3129 3130 3131 3315 3132 3134 3135 3136 3137 3138 3139 3140 3141 3142 3327 3145 3146 3147 2954 3331 3149 3150 3151 2962 3511 3337 3155 3156 3157 3158 2967 3159 3160 3161 3163 3164 3165 3166 3167 2978 2782 2576 2362 2142 1913 1676 1431 1178  917  649  370   86
 275  556  829 1094 1351 1600 1841 2074 2299 2516 2725 2926 3119 3304 3305 3306 3307 3308 3309 3310 3311 3312 3313 3314 3490 3133 3317 3318 3319 3320 3321 3322 3323 3324 3325 3144 3326 3328 3329 3505 3330 3332 3333 3334 3152 3335 3336 3338 3339 3340 3341 3342 2969 3344 3162 3345 3346 3347 3349 3168 2979 2783 2577 2363 2143 1914 1677 1432 1179  918  371  372   87
 274  555  828 1093 1350 1599 1840 2073 2298 2515 2724 2925 3118 3303 3480 3481 3482 3483 3484 3485 3486 3487 3488 3489 3316 3658 3491 3493 3494 3495 3496 3497 3498 3499 3500 3501 3502 3503 3504 3672 3506 3507 3508 3509 3677 3510 3512 3513 3514 3515 3517 3518 3343 3519 3520 3521 3522 3348 3523 3350 3169 2980 2578 2364 2365 1434 2144 1433 1180  919  650  373   88
 273  554  827 1092 1349 1598 1839 2072 2297 2514 2723 2924 3117 3302 3479 3648 3649 3650 3651 3652 3653 3654 3655 3656 3657 3492 3660 3661 3820 3663 3822 3664 3665 3666 3667 3668 3669 3670 3671 3673 3832 3674 3675 3835 3676 3678 3679 3680 3682 3841 3516 3684 3685 3686 3687 3688 3525 3689 3351 3170 2981 2784 2579 2366 1679 1678 1915 1181 1182  920  651  374   89
 272  553  826 1091 1348 1597 1838 2071 2296 2513 2722 2923 3116 3301 3478 3647 3808 3809 3810 3811 3812 3813 3814 3815 3817 3818 3659 3819 3821 3662 3973 3823 3824 3825 3977 3827 3828 3829 3830 3831 3833 3984 3834 3836 3837 3988 3838 3840 3681 3842 3683 3843 3844 3845 3997 3846 3847 3171 3524 2982 2983 2785 2580 2367 2368 2145 1916 1435 1184 1183  652  375   90
 271  552  825 1090 1347 1596 1837 2070 2295 2512 2721 2922 3114 3115 3477 3646 3807 3960 3961 3962 3963 3964 3965 3966 3816 3968 3969 3970 3971 3972 3974 3975 4118 3976 3978 3826 3979 3980 3981 3982 3983 4127 3985 3986 3987 4131 3989 3839 3990 3991 3993 3995 3996 3999 4139 3848 3526 3352 3353 3172 2984 2786 2581 2147 1681 2146 1680 1438 1436  921  653  376   91
 270  551  824 1089 1346 1595 1836 2069 2294 2511 2720 2921 3113 3300 3299 3645 3806 3959 4104 4105 4106 4107 4109 4110 4245 4111 4112 4113 4114 4115 4116 4117 4119 4254 4120 4121 4122 4123 4124 4125 4126 4262 4128 4129 4130 4132 4133 4134 4272 3992 4270 4135 3994 3849 3692 3691 3693 3527 3354 3173 2985 2787 2582 1919 1917 1918 1682 1185 1437  922  923  377   92
 269  550  823 1088 1345 1594 1835 2068 2293 2510 2719 2920 3112 3298 3476 3804 3644 3958 4103 4240 4241 4243 4108 3967 4370 4373 4247 4248 4249 4250 4251 4252 4253 4381 4255 4256 4257 4258 4259 4260 4261 4508 4263 4264 4265 4266 4267 4395 4268 4269 4271 4273 4138 3998 4140 3850 3528 3690 3355 3174 2788 2789 2583 2369 2370 2148 1920 1683  925  655 1186   94   93
 268  549  822 1087 1344 1593 1834 2067 2292 2509 2718 2919 3297 3475 3473 3474 3805 3957 4102 4239 4368 4242 4369 4371 4244 4246 4374 4375 4376 4377 4378 4379 4380 4382 4383 4502 4384 4385 4386 4387 4389 4390 4509 4391 4392 4393 4394 4396 4516 4397 4398 4136 4137 4274 4142 3851 3695 3694 3529 3175 2986 2790 2584 2371 2149 1921 1684 1440 1188 1439  378  654   95
 267  548  821 1086 1343 1592 1833 2066 2291 2508 2717 2918 3111 3296 3472 3643 3803 3956 4101 4238 4367 4488 4489 4490 4491 4372 4492 4494 4495 4496 4497 4498 4499 4500 4501 4613 4503 4504 4505 4506 4388 4723 4510 4511 4622 4512 4513 4514 4515 4517 4400 4627 4141 4275 4000 3696 3853 3358 3356 3176 2987 2791 2372 2151 2150 1922 1685 1187  656  924  379  380  381
 266  547  820 1085 1342 1591 1832 2065 2290 2507 2716 2917 3110 3295 3471 3642 3802 3955 4237 4236 4366 4487 4600 4601 4706 4602 4493 4606 4708 4607 4709 4609 4713 4610 4612 4716 4718 4616 4719 4617 4507 4722 4619 4724 4621 4727 4623 4908 4519 4729 4518 4399 4276 4143 4001 3697 3854 3532 3357 3177 2988 2586 2585 2373 2152 1923 1686 1441  927  926  657  382   96
 265  546  819 1084 1341 1590 1831 2064 2289 2506 2715 2916 3109 3294 3470 3641 3801 3953 3954 4365 4486 4485 4800 4599 4703 4801 4604 4605 4804 4711 4805 4608 4807 4712 4611 4714 4615 4614 4720 4815 4618 4620 4818 4725 4820 4726 4625 4624 4728 4521 4630 4401 4402 4278 4277 3852 3856 3360 3531 3178 2989 2792 2587 2374 2153 1924 1687 1442 1189  658  928  383   97
 264  545  818 1083 1340 1589 1830 2063 2288 2505 2714 2915 3108 3293 3639 3638 3951 3640 4100 4235 4364 4484 4598 4704 4603 4799 4702 4802 4803 4891 4710 4808 4974 4809 4810 4717 4715 4812 4814 4902 4721 4817 4906 4905 4819 4821 4822 4823 4626 4520 4404 4628 4146 4144 4004 4003 3855 3533 3530 3181 3359 2793 2588 2375 2154 1925 1688 1443 1190  929  659  660  384
 263  544  817 1082 1339 1588 1829 2062 2287 2504 2713 2913 2914 3290 3107 3292 3952 3800 4099 4096 4233 4097 4700 4595 4888 4889 4707 5040 4890 4892 4806 4893 4895 4897 4898 5048 4811 4813 4901 4981 4816 4903 4982 4904 4986 4825 4909 4731 4629 4730 4403 4280 4145 4005 3699 4002 3534 3180 3361 3179 2990 2589 2590 2376 2155 1926 1689 1444 1191  930  661  385   98
 262  543  816 1081 1338 1587 1828 2061 2286 2503 2712 3106 3291 3637 3468 3469 3797 3799 4095 4098 4234 4363 4361 4705 4798 4797 4968 4970 5103 5042 4971 4973 4975 4896 4976 4899 4977 4979 4980 5051 5053 4984 5117 4907 5057 4988 4987 4824 4732 4631 4522 4279 4147 4006 4007 3857 3700 3698 3536 2991 2794 2992 2795 2156 2157 1927 1690 1445 1192  931  662  100   99
 261  542  815 1080 1337 1586 1827 2060 2285 2502 2711 2912 3105 3466 3467 3635 3636 3798 3950 4232 4483 4362 4597 4596 4482 4701 4966 4969 5039 5041 5104 5108 4894 5045 5047 5110 4900 4978 5114 5169 5052 4983 5118 5055 5056 4910 4826 4827 4733 4632 4406 4405 4282 4281 4148 3858 3701 3362 3535 3363 2993 2796 2797 2378 2377 1928 1691 1446 1193  932  663  386  101
 260  541  814 1079 1336 1585 1826 2059 2284 2501 2710 2911 3104 3288 3634 3289 3795 3949 4094 4231 4360 4481 4594 4699 4796 4887 4885 4967 5106 5160 5107 4972 5164 5046 5109 5111 5049 5167 5050 5217 5115 5054 5173 5119 4985 4989 4911 4828 4736 4633 4523 4524 4407 4149 4008 3859 3702 3537 3182 2994 3364 2592 2591 2379 2158 1929 1692 1447 1194  933  664  387  102
 259  540  813 1078 1335 1584 1825 2058 2283 2500 2709 2910 3103 3465 3948 3633 4093 3947 4230 4359 4480 4479 4593 4698 4795 4886 4884 4965 5037 5159 5161 5044 5163 5162 5165 5213 5113 5112 5170 5168 5171 5172 5120 5121 5058 4990 4912 4914 4734 4634 4525 4408 4283 4150 4009 3703 3538 3539 3184 2995 3183 2798 2593 2380 2159 1930 1693 1448 1195  934  665  388  103
 258  539  812 1077 1334 1583 1824 2057 2282 2499 2708 2909 3102 3287 3464 3794 3796 3946 4091 4092 4358 4478 4592 4697 4794 4883 5101 5105 5038 5208 5043 5209 5210 5251 5211 5214 5254 5216 5255 5215 5116 5257 5219 5122 5059 4991 4913 4829 4735 4636 4526 4409 4284 4151 4010 3860 3861 3540 3185 3365 2996 2799 2594 2381 2160 1931 1694 1449 1196  935  666  389  104
 257  538  811 1076 1333 1582 1823 2056 2281 2498 2707 2908 3101 3286 3463 3632 3793 3945 4090 4229 4228 4357 4591 4696 4793 4882 4881 4964 5102 5205 5158 5248 5247 5250 5252 5283 5306 5253 5309 5286 5256 5220 5174 5175 5060 4992 4831 4635 4637 4737 4527 4285 4286 4152 4011 3705 3704 3368 3366 3186 2997 2800 2595 2382 2161 1932 1695 1450 1197  936  667  390  105
 256  537  810 1075 1332 1581 1822 2055 2280 2497 2706 2907 3100 3285 3462 3631 3792 3944 4227 4226 4356 4477 4590 4695 4694 4792 4880 5036 5157 5034 5207 5280 5249 5281 5212 5328 5166 5285 5218 5287 5259 5221 5177 5176 5061 4915 4830 4832 4739 4528 4411 4410 4153 4012 3863 3862 3706 3367 3541 3188 2998 2801 2596 2383 2162 1933 1696 1451 1198  937  668  391  106
 255  536  809 1074 1331 1580 1821 2054 2279 2496 2705 2906 3099 3284 3461 3629 3630 3791 4089 4352 4355 4476 4589 4587 4693 4791 4963 4961 4962 5100 5206 5246 5304 5305 5282 5307 5284 5308 5258 5260 5223 5262 5125 5063 5064 4993 4917 4738 4916 4638 4412 4529 4287 4154 4013 3864 3707 3542 3187 3369 2803 2802 2597 2384 2163 1934 1697 1452 1199  938  669  392  107
 254  535  808 1073 1330 1579 1820 2053 2278 2495 2704 2905 3098 3283 3460 3790 3942 3943 4088 4225 4353 4354 4473 4588 4692 4790 4960 5035 5099 5155 5204 5245 5279 5320 5317 5319 5322 5310 5222 5311 5289 5123 5224 5124 4994 5062 4918 4740 4833 4413 4741 4288 4289 4155 4014 3865 3708 3543 3370 3190 2999 3000 2599 2385 2164 1935 1698 1453 1200  939  670  393  108
 253  534  807 1072 1329 1578 1819 2052 2277 2494 2703 2904 3097 3282 3459 3628 3941 4224 4221 4788 4475 4691 4474 4878 4690 4879 5030 5032 5156 5098 5203 5303 5277 5301 5302 5321 5326 5324 5323 5288 5291 5261 5178 5126 5065 4996 4995 4834 4835 4639 4530 4640 4290 4156 4015 3866 3709 3544 3189 3002 3191 2598 2804 2386 2165 1936 1699 1454 1201  940  671  394  109
 252  533  806 1071 1328 1577 1818 2051 2276 2493 2702 2903 3096 3281 3458 3627 3789 3788 3787 4087 4223 4351 4877 4789 4958 4689 4959 5031 5095 5153 5201 5278 5244 5275 5276 5318 5316 5325 5312 5290 5263 5180 5225 5127 5066 4997 4920 4919 4532 4531 4533 4415 4414 4157 4016 3867 3710 3545 3371 3373 3372 2805 2600 2387 2166 1937 1700 1455 1202  941  672  395  110
 251  532  805 1070 1327 1576 1817 2050 2275 2492 2701 2902 3095 3280 3457 3626 3786 3937 4086 4222 4348 4585 4586 4875 4786 4787 5096 5033 5029 4957 5242 5243 5241 5274 5300 5315 5327 5314 5293 5264 5229 5228 5179 5128 4921 4836 4998 4742 4744 4743 4643 4416 4291 4158 4017 3868 3711 3546 3192 3193 3001 2806 2601 2388 2167 1938 1701 1456 1203  942  673  396  111
 250  531  804 1069 1326 1575 1816 2049 2274 2491 2700 2901 3094 3279 3455 3456 3938 4084 4083 4085 3940 4472 4471 4687 4688 4876 4785 5028 5154 5090 5152 5202 5240 5299 5298 5297 5296 5295 5266 5313 5226 5231 5129 5068 5130 5067 4999 4641 4837 4535 4642 4534 4417 4159 4018 3869 3712 3547 3374 3004 3003 2807 2602 2389 2168 1939 1702 1457 1204  943  674  397  112
 249  530  803 1068 1325 1574 1815 2048 2273 2490 2699 2900 3092 3093 3454 3625 3623 3785 3939 4467 4219 4349 4350 4874 4781 4955 4956 5097 5149 5197 5150 5199 5238 5273 5271 5270 5268 5233 5267 5294 5227 5181 5131 5070 4924 5000 4839 4922 4745 4645 4418 4292 4160 4161 4019 3870 3713 3548 3375 3194 3005 2808 2603 2390 2169 1940 1703 1458 1205  944  675  398  113
 248  529  802 1067 1324 1573 1814 2047 2272 2489 2698 2898 2899 3278 3277 3622 3624 3784 4218 4082 4468 4220 4584 4470 4782 4784 5093 5094 5092 5200 5151 5088 5198 5272 5237 5236 5235 5269 5186 5292 5265 5230 5187 5182 5183 5001 5069 4838 4644 4746 4293 4420 4419 4294 4020 3871 3714 3549 3376 3195 3006 2809 2604 2391 2170 1941 1704 1459 1206  945  676  399  114
 247  528  801 1066 1323 1572 1813 2046 2270 2271 2488 2697 3091 3276 3453 3781 3621 3936 4081 4347 4583 4582 4469 4952 4581 4873 4685 5027 5091 5147 5239 5146 5144 5194 5192 5191 5234 5190 5232 5189 5135 5184 5132 5071 5002 5003 4923 4840 4748 4537 4536 4421 4295 4162 4021 3872 3715 3550 3377 3196 3007 2810 2605 2392 2171 1942 1705 1460 1207  946  677  400  115
 246  527  800 1065 1322 1571 1812 2045 2269 2487 2696 2897 3090 3275 3452 3783 3780 3620 3935 4217 4346 4580 4579 4783 4954 5026 4951 5022 5196 5148 5019 5018 5195 5143 5084 5141 5140 5139 5138 5188 5077 5185 5136 5074 5134 4926 4925 4747 4749 4646 4647 4538 4296 4163 4022 3873 3716 3551 3378 3197 3008 2811 2606 2393 2172 1943 1706 1461 1208  947  678  401  116
 245  526  799 1064 1321 1570 2043 2044 2486 2485 2695 3089 2894 3274 3451 3782 3933 3934 4080 4345 4344 4466 4686 4684 4953 5025 4947 5089 5024 5145 5020 5086 5085 5142 5193 5082 5081 5079 5012 5078 5076 5137 5008 5072 5073 5133 5004 4841 4927 4648 4539 4422 4297 4164 4023 3874 3717 3552 3379 3198 3009 2812 2607 2394 2173 1944 1707 1462 1209  948  679  402  117
 244  525  798 1063 1320 1569 1811 2042 2268 2694 2895 2896 3088 3273 3450 3619 4078 4077 4215 4214 4216 4465 4683 4578 4870 4780 4871 5023 4949 5021 5087 4943 5017 4941 4860 5015 5014 5080 4937 5011 5010 5075 4932 4933 5006 5005 4843 4842 4750 4649 4540 4423 4298 4165 4024 3875 3718 3553 3380 3199 3010 2813 2608 2395 2174 1945 1708 1463 1210  949  680  403  118
 243  524  797 1062 1319 1568 1810 1809 2267 2483 2692 3087 3272 3270 3271 3618 3779 4079 3932 4343 4342 4464 4577 4682 4869 4867 4950 4865 4863 4944 4862 4942 4562 5083 4858 5016 4939 5013 4853 4854 4935 5009 5007 4931 4848 4930 4928 4751 4752 4650 4541 4424 4299 4166 4025 3876 3719 3554 3381 3200 3011 2814 2609 2396 2175 1946 1709 1464 1211  950  681  404  119
 242  523  796 1061 1318 1567 1808 2041 2266 2484 2693 2892 2893 3086 3449 3617 3778 3931 4076 4213 4463 4575 4576 4776 4779 4866 4872 4773 4868 4946 4566 4945 4768 4859 4940 4857 4856 4938 4936 4762 4852 4934 4850 4849 4847 4846 4929 4845 4844 4651 4542 4425 4300 4167 4026 3877 3720 3555 3382 3201 3012 2815 2610 2397 2176 1947 1710 1465 1212  951  682  405  120
 241  522  795 1060 1317 1566 1807 2040 2265 2481 2482 2691 3085 3447 3448 3616 3777 3930 4075 4212 4462 4680 4777 4681 4778 4677 4948 4454 4864 4771 4670 4770 4767 4766 4861 4765 4666 4855 4764 4663 4761 4851 4759 4758 4757 4756 4755 4754 4546 4652 4653 4426 4427 4168 4027 3878 3721 3556 3383 3202 3013 2816 2611 2398 2177 1948 1711 1466 1213  952  683  406  121
 240  521  794 1059 1316 1565 1806 2039 2264 2480 2690 2891 3084 3268 3269 3446 3615 3775 4211 4210 4341 4340 4679 4573 4678 4676 4775 4774 4772 4674 4671 4672 4769 4563 4668 4667 4665 4558 4763 4662 4555 4760 4660 4659 4658 4657 4656 4655 4753 4654 4543 4302 4301 4169 4028 3879 3722 3557 3384 3203 3014 2817 2612 2399 2178 1949 1712 1467 1214  953  684  407  122
 239  520  793 1058 1314 1315 1805 2038 2263 2689    0 2889 2890 3083 3445 3774 3614 4074 3929 4339 4338 4574 4333 4334 4572 4456 4675 4570 4332 4328 4673 4451 4564 4669 4561 4560 4559 4557 4664 4556 4554 4661 4553 4552 4551 4550 4549 4548 4547 4545 4544 4428 4303 4170 4029 3880 3723 3558 3385 3204 3015 2818 2613 2400 2179 1950 1713 1468 1215  954  685  408  123
 518  792  517 1057 1564 1563 1803 1804 2037 2262 2688 3082 2888 3267 3444 3927 3773 3776 4068 4072 4460 4461 4458 4459 4455 4457 4453 4569 4567 4568 4565 4449 4448 4447 4446 4445 4320 4443 4442 4441 4440 4439 4438 4437 4436 4435 4434 4433 4432 4431 4430 4429 4304 4171 4030 3881 3724 3559 3386 3205 3016 2819 2614 2401 2180 1951 1714 1469 1216  955  686  409  124
 519  791  237 1056 1313 1562 2260 2259 2686 2479 2477 2687 3265 3611 3266 3613 3926 3928 4071 4209 4207 4336 4202 4204 4064 4571 4200 4198 4330 4452 4450 4326 4325 4324 4323 4322 4444 4321 4319 4318 4317 4316 4315 4314 4313 4312 4311 4310 4309 4308 4307 4306 4305 4172 4031 3882 3725 3560 3387 3206 3017 2820 2615 2402 2181 1952 1715 1470 1217  956  687  410  125
 238  236 1053  516 1312 1802 1560 2034 2478 2685 2261 2887 3442 3443 3612 3610 3772 3925 4069 4208 4337 4206 4205 4203 4063 4062 4331 3912 4197 4058 4327 4195 4194 4193 4192 4191 4190 4189 4188 4187 4186 4185 4184 4183 4182 4181 4180 4179 4178 4177 4176 4175 4174 4173 4032 3883 3726 3561 3388 3207 3018 2821 2616 2403 2182 1953 1716 1471 1218  957  688  411  126
 235 1054  234 1055 1311 1561 1801 2036 2475 2035 3079 3080 3081 3263 3441 3609 3771 3924 4073 4070 4067 4066 4065 4335 3916 4201 4329 4199 3756 3910 4196 4056 4055 4054 4053 4052 4051 4050 4049 4048 4047 4046 4045 4044 4043 4042 4041 4040 4039 4038 4037 4036 4035 4034 4033 3884 3727 3562 3389 3208 3019 2822 2617 2404 2183 1954 1717 1472 1219  958  689  412  127
 787  789  790  513 1559 1558 1800 2033 2476 2886 2684 2885 3078 3440 3264 3608 3770 3923 3922 3921 3920 3919 3917 3764 3762 4061 4060 3914 3913 3593 3911 3909 3908 3753 3907 3905 3904 3903 3902 3901 3900 3899 3898 3897 3896 3895 3894 3893 3892 3891 3890 3889 3888 3887 3886 3885 3728 3563 3390 3209 3020 2823 2618 2405 2184 1955 1718 1473 1220  959  690  413  128
 232  515  786 1309 1310 1557 2032 2257 2258 2474 2683 2884 3077 3262 3439 3769 3768 3767 3604 3766 3430 3765 3599 3761 3760 3759 3594 4059 4057 3757 3592 3755 3752 3751 3906 3750 3749 3748 3747 3746 3745 3744 3743 3742 3741 3740 3739 3738 3737 3736 3735 3734 3733 3732 3731 3730 3729 3564 3391 3210 3021 2824 2619 2406 2185 1956 1719 1474 1221  960  691  414  129
 514  788 1308 1052 1051 1798 1799 2031 2256 2473 2682 2883 3076 3261 3438 3607 3606 3605 3603 3252 3600 3428 3918 3426 3915 3758 3596 3595 3424 3422 3420 3754 3591 3588 3419 3587 3586 3585 3584 3583 3582 3581 3580 3579 3578 3577 3576 3575 3574 3573 3572 3571 3570 3569 3568 3567 3566 3565 3392 3211 3022 2825 2620 2407 2186 1957 1720 1475 1222  961  692  415  130
 233  509  229  512 1050 1556 1797 2030 2255 2472 2681 2882 3075 3260 3437 3436 3435 3434 3433 3602 3601 3598 3763 3062 3249 3248 3597 3425 3423 3056 3243 3589 3590 3238 3417 3416 3415 3414 3413 3412 3411 3410 3409 3408 3407 3406 3405 3404 3403 3402 3401 3400 3399 3398 3397 3396 3395 3394 3393 3212 3023 2826 2621 2408 2187 1958 1721 1476 1223  962  693  416  131
 230  231 1048  785 1307 1555 1796 2029 2254 2471 2680 2881 3074 3259 3258 3257 3256 3255 3254 3431 3253 3063 3251 3250 3429 3247 3246 3058 3242 3055 3421 3241 3240 3418 3239 3237 3236 3235 3234 3233 3232 3231 3230 3229 3228 3227 3226 3225 3224 3223 3222 3221 3220 3219 3218 3217 3216 3215 3214 3213 3024 2827 2622 2409 2188 1959 1722 1477 1224  963  694  417  132
 228  784 1046 1049 1306 1554 2027 2253 2252 2470 2679 2880 3073 3072 3071 3070 3069 3068 3067 3432 3065 3064 3427 3061 2866 3060 3059 3245 3057 3244 2860 3054 3053 3052 3051 3050 3049 3048 3047 3046 3045 3044 3043 3042 3041 3040 3039 3038 3037 3036 3035 3034 3033 3032 3031 3030 3029 3028 3027 3026 3025 2828 2623 2410 2189 1960 1723 1478 1225  964  695  418  133
 507  510  782  511  783 1303 2026 1553 1795 2469 2678 2676 2879 2878 2877 2875 2874 2873 2872 3066 2871 2869 2868 2867 2662 2865 2864 2863 2862 2658 2861 2859 2656 2857 2856 2855 2854 2853 2852 2851 2850 2849 2848 2847 2846 2845 2844 2843 2842 2841 2840 2839 2838 2837 2836 2835 2834 2833 2832 2831 2830 2829 2624 2411 2190 1961 1724 1479 1226  965  696  419  134
 227  779  226 1304 1793 1794 1792 2028 2251 2468 2677 2465 2675 2674 2876 2673 2671 2670 2669 2668 2870 2667 2455 2664 2661 2663 2451 2660 2659 2447 2657 2445 2858 2654 2653 2652 2651 2650 2649 2648 2647 2646 2645 2644 2643 2642 2641 2640 2639 2638 2637 2636 2635 2634 2633 2632 2631 2630 2629 2628 2627 2626 2625 2412 2191 1962 1725 1480 1227  966  697  420  135
 508 1044 1305  781 1047 1302 1552 1791 2250 2023 2467 2466 2246 2463 2462 2672 2461 2458 2239 2457 2456 2665 2666 2454 1773 2005 2232 2448 2004 2449 2226 2444 2655 2225 2442 2441 2440 2439 2438 2437 2436 2435 2434 2433 2432 2431 2430 2429 2428 2427 2426 2425 2424 2423 2422 2421 2420 2419 2418 2417 2416 2415 2414 2413 2192 1963 1726 1481 1228  967  698  421  136
 225  780  778 1301 1551 1789 1045 1787 2247 2249 2024 2019 2245 2244 2243 2242 2460 2241 2459 2238 2237 2236 2234 2452 2453 1770 2230 2450 2003 2228 2446 2227 1998 2443 2224 2223 2221 2220 2219 2218 2217 2216 2215 2214 2213 2212 2211 2210 2209 2208 2207 2206 2205 2204 2203 2202 2201 2200 2199 2198 2197 2196 2195 2194 2193 1964 1727 1482 1229  968  699  422  137
 224  506  777 1043 1299 1548 1550 1786 2248 1544 2464 1784 2020 2017 2016 2015 2014 2240 2012 1776 2011 2010 2235 2006 1772 2233 2231 2229 2001 1524 2000 1999 1763 1997 1996 2222 1994 1993 1992 1991 1990 1989 1988 1987 1986 1985 1984 1983 1982 1981 1980 1979 1978 1977 1976 1975 1974 1973 1972 1971 1970 1969 1968 1967 1966 1965 1728 1483 1230  969  700  423  138
 223  505  503  504 1549 1300 1790 1788 2022 1543 2021 1540 2018 1783 1781 1780 1779 2013 1778 1533 1775 1774 2009 2008 1771 1527 1768 1766 2002 1765 1764 1520 1268 1009 1761 1995 1760 1759 1757 1756 1755 1754 1753 1752 1751 1750 1749 1748 1747 1746 1745 1744 1743 1742 1741 1740 1739 1738 1737 1736 1735 1734 1733 1732 1731 1730 1729 1484 1231  970  701  424  139
 222  500  776 1042 1040 1547 1546 1545 2025 1293 1785 1541 1030 1539 1538 1537 1536 1535 1777 1534 1531 1530 2007 1529 1528 1276 1769 1526 1767 1272 1523 1522 1521 1269 1762 1518 1517 1515 1514 1513 1512 1511 1510 1509 1508 1507 1506 1505 1504 1503 1502 1501 1500 1499 1498 1497 1496 1495 1494 1493 1492 1491 1490 1489 1488 1487 1486 1485 1232  971  702  425  140
 221  498 1039 1297 1041 1294  770  494 1034 1292 1542 1290 1782 1289 1287 1286 1285 1284 1283 1281 1022 1532 1279 1278 1277 1274 1275 1525 1273 1013 1012 1271 1519 1008 1266 1265 1758 1516 1263 1262 1261 1260 1259 1258 1257 1256 1255 1254 1253 1252 1251 1250 1249 1248 1247 1246 1245 1244 1243 1242 1241 1240 1239 1238 1237 1236 1235 1234 1233  972  703  426  141
 773  220  218  502 1037  772 1295 1036  210  765 1033 1291 1031  762 1029 1027 1026 1025 1024 1282 1280 1023 1021 1019 1018  750 1017 1016 1015 1270  745 1011 1010  742 1267 1006 1005 1264 1004 1003 1002 1001 1000  999  998  997  996  995  994  993  992  991  990  989  988  987  986  985  984  983  982  981  980  979  978  977  976  975  974  973  704  427  142
 219  774  771  493 1038 1298  769 1035 1296 1032  764  488  761 1288 1028  760  759  758  757  756  755  754 1020  752  751  475  749  748 1014  471  746  744  743  741 1007  740  739  738  737  736  735  734  733  732  731  730  729  728  727  726  725  724  723  722  721  720  719  718  717  716  715  714  713  712  711  710  709  708  707  706  705  428  143
 496  775  501  212  214  499  211  209  768  766  489  206  763  487  486  485  484  483  482  480  198  479  753  195  193  476  474  473  747  472  470  469  468  467  466  465  464  463  462  461  460  459  458  457  456  455  454  453  452  451  450  449  448  447  446  445  444  443  442  441  440  439  438  437  436  435  434  433  432  431  430  429  144
 217  216  497  215  495  490  213  492  767  208  491  207  205  204  203  202  201  200  199  481  197  196  477  478  194  192  191  190  189  188  187  186  185  184  183  182  181  180  179  178  177  176  175  174  173  172  171  170  169  168  167  166  165  164  163  162  161  160  159  158  157  156  155  154  153  152  151  150  149  148  147  146  145
