# This puzzle is unsolvable
75
   2    1  298    3  588 1136    4    9  303  305   10   11  307   14   15   16   18   19   20  315  601   21   23  318  607   25  323   27   29   30   31   32   33   35   37  617  333   36   39  335   41   42   43   44   45   46   47  343  344   48  633   53  347  915  637  354   54  352   56   60   61   62   63   64   65   66   67   68   69   70   71   72   73   74   75
 294  296  865  299  866    5    7  302    8  871  593   13  308  598  877  312   17  313  314  317  883  316  884  605  606  319   26  321  324  325  326  328  615   34  896  331  332   38  620  334  336  337  338  339  340  341  629  342   49  348   50  632  350 1186  351  916   58   55  355   59  644  643  358  359  360  361  362  363  364  365  366  367  368  369   76
 864  587  295  862 1138  589    6  591  306  304  873  309   12  875 1146 1149  597  310  604  880  881   28 1155   24 1157  320 1159  888 1161  610  612  613  327  329  895  330   40  898  621  622  623  624  625  626  627  907  628 1181  630  345   52  914  349  635 1453   57 1189  640  356  642  922  357  645  646  647  648  649  650  651  652  653  654  655  370   77
 584  586  585 1135  867  300  868  869  870  590  592  594 1144  878 1666 1412 1915  602  600 1152  603  882 1419   22 1156  322  608 1423  891  611  892  614  893  616 1166  618  619  899  900  901  902  903  904  905  906 1178  911  631  913  910  346   51  634 1184  636  641  638 1190  353 1193  921  923  924  925  926  927  928  929  930  931  932  933  656  371   78
 293  297  861 1137 1400 1143 1407 1659 1141 1406  874 1405 1148  595 1145 1147 1668 1151  599  879 1153 1154  886  887 1418 1422  609 1160  889 1424 1162 1164  894 1429 1431  897 1167 1169 1171 1172 1173 1174 1175 1176 1440 1177  908  909 1443 1182 1446 1445 1185 1450 1188  918 1711  639  919  920 1455 1457 1195 1196 1197 1198 1199 1200 1201 1202 1203  934  657  372   79
 583  292  581  863 1656  301 1657 1905 1139 1662  872 1408  596 1411 1409 1665 1667 1150 1415 1671 1672 1416 1417  885 1420 1421 1158  890 1676 1163 1427 1682 1165 1684 1430 1432 1168 1170 1689 1434 1436 1437 1438 1439 1695 1441 1442 1180 1179 1444  912 1183 1447 1704 1187 1707 1451 1454 1192 1957 1194 1456 1458 1459 1460 1461 1462 1463 1464 1465 1204  935  658  373   80
 290  287  291  860  582 1401 1399 1142 2147 1404 1140  311 1910  876 1410 1669 1413 1917 1414 1670 1919 2159 2160 1673 1675 1923 1677 1678 1679 1927 1425 2166 2169 1428 1683 2171 1433 1687 1688 1435 1690 1692 1693 1694 1696 1943 1697 1698 1699 1700 1701 1703 1449 1448  917 1705 1708 1191 1955 1709 1956 1712 1713 1714 1715 1716 1717 1718 1719 1466 1205  936  659  374   81
 579  578 1133 1134 1904 1402 1658 2376 2141 1907 1660 1908 1663 1912 1911 2150 1914 1918 2386 2157 2388 2390 1920 1674 1922 2163 2395 1925 1680 2399 2396 2400 1932 2168 1686 2402 1933 1937 1936 1938 1691 1939 1940 1941 2182 1942 1944 1945 1946 1947 1948 1702 1949 1951 1952 1953 1452 1954 1958 2196 1710 1959 1960 1961 1962 1963 1964 1965 1720 1467 1206  937  660  375   82
 289  577  859 1398 1397 1654 1903 1652 2602 2375 2146 2600 2149 2145 2152 2607 2381 1913 2154 1916 2155 2389 2158 1921 2617 1924 1926 2164 2165 1928 1426 2167 1929 1930 2170 2175 1934 1935 2630 2176 2177 2179 2410 2180 2411 2183 2414 2184 2185 2186 2188 2189 1950 2190 2191 1706 2192 2193 2194 2195 2197 2198 2199 2200 2201 2202 2203 1966 1721 1468 1207  938  661  376   83
 288  858 1395  580 1131 1132 1403 1653 2143 1906 1661 1664 2603 1909 2604 2151 2153 2608 2156 3031 2387 2392 2612 3038 2391 2161 2616 2834 2621 1681 2836 2398 1931 2173 2627 3247 2838 2628 2629 2403 2408 2178 3057 2181 3059 2413 2415 2639 2416 2417 2187 2418 2420 2421 2422 2423 2424 2425 2426 2427 2428 2429 2430 2431 2432 2433 2204 1967 1722 1469 1208  939  662  377   84
 576 1130 1396 1655 1897 1902 2144 2142 1901 2380 3225 2378 2148 2379 2605 2385 2606 3029 3030 2825 2610 2611 2613 2832 2833 2829 2619 2162 2393 2620 2837 2624 2622 2839 1685 2625 2401 2172 2405 2847 3052 2631 2409 2412 3056 2850 2636 2638 2854 2640 2641 2856 2643 2644 2645 2646 2647 2648 2649 2650 2651 2652 2653 2654 2655 2434 2205 1968 1723 1470 1209  940  663  378   85
 286  285  575  857 1129 1651 1650 2377 2599 2598 2816 2817 2819 2382 2383 3028 2823 2384 2822 2824 2826 2827 3035 2828 2830 3237 2394 2615 3040 2397 3043 3435 3044 3045 2840 2842 2843 2407 3048 2846 2174 2632 2633 2634 2849 2635 2637 3058 2853 2855 3063 2419 2857 2859 2860 2861 2862 2863 2864 2865 2866 2867 2868 2869 2656 2435 2206 1969 1724 1471 1210  941  664  379   86
 574  856  854  855 2140 1394 2372 2373 2374 2597 3023 2601 2818 2820 3226 2821 3027 2609 3230 3232 3231 3033 3034 3234 2831 2614 3039 3041 3042 3431 2618 2623 3244 2626 2841 3246 3248 2404 2406 2845 2844 3054 3055 3256 3447 2851 3060 2852 3451 3061 3263 2642 2858 3066 3067 3068 3069 3070 3071 3072 3073 3074 3075 2870 2657 2436 2207 1970 1725 1472 1211  942  665  380   87
 573 1128 1393 1127 1648 1898 2139 2138 1392 1900 2814 2815 3025 3024 3026 3224 3418 3229 3032 3604 3423 3233 3037 3036 3236 3427 3239 3433 2835 3613 3240 3432 3436 3046 3245 3440 3249 3050 3441 3443 3053 3253 2848 3254 3446 3448 3258 3259 3261 3453 3062 3262 3065 3264 3266 3458 3267 3269 3270 3271 3272 3273 3076 2871 2658 2437 2208 1971 1726 1473 1212  943  666  381   88
 284  572  853 1124 1647 1895 1389 1390 1649 2596 2595 2813 3022 3223 3416 3417 3228 3227 3419 3420 3606 3424 3608 3425 3235 3426 3238 3429 3241 3792 3434 3793 3616 3617 3438 3047 3439 3051 3624 3252 3251 3444 3445 3630 3257 3255 3449 3450 3452 3064 3260 3454 3455 3265 3456 3457 3268 3460 3461 3462 3463 3274 3077 2872 2659 2438 2209 1972 1727 1474 1213  944  667  382   89
 283  282 1126 1125  850 1899 1896 2370 2371 2594 2369 3021 3222 3415 3600 3601 3602 3603 3605 3422 3421 3782 3609 3610 3428 3611 3612 3430 3614 3789 3242 3618 3794 3243 3619 3621 3049 3797 3250 3800 3625 3627 3803 3628 3805 3631 3632 3633 3634 3635 3636 3637 3638 3639 3640 3641 3459 3643 3644 3645 3464 3275 3078 2873 2660 2439 2210 1973 1728 1475 1214  945  668  383   90
 281  571  852 1120 2135 1391 2137 1645 2136 2811 2812 3020 3221 3414 3599 3776 3777 3778 3779 3607 3781 3783 3951 3784 3785 3786 3787 3788 3615 3957 3790 3791 3960 3437 3622 3623 3796 3798 3442 3799 3626 3801 3802 3629 3804 3806 3807 3808 3809 3810 3811 3812 3813 3814 3815 3816 3642 3818 3819 3646 3465 3276 3079 2874 2661 2440 2211 1974 1729 1476 1215  946  669  384   91
 280    0  848 1388 1122 1387 1893 1894 2368 2593 2810 3019 3220 3598 3775 3944 3945 3947 3780 3948 4107 3949 3950 4110 3952 3953 3954 3955 3956 3958 4117 4119 3959 3620 3962 3795 3963 3965 3966 3967 3968 3969 3970 3971 3972 4131 3973 3975 3976 3977 3978 3979 3980 3981 3982 3984 3817 3985 3820 3647 3466 3277 3080 2875 2662 2441 2212 1975 1730 1477 1216  947  670  385   92
 568  851  569 1121 1123 1891 1644 2134 2367 2591 2809 3018 3219 3413 3597 3942 3774 3946 4257 4258 4108 4259 4109 4111 4262 4112 4113 4114 4115 4116 4269 4120 4270 4272 3961 4122 3964 4124 4125 4126 4127 4128 4129 4130 4282 4132 3974 4134 4135 4136 4137 4138 4139 4141 4142 3983 4143 3986 3821 3648 3467 3278 3081 2876 2663 2442 2213 1976 1731 1478 1217  948  671  386   93
 278  570  849 1386 1646  846 1643 2133 2592 2366 2807 3017 3218 3412 3411 3773 4101 4400 4255 4102 4105 4256 4260 4261 4263 4406 4264 4266 4267 4410 4118 4412 4413 4271 4273 4121 4417 4274 4275 4276 4278 4279 4280 4281 4425 4283 4133 4284 4285 4287 4288 4289 4290 4140 4291 4293 4144 3987 3822 3649 3468 3279 3082 2877 2664 2443 2214 1977 1732 1479 1218  949  672  387   94
 279  566 1119  567 1641 1642 1892 2132 2365 2808 2590 3016 3217 3410 3596 3772 4103 4104 3943 4399 4106 4401 4403 4404 4405 4407 4408 4265 4409 4545 4268 4411 4548 4414 4415 4123 4552 4418 4419 4277 4421 4423 4424 4559 4560 4426 4427 4429 4286 4430 4431 4432 4433 4435 4292 4294 4145 3988 3823 3650 3469 3280 3083 2878 2665 2444 2215 1978 1733 1480 1219  950  673  388   95
 277  276  565 1118 1385 1890 1889 2131 2364 2589 2806 3015 3216 3409 3595 3594 3941 3940 4254 4398 4665 4402 4538 4539 4540 4541 4542 4543 4544 4546 4673 4547 4795 4550 4677 4678 4551 4553 4554 4420 4556 4422 4558 4561 4687 4688 4562 4428 4564 4565 4566 4567 4568 4434 4436 4295 4146 3989 3824 3651 3470 3281 3084 2879 2666 2445 2216 1979 1734 1481 1220  951  674  389   96
 275  564  847  845 1383 1384 2130 2363 2588 2587 2805 3014 3215 3408 3593 3770 3771 4100 4253 4536 4537 4663 4666 4785 4667 4668 4669 4670 4671 4672 4674 4675 4794 4549 4679 4797 4416 4680 4681 4555 4683 4557 4684 4686 4917 4689 4690 4563 4691 4692 4693 4695 4570 4569 4437 4296 4147 3990 3825 3652 3471 3282 3085 2880 2667 2446 2217 1980 1735 1482 1221  952  675  390   97
 274  563  844 1117 1382 1640 1888 2129 2361 2804 3013 3214 3407 3592 3769 3938 3939 4252 4397 4533 4535 4662 4664 4896 4786 4787 4788 4789 4790 4791 4792 4904 4793 4676 4796 4909 4798 4799 4801 4682 4802 4803 4685 4804 4806 4807 4918 4808 4809 4812 4694 4813 4696 4571 4438 4297 4148 3991 3826 3653 3472 3283 3086 2881 2668 2447 2218 1981 1736 1483 1222  953  676  391   98
 273  562  843 1116 1381 1639 1887 2128 2586 2362 2803 3012 3213 3406 3591 3768 4099 3937 4098 4251 4534 4661 4784 4783 4897 4898 4899 4900 4901 4902 4903 5007 4905 4906 4907 4908 4910 5013 4800 4912 4913 4914 4915 4805 4919 5022 4920 5021 4811 4810 4922 4923 4697 4572 4439 4298 4149 3992 3827 3654 3473 3284 3087 2882 2669 2448 2219 1982 1737 1484 1223  954  677  392   99
 272  561  842 1115 1380 1638 1885 2127 2360 2585 2802 3011 3212 3405 3590 3767 3936 4097 4250 4396 4532 4660 4782 4895 5000 5001 5002 5003 5004 5005 5101 5006 5008 5010 5011 5106 5012 5014 5015 5016 5111 5017 5018 5019 4916 5116 5023 4921 5024 5025 4924 4814 4573 4574 4440 4299 4150 3993 3828 3655 3474 3285 3088 2883 2670 2449 2220 1983 1738 1485 1224  955  678  393  100
 271  560  841 1114 1379 1886 1637 2125 2359 2584 2801 3010 3211 3404 3589 3766 3935 4096 4249 4395 4531 4530 4781 4894 4999 5096 5097 5098 5099 5100 5189 5188 5103 5009 5105 5193 5107 5108 4911 5110 5198 5112 5113 5114 5020 5115 5117 5118 5119 4925 4816 4698 4815 4699 4441 4300 4151 3994 3829 3656 3475 3286 3089 2884 2671 2450 2221 1984 1739 1486 1225  956  679  394  101
 270  559  840 1113 1378 1636 2126 1884 2358 2583 2800 3009 3210 3403 3588 3765 3934 4095 4248 4394 4393 4659 4780 4998 4997 5095 5184 5185 5186 5187 5102 5268 5191 5104 5192 5272 5274 5194 5109 5197 5277 5199 5201 5281 5203 5204 5283 5205 5120 5026 4927 4817 4700 4575 4442 4301 4152 3995 3830 3657 3476 3287 3090 2885 2672 2451 2222 1985 1740 1487 1226  957  680  395  102
 269  558  839 1112 1377 1634 1883 1635 2357 2582 2799 3008 3209 3402 3587 3764 3933 4094 4247 4392 4529 4779 4892 4893 4996 5094 5183 5264 5265 5266 5267 5339 5190 5270 5271 5273 5195 5275 5196 5410 5347 5278 5279 5200 5202 5282 5206 5121 5028 4926 4928 4818 4701 4576 4443 4302 4153 3996 3831 3658 3477 3288 3091 2886 2673 2452 2223 1986 1741 1488 1227  958  681  396  103
 268  557 1111 1376 1882 1881 2356 2124 2355 2581 2798 3007 3208 3401 3586 3763 3932 4093 4246 4391 4528 4658 4778 4657 4995 5093 5182 5263 5336 5337 5338 5340 5269 5341 5342 5343 5344 5345 5276 5465 5411 5349 5280 5351 5352 5353 5284 5207 5122 5027 5029 4819 4702 4577 4444 4303 4154 3997 3832 3659 3478 3289 3092 2887 2674 2453 2224 1987 1742 1489 1228  959  682  397  104
 556  837  838 1375 1632 1633 2123 1880 2353 2797 2796 3006 3207 3400 3585 3762 3931 4092 4245 4390 4527 4656 4777 4891 4890 5092 5181 5262 5335 5399 5400 5402 5403 5404 5405 5408 5409 5463 5346 5348 5552 5467 5350 5469 5415 5354 5285 5208 5123 5030 4929 4820 4703 4578 4445 4304 4155 3998 3833 3660 3479 3290 3093 2888 2675 2454 2225 1988 1743 1490 1229  960  683  398  105
 267  555  836 1110 1109 1374 1631 2122 1879 2579 2580 3005 3206 3399 3584 3761 3930 4091 4244 4389 4526 4655 4776 4994 4993 5091 5180 5261 5334 5398 5401 5456 5457 5506 5459 5406 5407 5511 5464 5512 5513 5466 5414 5470 5416 5355 5286 5209 5124 5031 4930 4821 4704 4579 4446 4305 4156 3999 3834 3661 3480 3291 3094 2889 2676 2455 2226 1989 1744 1491 1230  961  684  399  106
 266  554  835 1107 1630 1372 2354 2120 2121 2578 2795 3004 3205 3398 3583 3759 4090 4243 4242 4388 4525 4654 4888 4889 5090 5179 5260 5259 5332 5333 5455 5504 5458 5545 5460 5461 5462 5549 5509 5510 5514 5412 5413 5418 5471 5417 5287 5210 5125 5032 4931 4822 4705 4580 4447 4306 4157 4000 3835 3662 3481 3292 3095 2890 2677 2456 2227 1990 1745 1492 1231  962  685  400  107
 265  553  833  834 1877 1629 1373 2119 2352 2577 2794 3003 3203 3204 3929 3755 3760 4089 3928 4387 4524 4652 4775 4774 4992 5089 5178 5258 5331 5397 5454 5502 5505 5543 5546 5507 5547 5548 5551 5583 5555 5554 5553 5468 5357 5356 5288 5211 5126 5033 4932 4823 4706 4581 4448 4307 4158 4001 3836 3663 3482 3293 3096 2891 2678 2457 2228 1991 1746 1493 1232  963  686  401  108
 264  552  551 1108 1371 1106 1878 2118 2351 2576 2793 3001 3581 3582 3397 3758 3927 4241 4240 4523 4651 4522 4653 4887 4991 5088 5176 5177 5396 5452 5453 5544 5503 5599 5508 5578 5602 5579 5550 5584 5585 5516 5515 5472 5419 5358 5289 5212 5127 5034 4933 4824 4707 4582 4449 4308 4159 4002 3837 3664 3483 3294 3097 2892 2679 2458 2229 1992 1747 1494 1233  964  687  402  109
 263  261  262  832 1370 1628 1876 2117 2350 2575 2792 3202 3002 3396 3580 3756 3926 4088 4385 4386 4521 4886 4773 4884 4885 4990 5257 5175 5329 5451 5500 5395 5575 5576 5542 5616 5617 5581 5604 5580 5582 5518 5517 5473 5420 5359 5290 5213 5128 5035 4934 4825 4708 4583 4450 4309 4160 4003 3838 3665 3484 3295 3098 2893 2680 2459 2230 1993 1748 1495 1234  965  688  403  110
 260  550 1105 1369 1626 1627 1875 2116 2349 2574 2791 3000 3201 3395 3757 3925 3923 3924 4238 4239 4384 4772 4650 4771 4989 5087 5086 5256 5393 5330 5539 5448 5501 5623 5577 5618 5615 5601 5607 5603 5605 5556 5519 5474 5421 5360 5291 5214 5129 5036 4935 4826 4709 4584 4451 4310 4161 4004 3839 3666 3485 3296 3099 2894 2681 2460 2231 1994 1749 1496 1235  966  689  404  111
 259  549  831  830 1103 1368 1874 2115 2348 2573 2790 2999 3200 3393 3394 3579 3578 4087 4383 4382 4648 4520 4770 4883 4988 5085 5255 5327 5328 5254 5394 5541 5573 5600 5540 5597 5624 5612 5614 5606 5586 5557 5520 5475 5422 5361 5292 5215 5130 5037 4936 4827 4710 4585 4452 4311 4162 4005 3840 3667 3486 3297 3100 2895 2682 2461 2232 1995 1750 1497 1236  967  690  405  112
 258  547 1102 1104 1366 1625 1873 2114 2347 2572 2789 2998 3199 3392 3577 3754 4085 4086 4084 4237 4519 4649 4769 4882 4987 5084 5174 5450 5253 5572 5498 5499 5571 5574 5596 5594 5567 5620 5619 5608 5587 5558 5521 5476 5423 5362 5293 5216 5131 5038 4937 4828 4711 4586 4453 4312 4163 4006 3841 3668 3487 3298 3101 2896 2683 2462 2233 1996 1751 1498 1237  968  691  406  113
 257  548  829 1367  828 1872 1871 2113 2346 2571 2788 2997 3198 3391 3576 3753 3922 4083 4380 4235 4518 4647 4768 4881 4986 5083 5173 5172 5447 5392 5390 5494 5538 5569 5537 5611 5593 5622 5621 5609 5559 5560 5522 5477 5424 5363 5294 5217 5132 5039 4938 4829 4712 4587 4454 4313 4164 4007 3842 3669 3488 3299 3102 2897 2684 2463 2234 1997 1752 1499 1238  969  692  407  114
 256  546 1100 1101 1624 1622 1623 2112 2345 2570 2787 2996 3197 3390 3575 3752 3921 4082 4234 4381 4517 4236 4767 4880 4985 5082 5171 5325 5326 5391 5446 5497 5496 5536 5613 5595 5592 5565 5610 5591 5588 5561 5523 5478 5425 5364 5295 5218 5133 5040 4939 4830 4713 4588 4455 4314 4165 4008 3843 3670 3489 3300 3103 2898 2685 2464 2235 1998 1753 1500 1239  970  693  408  115
 544  545  827  826 1365 1364 1621 2111 2569 2568 2786 3195 2994 3196 3389 3918 3920 4080 4232 4081 4379 4646 4766 4879 4984 5081 5170 5251 5324 5252 5449 5495 5570 5534 5568 5532 5598 5529 5563 5589 5527 5590 5524 5479 5426 5365 5296 5219 5134 5041 4940 4831 4714 4589 4456 4315 4166 4009 3844 3671 3490 3301 3104 2899 2686 2465 2236 1999 1754 1501 1240  971  694  409  116
 255  825  824 1099 1363 1868 2109 1867 1869 2566 2342 2785 2995 3388 3573 3574 3917 3750 3919 4233 4515 4516 4765 4878 4983 5080 5169 5250 5323 5387 5389 5388 5535 5491 5489 5531 5566 5487 5530 5564 5528 5483 5526 5525 5427 5366 5297 5220 5135 5042 4941 4832 4715 4590 4457 4316 4167 4010 3845 3672 3491 3302 3105 2900 2687 2466 2237 2000 1755 1502 1241  972  695  410  117
 254  543 1097 1098 1362 1870 1619 2107 2344 2783 2784 2993 3194 3387 3751 3571 3749 4079 4378 4513 4514 4645 4644 4763 4764 4982 5168 5249 5322 5384 5445 5493 5492 5440 5533 5490 5488 5436 5486 5485 5562 5431 5482 5480 5428 5367 5298 5221 5136 5043 4942 4833 4716 4591 4458 4317 4168 4011 3846 3673 3492 3303 3106 2901 2688 2467 2238 2001 1756 1503 1242  973  696  411  118
 253  542  823 1096 1361 1620 1618 2108 2343 2341 2567 2992 3193 3386 3748 3572 3916 4078 4231 4377 4376 4642 4643 4877 4981 5079 5167 5248 5320 5321 5386 5442 5382 5441 5439 5379 5437 5438 5435 5434 5484 5373 5430 5481 5429 5368 5299 5222 5137 5044 4943 4834 4717 4592 4459 4318 4169 4012 3847 3674 3493 3304 3107 2902 2689 2468 2239 2002 1757 1504 1243  974  697  412  119
 252  541  822 1095 1360 1617 2110 1866 2340 2565 2782 2991 3192 3385 3570 3747 4077 4076 4230 4375 4512 4641 4762 4876 4875 5078 5166 5247 5319 5443 5444 5383 5315 5381 5378 5312 5311 5310 5375 5374 5432 5433 5372 5303 5371 5369 5300 5223 5138 5045 4944 4835 4718 4593 4460 4319 4170 4013 3848 3675 3494 3305 3108 2903 2690 2469 2240 2003 1758 1505 1244  975  698  413  120
 251  540  821 1094 1359 1616 1865 2106 2339 2564 2781 2990 3191 3384 3569 3746 3914 3915 4229 4374 4511 4640 4874 4978 5077 4979 5165 5246 5318 5385 5317 5316 5240 5314 5313 5380 5377 5236 5376 5308 5307 5306 5305 5304 5370 5302 5301 5224 5139 5046 4945 4836 4719 4594 4461 4320 4171 4014 3849 3676 3495 3306 3109 2904 2691 2470 2241 2004 1759 1506 1245  976  699  414  121
 250  539  820 1093 1358 1615 1864 2105 2338 2563 2780 2989 3190 3383 3568 3745 4075 4228 4227 4373 4510 4639 4761 4873 4980 5076 5164 5245 5244 5243 5068 5242 5157 5237 5235 5154 5153 5151 5234 5309 5232 5231 5230 5146 5229 5227 5226 5225 5140 5047 4946 4837 4720 4595 4462 4321 4172 4015 3850 3677 3496 3307 3110 2905 2692 2471 2242 2005 1760 1507 1246  977  700  415  122
 249  538  819 1092 1357 1614 1863 2104 2337 2562 2779 2988 3189 3382 3567 3744 3913 4074 4372 4509 4638 4760 4758 4759 4977 5075 5163 5162 5160 4970 5070 5241 5158 5238 4965 5155 5062 5063 5150 5233 5148 5147 4956 5056 5228 5144 5143 5142 5141 5048 4947 4838 4721 4596 4463 4322 4173 4016 3851 3678 3497 3308 3111 2906 2693 2472 2243 2006 1761 1508 1247  978  701  416  123
 248  537  818 1091 1356 1613 1862 2103 2336 2561 2778 2987 3188 3381 3566 3743 3912 4073 4226 4371 4508 4637 4872 4976 5073 4975 4867 5071 5161 5069 4862 4967 5239 5066 5065 5064 5061 5152 5060 5149 5059 5058 5055 5054 5145 5053 5052 5051 5050 5049 4948 4839 4722 4597 4464 4323 4174 4017 3852 3679 3498 3309 3112 2907 2694 2473 2244 2007 1762 1509 1248  979  702  417  124
 247  536  817 1090 1355 1612 1861 2102 2335 2560 2777 2986 3187 3380 3565 3742 3911 4072 4225 4370 4507 4636 4757 4871 4974 5074 5072 4973 4972 4863 4969 5159 5067 5156 4966 4964 4963 4962 4961 4960 4959 5057 4958 4849 4955 4954 4953 4952 4951 4950 4949 4840 4723 4598 4465 4324 4175 4018 3853 3680 3499 3310 3113 2908 2695 2474 2245 2008 1763 1510 1249  980  703  418  125
 246  535  816 1089 1354 1611 1860 2101 2334 2559 2776 2985 3186 3379 3564 3741 3910 4071 4224 4369 4506 4635 4756 4870 4869 4868 4866 4865 4971 4864 4861 4968 4860 4859 4858 4857 4856 4855 4854 4853 4852 4851 4957 4850 4848 4847 4846 4845 4844 4843 4842 4841 4724 4599 4466 4325 4176 4019 3854 3681 3500 3311 3114 2909 2696 2475 2246 2009 1764 1511 1250  981  704  419  126
 245  534  815 1088 1353 1610 1859 2100 2333 2558 2775 2984 3185 3378 3563 3740 3909 4070 4223 4368 4505 4634 4755 4754 4753 4752 4751 4750 4749 4748 4747 4746 4745 4744 4743 4742 4741 4740 4739 4738 4737 4736 4735 4734 4733 4732 4731 4730 4729 4728 4727 4726 4725 4600 4467 4326 4177 4020 3855 3682 3501 3312 3115 2910 2697 2476 2247 2010 1765 1512 1251  982  705  420  127
 244  533  814 1087 1352 1609 1858 2099 2332 2557 2774 2983 3184 3377 3562 3739 3908 4069 4222 4367 4504 4633 4632 4631 4630 4629 4628 4627 4626 4625 4624 4623 4622 4621 4620 4619 4618 4617 4616 4615 4614 4613 4612 4611 4610 4609 4608 4607 4606 4605 4604 4603 4602 4601 4468 4327 4178 4021 3856 3683 3502 3313 3116 2911 2698 2477 2248 2011 1766 1513 1252  983  706  421  128
 243  532  813 1086 1351 1608 1857 2098 2331 2556 2773 2982 3183 3376 3561 3738 3907 4068 4221 4366 4503 4502 4501 4500 4499 4498 4497 4496 4495 4494 4493 4492 4491 4490 4489 4488 4487 4486 4485 4484 4483 4482 4481 4480 4479 4478 4477 4476 4475 4474 4473 4472 4471 4470 4469 4328 4179 4022 3857 3684 3503 3314 3117 2912 2699 2478 2249 2012 1767 1514 1253  984  707  422  129
 242  531  812 1085 1350 1607 1856 2097 2330 2555 2772 2981 3182 3375 3560 3737 3906 4067 4220 4365 4364 4363 4362 4361 4360 4359 4358 4357 4356 4355 4354 4353 4352 4351 4350 4349 4348 4347 4346 4345 4344 4343 4342 4341 4340 4339 4338 4337 4336 4335 4334 4333 4332 4331 4330 4329 4180 4023 3858 3685 3504 3315 3118 2913 2700 2479 2250 2013 1768 1515 1254  985  708  423  130
 241  530  811 1084 1349 1606 1855 2096 2329 2554 2771 2980 3181 3374 3559 3736 3905 4066 4219 4218 4217 4216 4215 4214 4213 4212 4211 4210 4209 4208 4207 4206 4205 4204 4203 4202 4201 4200 4199 4198 4197 4196 4195 4194 4193 4192 4191 4190 4189 4188 4187 4186 4185 4184 4183 4182 4181 4024 3859 3686 3505 3316 3119 2914 2701 2480 2251 2014 1769 1516 1255  986  709  424  131
 240  529  810 1083 1348 1605 1854 2095 2328 2553 2770 2979 3180 3373 3558 3735 3904 4065 4064 4063 4062 4061 4060 4059 4058 4057 4056 4055 4054 4053 4052 4051 4050 4049 4048 4047 4046 4045 4044 4043 4042 4041 4040 4039 4038 4037 4036 4035 4034 4033 4032 4031 4030 4029 4028 4027 4026 4025 3860 3687 3506 3317 3120 2915 2702 2481 2252 2015 1770 1517 1256  987  710  425  132
 239  528  809 1082 1347 1604 1853 2094 2327 2552 2769 2978 3179 3372 3557 3734 3903 3902 3901 3900 3899 3898 3897 3896 3895 3894 3893 3892 3891 3890 3889 3888 3887 3886 3885 3884 3883 3882 3881 3880 3879 3878 3877 3876 3875 3874 3873 3872 3871 3870 3869 3868 3867 3866 3865 3864 3863 3862 3861 3688 3507 3318 3121 2916 2703 2482 2253 2016 1771 1518 1257  988  711  426  133
 238  527  808 1081 1346 1603 1852 2093 2326 2551 2768 2977 3178 3371 3556 3733 3732 3731 3730 3729 3728 3727 3726 3725 3724 3723 3722 3721 3720 3719 3718 3717 3716 3715 3714 3713 3712 3711 3710 3709 3708 3707 3706 3705 3704 3703 3702 3701 3700 3699 3698 3697 3696 3695 3694 3693 3692 3691 3690 3689 3508 3319 3122 2917 2704 2483 2254 2017 1772 1519 1258  989  712  427  134
 237  526  807 1080 1345 1602 1851 2092 2325 2550 2767 2976 3177 3370 3555 3554 3553 3552 3551 3550 3549 3548 3547 3546 3545 3544 3543 3542 3541 3540 3539 3538 3537 3536 3535 3534 3533 3532 3531 3530 3529 3528 3527 3526 3525 3524 3523 3522 3521 3520 3519 3518 3517 3516 3515 3514 3513 3512 3511 3510 3509 3320 3123 2918 2705 2484 2255 2018 1773 1520 1259  990  713  428  135
 236  525  806 1079 1344 1601 1850 2091 2324 2549 2766 2975 3176 3369 3368 3367 3366 3365 3364 3363 3362 3361 3360 3359 3358 3357 3356 3355 3354 3353 3352 3351 3350 3349 3348 3347 3346 3345 3344 3343 3342 3341 3340 3339 3338 3337 3336 3335 3334 3333 3332 3331 3330 3329 3328 3327 3326 3325 3324 3323 3322 3321 3124 2919 2706 2485 2256 2019 1774 1521 1260  991  714  429  136
 235  524  805 1078 1343 1600 1849 2090 2323 2548 2765 2974 3175 3174 3173 3172 3171 3170 3169 3168 3167 3166 3165 3164 3163 3162 3161 3160 3159 3158 3157 3156 3155 3154 3153 3152 3151 3150 3149 3148 3147 3146 3145 3144 3143 3142 3141 3140 3139 3138 3137 3136 3135 3134 3133 3132 3131 3130 3129 3128 3127 3126 3125 2920 2707 2486 2257 2020 1775 1522 1261  992  715  430  137
 234  523  804 1077 1342 1599 1848 2089 2322 2547 2764 2973 2972 2971 2970 2969 2968 2967 2966 2965 2964 2963 2962 2961 2960 2959 2958 2957 2956 2955 2954 2953 2952 2951 2950 2949 2948 2947 2946 2945 2944 2943 2942 2941 2940 2939 2938 2937 2936 2935 2934 2933 2932 2931 2930 2929 2928 2927 2926 2925 2924 2923 2922 2921 2708 2487 2258 2021 1776 1523 1262  993  716  431  138
 233  522  803 1076 1341 1598 1847 2088 2321 2546 2763 2762 2761 2760 2759 2758 2757 2756 2755 2754 2753 2752 2751 2750 2749 2748 2747 2746 2745 2744 2743 2742 2741 2740 2739 2738 2737 2736 2735 2734 2733 2732 2731 2730 2729 2728 2727 2726 2725 2724 2723 2722 2721 2720 2719 2718 2717 2716 2715 2714 2713 2712 2711 2710 2709 2488 2259 2022 1777 1524 1263  994  717  432  139
 232  521  802 1075 1340 1597 1846 2087 2320 2545 2544 2543 2542 2541 2540 2539 2538 2537 2536 2535 2534 2533 2532 2531 2530 2529 2528 2527 2526 2525 2524 2523 2522 2521 2520 2519 2518 2517 2516 2515 2514 2513 2512 2511 2510 2509 2508 2507 2506 2505 2504 2503 2502 2501 2500 2499 2498 2497 2496 2495 2494 2493 2492 2491 2490 2489 2260 2023 1778 1525 1264  995  718  433  140
 231  520  801 1074 1339 1596 1845 2086 2319 2318 2317 2316 2315 2314 2313 2312 2311 2310 2309 2308 2307 2306 2305 2304 2303 2302 2301 2300 2299 2298 2297 2296 2295 2294 2293 2292 2291 2290 2289 2288 2287 2286 2285 2284 2283 2282 2281 2280 2279 2278 2277 2276 2275 2274 2273 2272 2271 2270 2269 2268 2267 2266 2265 2264 2263 2262 2261 2024 1779 1526 1265  996  719  434  141
 230  519  800 1073 1338 1595 1844 2085 2084 2083 2082 2081 2080 2079 2078 2077 2076 2075 2074 2073 2072 2071 2070 2069 2068 2067 2066 2065 2064 2063 2062 2061 2060 2059 2058 2057 2056 2055 2054 2053 2052 2051 2050 2049 2048 2047 2046 2045 2044 2043 2042 2041 2040 2039 2038 2037 2036 2035 2034 2033 2032 2031 2030 2029 2028 2027 2026 2025 1780 1527 1266  997  720  435  142
 229  518  799 1072 1337 1594 1843 1842 1841 1840 1839 1838 1837 1836 1835 1834 1833 1832 1831 1830 1829 1828 1827 1826 1825 1824 1823 1822 1821 1820 1819 1818 1817 1816 1815 1814 1813 1812 1811 1810 1809 1808 1807 1806 1805 1804 1803 1802 1801 1800 1799 1798 1797 1796 1795 1794 1793 1792 1791 1790 1789 1788 1787 1786 1785 1784 1783 1782 1781 1528 1267  998  721  436  143
 228  517  798 1071 1336 1593 1592 1591 1590 1589 1588 1587 1586 1585 1584 1583 1582 1581 1580 1579 1578 1577 1576 1575 1574 1573 1572 1571 1570 1569 1568 1567 1566 1565 1564 1563 1562 1561 1560 1559 1558 1557 1556 1555 1554 1553 1552 1551 1550 1549 1548 1547 1546 1545 1544 1543 1542 1541 1540 1539 1538 1537 1536 1535 1534 1533 1532 1531 1530 1529 1268  999  722  437  144
 227  516  797 1070 1335 1334 1333 1332 1331 1330 1329 1328 1327 1326 1325 1324 1323 1322 1321 1320 1319 1318 1317 1316 1315 1314 1313 1312 1311 1310 1309 1308 1307 1306 1305 1304 1303 1302 1301 1300 1299 1298 1297 1296 1295 1294 1293 1292 1291 1290 1289 1288 1287 1286 1285 1284 1283 1282 1281 1280 1279 1278 1277 1276 1275 1274 1273 1272 1271 1270 1269 1000  723  438  145
 226  515  796 1069 1068 1067 1066 1065 1064 1063 1062 1061 1060 1059 1058 1057 1056 1055 1054 1053 1052 1051 1050 1049 1048 1047 1046 1045 1044 1043 1042 1041 1040 1039 1038 1037 1036 1035 1034 1033 1032 1031 1030 1029 1028 1027 1026 1025 1024 1023 1022 1021 1020 1019 1018 1017 1016 1015 1014 1013 1012 1011 1010 1009 1008 1007 1006 1005 1004 1003 1002 1001  724  439  146
 225  514  795  794  793  792  791  790  789  788  787  786  785  784  783  782  781  780  779  778  777  776  775  774  773  772  771  770  769  768  767  766  765  764  763  762  761  760  759  758  757  756  755  754  753  752  751  750  749  748  747  746  745  744  743  742  741  740  739  738  737  736  735  734  733  732  731  730  729  728  727  726  725  440  147
 224  513  512  511  510  509  508  507  506  505  504  503  502  501  500  499  498  497  496  495  494  493  492  491  490  489  488  487  486  485  484  483  482  481  480  479  478  477  476  475  474  473  472  471  470  469  468  467  466  465  464  463  462  461  460  459  458  457  456  455  454  453  452  451  450  449  448  447  446  445  444  443  442  441  148
 223  222  221  220  219  218  217  216  215  214  213  212  211  210  209  208  207  206  205  204  203  202  201  200  199  198  197  196  195  194  193  192  191  190  189  188  187  186  185  184  183  182  181  180  179  178  177  176  175  174  173  172  171  170  169  168  167  166  165  164  163  162  161  160  159  158  157  156  155  154  153  152  151  150  149
