# This puzzle is unsolvable
35
   2    1    3    4    5    6  142   10  273  145    9   11   12   14  150   15  398  153   18   20   21   23   24  407   25   26   27   28   29   30   31   32   33   34   35
 136  137  138  139  140  141  143    7    8  272  146  149   13  507  151  279  509   16   17   19  155   22  284  283  160  162  289  163  164  165  166  167  168  169   36
 135  264  265  266  267  268  269  270  144  276  391  274  277  152  508  278  510  280  154  281  156  403  158  404  159  288  518  290  291  292  293  294  295  170   37
 134  263  384  385  386  387  388  389  271  390  392  148  147  396  400  705  395  282  401  402  614  617  513  516  285  161  287  409  410  411  412  413  296  171   38
 133  262  383  496  497  498  499  603  500  606  701  275  394  505  397  706  703  399  613  611  512  616  157  618  286  514  408  519  521  522  414  415  297  172   39
 132  261  382  495  600  601  602  501  604  502  605  393  504  506  610  792  874  795  511  796  714  713  619  515  517    0  622  520  623  624  523  416  298  173   40
 131  260  381  494  599  696  697  698  699  790  503  788  789  609  871  704  708  876  707  612  709  711  405  406  620  717  621  718  626  625  524  417  299  174   41
 130  259  380  493  598  695  784  785  700  866  867  868 1003  608  791  872  942  793  947  710  879  881  801  949  883  803  882  805  719  525  526  301  418  175   42
 129  258  379  492  597  694  783  864  786  937  787  702  870  607  873  945  944 1007  615  794  797  712  716  954  952  953  804  807  627  720  527  300  302  176   43
 256  128  378  595  491  693  863  862  865  938 1103  940 1001 1004  941  943 1110 1064 1009  946 1114  798 1016 1015  808  884  802  806  628  725  629  528  177  178   44
 257  253  377  490  781  692  690  782  936  999  939 1000  869 1005 1006 1058 1063 1148 1066  877  800 1065  715  880 1067  950 1017  809  722  632  630  419  303   45   46
 127  125  124  376  596  691  861  780  935 1056 1057 1144 1107 1002 1061 1008 1111 1012 1180 1010  799  948 1068  878 1072  956  885  726  721  724  420  531  304  529  181
 126  255  375  592  593  594  779  860  998 1104 1055 1105 1147 1059 1060 1106 1108 1149 1153 1013  875 1113 1011  951  889  955 1014  425  421  530  723  179  305  532   47
 123  254  487  486  488  489  778  931  996  933 1143 1175 1145 1102 1203 1200 1179 1204 1184 1116 1115 1019 1069 1117  958  886  631  634  533  890  887  422   49  426  180
 122  373  252  372  777  483  856  858  859 1101  995 1054 1146 1177 1198 1109 1062 1202 1150 1071 1155 1154 1018 1073 1070  888  811  813  534  306  427  309  633  183   48
 374  250  590  484  687  591  994  776  932  930  997 1100 1140 1099 1199 1174 1216 1178 1182 1181 1151 1112 1118 1152  957  959 1020  960  727  424  812   50  423  308  307
 120  251  371  485  689  688 1053  934 1052 1049  928 1176 1139 1050 1173 1201 1206 1219 1220 1185 1183 1156 1119 1074 1021  961  814  728  810  635  535  311  310  182  184
 121  249  482  589  369  686  857  854  684  929 1141 1098  991 1172 1215 1142 1224 1218 1205 1208 1207 1157 1121 1120 1022  962  891  731  730  636  892  312  538  186   51
 119  248  370  775  588  774  587  855  992 1095  927 1096 1097 1138 1223 1213 1195 1221 1210 1188 1186 1025 1158 1075 1023  963  815  816  637  428  729   52  185  189   53
 118  247  368  685  683  682  773  853  993 1093 1135 1051 1136 1193 1197 1212 1196 1164 1217 1163 1189 1159 1122 1076 1024  817  893  895  732  641  639  537  536   54   56
 117  246  367  481  586  772  852  989  926  924 1090 1048 1168 1046 1171 1132 1166 1191 1190 1209 1187 1123 1124 1077 1026  964  894  733  734  540  638  429  188  187  313
 116  245  366  585  583  851  925  771  850  990 1047 1045 1170 1194 1167 1130 1222 1214 1129 1160 1162 1126 1079 1078  897  967  819  818  736  539  430  314  640  316   57
 115  363  244  480  478  770  477  580  680  986  915 1040 1042 1137 1038  978 1131  979 1192 1083 1127 1032 1128 1027  966 1028  896  738  820  735  432  541  431   55  190
 243  242  113  365  479  681  849  921  922  767 1044 1094 1043  839 1092 1041 1087 1211 1085 1082 1086 1161 1080  965 1029 1030  898  543  737  642  542  315  434  191   58
 241  584  581  582  769  679  923  985 1169  987  841  984 1039  916  977 1088 1037 1084 1165 1036 1033  974 1125 1031  971  900  739  648  743  821  644  435  436  317   59
 114  112  240  476  364  475  847  678  766  762 1091 1134  983  838  982  976  981  911  836 1034 1035  973  830  972  748  968  745  899  545  643  645  319  195  192  194
 111  239  362  579  361  677  768  763  848  920  988  980 1089  757 1133  754  835  908  837  833  975  831  742  903  904 1081  822  646  825  433  544  546  193   60  318
 110  360  474  472  675  578  919  574  765  844  917  918  756  664  914  910  912  750  913  906  746  557  828  905  741  969  826  647  547  320  437   61  439   63  196
 109  238  359  358  473  676  764  761  846  671  760  845  843  840  755  564  660  456  909  907  659  559  656  654  827  970  824  653  550  650  440  321  438  198   64
 108  237  357  673  674  577  571  576  570  669  758  842  665  667  460  567  457  834  562  751  749  832  556  657  744  902  446  555  823  901  331  740  649   62  197
 231  107  471  468  470  467  672  572  573  569  462  759  666  347  663  661  563  662  752  452  747  658  829  652  552  447  444  551  443  553  548  324  322  323   65
 105  236  232  354  465  353  464  466  670  226  221  668  344  346  565  217  753  561  558  560  338  213  451  655  449  334  332  554   76  327  442  328  200  201   66
 469  104  356  575  234  229  352  351  348  349  463  461  568  459  342  458  219  341  218  337  453  335  450   82   79   78  210  549  206  205  325  326   67   71  202
 233  355  235  106   99   96  350  227   95  225  224  345   91  223  220  566  455  454  214  339  222  216   83  333  651  208   77  448  207  329  330  204  441  199   68
 103  102  101  230  100   98  228   97   94   93   92   90   89   88  343   87  340   85   84   86   81  336  215   80  211  212  209  445   73   75   74  203   72   70   69
