# This puzzle is unsolvable
51
   2    1  201    3    4    7    8    9   10  209   11   12   13   14   15   16   17   18   19   20   21   22   23  223   25  416  225   28   30  228   29   32   33   34   35   36   37   38   39   40   41   42   44   45  243  245   46   48   49   50   51
 200  393  203    6    5  205  396  207  208  210  211  402  212  213  214  215  216  217  218  219  220  221  222  224   24   26  419  227  420   31  231  422  232  233  234  235  236  237  238  239  240  432  244  433   47  241  437  436  248  249   52
 197  392  198  579  576  580  206  397  398  399  401  585  403  404  405  406  407  408  409  410  412  594  413  414  415  599  226  418  229  230  604  421  423  424  425  426  427  428  429  613  430  791  242   43  621  435  247  246  438  439   53
 394  199  202  391  395  204  755  581  582  400  758  584  586  587  588  589  590  591  592  593  411  595  596  597  598  773   27  600  602  603  779  605  606  607  608  609  610  611  612  431  614  790  615  434  618  617  795  794  622  250  251
 390  389  575  577  751  753  921  923  756  924  583  760  761  762  763  764  765  766  767  768 1095  769  770  772  775  776  417  601  777  778  947  780  781  782  783  784  785  786  954  787  788  789  616  792  793  619  620  442  440  252   54
 196  388  573  752 1080  578  754 1082  757 1084  925  927  928  929  930  931  932  933  935 1094  938  771 1097  939  940  774  941  942  944  945 1257 1106  948  949  950  951  952 1112 1114  953  956  957  959  958 1118  623  798 1120  441   56   55
 195  387  920  750  574 1231  922 1081 1234 1083  759 1085 1238 1087 1088 1089 1091 1092  934 1245 1096  937 1098 1099 1100 1101 1102  943 1103 1104  946 1107 1258 1109 1260 1110 1262 1111 1113  955 1115 1116 1268  960 1269  961  797  801  624  255   57
 194  749  917  571  919  918 1079 1232 1233 1235  926 1237 1086 1239 1240 1385 1090 1241 1093 1389 1524  936 1246 1249 1250 1251 1252 1253 1255 1256 1400 1401 1259 1108 1536 1404 1261 1263 1264 1265 1266 1267  965  963 1119 1117  796  962  253  254  626
 193  385  572  386  748 1078 1076 1376 1378 1379 1236 1380 1381 1382 1383 1519 1242 1243 1386 1650 1390 1391 1248 1392 1393 1394 1395 1254 1397 1662 1533 1535 1399 1402 1403 1539 1405 1406 1407 1408 1409 1410 1411 1270  627  446  964  258  256   58   60
 192  570  384  747  915 1375  916 1512 1377 1513 1514 1515 1517 1645 1384 1520 1387 1523 1388 1522 1769 1654 1247 1526 1527 1529 1530 1396 1659 1531 1660 1661 1534 1665 1538 1540 1667 1541 1542 1543 1544 1545 1412 1121 1271  800  799   62  625  444   59
 191  569  744  568 1229 1075 1373 1077 1760 1871 1641 1642 1516 1518 1644 1646 1647 1648 1244 1881 1651 1525 1653 1655 1528 1656 1657 1658 1105 1780 1779 1398 1782 1663 1783 1537 1784 1668 1669 1670 1671 1546 1413 1272  966  628  629  257   61  443  259
 190  382  745 1230  746  914 1227 1640 1509 1639 1759 1873 1761 1763 1764 1765 1649 1878 1768 1521 1767 1652 1884 1773 1774 1775 1776 1777 1778 1890 1532 1893 1894 1895 1666 1664 1786 1787 1790 1788 1672 1547 1414 1123 1122  447  968  449  445  450   63
 189  567  912  383 1073 1372 1228 1074 1370 1872 1762 1511 1974 1643 1874 1875 1980 1877 2076 1981 1771 1770 1772 1883 1885 1989 1886 1991 1888 1889 1781 1892 1995 2092 1785 1999 1897 1898 1899 1789 1415 1416 1274 1273 1275 1124  802  804  448  260  261
 381  566  913  743 1225 1072 1638 1508 1637 1374 1635 1976 1972 1977 1979 1766 1876 2077 2078 2164 1879 1882 2080 1987 1988 2084 1887 1990 1992 1993 1891 1994 1997 2091 1896 2000 2001 1900 1901 1791 1549 1673 1417  803  967  969  631  630  806  451   64
 564  378  380  737 1226 1071 1371 1636 1504 1369 1507 1758 1975 2072 1978 2073 2074 2163 1983 2079 1880 1986 2167 2082 2083 2171 2085 2086 2087 2088 2176 2178 2089 2093 1998 2094 2095 2002 1674 1677 1548 1552 1127 1126 1277 1129  970  805  262  263   65
 562  742  377  909  910  741 1223 1510 1368 1754 1634 1868 1757 2070 2160 2161 2075 2162 2243 2165 1982 2245 2081 2169 2249 2170 2172 2173 2174 2175 2256 2328 1996 2090 2177 2180 2096 2003 1902 1903 1792 1418 1550 1420 1276 1125  634  632  452  264   66
 187  911  560  740 1070  739 1366 1224 1222 1756 1865 1870 2071 1973 2159 2240 2241 2313 2242 2316 1985 1984 2166 2318 2319 2248 2250 2253 2323 2255 2254 2257 2326 2258 2259 2181 2182 2097 2004 1904 1794 1793 1553 1278 1130 1128  972  633  807  453   67
 186  565  188  563  379 1069 1367 1503 1755 1506 1631 1869 2068 1971 2158 2239 2312 2244 2377 2314 2379 2246 2168 2247 2320 2321 2322 2252 2441 2325 2327 2445 2329 2179 2330 2260 2098 2006 2005 1795 1678 1675 1551 1676 1279  973  971  635  265   68  266
 183  185  559  907 1067 1221 1365 1864 1632 1505 1753 1969 1867 2069 2238 2237 2311 2376 2433 2434 2435 2317 2380 2382 2383 2438 2384 2387 2251 2443 2324 2388 2390 2183 2261 2185 2184 2099 1905 1796 1679 1421 1419 1280 1131  974  808  636   70  267  455
 181  182  736  375 1068  561  908 1363 1502 1633 1751 1752 1866 2157 2067 2156 2310 2315 2430 2432 2520 2378 2483 2381 2437 2525 2386 2439 2440 2442 2444 2491 2391 2331 2262 2186 2100 2007 1906 1797 1680 1555 1554 1422 1132  975  809  810  637  454   69
 180  376  184  735  905 1065  903 1220 1630 1364 1750 1970 1968 2066 2155 2309 2374 2431 2375 2480 2481 2436 2484 2485 2486 2526 2385 2527 2492 2490 2389 2529 2446 2392 2263 2101 2008 2009 1907 1798 1681 1556 1423 1281 1133  976  638  458  456  268   71
 179  374  734  738 1219  906 1360 1218 1500 1501 1629 1862 1863 2065 2235 2236 2308 2370 2373 2479 2521 2482 2576 2522 2524 2557 2487 2530 2489 2528 2494 2393 2448 2332 2264 2187 2102 1908 1799 1800 1682 1557 1425 1282 1284 1134  977  811  457  269   72
 370  732  373  904  902  733 1361 1359 1362 1628 1861 1967 1966 2153 2152 2154 2234 2477 2372 2428 2429 2553 2555 2577 2593 2556 2559 2582 2488 2493 2395 2396 2333 2266 2265 2188 2103 2010 1909 1683 1684 1558 1135 1424 1137  812  639  641  640  459   73
 557  176  372  556  555 1217 1058 1215 1216 1627 1747 1860 1749 2063 2064 2306 2307 2427 2476 2551 2552 2519 2592 2591 2523 2581 2558 2531 2562 2449 2334 2450 2447 2335 2189 2190 2104 2011 1910 1801 1685 1559 1426 1136 1283  814  978  815  460  270   74
 177  178 1066 1498 1063 1060 1064  558 1495 1497 1748 1965 2151 2232 2233 2231 2371 2305 2518 2478 2517 2600 2574 2590 2554 2580 2598 2595 2561 2532 2495 2394 2397 2336 2191 2267 2105 2012 1911 1802 1686 1427 1286 1285  980  813  816 1138  642   75  272
 369    0  371  730 1059 1062 1496 1214 1859 1499 1746 1623 2062 2061 2150 2230 2304 2369 2475 2515 2516 2549 2550 2575 2578 2579 2594 2560 2597 2496 2534 2533 2451 2268 2337 2192 2106 2013 1912 1803 1561 1560 1428 1287 1139  979  981  644  643  271   77
 175  729  172  554  553 1061 1357  900 1358 1626 1745 1964 1963 2060 2148 2147 2368 2425 2474 2473 2513 2426 2572 2573 2599 2596 2584 2564 2583 2563 2497 2452 2398 2399 2338 2269 2107 2014 1913 1804 1687 1562 1429 1288  982  983  817  819  466   76  462
 368  552  899  549 1213  901  728 1211 1494 1624 1744 1858 1962 2149 2302 2229 2367 2424 2366 2514 2472 2548 2547 2589 2588 2587 2568 2586 2536 2535 2498 2453 2400 2339 2270 2193 2108 2015 1914 1805 1688 1563 1430 1289 1140  818  464  645  274  275  273
 366  174  898  731  725  895 1210 1356 1492 1625 1739 1857 1856 2059 2146 2301 2303 2365 2422 2423 2471 2571 2570 2543 2569 2567 2540 2585 2503 2537 2499 2454 2401 2340 2271 2194 2109 2016 1915 1806 1689 1564 1431 1290 1141  984  820   79  461  463   78
 171  897  727 1056  367 1055 1353 1212 1621 1622 1355 1743 1741 1960 1961 2227 2145 2469 2228 2364 2510 2546 2509 2544 2542 2541 2539 2566 2538 2565 2500 2456 2455 2272 2273 2195 2110 2017 1916 1807 1690 1565 1432 1291 1143 1142  646  821  465   80  278
 547  173  726  551  894 1057 1493 1490 1208 1740 1855 1742 1957 2058 2056 2226 2298 2300 2418 2470 2545 2467 2466 2508 2506 2505 2504 2461 2460 2502 2501 2457 2341 2402 2197 2111 1917 2112 1808 1809 1691 1566 1433 1292  985  822  649  467  647  276   81
 170  363  365  550  364  548 1354 1352 1618 1491 1854 2055 1738 2057 2225 2299 2224 2512 2362 2421 2417 2357 2511 2465 2413 2464 2411 2410 2459 2408 2458 2344 2404 2403 2196 2343 2018 2019 1918 1810 1692 1567 1434 1293 1144  986  277  823  279  468   82
 169  362  724  896  893  892 1054 1209 1207 1206 1617 2053 1959 1852 2144 2222 2223 2296 2358 2468 2292 2416 2415 2353 2355 2463 2462 2412 2351 2409 2348 2407 2405 2342 2277 2198 2113 2020 1919 1811 1693 1568 1435 1294 1145  988  824  648  650  280   83
 168  361  722  545  723 1053 1052 1351 1619 1615 1488 1851 1956 2052 2054 2142 2143 2360 2359 2297 2291 2290 2214 2414 2352 2507 2210 2209 2282 2349 2406 2274 2345 2278 2275 2276 2199 2021 1920 1694 1569 1436 1437 1146  989  651  987  470  469  281   84
 167  360  721  891 1050  890 1202 1487 1620 1489 1736 1958 1853 1955 2141 2295 2419 2363 2294 2420 2293 2289 2212 2356 2354 2211 2286 2285 2350 2284 2281 2347 2280 2346 2203 2115 2114 2023 1921 1922 1695 1570 1296 1295 1147  990  825  652  471  282   85
 166  359  546  544 1051 1204 1616 1486 1737 1850 1735 1849 1954 2051 2140 2221 2220 2218 2361 2217 2216 2215 2288 2287 2129 2213 2036 2127 2208 2283 2123 2206 2204 2279 2201 2200 2116 2024 2022 1812 1696 1571 1438 1297 1148  991  826  653  472  283   86
 165  358  543  720  889 1049 1203 1205 1350 1734 1613 1614 2049 2050 2139 2138 2137 2219 2136 2135 2133 2132 1718 2040 2130 2128 1935 2035 2125 2207 2124 2031 2120 2121 2202 2118 2117 2025 1813 1814 1697 1572 1439 1298 1149  992  827  654  473  284   87
 164  357  542  719  888 1201 1348 1349 1611 1483 1848 1952 1953 1950 2048 2047 2045 2046 2044 2042 2134 1941 1940 2041 2038 2037 2126 2033 1934 2034 2032 2122 2205 2028 2119 2027 2026 1924 1923 1815 1698 1573 1440 1299 1150  993  828  655  474  285   88
 163  356  541  718  887 1047 1346 1048 1347 1485 1845 1847 1846 1949 1604 1948 1946 1944 1836 1468 1942 1720 1598 2131 2039 1832 1937 1939 1827 1933 1825 1824 2030 2029 1928 1583 1927 1926 1925 1699 1700 1574 1441 1300 1151  994  829  656  475  286   89
 162  355  540  717  886 1200 1484 1199 1612 1730 1733 1729 1951 1843 1842 1840 1947 1725 1945 1721 1943 1837 1719 1717 1938 1831 1936 1714 1830 1828 1826 1932 1929 1931 1823 1822 1704 1820 1818 1817 1816 1575 1442 1301 1152  995  830  657  476  287   90
 161  354  539  716  885 1046 1344 1482 1481 1732 1731 1728 1476 1844 1724 1333 1841 1602 1601 1600 1467 1834 2043 1597 1833 1715 1463 1591 1460 1712 1711 1710 1708 1930 1707 1821 1705 1819 1703 1702 1576 1577 1443 1302 1153  996  831  658  477  288   91
 160  353  538  715  884 1045 1198 1345 1343 1609 1608 1477 1610 1335 1473 1472 1332 1726 1188 1722 1835 1839 1599 1464 1594 1716 1592 1713 1458 1589 1588 1586 1709 1585 1706 1584 1581 1450 1580 1579 1701 1444 1303 1304 1154  997  832  659  478  289   92
 159  352  537  714  883 1044 1197 1342 1337 1339 1480 1605 1606 1607 1471 1330 1603 1329 1328 1723 1466 1596 1178 1595 1325 1462 1829 1590 1174 1457 1318 1587 1454 1455 1452 1451 1582 1449 1448 1308 1578 1446 1445 1155 1156  998  833  660  479  290   93
 158  351  536  713  882 1043 1196 1193 1340 1478  874 1475 1474 1727 1187 1186 1184 1029 1183 1838 1331 1327 1326 1179 1461 1459 1323 1322 1320 1317 1316 1456 1453 1168 1314 1313 1312 1311 1309 1447 1161 1307 1306 1305  999 1000  834  481  661  291   94
 157  350  535  712  881 1042 1195 1341 1194 1037 1479 1338 1035 1192 1334 1189 1185 1470 1182 1181 1026 1180 1324 1023 1176 1465 1593 1173 1018 1319 1015 1171 1169 1315 1167 1166 1165 1164 1310 1163 1162 1160 1159 1158 1002  835  662  480  482  292   95
 156  349  534  711  880 1041 1040 1039 1038 1036 1191  872 1336 1032  868  869 1030 1469  865 1027 1025  861 1024 1022 1021 1177 1020 1321 1175 1172 1016 1170 1014 1013 1012 1011 1010 1009 1008 1007 1006 1005 1004 1003 1001 1157  836  663  483  293   96
 155  348  533  710  879  878  877  876  875  873 1190  702  870 1033 1034  698  867 1028  694  864  863  862  690  860  859  858  856 1019  855 1017  854  853  852  850  849  848  847  846  845  844  843  842  841  840  839  667  838  837  664  294   97
 154  347  532  709  708  707  706  705  704  703  700  701  699  521  518 1031  866  516  695  693  692  691  511  689  687  686  857  685  684  683  682  681  851  500  679  677  676  675  674  673  672  671  670  669  489  668  666  665  484  295   98
 153  346  531  530  529  528  527  526  525  524  523  522  871  333  520  519  696  697  515  514  513  512  324  510  688  508  507  506  505  504  503  314  680  501  678  499  498  496  495  494  493  492  491  490  302  488  487  486  485  296   99
 152  345  344  343  342  341  340  339  338  337  336  335  334  331  330  332  517  134  328  327  326  325  323  128  509  322  320  319  318  317  316  502  315  118  312  311  497  310  309  308  306  305  304  108  303  301  300  299  298  297  100
 151  150  149  148  147  146  145  144  143  142  141  140  139  138  137  136  329  135  133  132  131  130  129  127  126  321  125  124  123  122  121  120  313  119  117  116  115  114  113  307  112  111  110  109  107  106  105  104  103  102  101
