# This puzzle is unsolvable
72
 284  285  561    4    5  289    8    6   10  293   12   13  297   16   17   18  300   19  303   20   21  306   22   25  582  307  310   27   28  313   30   31   32   35   36  319  318  320   39   42   43  326  325  327  329   47   48  873   50  331  609  334  336   52  338   55   56   58   59   60   61   62   63   64   65   66   68  626   70   72   73  354
   1  286  288  287  830  564  292    7  294  569  835   14  295  298   15  299  574  576  578  577  305   24 1110 1109   26  585  584  311   29  312  314  315   33  316   34  594   38   37  596  321 1124   44   45  870   46  328  605  332   51   49  335  610   53   54  613  339   57  341  342  343  344  345  347  622  348  350   67  625  628  630   75  355
 283  559    3  560    9    0  563 1343  833   11  568  291  571  572 1099 1100 1101  840  575  301  304  581  580   23  849  583  309  586  587  588  589  590  592  858  317  860  595  323   41  324  867  868  600 1125  602  606  607 1131  875  333 1134  877  611  337  612  881  340  615  616  617  618  619  620  889  624  349  892  627   69  353  629   71
 282  828  827    2  290 1090  566 1092  834 1091 1345  296 1097  570  839 1349  573 1102  302  844 1104  579  846  848  308  852 1111  853  854  855  856  857 1117 1368  591  593  862  597  863   40  598  866  603  869  604  330  871 1132  874 1385  608  876 1137  879  614  880  882  883  884  885  886  887  621  890  623  891  893  351  894  352  358  356
 281  558  829  831  562 1088 1089 1342  567 1095 1346  836  837  838  842  841 1098 1103  845 1354 1106  847 1108  850 1360 1361 1112 1113 1366 1364 1115 1367 1116 1370 1119  861 1373 1121 1123  322  865  864 1378  599  872 1857 1379 1382 1383 1384 1133 1866 1138  878 1139 1140 1141 1142 1143 1144 1146 1147  346 1148  888 1149 1150 1152  895  631   77   74
 280  557  826 1087 1340 1585  565  832 1588 1093 1590 1096 1592 1347 1348 1594 1351 1353  843 1833 1355 1356 1107 1359 1602 1362  851 1363 1114 1845 1611 1369  859 1118 1371 1120 1372 1122 1374 1375 1376 1377  601 1620 1129 2088 1381 1627 1624 1865 1135 1629 1136 1388 1390 1391 1393 1636 1394 1395 1145 1397 1398 1399 1400 1401 1151 1153  897  896  357   76
 279  556  825 1086 1339 1341 1338 1094 1583 1344 1824 1825 1589 1593 1350 1596 1352 1595 1598 1600 1105 1357 1358 1601 1603 1604 1605 1841 1608 1843 1365 1610 1847 1609 1613 1614 1615 1616 1617 1618 1619 1858 1126 1127 1621 1130 1622 1626 1862 1386 1864 1387 1630 1389 1633 1634 1392 1637 1638 1639 1396 1640 1641 1642 1643 1644 1402 1403 1154  632  359   78
 278  555  824 1084 1337 1819 1584 1586 1587 1822 1823 1826 1591 1828 2055 1829 1830 1597 2060 1831 1834 1835 1836 1837 1838 1839 1606 1840 2068 2072 2292 2073 2290 1612 1848 1849 1850 1851 1852 1853 1854 2082 1855 1380 1856 1623 1625 2305 1860 1863 2310 2091 1631 1632 1868 1869 1635 1871 1872 1873 1874 1875 1876 1877 1878 1645 1404 1155  898  633  360   79
 277  554 1085  823 1582 1820 2048 1821 2047 2050 2051 2052 1827 2053 2054 2056 2057 1832 2278 2279 2280 1599 2063 2064 2065 2066 2067 1607 1842 1844 2289 2293 1846 2074 2075 2076 2077 2078 2079 2080 2081 2083 2303 1128 2085 2304 2086 2089 2090 1628 2092 2094 2095 1867 2097 2316 1870 2098 2099 2100 2101 2102 2103 2104 1879 1646 1405 1156  899  634  361   80
 276  553  822 1083 1336 1581 1818 2268 2049 2269 2270 2271 2272 2273 2276 2275 2277 2059 2489 2281 2061 2062 2282 2283 2284 2285 2286 2287 2069 2070 2291 2071 2503 2294 2505 2295 2296 2297 2298 2299 2300 2301 2084 2302 2516 1859 2087 2306 2308 2722 2309 2311 2093 2313 2315 2525 2527 2317 2318 2319 2320 2321 2322 2105 1880 1647 1406 1157  900  635  362   81
 275  552  821 1082 1335 1580 1817 2046 2267 2480 2481 2482 2483 2484 2274 2485 2487 2488 2692 2490 2491 2492 2493 2494 2495 2496 2497 2499 2701 2288 2501 2705 2706 2502 2504 2506 2507 2508 2509 2510 2511 2512 2513 2514 2720 2307 2518 1861 2519 2520 2521 2522 2524 2728 2526 2314 2096 2528 2529 2530 2531 2532 2323 2106 1881 1648 1407 1158  901  636  363   82
 274  551  820 1081 1334 1579 1816 2045 2266 2479 2684 2685 2686 2687 2688 2486 2689 2058 2691 2693 2694 2695 2696 2697 2698 2699 2700 2498 2703 2500 3085 2900 2899 3089 2708 2709 2710 2711 2712 3097 2908 2714 2716 2717 2515 2517 3103 2916 2918 2725 2523 2921 2312 2727 2923 2729 2730 2731 2732 2733 2533 2534 2324 2107 1882 1649 1408 1159  902  637  364   83
 273  550  819 1080 1333 1578 1815 2044 2265 2478 2683 2880 2881 2882 2883 3071 2690 2885 2887 2888 2889 2890 2891 2892 2893 2894 2895 2896 3084 2702 2901 3086 3088 2707 2903 2904 2905 2906 3094 2907 2713 2715 3098 2912 2718 2719 2721 3281 2723 2724 2919 3105 2726 3109 2922 2924 2925 2926 2927 2928 2734 2325 2108 2109 1883 1650 1409 1160  903  638  365   84
 272  549  818 1079 1332 1577 1814 2043 2264 2477 2682 2879 3068 3069 3249 3073 2884 2886 3251 3075 3076 3077 3078 3079 3080 3081 3261 3082 3083 2897 2704 3266 3087 2902 3090 3091 3092 3272 3093 2909 3096 2911 2910 3099 2913 2914 2915 3283 2917 3284 3104 2920 3107 3108 3110 3111 3112 3113 3114 2929 2736 2735 2535 2326 1884 1651 1410 1161  904  639  366   85
 271  548  817 1078 1331 1576 1813 2042 2263 2476 2681 2878 3067 3247 3248 3250 3070 3072 3074 3254 3255 3256 3257 3258 3259 3260 3433 3432 3263 3265 2898 3437 3267 3268 3269 3270 3271 3443 3273 3095 3275 3447 3276 3450 3101 3278 3102 3453 3285 3618 3106 3454 3458 3287 3289 3290 3291 3292 3116 2737 2536 2537 2111 2110 1885 1653 1652 1411  905  640  367   86
 270  547  816 1077 1330 1575 1812 2041 2262 2475 2680 2877 3066 3419 3421 3422 3423 3253 3252 3424 3425 3426 3591 3429 3593 3430 3431 3262 3434 3264 3599 3436 3438 3439 3440 3441 3442 3606 3444 3274 3445 3446 3277 3448 3279 3614 3280 3282 3771 3619 3457 3286 3456 3288 3459 3461 3462 3293 2930 3115 2738 2538 2327 2328 1886 1654 1163 1162  906  641  368   87
 269  546  815 1076 1329 1574 1811 2040 2261 2474 2679 2876 3065 3420 3246 3584 3585 3586 3741 3588 3892 3427 3592 3428 3594 3896 3595 3596 3597 3435 3598 3600 3601 3602 3603 3604 3761 3607 3762 3608 3764 3609 3612 3449 3613 3769 3451 3770 3616 3920 3620 3621 3776 3622 3460 3623 3463 3294 3117 2932 2931 2739 2329 2112 1887 1655 1164  907  642  643  369   88
 268  545  814 1075 1328 1573 1810 2039 2260 2473 2678 2875 3064 3245 3418 3583 3740 3888 3587 3889 3742 3589 3745 3747 3748 3749 3750 3751 3752 3753 3754 3755 3756 3757 3758 3759 3605 3908 3909 3763 3610 3611 3766 3768 3100 3917 3452 4059 3455 3919 3774 3921 3775 3777 3778 3624 3464 3295 3118 2933 2740 2539 2330 2113 1888 1413 1412 1165  908  644  370   89
 267  544  813 1074 1327 1572 1809 2038 2259 2472 2677 2874 3063 3244 3417 3582 3739 3887 4160 3743 3590 3891 3746 3893 3895 4035 3897 3898 3899 3900 3901 3902 3903 3904 3905 3906 3760 3907 3910 3911 4050 3765 3767 4052 3914 3615 3617 3918 4062 3772 4191 4192 3923 3924 3779 3625 3626 3465 3297 3119 2741 2540 2331 2114 1889 1656 1414 1166  909  371   90  373
 266  543  812 1073 1326 1571 1808 2037 2258 2471 2676 2873 3062 3243 3416 3581 3738 4028 3890 4030 3744 4032 4033 3894 4034 4166 4036 4037 4038 4039 4040 4041 4042 4043 4044 4045 4046 4047 4048 4181 4051 3912 3913 3916 3915 4055 4187 4056 3922 4057 4063 3773 4064 3782 3780 3926 3627 3296 3299 2934 2742 2332 2115 2333 1890 1416 1415 1167  910  645  372   91
 265  542  811 1072 1325 1570 1807 2036 2257 2470 2675 2872 3061 3242 3415 3580 3737 4027 4029 4161 4284 4031 4162 4163 4165 4167 4290 4168 4169 4170 4171 4172 4173 4174 4175 4176 4177 4178 4179 4049 4180 4182 4184 4054 4185 4311 4188 4424 4310 4058 4060 3925 4314 3631 3781 3468 3466 2937 3120 3298 2542 2545 2541 2334 1891 1657 1417 1168  911  646   92   93
 264  541  810 1071 1324 1569 1806 2035 2256 2469 2674 2871 3060 3241 3414 3579 3735 3886 4026 4159 4283 4286 4287 4164 4288 4289 4291 4292 4407 4293 4294 4295 4296 4297 4298 4299 4300 4301 4302 4303 4305 4306 4183 4307 4053 4308 4425 4309 4190 4313 4189 4428 4193 4316 3784 3927 3467 3122 3628 2935 2938 2936 2335 2117 2118 1660 1418 1170  912  647  375  374
 263  540  809 1070 1323 1568 1805 2034 2255 2468 2673 2870 3059 3240 3413 3578 3734 3736 3885 4025 4158 4285 4401 4402 4403 4404 4405 4406 4408 4409 4516 4410 4411 4412 4413 4414 4415 4416 4417 4418 4527 4420 4421 4422 4423 4186 4631 4531 4427 4065 4430 4061 4066 3786 4194 3469 3121 3300 3123 2744 2745 2543 2544 2116 1659 1893  914 1661 1169 1420  376   94
 262  539  808 1069 1322 1567 1804 2033 2254 2467 2672 2869 3058 3239 3412 3577 3884 3882 4024 4157 4282 4400 4508 4509 4510 4511 4512 4513 4514 4515 4517 4518 4519 4619 4521 4522 4523 4524 4525 4526 4304 4419 4528 4529 4530 4532 4426 4535 4312 4534 3785 4315 3929 4195 3928 3630 3629 3470 3301 2940 2747 2546 2939 1419 1663 1658 1892 1171  913  648   95   96
 261  538  807 1068 1321 1566 1803 2032 2253 2466 2671 2868 3057 3238 3411 3576 3733 4023 3883 4156 4281 4399 4398 4608 4609 4610 4611 4703 4612 4613 4614 4615 4618 4520 4709 4620 4621 4622 4623 4624 4625 4798 4626 4629 4719 4630 4722 4721 4533 4632 4429 4318 4196 3931 3632 3472 3303 3124 3125 2746 2748 2339 2743 1896 2119 2336  917 1421  915 1174  649  650
 260  537  806 1067 1320 1565 1802 2031 2252 2465 2670 2867 3056 3237 3410 3575 3732 3881 4022 4155 4280 4506 4507 4607 4700 4701 4785 4702 4704 4705 4706 4617 4707 4708 4794 4793 4713 4714 4869 4796 4715 4800 4627 4944 4628 4804 4878 4633 4536 4637 4319 4431 3930 3783 3787 3634 3302 3471 3126 2942 2548 2547 1897 2120 1662 1894 1665 1895  652 1172   97  377
 259  536  805 1066 1319 1564 1801 2030 2251 2464 2669 2866 3055 3236 3409 3574 3731 3880 4021 4154 4396 4397 4505 4606 4699 4784 4860 4786 4787 4788 4789 4616 4790 4792 4710 4868 4711 4797 4872 4873 4717 4716 4718 4943 4876 4803 4433 4634 4432 4067 4434 4317 4069 3932 3788 3633 3127 3304 3128 2337 2941 2943 2549 2338 1898 1664 1422 1423  916  378  651   98
 258  535  804 1065 1318 1563 1800 2029 2250 2463 2668 2865 3054 3235 3408 3573 3730 3879 4020 4153 4279 4278 4504 4605 4698 4783 4859 4861 4862 4863 4864 4866 4791 4867 4935 4995 4712 4870 4937 4871 4799 4875 4802 4801 4880 4724 4720 4805 4635 4321 4198 4197 4068 3935 3473 3636 3475 3474 2751 2749 3305 2750 2340 2121 2123 1666 1424 1175  653  379  380   99
 257  534  803 1064 1317 1562 1799 2028 2249 2462 2667 2864 3053 3234 3407 3572 3729 3878 4019 4152 4277 4395 4394 4604 4696 4697 4782 4928 4989 5040 4930 4865 4932 4934 5045 4993 4994 4936 4795 4939 4940 4807 4941 4723 4877 4806 4537 4538 4320 4636 4070 4199 3635 3933 4071 3934 3476 3306 3129 2945 2550 2341 2122 2124 1899 1667  918  920 1176 1177  381  100
 256  533  802 1063 1316 1561 1798 2027 2248 2461 2666 2863 3052 3233 3406 3571 3728 3877 4018 4151 4276 4502 4503 4602 4603 4781 4858 4927 4929 5084 4990 4931 4933 4992 4996 5049 4997 5048 4938 4942 4874 5000 5002 5052 4946 4726 4808 4638 4541 4539 4323 4200 3789 3790 3638 3309 3307 3130 2946 2752 2944 2552 2342 2125 1900 1426 1425 1178  654  382  656  101
 255  532  801 1062 1315 1560 1797 2026 2247 2460 2665 2862 3051 3232 3405 3570 3727 3876 4017 4150 4275 4393 4392 4501 4695 4780 4857 4926 4988 5039 5041 5085 4991 5044 5046 5090 5089 4998 5051 4999 5053 5004 4879 4945 4882 4947 4639 4544 4540 4322 4436 4074 4072 4435 3936 3637 3479 3308 3477 3131 2753 2344 2551 2126 1901 1668 1669 1427 1173  919  921  102
 254  531  800 1061 1314 1559 1796 2025 2246 2459 2664 2861 3050 3231 3404 3569 3726 3875 4016 4149 4274 4391 4500 4600 4694 4779 4856 4924 4987 4985 5083 5042 5043 5086 5087 5088 5047 5091 5050 5093 5094 5001 4881 5005 4725 4640 4729 4727 4542 4437 4202 4201 4203 3937 3792 4073 3791 3132 2947 2948 2754 2343 2129 2345 2127 1428 1179  922  657  384  655  103
 253  530  799 1060 1313 1558 1795 2024 2245 2458 2663 2860 3049 3230 3403 3568 3725 3874 4015 4148 4273 4390 4499 4693 4601 4778 4855 4986 4925 5037 5038 5082 5121 5149 5122 5124 5125 5126 5092 5127 5128 5095 5054 4948 5003 4728 4883 4884 4641 4440 4438 3940 4076 3640 3796 3639 3311 3310 3133 2755 2756 2553 2554 1903 1902 1670 1429  923  924  385  383  104
 252  529  798 1059 1312 1557 1794 2023 2244 2457 2662 2859 3048 3229 3402 3567 3724 3873 4014 4147 4272 4389 4498 4599 4692 4777 4854 4923 4984 5036 5119 5120 5147 5148 5123 5150 5152 5153 5154 5098 5097 5056 5055 5007 4949 4886 4809 4543 4325 4204 4075 3941 4324 3942 3938 3478 3481 3480 3134 2950 2556 2346 2347 2128 1904 1671 1181 1180  659  658  386  105
 251  528  797 1058 1311 1556 1793 2022 2243 2456 2661 2858 3047 3228 3401 3566 3723 3872 4013 4146 4271 4388 4497 4598 4691 4776 4921 4852 4922 4983 5081 5118 5170 5167 5151 5182 5172 5173 5155 5096 5129 5058 5006 4951 4885 4730 4810 4439 4326 4205 4077 3939 4206 3793 4208 3641 4078 3313 3135 2555 2949 2757 2130 1905 1672 1431 1430 1182  925  660  387  106
 250  527  796 1057 1310 1555 1792 2021 2242 2455 2660 2857 3046 3227 3400 3565 3722 3871 4012 4145 4270 4387 4496 4597 4690 4774 4775 4853 4982 5035 5080 5117 5168 5169 5179 5181 5183 5171 5131 5130 5057 5008 4950 4813 4546 4812 4811 4732 4731 4545 4328 4207 4327 4079 3644 3642 3312 3482 3136 2951 2758 2349 2348 2131 1906 1673 1432 1183  926  661  388  107
 249  526  795 1056 1309 1554 1791 2020 2241 2454 2659 2856 3045 3226 3399 3564 3721 3870 4011 4144 4269 4386 4495 4596 4688 4850 4689 4920 4981 5034 5079 5116 5146 5145 5166 5176 5174 5157 5156 5132 5100 5099 5009 4953 4887 4734 4814 4642 4733 4547 4443 4330 4329 3794 3643 3795 3483 3314 3137 2952 2759 2557 2558 2132 1907 1674 1433 1184  927  662  389  108
 248  525  794 1055 1308 1553 1790 2019 2240 2453 2658 2855 3044 3225 3398 3563 3720 3869 4143 4142 4385 4267 4494 4595 4687 4773 4851 4919 4980 5033 5078 5115 5144 5164 5180 5165 5177 5175 5158 5133 5101 5059 4952 5010 4815 4889 4643 4645 4442 4549 4548 4644 4331 4209 3797 3798 3645 3315 3138 2953 2760 2559 2350 2133 1908 1675 1434 1185  928  663  390  109
 247  524  793 1054 1307 1552 1789 2018 2239 2452 2657 2854 3043 3224 3397 3562 3719 3868 4007 4010 4268 4384 4493 4594 4772 4771 4849 4918 4979 5032 5077 5114 5142 5143 5163 5178 5161 5160 5159 5134 5102 5060 5011 4954 4888 4736 4816 4646 4444 4445 4551 4441 4210 3799 4080 3485 3484 3316 3139 2954 2761 2560 2351 2134 1909 1676 1435 1186  929  664  391  110
 246  523  792 1053 1306 1551 1788 2017 2238 2451 2656 2853 3042 3223 3396 3561 3718 3867 3866 4008 4009 4141 4492 4593 4770 4685 4848 4917 4978 5031 5076 5113 5141 5071 5140 5162 5139 5137 5136 5135 5061 5012 5013 4955 4891 4735 4737 4647 4550 4212 4211 4081 3800 4083 3943 3646 3317 3487 3140 2955 2762 2561 2352 2135 1910 1677 1436 1187  930  665  392  111
 245  522  791 1052 1305 1550 1787 2016 2237 2450 2655 2852 3041 3222 3395 3560 3717 3865 4005 4140 4265 4382 4490 4491 4592 4686 4847 4916 4977 5030 5075 5109 5070 5025 5110 5107 5138 5106 5105 5104 5103 5062 5015 5014 4817 4890 4739 4818 4446 4332 4084 3947 3944 4082 3647 3801 3319 3486 3488 3141 2956 2763 2353 2137 1911 1437 1438 1188  931  666  113  393
 244  521  790 1051 1304 1549 1786 2015 2236 2449 2654 2851 3040 3221 3394 3559 3716 4006 4139 4264 4383 4266 4591 4590 4684 4769 4846 4915 4976 5029 5073 5112 5072 5022 5023 5108 5068 5067 5018 5066 5064 5063 4956 4892 4819 4738 4650 4552 4648 4447 4334 3948 4213 3949 3945 3648 3650 3318 3142 2957 2764 2562 2136 2354 1912 1678 1189 1439  667  395  394  112
 243  520  789 1050 1303 1548 1785 2014 2235 2448 2653 2850 3039 3220 3393 3558 3715 3864 4004 4138 4380 4381 4489 4683 4768 4767 4845 4914 4975 5028 5074 5026 5111 4968 5024 5069 4967 5020 5019 5065 5017 4960 4958 4957 4893 4651 4821 4649 4449 4448 4085 4214 4086 3804 3946 3803 3649 3489 3143 2958 2765 2563 2355 2138 1913 1679 1680 1190  933  932  934  115
 242  519  788 1049 1302 1547 1784 2013 2234 2447 2652 2849 3038 3219 3392 3557 3714 3863 4137 4136 4263 4378 4488 4589 4682 4844 4913 4974 4911 4973 4972 5027 4835 4970 4969 4966 5021 4965 4964 4901 4962 5016 4961 4959 4894 4820 4740 4553 4652 4337 4333 4087 4216 3802 3950 3654 3322 3320 3144 2959 2766 2564 2565 2139 1682 1914 1440 1191  668  670  114  396
 241  518  787 1048 1301 1546 1783 2012 2233 2446 2651 2848 3037 3218 3391 3556 3713 3862 4003 4261 4379 4262 4487 4588 4681 4766 4843 4912 4840 4910 4909 4907 4836 4906 4905 4904 4903 4902 4900 4963 4899 4898 4897 4896 4895 4822 4555 4336 4554 4335 4450 4215 3951 3805 3651 3490 3652 3321 2960 2961 2767 2566 2356 2141 2140 1681 1441 1192  935  936  669  116
 240  517  786 1047 1300 1545 1782 2011 2232 2445 2650 2847 3036 3217 3390 3555 3712 3861 4002 4135 4260 4377 4486 4587 4680 4765 4842 4841 4839 4838 4837 4971 4908 4834 4755 4833 4832 4831 4830 4829 4827 4748 4826 4825 4824 4823 4741 4742 4653 4451 4338 4217 4088 3952 3491 3493 3492 3323 3145 2768 2567 2568 2357 2358 1915 1683 1442 1193  937  118  397  117
 239  516  785 1046 1299 1544 1781 2010 2231 2444 2649 2846 3035 3216 3389 3554 3711 3860 4001 4134 4259 4376 4485 4586 4679 4764 4763 4762 4761 4760 4759 4758 4757 4756 4668 4753 4666 4752 4751 4750 4828 4747 4660 4746 4745 4744 4743 4654 4556 4452 4339 4218 4089 3807 3653 3806 3324 3657 3146 2962 2769 2569 2359 2142 1916 1917 1443 1194 1195  398  671  119
 238  515  784 1045 1298 1543 1780 2009 2230 2443 2648 2845 3034 3215 3388 3553 3710 3859 4000 4133 4258 4375 4484 4585 4678 4677 4676 4675 4674 4673 4672 4671 4670 4669 4667 4754 4665 4569 4570 4663 4749 4661 4659 4658 4563 4657 4656 4655 4557 4453 4340 4219 4090 3953 3808 3495 3494 3147 3148 2963 2770 2360 2361 1918 1685 1684 1444 1196  938  672  673  400
 237  514  783 1044 1297 1542 1779 2008 2229 2442 2647 2844 3033 3214 3387 3552 3709 3858 3999 4132 4257 4374 4483 4584 4583 4582 4581 4580 4579 4578 4577 4576 4575 4574 4573 4572 4571 4664 4568 4464 4662 4463 4566 4462 4564 4562 4561 4560 4558 4454 4341 4220 4091 3954 3809 3655 3326 3325 3149 2964 2771 2570 2144 2143 1919 1686 1445 1197  674  401  402  399
 236  513  782 1043 1296 1541 1778 2007 2228 2441 2646 2843 3032 3213 3386 3551 3708 3857 3998 4131 4256 4373 4482 4481 4480 4479 4478 4477 4476 4475 4474 4473 4472 4471 4470 4469 4468 4467 4466 4567 4465 4352 4351 4565 4460 4459 4458 4457 4559 4455 4344 4221 3955 3956 3658 3810 3656 3496 3150 2965 2772 2571 2362 2145 1920 1687 1446 1198  939  675  121  120
 235  512  781 1042 1295 1540 1777 2006 2227 2440 2645 2842 3031 3212 3385 3550 3707 3856 3997 4130 4255 4372 4371 4370 4369 4368 4367 4366 4365 4364 4363 4362 4361 4360 4359 4358 4357 4356 4355 4354 4353 4232 4231 4461 4350 4347 4228 4346 4456 4342 4222 4223 4092 3812 3957 3497 3328 3327 3151 2966 2773 2572 2363 2146 1921 1688 1447 1200  940  677  403  122
 234  511  780 1041 1294 1539 1776 2005 2226 2439 2644 2841 3030 3211 3384 3549 3706 3855 3996 4129 4254 4253 4252 4251 4250 4249 4248 4247 4246 4245 4244 4243 4242 4241 4240 4239 4238 4237 4236 4235 4234 4233 4230 4104 4229 4348 4227 4226 4224 4345 4097 4343 4095 4093 3811 3659 3498 3329 3152 2967 2774 2573 2364 2147 1922 1689 1448  941 1199  942  404  123
 233  510  779 1040 1293 1538 1775 2004 2225 2438 2643 2840 3029 3210 3383 3548 3705 3854 3995 4128 4127 4126 4125 4124 4123 4122 4121 4120 4119 4118 4117 4116 4115 4114 4113 4112 4111 4110 4109 4106 3972 4105 3971 3969 4349 4102 4101 4100 4225 4099 4098 4094 4096 3958 3813 3660 3499 3330 3153 2968 2775 2574 2365 2148 1923 1690 1449 1201  676  678  405  124
 232  509  778 1039 1292 1537 1774 2003 2224 2437 2642 2839 3028 3209 3382 3547 3704 3853 3994 3993 3992 3991 3990 3989 3988 3987 3986 3985 3984 3983 3982 3981 3980 3979 3978 3977 3976 3975 3974 4108 3973 3828 3970 3968 4103 3967 3966 3965 3964 3963 3962 3961 3960 3959 3814 3661 3500 3331 3154 2969 2776 2575 2366 2149 1691 1692 1450  945  943  679  125  126
 231  508  777 1038 1291 1536 1773 2002 2223 2436 2641 2838 3027 3208 3381 3546 3703 3852 3851 3850 3849 3848 3847 3846 3845 3844 3843 3842 3841 3840 3839 3838 3837 3836 3835 3834 3833 3832 3831 3830 4107 3829 3827 3826 3825 3824 3823 3822 3821 3820 3819 3818 3817 3816 3815 3662 3501 3332 3155 2970 2777 2576 2367 1925 1924 1451 1202  944  680  407  408  406
 230  507  776 1037 1290 1535 1772 2001 2222 2435 2640 2837 3026 3207 3380 3545 3702 3701 3700 3699 3698 3697 3696 3695 3694 3693 3692 3691 3690 3689 3688 3687 3686 3685 3684 3683 3682 3681 3680 3679 3678 3677 3676 3675 3674 3673 3672 3671 3670 3669 3668 3667 3666 3665 3664 3663 3502 3333 3156 2971 2778 2577 2368 2150 1926 1693 1452 1203  946  681  127  128
 229  506  775 1036 1289 1534 1771 2000 2221 2434 2639 2836 3025 3206 3379 3544 3543 3542 3541 3540 3539 3538 3537 3536 3535 3534 3533 3532 3531 3530 3529 3528 3527 3526 3525 3524 3523 3522 3521 3520 3519 3518 3517 3516 3515 3514 3513 3512 3511 3510 3509 3508 3507 3506 3505 3504 3503 3334 3157 2972 2779 2578 2152 2151 1927 1694 1453 1204  947  682  409  129
 228  505  774 1035 1288 1533 1770 1999 2220 2433 2638 2835 3024 3205 3378 3377 3376 3375 3374 3373 3372 3371 3370 3369 3368 3367 3366 3365 3364 3363 3362 3361 3360 3359 3358 3357 3356 3355 3354 3353 3352 3351 3350 3349 3348 3347 3346 3345 3344 3343 3342 3341 3340 3339 3338 3337 3336 3335 3158 2973 2780 2579 2369 2153 1928 1695 1454 1205  948  683  410  130
 227  504  773 1034 1287 1532 1769 1998 2219 2432 2637 2834 3023 3204 3203 3202 3201 3200 3199 3198 3197 3196 3195 3194 3193 3192 3191 3190 3189 3188 3187 3186 3185 3184 3183 3182 3181 3180 3179 3178 3177 3176 3175 3174 3173 3172 3171 3170 3169 3168 3167 3166 3165 3164 3163 3162 3161 3160 3159 2974 2781 2580 2370 2154 1929 1696 1455 1206  949  684  411  131
 226  503  772 1033 1286 1531 1768 1997 2218 2431 2636 2833 3022 3021 3020 3019 3018 3017 3016 3015 3014 3013 3012 3011 3010 3009 3008 3007 3006 3005 3004 3003 3002 3001 3000 2999 2998 2997 2996 2995 2994 2993 2992 2991 2990 2989 2988 2987 2986 2985 2984 2983 2982 2981 2980 2979 2978 2977 2976 2975 2782 2372 2371 2155 1930 1697 1456 1207  950  685  412  132
 225  502  771 1032 1285 1530 1767 1996 2217 2430 2635 2832 2831 2830 2829 2828 2827 2826 2825 2824 2823 2822 2821 2820 2819 2818 2817 2816 2815 2814 2813 2812 2811 2810 2809 2808 2807 2806 2805 2804 2803 2802 2801 2800 2799 2798 2797 2796 2795 2794 2793 2792 2791 2790 2789 2788 2787 2786 2586 2783 2582 2581 2373 2156 1931 1698 1457 1208  951  686  414  413
 224  501  770 1031 1284 1529 1766 1995 2216 2429 2634 2633 2632 2631 2630 2629 2628 2627 2626 2625 2624 2623 2622 2621 2620 2619 2618 2617 2616 2615 2614 2613 2612 2611 2610 2609 2608 2607 2606 2605 2604 2603 2602 2601 2600 2599 2598 2597 2596 2595 2594 2593 2592 2591 2590 2589 2588 2587 2784 2785 2584 2583 2374 2157 1932 1699 1458 1209  952  687  133  134
 223  500  769 1030 1283 1528 1765 1994 2215 2428 2427 2426 2425 2424 2423 2422 2421 2420 2419 2418 2417 2416 2415 2414 2413 2412 2411 2410 2409 2408 2407 2406 2405 2404 2403 2402 2401 2400 2399 2398 2397 2396 2395 2394 2393 2392 2391 2390 2389 2388 2387 2386 2385 2384 2383 2382 2381 2380 2378 2585 2377 2376 2375 2158 1933 1700 1459 1210  953  688  415  135
 222  499  768 1029 1282 1527 1764 1993 2214 2213 2212 2211 2210 2209 2208 2207 2206 2205 2204 2203 2202 2201 2200 2199 2198 2197 2196 2195 2194 2193 2192 2191 2190 2189 2188 2187 2186 2185 2184 2183 2182 2181 2180 2179 2178 2177 2176 2175 2174 2173 2172 2171 2170 2169 2168 2167 2166 1942 2379 2163 2162 2161 2160 2159 1934 1701 1461 1460 1211  417  418  690
 221  498  767 1028 1281 1526 1763 1992 1991 1990 1989 1988 1987 1986 1985 1984 1983 1982 1981 1980 1979 1978 1977 1976 1975 1974 1973 1972 1971 1970 1969 1968 1967 1966 1965 1964 1963 1962 1961 1960 1959 1958 1957 1956 1955 1954 1953 1952 1951 1950 1949 1948 1947 1946 1945 1944 1943 2164 2165 1941 1939 1938 1937 1936 1935 1702 1462  954  955  689  416  136
 220  497  766 1027 1280 1525 1762 1761 1760 1759 1758 1757 1756 1755 1754 1753 1752 1751 1750 1749 1748 1747 1746 1745 1744 1743 1742 1741 1740 1739 1738 1737 1736 1735 1734 1733 1732 1731 1730 1729 1728 1727 1726 1725 1724 1723 1722 1721 1720 1719 1718 1717 1716 1715 1714 1713 1712 1711 1710 1940 1470 1708 1466 1705 1703 1465 1213 1214 1212  956  691  419
 219  496  765 1026 1279 1524 1523 1522 1521 1520 1519 1518 1517 1516 1515 1514 1513 1512 1511 1510 1509 1508 1507 1506 1505 1504 1503 1502 1501 1500 1499 1498 1497 1496 1495 1494 1493 1492 1491 1490 1489 1488 1487 1486 1485 1484 1483 1482 1481 1480 1479 1478 1477 1476 1475 1474 1473 1472 1471 1469 1709 1707 1467 1220 1218 1463 1217 1215 1216  692  138  137
 218  495  764 1025 1278 1277 1276 1275 1274 1273 1272 1271 1270 1269 1268 1267 1266 1265 1264 1263 1262 1261 1260 1259 1258 1257 1256 1255 1254 1253 1252 1251 1250 1249 1248 1247 1246 1245 1244 1243 1242 1241 1240 1239 1238 1237 1236 1235 1234 1233 1232 1231 1230 1229 1228 1227 1226 1225  969 1222 1468 1706 1704  701  965  962 1464  960  957  693  420  139
 217  494  763 1024 1023 1022 1021 1020 1019 1018 1017 1016 1015 1014 1013 1012 1011 1010 1009 1008 1007 1006 1005 1004 1003 1002 1001 1000  999  998  997  996  995  994  993  992  991  990  989  988  987  986  985  984  983  982  981  980  979  978  977  976  975  974  973  972  971  707  970 1224  968  967  966 1221 1219  963  961  959  958  694  421  140
 216  493  762  761  760  759  758  757  756  755  754  753  752  751  750  749  748  747  746  745  744  743  742  741  740  739  738  737  736  735  734  733  732  731  730  729  728  727  726  725  724  723  722  721  720  719  718  717  716  715  714  713  712  711  710  709  708  706  435 1223  704  703  702  700  964  699  698  697  696  695  422  141
 215  492  491  490  489  488  487  486  485  484  483  482  481  480  479  478  477  476  475  474  473  472  471  470  469  468  467  466  465  464  463  462  461  460  459  458  457  456  455  454  453  452  451  450  449  448  447  446  445  444  443  442  441  440  439  438  437  436  155  705  433  432  431  430  429  428  427  426  425  424  423  142
 214  213  212  211  210  209  208  207  206  205  204  203  202  201  200  199  198  197  196  195  194  193  192  191  190  189  188  187  186  185  184  183  182  181  180  179  178  177  176  175  174  173  172  171  170  169  168  167  166  165  164  163  162  161  160  159  158  157  434  156  154  153  152  151  150  149  148  147  146  145  144  143
