# This puzzle is unsolvable
54
   2    1    3    4    5    6    7    8    9   10   11   12   13   14   15   16   17   18   19   20   21   22   23   24   25   26   27   28   29   30   31   32   33   34   35  247   36   38   39  251   40   41   42  254   43   44  462  258  259  263  264  464   52   54
 212  213  214  215  216  217  218  219  220  221  222  223  224  225  226  227  228  229  230  231  232  233  234  235  236  237  238  239  240  241  242  243  244  245  246  645   37  249  250  456  650  455  255  460  256  459  261   49  659  465   47   51   50   55
 211  416  417  418  419  420  421  422  423  424  425  426  427  428  429  430  431  432  433  434  435  436  437  438  439  440  441  442  443  444  445  446  447  448  450  248  452  648  453  252  253  838  458  652   46  257  461   45  466  658   56  265  262   53
 210  415  612  613  614  615  616  617  618  619  620  621  622  623  624  625  626  627  628  629  630  631  632  633  634  635  636  637  638  639  640  641  642  643  449  646  451  834  649  454  837 1018  651  457  653  655  842  656  657  260  467  266   57  660
 209  414  611  800  801  802  803  804  805  806  807  808  809  810  811  812  813  814  815  816  817  818  819  820  821  822  823  824  825  826  827  828  829  830  644  832  833 1345  647  835  836 1019  839   48  841  654 1024  844  463  847   61  469  267   58
 208  413  610  799  980  981  982  983  984  985  986  987  988  989  990  991  992  993  994  995  996  997  998  999 1000 1001 1002 1003 1004 1005 1006 1008 1179 1009  831 1346 1012 1182 1011 1014 1186 1016 1190 1015 1021 1192  843 1023 1025  662  845  661  663  270
 207  412  609  798  979 1152 1153 1154 1155 1156 1157 1158 1159 1160 1161 1162 1163 1164 1165 1166 1167 1168 1169 1170 1171 1172 1173 1175 1338 1177 1643 1007 1180 1181 1347 1010 1183 1649 1013 1185 1350 1189  840 1020 1191 1022 1193 1194  849 1026  846  468  268   59
 206  411  608  797  978 1151 1316 1317 1318 1319 1320 1321 1322 1323 1324 1325 1326 1327 1328 1329 1330 1331 1332 1333 1334 1336 1337 1174 1340 1176 1341 1178 1497 1342 1343 1499 1501 1502 1017 1184 1188 1187 1351 1354 1510 1355 1196 1197 1195  850  848  471  271  269
 205  410  607  796  977 1150 1315 1472 1473 1474 1475 1476 1477 1478 1479 1480 1481 1482 1483 1484 1485 1486 1487 1488 1489 1335 1490 1491 1641 1339 1495 1496 1644 1498 1784 1344 1500 1788 1651 1503 1508 1352 1507 1509 1656 1357 1356 1030  664  472  851   62   63  665
 204  409  606  795  976 1149 1314 1471 1620 1621 1622 1623 1624 1625 1626 1627 1628 1629 1630 1631 1632 1633 1634 1774 1635 1636 1637 1492 1639 1780 1493 1642 1781 1646 1785 1647 1648 1349 1650 1504 1348 1653 1353 1655 1198 1359  666 1358 1027   60  473  667  273  474
 203  408  605  794  975 1148 1313 1470 1619 1760 1761 1762 1763 1764 1765 1766 1767 1768 1769 1770 1771 1772 2027 1904 1775 1906 1638 2032 1494 1640 1912 2038 1645 1783 1786 1916 1787 1918 1505 1506 1652 1654 1793 1794 1511 1512 1199  478  852 1028  669  477  274  470
 202  407  604  793  974 1147 1312 1469 1618 1759 1892 1893 1894 1895 1896 1897 1898 1899 1900 1901 1902 1903 1773 1905 1776 2029 1777 1908 1778 1782 1910 1914 2039 2040 2153 2154 2042 1919 1789 1790 1922 1792 1923 1924 1360 1795 1513  668  671 1029 1031   66   64  272
 201  406  603  792  973 1146 1311 1468 1617 1758 1891 2016 2017 2018 2019 2020 2021 2022 2023 2024 2025 2026 2028 2030 2144 2031 2035 1909 1779 2150 2036 1913 2152 1915 2041 2155 2043 2265 2044 1921 1791 2046 1925 1658 1657 1660 1362 1361 1201 1200  476  853  475   65
 200  405  602  791  972 1145 1310 1467 1616 1757 1890 2015 2132 2133 2134 2135 2136 2137 2138 2139 2140 2141 2142 2143 2251 2145 1907 2147 2033 1911 2151 2258 2260 1917 2261 2157 1920 2158 2159 2160 2045 2047 1926 1796 1659 1661 1364 1515  855 1032   68  854   67  276
 199  404  601  790  971 1144 1309 1466 1615 1756 1889 2014 2131 2240 2241 2242 2243 2244 2245 2246 2247 2248 2249 2250 2350 2254 2146 2148 2034 2256 2149 2257 2037 2259 2262 2263 2156 2364 2266 2268 2161 2048 1800 1797 1514 1662 1516 1363  856  673  857  275  480  479
 198  403  600  789  970 1143 1308 1465 1614 1755 1888 2013 2130 2239 2340 2341 2342 2343 2344 2345 2346 2347 2348 2440 2352 2252 2351 2255 2354 2356 2447 2357 2358 2359 2360 2361 2362 2264 2267 2365 2162 1929 1798 1927 1663 1517 1202 1033 1036 1035  674  482  279  278
 197  402  599  788  969 1142 1307 1464 1613 1754 1887 2012 2129 2238 2339 2432 2433 2434 2435 2436 2437 2438 2439 2524 2349 2442 2253 2353 2445 2446 2529 2448 2449 2450 2451 2452 2453 2363 2269 2454 2164 2163 1799 2049 1801 1664 1518 1365 1205 1203  670   70   71   69
 196  401  598  787  968 1141 1306 1463 1612 1753 1886 2011 2128 2237 2338 2431 2516 2517 2518 2519 2521 2596 2522 2441 2523 2526 2443 2444 2528 2355 2530 2531 2532 2533 2534 2535 2537 2536 2366 2270 2165 1928 2050 1931 1930 1520  861  858  481  862  280  672  284   74
 195  400  597  786  967 1140 1305 1462 1611 1752 1885 2010 2127 2236 2337 2430 2515 2592 2593 2662 2594 2520 2597 2598 2599 2525 2602 2671 2668 2669 2603 2604 2673 2608 2609 2610 2455 2456 2368 2271 2052 2053 1932 1803 1519 1521 1367 1366   73   72 1368  859  277   76
 194  399  596  785  966 1139 1304 1460 1461 1610 2009 2008 2126 2235 2336 2429 2514 2590 2591 2660 2595 2663 2722 2665 2666 2726 2667 2527 2601 2670 2733 2606 2605 2607 2676 2611 2538 2367 2457 2166 2273 2051 2167 1804 1665 1666 1522 1034 1206 1037  677  282  675   75
 193    0  398  784  965 1138 1303 1750 1609 1884 1751 1883 2125 2334 2234 2428 2512 2513 2659 2661 2721 2773 2664 2723 2725 2819 2600 2822 2780 2729 2730 2672 2674 2675 2734 2677 2612 2458 2539 2369 2054 2055 1802 1805 1667 1524 1208 1040 1204  483  484  678  285  281
 192  397  595  783  964 1137 1302 1459 1608 1749 1881 1882 2007 2233 2232 2335 2427 2589 2658 2720 2816 2774 2775 2724 2820 2776 2728 2779 2782 2825 2731 2732 2784 2735 2678 2613 2540 2460 2459 2370 2272 1934 1933 1669 1935 1668 1210 1207 1369 1038  487  485  864  283
 191  396  594  593  782 1136 1301 1458 1607 1747 1748 2006 2124 2333 2332 2426 2588 2510 2657 2719 2772 2771 2818 2857 2727 2778 2777 2884 2821 2781 2826 2783 2785 2736 2679 2614 2541 2371 2274 2169 2170 2168 2057 1671 1523 1371 1370  866 1041 1039  676  488 1042   77
 190  395  592  781  963 1135 1300 1457 1606 1746 1880 2005 2123 2231 2425 2424 2511 2587 2718 2717 2814 2815 2817 2854 2856 2882 2885 2903 2883 2824 2860 2827 2786 2737 2680 2461 2544 2615 2373 2372 2171 1936 1806 2056 1525  865 1373 1212 1209  867  860  679  486  286
 189  394  591  780  962  961 1298 1299 1456 1605 1879 2004 2122 2230 2331 2586 2509 2716 2715 2656 2770 2813 2852 2850 2855 2912 2881 2904 2823 2861 2862 2828 2787 2681 2682 2542 2616 2543 2374 2275 2276 2058 1937 1807 1670 1672 1043 1372 1214  680  863  287   79   78
 188  393  590  779  960 1134 1133 1455 1604 1745 1878 2003 2121 2229 2330 2423 2508 2655 2583 2767 2654 2812 2880 2851 2853 2900 2901 2911 2859 2886 2888 2788 2739 2738 2618 2617 2546 2462 2375 2277 2172 2059 1938 1527 1808 1526 1213 1211  681 1044  682  490  489  289
 187  392  589  778  959 1132 1297 1454 1744 1877 2002 2001 2120 2228 2329 2507 2585 2714 2712 2652 2768 2848 2878 2915 2877 2876 2914 2906 2905 2887 2830 2792 2829 2684 2741 2619 2545 2464 2376 2278 2173 1940 1939 1809 1374 1673 1674 1529 1377 1530 1375   80  290  288
 186  391  588  777  958 1131 1453 1602 1603 1743 1875 1876 2119 2227 2328 2422 2421 2506 2584 2811 2766 2769 2810 2913 2898 2908 2902 2858 2890 2889 2865 2863 2833 2740 2742 2683 2463 2547 2465 2279 2174 2060 2061 1810 1675 1531 1216 1528 1046 1047 1045  684   82   81
 185  390  587  776  957 1130 1296 1452 1601 1742 2000 1999 2118 2226 2327 2420 2505 2582 2653 2713 2873 2899 2849 2879 2846 2910 2897 2894 2907 2870 2864 2834 2832 2789 2831 2685 2548 2466 2377 2280 2175 2062 1941 1811 1676 1217  872  873 1048  869  683  868  491  291
 184  389  586  775  956 1129 1295 1451 1600 1741 1874 2116 2117 2225 2326 2419 2504 2649 2651 2581 2711 2765 2764 2875 2845 2847 2893 2895 2892 2891 2866 2745 2790 2743 2791 2620 2621 2467 2378 2281 2176 2063 1942 1812 1677 1049 1219 1376  686  494  492  685  292   83
 183  388  585  774  955 1128 1294 1450 1292 1599 1873 1998 2115 2224 2418 2503 2578 2650 2710 2763 2808 2809 2806 2844 2896 2872 2909 2868 2753 2871 2838 2794 2793 2687 2686 2688 2622 2468 2379 2282 2177 2064 1943 1814 1813 1533  871 1380 1050  870  493  687  496  293
 182  387  584  773  954 1127 1293 1449 1598 1740 1996 1872 2114 2223 2325 2417 2580 2502 2579 2648 2762 2761 2874 2840 2843 2803 2801 2799 2869 2867 2836 2797 2796 2744 2623 2624 2549 2469 2380 2283 2178 2065 1944 1815 1532 1378 1215 1221 1220 1218  688  294   85   84
 181  386  583  772 1126 1291 1448 1597 1738 1739 1870 1997 2113 2222 2324 2323 2416 2501 2647 2709 2708 2805 2807 2804 2756 2842 2841 2839 2802 2798 2748 2835 2795 2746 2689 2551 2550 2470 2381 2284 2179 2066 1945 1816 1678 1534 1379 1535 1051  874  495  689  295  296
 180  385  771  952  953 1125 1447 1596 1737 1871 1736 1995 2112 2221 2322 2415 2500 2577 2646 2707 2760 2759 2758 2757 2699 2637 2754 2752 2700 2698 2751 2837 2749 2747 2690 2625 2552 2471 2382 2285 2180 2067 1817 1681 1679 1818 1536 1381 1382  875  690  498  497   86
 179  384  582  581  951 1290 1289 1445 1446 1595 1869 1994 2111 2220 2321 2414 2498 2499 2645 2706 2705 2704 2703 2702 2638 2701 2755 2635 2800 2696 2750 2631 2693 2692 2691 2626 2553 2472 2383 2286 2181 2068 1946 1682 1384 1680 1223 1383 1052  691  692  499  297   87
 178  579  383  770  950 1124 1288 1444 1594 1735 1868 1993 2110 2219 2320 2413 2497 2576 2575 2643 2571 2642 2640 2568 2566 2639 2634 2564 2697 2632 2695 2630 2694 2629 2628 2627 2554 2473 2384 2287 2182 2069 1948 1947 1683 1537 1385 1222 1054  876   89  299   88  298
 382  176  580  949 1122  769 1123 1443 1593 1734 1867 1992 2109 2218 2319 2411 2573 2574 2644 2493 2572 2492 2570 2569 2567 2401 2565 2563 2633 2562 2561 2560 2559 2558 2557 2556 2555 2474 2385 2288 2183 2070 1820 1819 1538 1387 1225 1053  878  877  693  300   90   91
 173  175  578  768 1121 1287 1286 1442 1592 1733 1866 1991 2108 2318 2216 2107 2408 2409 2412 2406 2403 2641 2490 2636 2487 2488 2489 2398 2484 2483 2482 2481 2480 2479 2478 2477 2476 2475 2386 2289 2184 2071 1949 1822 1821 1540 1684 1224 1055  879  694  500  501   92
 174  381  577  767  948  947 1284 1285 1591 1732 1865 1989 1990 2106 2217 2496 2314 2494 2495 2312 2405 2404 2309 2400 2491 2399 2303 2486 2397 2396 2395 2394 2393 2392 2391 2390 2389 2388 2387 2290 2185 2072 1950 1951 1386 1058 1539 1227 1056 1057  696  695  302  301
 177  576  379  766  946 1120 1119 1283 1441 1731 1864 2215 2105 2316 2213 2317 2315 2210 2313 2407 2311 2310 2307 2402 2304 2485 2202 2201 2302 2301 2300 2299 2298 2297 2296 2295 2294 2293 2292 2291 2186 2073 1952 1686 1685 1541 1388 1226 1059  880  881   94  504  303
 378  172 1118  765  945 1117 1439 1440 1590 1729 1730 1863 1988 2214 2102 2410 2212 2209 2208 2207 2206 2308 2094 2093 2306 2203 2305 2200 2199 2198 2197 2196 2195 2194 2193 2192 2191 2190 2189 2188 2187 2074 1953 1823 1824 1542 1389 1228 1060  698  882  697  502   93
 380  377  574  764  575 1282 1588 1437 1589 1587 1861 1862 1987 2104 1983 2101 2211 2099 2098 2097 2096 2205 2095 2092 2204 2091 2088 2089 1969 1841 1968 2086 2084 2083 2082 2081 2080 2079 2078 2077 2076 2075 1954 1688 1687 1543 1390 1229 1061  883  505  304  305   95
 171  376  573  761  763 1116 1281 1436 1586 1727 1985 1859 1986 2103 1856 1981 2100 1980 1979 1978 1977 1976 1975 1974 1973 1972 2090 1843 2087 1970 1967 2085 1964 1838 1965 1835 1961 1960 1959 1958 1957 1956 1955 1825 1689 1544 1391 1230  884 1231  885  506  503   97
 170  760  762  944  942 1115 1280 1438 1584 1728 1726 1860 1722 1984 1858 1982 1855 1853 1852 1851 1850 1849 1848 1847 1846 1845 1971 1844 1842 1706 1840 1966 1839 1837 1962 1963 1833 1698 1697 1832 1830 1831 1829 1827 1690 1545 1392  700 1232  702  699  886   96   98
 572  375  571  940  943  941 1114 1279 1583 1273 1433 1429 1721 1857 1720 1577 1854 1718 1717 1716 1715 1714 1713 1712 1711 1710 1709 1565 1707 1705 1562 1704 1560 1703 1836 1701 1834 1556 1554 1555 1696 1695 1826 1828 1692 1691 1234 1393 1062  701  887  309  306  307
 169  759  570  758 1113  569 1435 1275 1105 1582 1431 1581 1723 1428 1578 1426 1719 1575 1574 1572 1421 1571 1570 1569 1568 1567 1415 1254 1708 1563 1410 1561 1409 1702 1558 1700 1699 1553 1243 1550 1551 1694 1693 1548 1396 1546 1394 1233 1065 1063  509  507  308   99
 168  374  567  939  568 1112 1277 1276 1108 1107 1585 1725 1579 1580 1427 1425 1576 1266 1422 1573 1262 1420 1419 1418 1417 1416 1413 1566 1255 1412 1083 1559 1249 1406 1407 1557 1247 1078 1402 1552 1241 1399 1398 1549 1547 1397 1237 1064 1235  888  703  510  508  100
 373  165  372  371  937 1111 1278  938 1434  931 1724 1430 1270 1269 1268 1267 1099 1424 1423 1096 1095 1094  917  918 1090 1091 1256 1564 1087 1250 1253 1411 1084 1408 1248 1081 1405 1079 1404 1400 1401 1074 1240 1239  895 1238 1395 1236  889  704  705  311  511  101
 166  566  167  756 1110  936  933 1106 1274 1271  930 1272 1103 1102 1101 1100 1265 1263 1264  921  919 1259 1261  734 1092 1258 1257 1414 1089  912 1252 1251  910  907 1080 1246 1403  720  902 1242 1076 1075 1072 1071  897 1070 1069 1067 1066  890  512  513  310  312
 164  370  369  754  755  752 1109  934  932  929 1432 1104  928  927  926  925  924 1097  923  738  920  736 1260  916  915  914  731  730  911 1085 1086  728  906  909  904  721 1244  719  903 1077  900  899 1073  898  713  896  894 1068  892  891  707  706  313  102
 163  368  757  565  753  751  935  750  749  748  747  746  745  744  743  742  741 1098  739  922  547  735 1093  543  733  541  540  913  339  537  727  533  722  726 1082  905  532  529 1245  901  717  716  715  714  522  712  710  893  709  708  516  314  514  316
 162  367  564  563  562  561  560  559  558  557  556  555  554  553  552  145  352  740  349  548  546  545  139  137  542  342  729  732  538 1088  129  534  335  724  908  530  723  330  528  718  328  526  525  524  323  711  521  520  518  517  105  515  103  104
 161  366  365  364  363  362  361  360  359  358  357  356  355  354  353  551  351  549  350  348  737  544  346  344  343  341  340  539  338  536  131  535  127  332  531  725  331  123  329  327  527  118  325  523  324  322  321  519  320  318  110  317  315  106
 160  159  158  157  156  155  154  153  152  151  150  149  148  147  146  144  550  143  142  141  140  347  345  138  136  135  134  133  132  130  336  337  126  333  334  125  128  124  122  121  120  326  119  117  116  115  114  113  319  112  111  109  108  107
