# This puzzle is unsolvable
77
   2    1    3    4    5    6    7    8    9   10   11   12   13   14   15   16   17   18   19   20   21   22   23   24   25   26   27   28   29   30   31   32   33   34   35   36   37   38   39   40   41   42   43   44   45   46   47   48   49   50   51   52   53   54   55   56   57   58   59   60   61   62   63   64   65   66   67   68   69   70   71   72   73   74   75   76   77
 304  305  306  307  308  309  310  311  312  313  314  315  316  317  318  319  320  321  322  323  324  325  326  327  328  329  330  331  332  333  334  335  336  337  338  339  340  341  342  343  344  345  346  347  348  349  350  351  352  353  354  355  356  357  358  359  360  361  362  363  364  365  366  367  368  369  370  371  372  373  374  375  376  377  378  379   78
 303  600  601  602  603  604  605  606  607  608  609  610  611  612  613  614  615  616  617  618  619  620  621  622  623  624  625  626  627  628  629  630  631  632  633  634  635  636  637  638  639  640  641  642  643  644  645  646  647  648  649  650  651  652  653  654  655  656  657  658  659  660  661  662  663  664  665  666  667  668  669  670  671  672  673  380   79
 302  599  888  889  890  891  892  893  894  895  896  897  898  899  900  901  902  903  904  905  906  907  908  909  910  911  912  913  914  915  916  917  918  919  920  921  922  923  924  925  926  927  928  929  930  931  932  933  934  935  936  937  938  939  940  941  942  943  944  945  946  947  948  949  950  951  952  953  954  955  956  957  958  959  674  381   80
 301  598  887 1168 1169 1170 1171 1172 1173 1174 1175 1176 1177 1178 1179 1180 1181 1182 1183 1184 1185 1186 1187 1188 1189 1190 1191 1192 1193 1194 1195 1196 1197 1198 1199 1200 1201 1202 1203 1204 1205 1206 1207 1208 1209 1210 1211 1212 1213 1214 1215 1216 1217 1218 1219 1220 1221 1222 1223 1224 1225 1226 1227 1228 1229 1230 1231 1232 1233 1234 1235 1236 1237  960  675  382   81
 300  597  886 1167 1440 1441 1442 1443 1444 1445 1446 1447 1448 1449 1450 1451 1452 1453 1454 1455 1456 1457 1458 1459 1460 1461 1462 1463 1464 1465 1466 1467 1468 1469 1470 1471 1472 1473 1474 1475 1476 1477 1478 1479 1480 1481 1482 1483 1484 1485 1486 1487 1488 1489 1490 1491 1492 1493 1494 1495 1496 1497 1498 1499 1500 1501 1502 1503 1504 1505 1506 1507 1238  961  676  383   82
 299  596  885 1166 1439 1704 1705 1706 1707 1708 1709 1710 1711 1712 1713 1714 1715 1716 1717 1718 1719 1720 1721 1722 1723 1724 1725 1726 1727 1728 1729 1730 1731 1732 1733 1734 1735 1736 1737 1738 1739 1740 1741 1742 1743 1744 1745 1746 1747 1748 1749 1750 1751 1752 1753 1754 1755 1756 1757 1758 1759 1760 1761 1762 1763 1764 1765 1766 1767 1768 1769 1508 1239  962  677  384   83
 298  595  884 1165 1438 1703 1960 1961 1962 1963 1964 1965 1966 1967 1968 1969 1970 1971 1972 1973 1974 1975 1976 1977 1978 1979 1980 1981 1982 1983 1984 1985 1986 1987 1988 1989 1990 1991 1992 1993 1994 1995 1996 1997 1998 1999 2000 2001 2002 2003 2004 2005 2006 2007 2008 2009 2010 2011 2012 2013 2014 2015 2016 2017 2018 2019 2020 2021 2022 2023 1770 1509 1240  963  678  385   84
 297  594  883 1164 1437 1702 1959 2208 2209 2210 2211 2212 2213 2214 2215 2216 2217 2218 2219 2220 2221 2222 2223 2224 2225 2226 2227 2228 2229 2230 2231 2232 2233 2234 2235 2236 2237 2238 2239 2240 2241 2242 2243 2244 2245 2246 2247 2248 2249 2250 2251 2252 2253 2254 2255 2256 2257 2258 2259 2260 2261 2262 2263 2264 2265 2266 2267 2268 2269 2024 1771 1510 1241  964  679  386   85
 296  593  882 1163 1436 1701 1958 2207 2448 2449 2450 2451 2452 2453 2454 2455 2456 2457 2458 2459 2460 2461 2462 2463 2464 2465 2466 2467 2468 2469 2470 2471 2472 2473 2474 2475 2476 2477 2478 2479 2480 2481 2482 2483 2484 2485 2486 2487 2488 2489 2490 2491 2492 2493 2494 2495 2496 2497 2498 2499 2500 2501 2502 2503 2504 2505 2506 2507 2270 2025 1772 1511 1242  965  680  387   86
 295  592  881 1162 1435 1700 1957 2206 2447 2680 2681 2682 2683 2684 2685 2686 2687 2688 2689 2690 2691 2692 2693 2694 2695 2696 2697 2698 2699 2700 2701 2702 2703 2704 2705 2706 2707 2708 2709 2710 2711 2712 2713 2714 2715 2716 2717 2718 2719 2720 2721 2722 2723 2724 2725 2726 2727 2728 2729 2730 2731 2732 2733 2734 2735 2736 2737 2508 2271 2026 1773 1512 1243  966  681  388   87
 294  591  880 1161 1434 1699 1956 2205 2446 2679 2904 2905 2906 2907 2908 2909 2910 2911 2912 2913 2914 2915 2916 2917 2918 2919 2920 2921 2922 2923 2924 2925 2926 2927 2928 2929 2930 2931 2932 2933 2934 2935 2936 2937 2938 2939 2940 2941 2942 2943 2944 2945 2946 2947 2948 2949 2950 2951 2952 2953 2954 2955 2956 2957 2958 2959 2738 2509 2272 2027 1774 1513 1244  967  682  389   88
 293  590  879 1160 1433 1698 1955 2204 2445 2678 2903 3120 3121 3122 3123 3124 3125 3126 3127 3128 3129 3130 3131 3132 3133 3134 3135 3136 3137 3138 3139 3140 3141 3142 3143 3144 3145 3146 3147 3148 3149 3150 3151 3152 3153 3154 3155 3156 3157 3158 3159 3160 3161 3162 3163 3164 3165 3166 3167 3168 3169 3170 3171 3172 3173 2960 2739 2510 2273 2028 1775 1514 1245  968  683  390   89
 292  589  878 1159 1432 1697 1954 2203 2444 2677 2902 3119 3328 3329 3330 3331 3332 3333 3334 3335 3336 3337 3338 3339 3340 3341 3342 3343 3344 3345 3346 3347 3348 3349 3350 3351 3352 3353 3354 3355 3356 3357 3358 3359 3360 3361 3362 3363 3364 3365 3366 3367 3368 3369 3370 3371 3372 3373 3374 3375 3376 3377 3378 3379 3174 2961 2740 2511 2274 2029 1776 1515 1246  969  684  391   90
 291  588  877 1158 1431 1696 1953 2202 2443 2676 2901 3118 3327 3528 3529 3530 3531 3532 3533 3534 3535 3536 3537 3538 3539 3540 3541 3542 3543 3544 3545 3546 3547 3548 3549 3550 3551 3552 3553 3554 3555 3556 3557 3558 3559 3560 3561 3562 3563 3564 3565 3566 3567 3568 3569 3570 3571 3572 3573 3574 3575 3576 3577 3380 3175 2962 2741 2512 2275 2030 1777 1516 1247  970  685  392   91
 290  587  876 1157 1430 1695 1952 2201 2442 2675 2900 3117 3326 3527 3720 3721 3722 3723 3724 3725 3726 3727 3728 3729 3730 3731 3732 3733 3734 3735 3736 3737 3738 3739 3740 3741 3742 3745 4102 3928 3746 3747 3748 3749 3750 3751 3752 3753 3754 3755 3756 3757 3758 3759 3760 3761 3762 3763 3764 3765 3766 3767 3578 3381 3176 2963 2742 2513 2276 2031 1778 1517 1248  971  686  393   92
 289  586  875 1156 1429 1694 1951 2200 2441 2674 2899 3116 3325 3526 3719 3904 3905 3906 3907 3908 3909 3910 3911 3912 3913 3914 3915 3916 3917 3918 3919 3920 3921 3922 3923 3924 3925 3744    0 3927 3929 3930 3931 3932 3933 3934 3935 3936 3937 3938 3939 3940 3941 3942 3943 3944 3945 3946 3947 3948 3949 3768 3579 3382 3177 2964 2743 2514 2277 2032 1779 1518 1249  972  687  394   93
 288  585  874 1155 1428 1693 1950 2199 2440 2673 2898 3115 3324 3525 3718 3903 4080 4081 4082 4083 4084 4085 4086 4087 4088 4089 4090 4091 4092 4093 4094 4095 4096 4097 4098 4099 4100 3743 4101 4270 4104 4105 4106 4107 4108 4109 4110 4111 4112 4113 4114 4115 4116 4117 4118 4119 4120 4121 4122 4123 3950 3769 3580 3383 3178 2965 2744 2515 2278 2033 1780 1519 1250  973  688  395   94
 287  584  873 1154 1427 1692 1949 2198 2439 2672 2897 3114 3323 3524 3717 3902 4079 4248 4249 4250 4251 4252 4253 4254 4255 4256 4257 4258 4259 4260 4261 4262 4263 4264 4265 4266 4267 4103 3926 4269 4271 4272 4273 4274 4275 4276 4277 4278 4279 4280 4281 4282 4283 4284 4285 4286 4287 4288 4289 4124 3951 3770 3581 3384 3179 2966 2745 2516 2279 2034 1781 1520 1251  974  689   95   96
 286  583  872 1153 1426 1691 1948 2197 2438 2671 2896 3113 3322 3523 3716 3901 4078 4247 4408 4409 4410 4411 4412 4413 4414 4415 4416 4417 4418 4419 4420 4572 4421 4422 4423 4425 4427 4268 4428 4429 4430 4431 4432 4433 4434 4435 4436 4437 4438 4439 4440 4441 4442 4443 4444 4445 4446 4447 4290 4125 3952 3771 3582 3385 3180 2967 2746 2517 2280 2035 1782 1521 1252  975  691  690   97
 285  582  871 1152 1425 1690 1947 2196 2437 2670 2895 3112 3321 3522 3715 3900 4077 4246 4407 4560 4561 4562 4563 4564 4565 4566 4567 4568 4569 4570 4571 4715 4573 4424 4576 4577 4426 4578 4579 4580 4581 4582 4583 4584 4585 4586 4587 4588 4589 4590 4591 4592 4593 4594 4595 4596 4597 4448 4291 4126 3953 3772 3583 3386 3181 2968 2747 2518 2281 2036 1783 1522 1253  976  692  396  399
 284  581  870 1151 1424 1689 1946 2195 2436 2669 2894 3111 3320 3521 3714 3899 4076 4245 4406 4559 4704 4705 4706 4707 4708 4709 4710 4711 4712 4713 4714 4716 4718 4574 4575 4719 4720 4721 4722 4723 4724 4725 4726 4727 4728 4729 4730 4731 4732 4733 4734 4735 4736 4737 4738 4739 4598 4449 4292 4127 3954 3773 3584 3387 3182 2969 2748 2519 2282 2037 1784 1523 1254  977  397  401  398
 283  580  869 1150 1423 1688 1945 2194 2435 2668 2893 3110 3319 3520 3713 3898 4075 4244 4405 4558 4703 4840 4841 4842 4843 4844 4845 4846 4847 4848 4849 4850 4852 4717 4853 4854 4855 4856 4857 4858 4859 4861 4862 4863 4990 4864 4865 4866 4867 4868 4869 4870 4871 4872 4873 4740 4599 4450 4293 4128 3955 3774 3585 3388 3183 2970 2749 2520 2283 2038 1785 1524 1255  978  693   98  400
 282  579  868 1149 1422 1687 1944 2193 2434 2667 2892 3109 3318 3519 3712 3897 4074 4243 4404 4557 4702 4839 4968 4969 4970 4971 4972 4973 4974 4975 4976 4978 4851 4979 4980 4981 4982 4983 4985 4986 4988 4860 5107 4989 5109 4991 4992 4993 4994 4995 4996 4997 4998 4999 4874 4741 4600 4451 4294 4129 3956 3775 3586 3389 3184 2971 2750 2521 2284 2039 1786 1525 1256  979  694   99  100
 281  578  867 1148 1421 1686 1943 2192 2433 2666 2891 3108 3317 3518 3711 3896 4073 4242 4403 4556 4701 4838 4967 5088 5089 5090 5091 5092 5093 5094 5095 4977 5097 5098 5099 5100 5101 5102 5104 5105 4987 5106 5218 5219 5108 5110 5111 5112 5113 5114 5115 5116 5117 5000 4875 4742 4601 4452 4295 4130 3957 3776 3587 3185 3391 2972 2751 2522 2285 2040 1527 1787  980  695  402  101  102
 280  577  866 1147 1420 1685 1942 2191 2432 2665 2890 3107 3316 3517 3710 3895 4072 4241 4402 4555 4700 4837 4966 5087 5200 5201 5202 5203 5204 5205 5206 5096 5208 5209 5210 5211 5212 5213 4984 5103 5216 5321 5322 5220 5323 5221 5222 5223 5224 5225 5226 5227 5118 5001 4876 4743 4602 4453 4296 4131 3958 3777 3588 3390 3187 3186 2524 2752 2286 2041 1258  981 1526  696  697  403  103
 279  576  865 1146 1419 1684 1941 2190 2431 2664 2889 3106 3315 3516 3709 3894 4071 4240 4401 4554 4699 4836 4965 5086 5199 5304 5305 5306 5307 5403 5308 5207 5311 5312 5313 5314 5315 5317 5214 5215 5318 5217 5319 5417 5416 5324 5325 5326 5327 5328 5329 5228 5119 5002 4877 4744 4603 4454 4297 4132 3959 3778 3589 3392 2975 2973 2974 2523 2042 1789 1788 1257 1528  982  698  406  404
 278  575  864 1145 1418 1683 1940 2189 2430 2663 2888 3105 3314 3515 3708 3893 4070 4239 4400 4553 4698 4835 4964 5085 5198 5303 5400 5401 5402 5490 5309 5310 5494 5493 5406 5408 5497 5412 5410 5413 5414 5320 5503 5415 5504 5418 5419 5421 5422 5423 5330 5229 5120 5003 4878 4745 4604 4455 4298 4133 3960 3779 3590 3395 3393 2754 2756 2753 2287 2043 1790 1529 1259 1260  405  983  104
 277  574  863 1144 1417 1682 1939 2188 2429 2662 2887 3104 3313 3514 3707 3892 4069 4238 4399 4552 4697 4834 4963 5084 5197 5302 5399 5488 5489 5569 5491 5405 5492 5496 5407 5575 5498 5409 5316 5499 5501 5580 5502 5582 5505 5507 5420 5508 5509 5424 5331 5230 5121 5004 4879 4746 4605 4457 4456 4299 4134 3780 3591 3191 3189 2976 2755 2525 2288 2044 1791 1530 1261  984  700  699  105
 276  573  862 1143 1416 1681 1938 2187 2428 2661 2886 3103 3312 3513 3706 3891 4068 4237 4398 4551 4696 4833 4962 5083 5196 5301 5398 5487 5568 5570 5404 5571 5643 5572 5647 5573 5576 5577 5411 5714 5581 5500 5653 5583 5584 5506 5586 5587 5510 5425 5332 5231 5122 5005 4880 4747 4606 4458 4301 4300 3961 4135 3962 3781 3188 3190 2526 2289 2290 2045 1792 1531 1262  985  407  408  106
 275  572  861 1142 1415 1680 1937 2186 2427 2660 2885 3102 3311 3512 3705 3890 4067 4236 4397 4550 4695 4832 4961 5082 5195 5300 5397 5486 5567 5640 5641 5642 5706 5645 5574 5495 5709 5579 5578 5650 5713 5654 5651 5717 5658 5585 5656 5588 5511 5426 5333 5232 5123 5006 4881 4608 4749 4607 4136 3963 3783 3593 3594 3592 2978 2757 2527 2528 2291 2046 1793 1532 1263  986  701  409  107
 274  571  860 1141 1414 1679 1936 2185 2426 2659 2884 3101 3310 3511 3704 3889 4066 4235 4396 4549 4694 4831 4960 5081 5194 5299 5396 5485 5566 5639 5704 5705 5760 5761 5707 5764 5648 5710 5767 5649 5715 5716 5652 5718 5655 5719 5659 5589 5512 5428 5427 5233 5124 5007 4882 4748 4609 4459 4302 4137 3782 3784 3396 3394 2977 3192 2979 2529 2292 2047 1794 1533  987  988  410  702  108
 273  570  859 1140 1413 1678 1935 2184 2425 2658 2883 3100 3309 3510 3703 3888 4065 4234 4395 4548 4693 4830 4959 5080 5193 5298 5395 5484 5565 5703 5637 5759 5644 5762 5708 5763 5646 5765 5711 5712 5769 5770 5771 5772 5773 5657 5720 5514 5591 5513 5334 5335 5234 5125 5008 4883 4750 4460 4303 4138 3964 3965 3399 3397 3398 3193 2758 2530 2293 2048 1795 1535 1534 1264  704  703  109
 272  569  858 1139 1412 1677 1934 2183 2424 2657 2882 3099 3308 3509 3702 3887 4064 4233 4394 4547 4692 4829 4958 5079 5192 5297 5394 5483 5564 5638 5702 5848 5809 5807 5810 5811 5812 5766 5815 5768 5816 5817 5818 5819 5774 5721 5660 5592 5590 5429 5336 5235 5126 5009 4884 4751 4610 4461 4304 4139 3966 3786 3595 3596 3194 2980 2759 2531 2294 2049 1796 1268 1265  989  705  111  706
 271  568  857 1138 1411 1676 1933 2182 2423 2656 2881 3098 3307 3508 3701 3886 4063 4232 4393 4546 4691 4828 4957 5078 5191 5296 5393 5482 5563 5636 5701 5758 5808 5849 5850 5851 5813 5853 5814 5854 5855 5856 5857 5820 5775 5722 5661 5515 5516 5430 5338 5337 5127 5010 4885 4752 4611 4462 4305 4140 3785 3967 3597 3400 3195 2982 2981 2760 2761 2050 1797 1267  990 1266  412  411  110
 270  567  856 1137 1410 1675 1932 2181 2422 2655 2880 3097 3306 3507 3700 3885 4062 4231 4392 4545 4690 4827 4956 5077 5190 5295 5392 5481 5562 5635 5700 5757 5806 5847 5880 5881 5882 5852 5884 5885 5886 5887 5858 5821 5776 5723 5662 5593 5517 5431 5432 5236 5128 5011 4886 4753 4612 4463 4306 4141 3968 3787 3598 3401 3196 2983 2762 2533 2532 2296 1798 1536  993 1269  708  991  112
 269  566  855 1136 1409 1674 1931 2180 2421 2654 2879 3096 3305 3506 3699 3884 4061 4230 4391 4544 4689 4826 4955 5076 5189 5294 5391 5480 5561 5634 5699 5756 5805 5846 5879 5904 5905 5883 5906 5908 5909 5888 5859 5822 5777 5724 5663 5594 5518 5339 5238 5237 5129 5012 4887 4754 4613 4464 4307 4142 3969 3788 3599 3402 3197 2984 2763 2534 2295 2052 1801 1799  707 1538  413  414  113
 268  565  854 1135 1408 1673 1930 2179 2420 2653 2878 3095 3304 3505 3698 3883 4060 4229 4390 4543 4688 4825 4954 5075 5188 5293 5390 5479 5560 5633 5698 5755 5804 5845 5878 5903 5919 5920 5907 5922 5910 5889 5860 5823 5725 5726 5664 5595 5435 5597 5340 5239 5130 5013 4888 4755 4614 4465 4308 4143 3970 3789 3600 3403 3198 2985 2764 2535 2297 2051 2054 1539 1537 1270  992  709  415
 267  564  853 1134 1407 1672 1929 2178 2419 2652 2877 3094 3303 3504 3697 3882 4059 4228 4389 4542 4687 4824 4953 5074 5187 5292 5389 5478 5559 5632 5697 5754 5803 5844 5877 5902 5918 5928 5923 5921 5911 5890 5861 5778 5665 5780 5596 5434 5519 5433 5341 5240 5131 5014 4889 4756 4615 4466 4309 4144 3971 3790 3601 3404 3199 2986 2765 2536 2298 2053 1273 1541 1540  994  416  417  114
 266  563  852 1133 1406 1671 1928 2177 2418 2651 2876 3093 3302 3503 3696 3881 4058 4227 4388 4541 4686 4823 4952 5073 5186 5291 5388 5477 5558 5631 5696 5753 5802 5843 5876 5900 5901 5927 5926 5924 5912 5891 5862 5824 5779 5727 5521 5668 5598 5242 5241 5343 5132 5015 4890 4757 4616 4467 4310 4145 3972 3791 3602 3405 3200 2987 2766 2537 2299 2055 1800 1803 1272  995  710  118  116
 265  562  851 1132 1405 1670 1927 2176 2417 2650 2875 3092 3301 3502 3695 3880 4057 4226 4387 4540 4685 4822 4951 5072 5185 5290 5387 5476 5557 5630 5695 5752 5801 5842 5875 5899 5917 5916 5915 5925 5914 5913 5826 5825 5781 5728 5437 5666 5667 5342 5523 5016 5243 4891 5018 4758 4468 4311 4312 4146 3973 3792 3603 3406 3201 2988 2767 2302 1802 2056 1542 1274 1271  712  996  120  117
 264  561  850 1131 1404 1669 1926 2175 2416 2649 2874 3091 3300 3501 3694 3879 4056 4225 4386 4539 4684 4821 4950 5071 5184 5289 5386 5475 5556 5629 5694 5751 5800 5841 5874 5871 5872 5897 5896 5866 5894 5892 5893 5827 5782 5520 5522 5670 5346 5436 5438 5133 5134 5017 4759 4618 4617 4469 4147 4148 3974 3793 3604 3407 3202 2989 2768 2538 2539 2300 2301 1804 1544  997  999  119  115
 263  560  849 1130 1403 1668 1925 2174 2415 2648 2873 3090 3299 3500 3693 3878 4055 4224 4385 4538 4683 4820 4949 5070 5183 5288 5385 5474 5555 5628 5693 5750 5799 5840 5873 5898 5870 5792 5895 5790 5832 5868 5863 5864 5828 5730 5599 5669 5603 5347 5524 5019 5135 5136 4892 4760 4619 4470 4313 3975 3976 3794 3605 3408 3203 2990 2769 2540 2057 2059 2058 1805 1543 1278  418  420  419
 262  559  848 1129 1402 1667 1924 2173 2414 2647 2872 3089 3298 3499 3692 3877 4054 4223 4384 4537 4682 4819 4948 5069 5182 5287 5384 5473 5554 5627 5692 5749 5798 5839 5838 5837 5794 5869 5835 5787 5831 5830 5784 5865 5786 5526 5731 5829 5672 5729 5345 5137 5245 4894 4893 4761 4620 4471 4314 4150 4149 3795 3606 3409 3204 2991 2770 2541 2303 2304 1546 1276 1275  998  711  713  714
 261  558  847 1128 1401 1666 1923 2172 2413 2646 2871 3088 3297 3498 3691 3876 4053 4222 4383 4536 4681 4818 4947 5068 5181 5286 5383 5472 5553 5626 5691 5748 5797 5796 5795 5683 5836 5791 5793 5834 5736 5833 5788 5785 5671 5733 5440 5783 5601 5441 5348 5439 5344 4897 4895 4762 4622 4621 4317 4315 3977 3796 3607 3410 3205 2992 2771 2542 2306 1808 1809 1545 1807  421 1277  422  121
 260  557  846 1127 1400 1665 1922 2171 2412 2645 2870 3087 3296 3497 3690 3875 4052 4221 4382 4535 4680 4817 4946 5067 5180 5285 5382 5471 5552 5625 5690 5747 5746 5745 5744 5743 5742 5741 5682 5677 5740 5867 5732 5676 5734 5607 5605 5600 5604 5525 5244 5247 5020 5021 4896 4763 4623 4472 4316 4151 3978 3797 3608 3411 3206 2993 2772 2543 2060 1806 2305 1548 1001 1000  715  123  122
 259  556  845 1126 1399 1664 1921 2170 2411 2644 2869 3086 3295 3496 3689 3874 4051 4220 4381 4534 4679 4816 4945 5066 5179 5284 5381 5470 5551 5624 5689 5688 5687 5686 5685 5684 5681 5615 5739 5789 5680 5679 5678 5737 5608 5673 5674 5530 5602 5350 5349 5246 5138 5351 5022 4765 4898 4321 4474 4473 3981 3980 3609 3412 3207 2994 2773 2544 2307 2063 2061 1547 1279 2062 1002  716  424
 258  555  844 1125 1398 1663 1920 2169 2410 2643 2868 3085 3294 3495 3688 3873 4050 4219 4380 4533 4678 4815 4944 5065 5178 5283 5380 5469 5550 5623 5622 5621 5620 5619 5618 5617 5616 5540 5614 5613 5612 5738 5735 5675 5610 5532 5529 5528 5527 5442 5250 5140 5443 4901 5024 5023 4155 4318 4477 4152 4153 3798 3413 3208 3209 2995 2774 2546 2545 2308 1810 1549 1280 1003  717  423  425
 257  554  843 1124 1397 1662 1919 2168 2409 2642 2867 3084 3293 3494 3687 3872 4049 4218 4379 4532 4677 4814 4943 5064 5177 5282 5379 5468 5549 5548 5547 5546 5545 5544 5543 5542 5458 5541 5539 5538 5537 5611 5536 5535 5609 5534 5606 5447 5446 5444 5139 5248 5141 5026 4766 5144 4475 4624 3801 4319 3983 3610 3611 3415 3414 2996 2775 2548 2309 2064 1811 1550 1004  719  426  718  124
 256  553  842 1123 1396 1661 1918 2167 2408 2641 2866 3083 3292 3493 3686 3871 4048 4217 4378 4531 4676 4813 4942 5063 5176 5281 5378 5467 5466 5465 5464 5463 5462 5461 5460 5459 5457 5456 5455 5364 5454 5453 5452 5533 5451 5360 5449 5448 5531 5255 5352 5251 5028 4764 5025 4767 4768 4625 3982 4322 3803 3979 3799 3210 2997 2547 2776 2549 2310 2065 1551 1282 1281 1005  720  125  427
 255  552  841 1122 1395 1660 1917 2166 2407 2640 2865 3082 3291 3492 3685 4047 4216 4215 4377 4530 4675 4812 4941 5062 5175 5280 5377 5376 5375 5374 5373 5372 5371 5370 5369 5368 5367 5366 5266 5365 5363 5362 5361 5261 5450 5357 5356 5355 5445 5354 5353 5253 5145 5249 4479 4626 4900 4156 4323 4476 3800 3612 4154 3416 3211 2777 2550 2779 2313 2066 1812 1552 1283 1006  431  127  126
 254  551  840 1121 1394 1659 1916 2165 2406 2639 2864 3081 3290 3491 3684 3870 4046 4045 4213 4376 4674 4811 4940 5061 5174 5279 5278 5277 5276 5275 5274 5273 5272 5271 5270 5269 5268 5267 5159 5265 5264 5263 5156 5259 5260 5358 5257 5150 5149 5256 5254 5142 5027 5143 4902 4899 4628 4627 4478 4158 3613 4320 3802 3614 3212 2998 2778 2551 2312 2311 1553 1816 1284  429  428  721  432
 253  550  839 1120 1393 1658 1915 2164 2405 2638 2863 3080 3289 3490 3683 3869 4044 4375 4374 4529 4673 4810 4939 5060 5173 5172 5171 5170 5169 5168 5167 5165 5164 5050 5163 5046 5160 5045 5158 4920 5043 5157 5039 5154 5036 5359 5037 5258 5033 4910 5146 5147 5252 5031 5030 4904 4629 4630 4480 3984 4159 3615 3417 3617 3000 2780 3213 2315 2068 2067 1813 1554 1285  723 1286  128  430
 252  549  838 1119 1392 1657 1914 2163 2404 2637 2862 3079 3288 3489 3682 3868 4043 4214 4373 4528 4526 4809 4938 5059 5058 5057 5056 5055 5054 5053 5052 5166 5051 5049 5048 4923 5162 4921 4790 4922 5042 5041 5155 5262 5038 5153 5151 5035 5034 4909 4907 5148 4906 4636 4903 4770 4157 4482 3986 4327 3985 3804 3987 3001 2999 2314 2781 2069 2552 2070 1817 1556 1815  724  433  130  434
 251  548  837 1118 1391 1656 1913 2162 2403 2636 2861 3078 3287 3488 3865 3867 3866 4372 4371 4671 4527 4808 4937 4936 4935 4934 4933 4932 4931 4930 4929 4928 4927 4926 4925 5161 4924 5044 4919 4788 4787 5040 4647 5152 4784 4915 4914 4911 4780 4908 4775 5032 5029 4772 4771 4633 4483 4481 3988 4325 4160 3418 3618 3214 3002 3003 2316 1814 2072 1555 1557 1287 1009  722  136  129  727
 250  547  836 1117 1390 1655 1912 2161 2402 2635 2860 3077 3286 3487 3681 3680 4042 4212 4210 4672 4525 4670 4807 4805 4804 4803 4802 4801 4800 4799 4798 4797 4796 4795 4794 4792 4506 4791 4789 4649 4918 4785 4646 4786 4783 4643 4781 4913 4641 4777 4776 4778 4638 4905 4487 4632 4484 4328 3807 4324 3616 3808 3419 3421 3420 3215 2782 2553 2318 2071 1818 1288 1012 1007 1559  131  133
 249  546  835 1116 1389 1654 1911 2160 2401 2634 2859 3076 3285 3486 3679 3864 4041 4211 4370 4523 4524 4365 4806 4667 4665 4664 4663 4662 4661 4660 4658 4511 4657 4655 4654 5047 4507 4652 4651 4501 4503 4502 4917 4916 4500 4782 4642 4912 4640 4779 4637 4635 4490 4774 4332 4769 4634 4485 4326 4162 3805 3806 3422 3423 3216 3004 2785 2784 3219 2074 2317 1821 2319 1291 1290 1008  725
 248  545  834 1115 1388 1653 1910 2159 2400 2633 2858 3075 3284 3485 3678 3863 4039 4040 4669 4368 4668 4521 4520 4666 4518 4517 4516 4515 4514 4513 4659 4355 4510 4656 4508 4793 4653 4505 4504 4650 4347 4648 4345 4498 4497 4644 4496 4495 4494 4493 4492 4639 4489 4335 4773 4488 4486 4631 4329 3810 4161 3989 3621 3218 3217 3008 3005 2786 2555 2783 1819 1558 2075  134  728  135 1011
 247  544  833 1114 1387 1652 1909 2158 2399 2632 2857 3074 3283 3484 3677 3862 4208 4369 4209 4367 4522 4366 4364 4519 4363 4362 4361 4360 4359 4195 4512 4357 4356 4509 4354 4353 4351 4350 4348 4187 4184 4013 4346 4344 4645 4342 4341 4340 4339 4338 4491 4337 4336 4334 4333 4331 4330 4166 4167 4163 3992 3809 3619 3425 3007 2557 2556 2073 2076 1560 1820 1561 1010 1289  132  436  730
 246  543  832 1113 1386 1651 1908 2157 2398 2631 2856 3073 3282 3483 3676 3861 4038 4207 4206 4205 4204 4203 4202 4201 4200 4199 4198 4197 4196 4194 4358 3843 4022 4192 4190 4352 4189 4188 4349 4185 4014 4499 4182 4010 4343 4009 4180 4177 4176 4175 4174 4173 4172 4171 4170 4169 4168 3994 4164 4165 3811 3623 3620 3990 3622 3221 3424 3006 2320 1822 1562 2554  726  435  138 1015  731
 245  542  831 1112 1385 1650 1907 2156 2397 2630 2855 3072 3281 3482 3675 3860 4037 4036 4035 4034 4033 4031 3852 4030 4029 4028 4027 4026 4025 4024 4193 4023 4021 4191 4019 3838 4018 4017 4016 3649 3833 3834 3832 4011 4008 4179 4181 4007 4006 4003 4002 4001 3822 4000 3821 3819 3999 3997 3996 3991 3993 3227 3426 3427 3220 3009 3222 2558 2077 1823 1824 1292 1017  729 1013  438 1014
 244  541  830 1111 1384 1649 1906 2155 2396 2629 2854 3071 3280 3481 3674 3859 3858 3857 3856 3855 3853 4032 3851 3850 3663 3849 3848 3847 3846 3845 3657 3844 3841 4020 3840 4015 3456 3837 4186 3835 4183 3645 4012 3644 3642 3828 4178 3827 4005 3826 3637 3823 3633 3632 3439 3820 3998 3818 3995 3817 3812 3813 3814 3624 3428 3429 2787 2788 2321 2078 1293 1563 1295 1016  732  440  437
 243  540  829 1110 1383 1648 1905 2154 2395 2628 2853 3070 3279 3480 3673 3672 3671 3670 3669 3668 3854 3666 3665 3664 3662 3467 3661 3660 3659 3658 3462 3656 3842 3655 3653 3839 3253 3651 3836 3829 3648 3647 3451 3450 3831 3830 3241 3640 3825 3824 3442 3636 3238 3437 3234 3631 3630 3434 3435 3815 3628 3627 3625 3223 3010 3011 2789 2561 2560 2559 2322 1294 1296  439  733  139  137
 242  539  828 1109 1382 1647 1904 2153 2394 2852 3069 3278 3277 3479 3478 3477 3476 3475 3474 3473 3667 3472 3470 3469 3468 3264 3466 3465 3464 3260 3463 3460 3459 3654 3255 3458 3652 3455 3453 3454 3249 3646 3247 3246 3448 3641 3447 3446 3639 4004 3638 3440 3237 3635 3634 3235 3438 3232 3629 3816 3229 3626 3432 3225 3226 3224 2790 2325 2323 1825 1564 1567 1019 1018  734  441  140
 241  538  827 1108 1381 1646 1903 2152 2393 2627 2851 3068 3276 3275 3064 3274 3273 3272 3271 3270 3269 3471 3056 3267 3266 3054 3263 3262 3261 3259 3258 3461 3257 3256 3457 3043 3254 3252 3650 3251 3452 3038 3035 3248 3449 3643 3244 3032 3445 3443 3028 3029 3239 3026 3441 3023 3436 3231 3433 3018 3020 3230 3431 3228 3430 3012 2791 2562 2080 2079 1827 1826 1565 1297  736  442  141
 240  537  826 1107 1380 1645 1902 2392 2625 2626 2850 3067 3066 3065 2844 3063 3062 3061 3060 2840 3059 3058 3268 3057 2836 3265 3053 3052 3050 3049 3048 3047 3046 3045 3044 3042 2823 3041 3040 3250 3039 3037 2815 3033 2814 3245 2813 3444 3242 3240 2810 2582 3027 3236 2805 3025 3233 3021 3019 2801 2798 2572 3016 3014 2795 2792 2563 2324 2081 2082 1828 1298 1566  735  444  737  142
 239  536  825 1106 1379 1644 2150 2151 2391 2623 2624 2849 2848 2845 2846 2843 2616 2842 2841 2613 2839 2838 2837 2835 3055 2834 2833 3051 2830 2604 2829 2828 2827 2826 2825 2824 2596 2822 2820 2819 2817 3036 3034 2816 2589 3243 2586 2812 3031 3030 2811 2808 3024 2807 2577 2342 3022 2802 2800 2338 2571 2796 2797 3015 2794 3013 2793 2327 2565 2326 1829 1568 1299 1020 1021  443  143
 238  535  824 1105 1378 1643 1901 2149 2390 2388 2622 2386 2621 2847 2619 2617 2615 2614 2380 2379 2612 2611 2610 2609 2608 2607 2832 2371 2605 2831 2602 2601 2600 2599 2598 2597 2595 2594 2821 2592 2116 2593 2818 2590 2588 2351 2352 2587 2350 2809 2348 2581 2806 2580 2578 2803 2804 2574 2576 2799 2573 2335 3017 2569 2568 2567 2566 2564 2083 2084 1830 1569 1300 1022  738  739  144
 237  534  823 1104 1377 1642 1900 2148 2389 2145 2385 2144 2142 2620 2384 2618 2383 2381 2378 2377 2134 2376 2375 2374 2373 2372 2606 2370 2369 2603 2367 2364 2121 2363 2362 2119 2361 2360 2115 2358 2356 2591 2355 2354 2353 2109 2107 2347 2585 2584 2105 1852 2345 2579 2344 2343 2099 2575 2339 2336 2337 2092 1841 2089 2090 2332 2331 2329 2328 1831 1570 1571 1301 1023  446  445  145
 236  533  822 1103 1376 1641 1899 2147 2146 2387 1634 1893 2141 1888 2143 1362 2139 2138 2137 1885 2135 2133 2132 2131 2130 2129 2128 2126 2368 2125 1346 2365 2366 2123 2120 1868 2118 2117 2359 2114 2357 2113 2112 2111 2110 1858 2106 1856 2349 2346 2103 2583 2102 2101 2100 2341 2097 1847 2340 1585 2095 2334 1580 2570 1313 2333 2088 2330 2086 2085 1832 1302 1025 1024  740  447  146
 235  532  821 1102 1375 1640 1898 1896 1895 1635 1894 1892 1891 1630 1889 2382 1628 1626 1884 2136 1882 1623 1881 1621 1880 1879 1875 1617 1616 1874 2124 1613 2122 1870 1869 1867 1608 1866 1865 1864 1863 1862 1861 1859 1332 1598 2108 1855 1854 1853 2104 1326 1851 1850 1588 1848 2098 1843 1845 1586 1584 2093 2091 1579 1838 1837 1311 2087 1835 1834 1833 1572 1303 1026  741  448  147
 234  531  820 1101 1374 1639 1897 1637 1636 1633 1631 1363 1890  806 2140 1361 1887 1886 1625 1624 1883 1356 1622 1352 1076 1878 2127 1877 1876 1615 1873 1072 1871 1611 1610 1341 1609 1607 1606 1605 1337 1604 1603 1860 1600 1599 1857 1597 1596 1595 1593 1594 1592 1591 1849 1590 1322 1320 1846 2096 1583 1842 1582 1315 1039 1578 1577 1836 1576 1575 1574 1573 1304 1027  742  449  148
 233  530  819 1100 1373 1371 1638 1370 1369 1368 1365 1632 1089 1090 1087 1091 1629 1360 1627 1083  799 1355 1353 1354 1620 1618 1619 1351 1074 1348 1347 1612 1872 1344 1343 1068 1066 1340 1339 1338 1062 1336 1333 1601  775 1056 1331 1330 1055 1329 1051  768 1325 1324 1323 1589 1587 1318 1844 1317 2094 1316 1040 1581 1839 1037 1312 1310 1309 1308 1307 1306 1305 1028  743  450  149
 232  529  818 1098 1097 1372 1096 1095 1094 1093 1367 1366  807  805 1364 1086  512 1085  508 1358  800  798 1080 1079  795  793 1075 1349 1350 1614 1073 1070 1345 1069 1342  783  784 1064 1063  488 1061 1334 1602 1335 1060 1057  773  772 1328  479 1052 1327 1050 1048  765  763 1046 1044 1319 1043 1042 1041 1314 1840 1038  754 1036 1035 1034 1033 1032 1031 1030 1029  744  451  150
 231  528  817 1099  814  813  524  812  811  810  809 1092  516  515  804  803  213  801 1359 1082  209  797  509 1078  505 1077  502  792  791  790  789 1071  496  787  785 1067  491 1065  782  779  780  778  777 1059  485  484  774 1054  480 1053  477  767  476  766  764  762 1047  472  171  761  470  758  757  465  756  755  753  752  751  750  749  748  747  746  745  452  151
 230  527  227  816  526  815  525  522  521  520  808  218  216  217  514  215 1088  802  510  210 1357  506 1081  205  504  794  204  501  500  499  498  788  497  786  494  493  492  192  781  490  489  487  486 1058  776  483  482  481  771  769  770  478  177  175  475 1321  473  474  170  760  759  468  466  166  464  463  462  461  460  459  458  457  456  455  454  453  152
 229  228  226  225  224  223  523  222  221  519  220  219  517  518  513  214  212  211  511 1084  208  507  796  207  206  203  503  202  201  200  199  198  197  495  196  195  194  193  191  190  189  188  187  186  185  184  183  182  181  180  179  178  176 1049  173  174 1045  471  172  469  168  169  467  167  165  164  163  162  161  160  159  158  157  156  155  154  153
