# This puzzle is unsolvable
48
   2    1    3    4    5    6    7    8    9   10   11   12   13   14   15   16   17   18   19   20  208   21   22   23   24   26   27   28   29   30   31   32   33   34   35   36   37   38   39   40   41   42   43   44   45   46   47   48
 188  189  190  191  192  193  194  195  196  197  198  199  200  201  202  203  204  205  207  558  209  210  390  211   25  213  214  215  216  217  218  219  220  221  222  223  224  225  226  227  228  229  230  231  232  233  234   49
 187  368  369  370  371  372  373  374  375  376  377  378  379  380  381  382  383  384  206  557  386  560  388  391  212  392  393  394  395  396  397  398  399  400  401  402  403  404  405  406  407  408  409  410  411  412  235   50
 186  367  540  541  542  543  544  545  546  547  548  549  550  551  552  553  554  555  385  387  559  879  722  561  562  563  564  565  566  567  568  569  570  571  572  573  574  575  576  577  578  579  580  581  582  413  236   51
 185  366  539  704  705  706  707  708  709  710  711  712  713  714  715  716  717  718  556  720  875  721  389  724  725  726  727  728  729  730  731  732  733  734  735  736  737  738  739  740  741  742  743  744  583  414  237   52
 184  365  538  703  860  861  862  863  864  865  866  867  868  869  870  871  872  873  719  874 1024  723  876 1026 1027  880  881 1030  883  886 1032  887  888  889  890  891  892  893  894  895  896  897  898  745  584  415  238   53
 183  364  537  702  859 1008 1009 1010 1011 1012 1013 1014 1015 1016 1017 1018 1019 1020 1021 1022 1163  878  877 1165 1028  882 1029  885 1170  884 1031 1034 1035 1036 1037 1038 1039 1040 1041 1042 1043 1044  900  899  746  585  239   54
 182  363  536  701  858 1007 1148 1149 1150 1151 1152 1153 1154 1155 1156 1290 1289 1159 1160 1162 1023 1295 1025 1164 1166 1167 1168 1169 1424 1172 1033 1173 1174 1175 1176 1177 1178 1179 1180 1181 1182 1046 1045  747  586  416  240   55
 181  362  535  700  857 1006 1147 1280 1281 1282 1283 1284 1285 1410 1286 1158 1634 1412 1413 1414 1161 1294 1418 1296 1421 1297 1300 1301 1425 1171 1302 1303 1305 1306 1307 1308 1309 1310 1311 1312 1183 1047  901  748  587  417  241   56
 180  361  534  699  856 1005 1146 1279 1404 1405 1406 1407 1408 1409 1157 1288 1633 1528 1292 1291 1293 1416 1419 1420 1535 1299 1298 1422 1538 1426 1427 1304 1428 1429 1430 1431 1432 1433 1434 1313 1185 1184  902  749  588  418  242   57
 179  360  533  698  855 1004 1145 1278 1403 1520 1521 1522 1523 1632 1411 1527 1636 1529 1530 1415 1531 1417 1533 1534 1642 1536 1645 1646 1423 1648 1540 1649 1542 1545 1546 1547 1653 1437 1548 1435 1314 1048  903  750  589  419  420   58
 178  359  532  697  854 1003 1144 1277 1402 1519 1628 1629 1524 1525 1729 1732 1287 1526 1635 1637 1639 1532 1739 1640 1641 1644 1537 1539 1745 1541 1748 1650 1544 1543 1752 1751 1655 1550 1549 1436 1315 1049  904  751  590  421  243   59
 177  358  531  696  853 1002 1143 1276 1401 1518 1627 1728 1631 1630 1822 1731 1733 1734 1735 1737 1638 1738 1830 1740 1741 1643 1743 1744 1746 1647 1747 1749 1750 1651 1841 1753 1652 1654 1438 1316 1051 1186  905  591  592  422  244   60
 175  176  357  530  695 1001 1142 1275 1400 1517 1626 1727 1820 1730 1823 1824 1907 1825 1826 1736 1827 1829 1831 1832 1916 1742 1918 1834 1836 1837 1838 1839 1921 1922 1840 1842 1439 1656 1317 1440 1187 1052  753  752  754  423  245   61
 174  356  529  694  852 1000 1141 1274 1399 1516 1625 1726 1819 1821 1904 1981 1906 1908 1909 1910 1828 1912 1913 1914 1833 1990 1917 1992 1835 2121 1920 1998 1923 1756 1924 1551 1843 1442 1318 1553 1188 1053  906  596  424  247  246   62
 355  354  528  693  851  999 1140 1273 1398 1515 1624 1725 1818 1980 1905 2048 1982 1983 1984 1985 1911 2053 1987 1989 1915 2059 1993 2119 1919 2062 1995 1997 1844 1754 1660 1755 1552 1662 1555 1657 1191 1050  756  907  593  425  248   63
 173  353  527  692  850  998 1139 1272 1397 1514 1623 1724 1817 2049 1978 2108 2047 2050 2051 2052 2054 1986 1988 2115 2057 2058 1991 2060 1994 2172 2064 1999 1926 1925 1658 1441 1757 1659 1193 1319 1054 1190  755  758  597  908   64   65
 172  525  848  997  849  996 1137 1138 1396 1512 1513 1622 1723 1901 1903 1977 2106 1979 2110 2111 2112 2113 2056 2055 2116 2117 2118 2170 2120 2061 1996 2122 1845 1928 1758 1554 1759 1320 1055 1321 1189  594  595  757  426  427  249   66
 352  526  351  690  691  847 1136 1271 1511 1395 1621 1722 1816 1815 2046 1902 2105 2109 2160 2205 2164 2165 2114 2166 2167 2168 2169 2213 2171 2174 2063 2001 1927 1929 1661 1443 1556 1557 1445 1324 1192  909  911  759  599  428   67  251
 170  171  350  524  689  995 1270 1269 1620 1509 1813 1721 1976 2044 1975 1974 2107 2204 2162 2161 2163 2207 2208 2209 2210 2211 2212 2248 2215 2214 2002 2124 2065 2000 1848 1760 1846 1558 1323 1195 1056 1057  913  910  253  252  430  250
 349  523  687  688  846  994 1135 1393 1510 1394 1619 1720 1814 1900 1812 2045 2104 2159 2203 2240 2206 2242 2243 2245 2291 2246 2273 2247 2274 2123 2173 2066 2003 1930 1847 1663 1664 1559 1326 1444  912 1194  598  429  254  601   69   68
 168  522  685  844  521  993 1134 1268 1618 1508 1719 1718 1617 1716 1899 2043 2158 2156 2202 2239 2241 2269 2271 2244 2290 2272 2125 2249 2216 2176 2175 2126 2068 1932 1849 1850 1665 1560 1448 1322 1061 1446 1196  760  600  914  255  259
 169  519  348  991  992  845 1392 1267 1391 1506 1896 1616 1809 1973 1897 2042 2201 2155 2238 2266 2268 2270 2282 2288 2289 2292 2275 2251 2217 2219 2005 2067 1931 2070 1851 1761 1762 1561 1447 1060 1325 1197  915  761 1059  762   70  431
 167  166  842  686  843 1132 1266 1133 1390 1264 1714 1898 1615 1969 1971 1972 2103 2157 2237 2264 2236 2267 2198 2300 2302 2303 2276 2294 2250 2128 2069 2071 1852 1936 2008 1853 1933 1854 1562 1327 1058  917  763  916   72  606  258   71
 164  520  518  839  683 1265  989  990 1507 1505 1131 1895 1614 1894 2041 2038 2101 2153 2154 2200 2285 2265 2283 2287 2280 2299 2293 2177 2252 2218 2130 2129 2072 2004 1934 1765 1763 1563 1667 1449  602  764  432  435   74  604  437  256
 347  165  346  841  684  987  682 1388 1389 1504 1717 1713 1970 1892 2099 2102 2151 2098 2152 2199 2234 2301 2286 2297 2298 2278 2277 2279 2220 2131 2178 2006 2007 2127 2009 1766 1764 1666 1328 1198 1199 1062 1063  433  766  765  257  434
 163  345  344  680 1262  838  840 1128 1130 1129 1810 1805 1811 1806 2040 2037 2039 2097 2096 2235 2263 2260 2261 2296 2295 2258 2221 2254 2181 2179 2180 2074 1855 1937 1668 1935 1669 1564 1450 1329 1200  918  919 1066  607  603  605  261
 162  343  517 1124  681 1263  988 1387 1611 1503 1808 1712 1891 1966 1968 2036 2100 2150 2197 2232 2262 2284 2189 2259 2228 2281 2253 2257 2222 2223 2132 2075 2073 2010 1856 1767 1330 1670 1565 1451 1331 1202 1065  767  922  260   73  436
 515  159  341 1259 1126 1260  834 1261 1258 1502 1501 1127 1893 1715 1890 1967 2033 2035 2233 2196 2191 2145 2230 2227 2226 2225 2255 2256 2224 2184 2133 2076 2011 1938 1857 1768 1566 1452 1567 1333 1064 1201 1203  769  439  768  440   75
 836  342  514  516  837 1383  986 1499 1386 1385 1710 1807 1804 1610 1961 2034 2095 2030 2195 2193 2192 2231 2229 2190 2188 2187 2186 2185 2183 2182 2134 2077 2012 1939 1858 1769 1671 1455 1334 1332 1204  920 1206  921  262  609  438   77
 339  161  510  513  679  677 1121  833 1613 1384 1607 1612 1965 1500 2149 1711 2148 2029 2147 2146 2089 2144 2143 2142 2141 2140 2139 2138 2137 2136 2135 2078 2013 1940 1859 1770 1672 1456 1205 1453 1069  923 1067  770   76  610   79  263
 678  160  509  983  832  984 1380  674 1257 1123 1709 1801 1889 1708 1888 1960 2194 2032 2092 2091 2090 1955 2088 2087 2086 2085 2084 2083 2082 2080 2015 2014 2079 1941 1860 1771 1673 1674 1568 1336 1335 1068  924  772  608  613   81  266
 340  158  338  512 1125  985  835  676 1609 1253 1803 1381 1706 1887 1256 1964 2093 2094 2028 2027 2026 2024 2023 2025 1952 2022 2020 2019 2017 2081 1946 2016 1944 1942 1861 1675 1772 1773 1458 1457 1207 1070  926  925   78  771  441   80
 157  156  335  511  675  975 1382 1800 1496 1707 1493 1605 1608 1886 1963 1882 2031 1959 1958 1877 1956 1954 1875 1873 1951 1950 2021 1949 1948 1869 2018 1945 1865 1943 1862 1569 1454 1570 1571 1208 1210 1209 1071  611  443  265  264  442
 155  337  830  829  982  976  981 1122 1252 1255 1497 1494 1884 1606 1802 1795 1881 1880 1879 1957 1878 1876 1788 1874 1953 1872 1871 1870 1947 1868 1779 1780 1866 1864 1863 1677 1573 1678 1337 1338 1572 1073  927  773  774  612  444   82
 507  336  508  831  978 1375 1495 1378 1118 1603 1702 1797 1885 1798 1883 1600 1794 1793 1792 1791 1790 1789 1787 1692 1786 1785 1784 1783 1782 1781 1867 1684 1778 1777 1776 1774 1676 1460 1339 1461 1459 1072  928  775  614  445  267   84
 154  671  980  506  828  977 1254 1251 1120 1491 1599 1604 1488 1487 1962 1700 1699 1698 1697 1696 1695 1694 1693 1589 1691 1690 1689 1688 1687 1686 1685 1683 1580 1682 1681 1775 1680 1574 1575 1074 1211 1340  929  776  446  447   83  268
 673  153  333 1117  973  672  827 1379 1498 1799 1602 1705 1704 1489 1796 1701 1595 1594 1483 1593 1592 1591 1590 1478 1588 1587 1586 1585 1584 1581 1472 1471 1579 1468 1679 1577 1465 1576 1341 1212 1075  930  778  931  615  270  269   85
 152  334  505  668  670 1377 1248  979 1119 1490 1492 1371 1370 1368 1598 1703 1596 1484 1485 1482 1481 1480 1360 1479 1477 1476 1475 1474 1473 1583 1352 1350 1470 1469 1578 1346 1467 1464 1462 1342 1213 1076  777  617  616  448  271   86
 332  331  974  666  503  972 1249 1376 1250 1373 1601 1243 1244 1369 1240 1597 1486 1238 1239 1363 1362 1233 1098 1359 1358 1357 1356 1355 1354 1353 1225 1582 1351 1222 1347 1220 1466 1344 1343 1216 1077 1078  932  779  618  449  272   87
 151  502  669  826  504 1115 1114 1247 1374 1246 1245 1372 1108 1367 1242 1105 1366 1364 1365 1237 1100 1361 1099 1232 1231 1230 1229 1228 1227 1226 1089 1090 1223 1349 1221 1348  942 1219 1463 1217 1214  933  934  780  619  450  273   88
 150  146  824  823 1116  971  825  970  968 1112 1111 1110 1109  965 1107 1106  810 1104 1102 1103 1235 1236  954  955 1097 1095 1094 1093 1092  947  795  946 1224 1086  944  943  941 1345  940 1081 1215  936 1079 1080  452  620  274   89
 326  149  501  148  820  821  662  969  660  967  966    0  814  812 1241  962  811  960  958 1101  956 1234  804  953 1096  952  951  950  798 1091  635 1088  794 1087  792  791  790 1083 1218 1082  938  937  784  781  621  451  275   90
 147  330  329  665  663  822  495  819 1113  658  490  816  656  654  964  652  809  959  808  957  807  646  805  803  802  801  800  799  797  948  471  638  796  634 1085  793  632 1084  939  627  625  935  783  782  622  454  276   91
 145  324  667  500  322  319  664  661  493  659  817  815  813  487  963  651  650  961  649  648  806  647  645  644  643  642  473  640  472  949  637  636  468  945  465  290  789  788  786  626  785  458  457  455  623  453  277   92
 327  144  328  499  496  137  494  315  318  818  316  489  486  488  653  485  484  483  482  481  480  479  478  477  476  475  641  474  297  639  470  293  110  633  631  467  464  629  628  787  284  459  624  456  281  280  279   93
 143  141  498  321  139  134  317  135  492  491  314  313  655  312  311  310  309  308  307  306  305  304  303  302  301  300  299  298  296  113  295  469  292  108  291  466  104  289  630  285  103  460  283  282   98   99  278   96
 325  142  323  497  140  138  320  136  657  133  132  131  130  129  128  127  126  125  124  123  122  121  120  119  118  117  116  115  114  112  111  294  109  107  106  105  463  288  286  287  461  462  102  101  100   97   95   94
