# This puzzle is unsolvable
57
 223    5    2  441  444  230  227  232  236  448   10   12  235  658   16  456  457  863  241  458  243   21   22   23   25   27  464   28   29  254   30   32   33   34   35   36   37   38  477   40   41   43   44  483   45  694   46   49   50  487   51   54  277   55    0   58  280
 440    1  229  446  228  231  445  651  449   11  854 1048  233   15   14  454  663   18  859   19  244  246  245  462   24  247  250  252  253  676  469  470  678 1250  255  259  475  476  261  480  263  268  266  267  269  484  692  273  271  894   52 1089   56  279  494   57  699
 224  439    6  225  226 1042    8  234  654  657  650  857   13  239  664  240   17  242  667  665 1056  459  461   26  463  249  465  466  467   31  468  256  677  257  258  881  880  883  264  260   42 1078  690  482  691  486   47  485  693  893  488  700  272  489  276   59  493
 220  222  442  649  648  851  447  450  655  855    9  860 1229  656  237  238 1054  661  864  862   20  666  460  669  670  248  672  673  675 1248  875 1067  878  681  471  682  474 1072   39  262  684  265  884  689 1081  891 1084 1086  270 1609 1268  490  278  274  284  498  285
 438  846    4  437  848  645 1039 1041    7  652 1047  856 1230  858 1235  451  861 1050  662  865  867  668 1058  870 1060  251  671 1064  674  872 1425 1249  680  473  472 1252  879  685  683  479 1079  686  889  481   48  687  695  696 1767  895 1087  275  492  491   53  282   60
 221  435    3  850 1040  443  852 1043  853 1044 1406  659 1572  455  452 1049  453 1052 1238 1239 1057  866 1241  869 1059 1244  871  873 1065  876 1594  874 1428 1251 1069 1070 1253 1074 1258  478 1077  887  885  888  688  892 1264 1082 1270 1085 1267  697  897  496  497  283  495
 218  219  646  436  647 1223 1038 1402  653 1045 1403 1046 1232 1051 1407  660 1055 1410 1237 1579 1413 1415  868 1243 1419 1242 1061 1063 1062 1426 1247 1593 1066  877  679 1430  882 1255 1259 1076 1260  886 1261 1263 1437  890 1607 1080 1610  899  281  901 1442 1090   64   61   66
 434  844  843 1036  849 1221 1225 1569 1224 1568 1731 1405 1231 1234 1576 1233 1736 1236 1053 1414 1240 1412 1582 1417 1418 1420 1421 1245 1246 1590 1424 1423 1068 1902 1071 1757 1257 1256 1254 1073 1433 1435 1436 1605 1438 1265 1083 1439  698  701 1269 1444 1088  902  286  898  707
 433  644  847 1037 1222 1399  845 1227 1727 1570 1404 1882 1408 1409 1733 1732 1578 1737 1411 1890 2031 1583 1740 1584 1585 1586 1746 1587 1422 1750 1749 1427 1754 1595 1075 1756 1907 1431 1600 1432 1434 1761 1912 1604 1602 1262 1608 1445 1441 1440  896  900  903  702   65  500   63
 217  216  643  642 1398 1401 1400 1228 1226 1879 1571 1881 1884 1883 1577 1575 1887 1580 1739 2294 1581 1742 1416 1743 1744 1745 1747 1589 1588 1591 1752 1592 1753 1597 1596 1755 1599 1758 1598 1759 1601 1760 1914 1764 1606 2058 1917 1766 1768 1443 1266 1273 1271  704  703  287   67
 215  432  641  842 1035 1220 1397 1728 1567 1726 1729 1885 1574 1573 2163 2030 2029 1738 2168 1889 1891 2171 1741 1894 2038 1896 1897 1898 1748 1899 1751 1901 2045 1904 1905 1429 2184 1908 1910 1913 2055 1603 1762 1765 1915 1916 1611 1770 1091 1446 1094 1272 1093  499  706   62   68
 429  214  431  841 1034 1219 1566 1565 1880 2024 2021 2289 2158 2160 2026 1886 2161 2165 2034 2032 2169 1892 1895 2036 1893 2039 2040 2041 2042 1900 2044 2046 2307 2047 2182 2048 2049 2051 1909 1911 2052 2054 1763 2191 2056 2192 2059 1612 1769 1447 1095 1274 1092  904  705  503   70
 430  640  840 1395 1218 1563 1725 1564 1875 1730 2288 1876 2162 1878 2410 2293 2413 2028 2295 2167 2414 2170 2035 2298 2037 2174 2175 2176 2177 2043 2179 1903 2180 2309 2185 2050 1906 2186 2187 2053 2317 2316 2190 2193 2057 2060 1918 1613 1614 1448 1098  906  905  501  708  289  288
 212  428  213  639 1032 1394 1396 1393 1217 1724 2025 2290 1877 2409 2407 2291 2412 1888 2411 2297 2296 2033 2172 2416 2173 2301 2302 2303 2304 2178 2305 2306 2425 2308 2183 2311 2312 2432 2313 2188 2189 2547 2435 2319 2194 2061 1919 1771 1449 1450 1097 1276 1278 1096  504   69  290
 208  210  638  839 1391 1216 1390 1874 1562 2023 2022 2027 2522 2292 2624 1735 2164 2524 2523 2525 2415 2417 2299 2419 2300 2420 2421 2422 2423 2424 2536 2427 2181 2428 2310 2430 2431 2543 2315 2314 2434 2437 2318 2436 2320 2062 1920 1772 1615 1451 1277 1275  291  502  506  292   71
 425  211  836  837  838 1214 1392 1029 1559 2020 2157 2287 2159 2626 1734 2156 2166 2521 2627 2526 2629 2528 2529 2418 2530 2531 2532 2533 2534 2535 2639 2426 2537 2540 2429 2539 2542 2646 2545 2433 2546 2549 2548 2322 2195 2196 1921 1922 1773 1616  907  711  710  709  293  505   72
 426  637  427  834 1389 1033 1561 1213 1722 1720 2408 2155 2285 2406 2623 2518 2622 2519 2628 2723 2527 2631 2812 2632 2633 2634 2635 2636 2732 2637 2734 2640 2642 2538 2643 2541 2644 2645 2647 2648 2544 2650 2321 2197 2064 2063 1923 1774 1617 1452 1279 1099  908  712  507  294   73
 207  209  636  634 1027 1215 1719 1723 1560 2018 1871 1721 2284 2286 2405 2625 2520 2721 2810 2724 2725 2630 2813 2726 2727 2729 2731 2818 2638 2733 2735 2736 2641 2737 2824 2738 2739 2828 2741 2649 2742 2439 2438 2440 2323 2065 1924 1775 1618 1453 1280  910  909  713  508  295   74
 424  635  835 1030  632 1028 1031 1026 1387 1557 2016 2017 2283 2019 2516 2517 2720 2719 2808 2722 2961 2892 2815 2728 2816 2895 2730 2819 2898 2820 2899 2822 2825 2904 2826 2740 2827 2907 2829 2744 2550 2743 2441 2324 2198 2066 1925 1776 1619 1454 1281 1100  911  714  509  296   75
 205  206  633  833  421 1024 1212 1872 1718 1873 2153 2154 2282 2404 2403 2718 2716 2807 2889 2811 2962 2963 2964 2893 2814 2894 2896 2817 2897 2900 2821 2901 2823 2903 2975 2905 2908 2830 2745 2652 2651 2551 2442 2325 2199 2067 1926 1777 1620 1455 1282 1101  912  715  510  297   76
 204  631  423 1023 1210 1025 1558 1555 1556 1717 2014 1869 2280 2402 2515 2619 2717 2806 2809 2888 2890 2891 3026 2965 3028 2966 3030 2968 2969 2970 2971 2972 2902 2973 3038 2976 2906 2977 2831 2746 2653 2552 2443 2326 2200 2068 1778 1779 1621 1456 1283 1102  913  716  511  298   77
 202  203  630 1211  831 1386 1388 1554 1716 1870 2151 2281 2015 2401 2514 2621 2715 2805 2886 2887 2960 2959 3025 3027 3083 2967 3029 3031 3032 3033 3034 3035 3036 2974 3037 3039 2978 2909 2832 2747 2654 2553 2444 2327 2201 2070 1928 1927 1622 1457 1284 1103  914  717  512  299   78
 201  419  832  422 1022 1209 1385 1715 1714 1868 2152 2150 2279 2399 2513 2620 2618 2714 2958 3023 3024 3080 3082 3129 3130 3084 3085 3086 3087 3088 3089 3090 3091 3092 3093 3040 2979 2910 2748 2656 2749 2554 2445 2203 2069 2202 1929 1780 1623 1458 1285 1104  915  718  513  300   79
 629  420  418  829 1207 1384 1208 1553 1867 2012 2013 2149 2278 2512 2400 2617 2803 2804 2885 2884 2957 3022 3079 3081 3169 3131 3132 3133 3134 3135 3136 3137 3138 3139 3094 3041 2911 2912 2833 2750 2655 2555 2446 2328 2329 2204 1930 1781 1624 1459 1286 1105  916  719  514  301   80
 200  627  628  830 1021 1206 1383 1552 1713 1866 2011 2148 2277 2398 2511 2616 2713 2802 2883 2956 3021 3078 3128 3126 3167 3170 3171 3172 3173 3174 3175 3176 3177 3140 3043 2981 2980 2835 2834 2751 2657 2556 2447 2330 2205 2071 1931 1782 1625 1460 1287 1106  917  720  515  302   81
 199  417  626  828 1020 1205 1382 1551 1712 1865 2010 2147 2276 2397 2510 2615 2712 2801 2882 2955 3020 3077 3200 3127 3168 3201 3202 3203 3204 3205 3206 3207 3178 3141 3096 3095 2982 2913 2837 2836 2658 2557 2332 2448 2206 2072 1932 1783 1626 1461 1288 1107  918  721  516  303   82
 416  625  624  827 1019 1204 1381 1550 1711 1864 2009 2146 2275 2396 2509 2614 2711 2800 2881 2954 3019 3076 3125 3166 3199 3224 3225 3226 3227 3228 3229 3208 3142 3097 3044 3042 3046 2914 2752 2659 2660 2558 2331 2333 2207 2073 2074 1784 1627 1462 1289 1108  919  722  517  304   83
 198  414  825  826 1018 1203 1380 1549 1710 1863 2008 2145 2274 2395 2508 2613 2710 2799 2880 2953 3018 3075 3124 3165 3198 3223 3240 3241 3243 3244 3230 3209 3179 3143 3045 3098 2983 2984 2838 2753 2559 2450 2449 2208 2075 1934 1933 1785 1628 1463 1290 1109  920  723  518  305   84
 415  197  623  824 1017 1202 1379 1548 1709 1862 2007 2144 2273 2394 2507 2612 2709 2798 2879 2952 3017 3074 3123 3164 3197 3222 3239 3248 3242 3231 3232 3210 3180 3144 3099 3047 2985 2915 2839 2754 2661 2560 2451 2334 2209 2076 1935 1786 1629 1464 1291 1110  921  724  519  306   85
 196  413  622  823 1016 1201 1378 1547 1708 1861 2006 2143 2272 2393 2506 2611 2708 2797 2878 2951 3016 3073 3122 3163 3196 3221 3238 3247 3246 3245 3211 3212 3181 3145 3100 2986 2917 2916 2840 2755 2662 2561 2452 2335 2210 2077 1936 1787 1630 1465 1292 1111  922  725  520  307   86
 195  412  621  822 1015 1200 1377 1546 1707 1860 2005 2142 2271 2392 2505 2610 2707 2796 2877 2950 3015 3072 3121 3162 3195 3220 3237 3236 3235 3234 3233 3183 3182 3146 3101 3048 2987 2918 2841 2756 2663 2562 2453 2336 2211 2078 1937 1788 1631 1466 1293 1112  923  726  521  308   87
 194  411  620  821 1014 1199 1376 1545 1706 1859 2004 2141 2270 2391 2504 2609 2706 2795 2876 2949 3014 3071 3120 3161 3194 3219 3218 3217 3216 3215 3214 3213 3184 3147 3102 3049 2988 2919 2842 2757 2664 2563 2454 2337 2212 2079 1938 1789 1632 1467 1294 1113  924  727  522  309   88
 193  410  619  820 1013 1198 1375 1544 1705 1858 2003 2140 2269 2390 2503 2608 2705 2794 2875 2948 3013 3070 3119 3160 3193 3192 3191 3190 3189 3188 3187 3186 3185 3148 3103 3050 2989 2920 2843 2758 2665 2564 2455 2338 2213 2080 1939 1790 1633 1468 1295 1114  925  728  523  310   89
 192  409  618  819 1012 1197 1374 1543 1704 1857 2002 2139 2268 2389 2502 2607 2704 2793 2874 2947 3012 3069 3118 3159 3158 3157 3156 3155 3154 3153 3152 3151 3150 3149 3104 3051 2990 2921 2844 2759 2666 2565 2456 2339 2214 2081 1940 1791 1634 1469 1296 1115  926  729  524  311   90
 191  408  617  818 1011 1196 1373 1542 1703 1856 2001 2138 2267 2388 2501 2606 2703 2792 2873 2946 3011 3068 3117 3116 3115 3114 3113 3112 3111 3110 3109 3108 3107 3106 3105 3052 2991 2922 2845 2760 2667 2566 2457 2340 2215 2082 1941 1792 1635 1470 1297 1116  927  730  525  312   91
 190  407  616  817 1010 1195 1372 1541 1702 1855 2000 2137 2266 2387 2500 2605 2702 2791 2872 2945 3010 3067 3066 3065 3064 3063 3062 3061 3060 3059 3058 3057 3056 3055 3054 3053 2992 2923 2846 2761 2668 2567 2458 2341 2216 2083 1942 1793 1636 1471 1298 1117  928  731  526  313   92
 189  406  615  816 1009 1194 1371 1540 1701 1854 1999 2136 2265 2386 2499 2604 2701 2790 2871 2944 3009 3008 3007 3006 3005 3004 3003 3002 3001 3000 2999 2998 2997 2996 2995 2994 2993 2924 2847 2762 2669 2568 2459 2342 2217 2084 1943 1794 1637 1472 1299 1118  929  732  527  314   93
 188  405  614  815 1008 1193 1370 1539 1700 1853 1998 2135 2264 2385 2498 2603 2700 2789 2870 2943 2942 2941 2940 2939 2938 2937 2936 2935 2934 2933 2932 2931 2930 2929 2928 2927 2926 2925 2848 2763 2670 2569 2460 2343 2218 2085 1944 1795 1638 1473 1300 1119  930  733  528  315   94
 187  404  613  814 1007 1192 1369 1538 1699 1852 1997 2134 2263 2384 2497 2602 2699 2788 2869 2868 2867 2866 2865 2864 2863 2862 2861 2860 2859 2858 2857 2856 2855 2854 2853 2852 2851 2850 2849 2764 2671 2570 2461 2344 2219 2086 1945 1796 1639 1474 1301 1120  931  734  529  316   95
 186  403  612  813 1006 1191 1368 1537 1698 1851 1996 2133 2262 2383 2496 2601 2698 2787 2786 2785 2784 2783 2782 2781 2780 2779 2778 2777 2776 2775 2774 2773 2772 2771 2770 2769 2768 2767 2766 2765 2672 2571 2462 2345 2220 2087 1946 1797 1640 1475 1302 1121  932  735  530  317   96
 185  402  611  812 1005 1190 1367 1536 1697 1850 1995 2132 2261 2382 2495 2600 2697 2696 2695 2694 2693 2692 2691 2690 2689 2688 2687 2686 2685 2684 2683 2682 2681 2680 2679 2678 2677 2676 2675 2674 2673 2572 2463 2346 2221 2088 1947 1798 1641 1476 1303 1122  933  736  531  318   97
 184  401  610  811 1004 1189 1366 1535 1696 1849 1994 2131 2260 2381 2494 2599 2598 2597 2596 2595 2594 2593 2592 2591 2590 2589 2588 2587 2586 2585 2584 2583 2582 2581 2580 2579 2578 2577 2576 2575 2574 2573 2464 2347 2222 2089 1948 1799 1642 1477 1304 1123  934  737  532  319   98
 183  400  609  810 1003 1188 1365 1534 1695 1848 1993 2130 2259 2380 2493 2492 2491 2490 2489 2488 2487 2486 2485 2484 2483 2482 2481 2480 2479 2478 2477 2476 2475 2474 2473 2472 2471 2470 2469 2468 2467 2466 2465 2348 2223 2090 1949 1800 1643 1478 1305 1124  935  738  533  320   99
 182  399  608  809 1002 1187 1364 1533 1694 1847 1992 2129 2258 2379 2378 2377 2376 2375 2374 2373 2372 2371 2370 2369 2368 2367 2366 2365 2364 2363 2362 2361 2360 2359 2358 2357 2356 2355 2354 2353 2352 2351 2350 2349 2224 2091 1950 1801 1644 1479 1306 1125  936  739  534  321  100
 181  398  607  808 1001 1186 1363 1532 1693 1846 1991 2128 2257 2256 2255 2254 2253 2252 2251 2250 2249 2248 2247 2246 2245 2244 2243 2242 2241 2240 2239 2238 2237 2236 2235 2234 2233 2232 2231 2230 2229 2228 2227 2226 2225 2092 1951 1802 1645 1480 1307 1126  937  740  535  322  101
 180  397  606  807 1000 1185 1362 1531 1692 1845 1990 2127 2126 2125 2124 2123 2122 2121 2120 2119 2118 2117 2116 2115 2114 2113 2112 2111 2110 2109 2108 2107 2106 2105 2104 2103 2102 2101 2100 2099 2098 2097 2096 2095 2094 2093 1952 1803 1646 1481 1308 1127  938  741  536  323  102
 179  396  605  806  999 1184 1361 1530 1691 1844 1989 1988 1987 1986 1985 1984 1983 1982 1981 1980 1979 1978 1977 1976 1975 1974 1973 1972 1971 1970 1969 1968 1967 1966 1965 1964 1963 1962 1961 1960 1959 1958 1957 1956 1955 1954 1953 1804 1647 1482 1309 1128  939  742  537  324  103
 178  395  604  805  998 1183 1360 1529 1690 1843 1842 1841 1840 1839 1838 1837 1836 1835 1834 1833 1832 1831 1830 1829 1828 1827 1826 1825 1824 1823 1822 1821 1820 1819 1818 1817 1816 1815 1814 1813 1812 1811 1810 1809 1808 1807 1806 1805 1648 1483 1310 1129  940  743  538  325  104
 177  394  603  804  997 1182 1359 1528 1689 1688 1687 1686 1685 1684 1683 1682 1681 1680 1679 1678 1677 1676 1675 1674 1673 1672 1671 1670 1669 1668 1667 1666 1665 1664 1663 1662 1661 1660 1659 1658 1657 1656 1655 1654 1653 1652 1651 1650 1649 1484 1311 1130  941  744  539  326  105
 176  393  602  803  996 1181 1358 1527 1526 1525 1524 1523 1522 1521 1520 1519 1518 1517 1516 1515 1514 1513 1512 1511 1510 1509 1508 1507 1506 1505 1504 1503 1502 1501 1500 1499 1498 1497 1496 1495 1494 1493 1492 1491 1490 1489 1488 1487 1486 1485 1312 1131  942  745  540  327  106
 175  392  601  802  995 1180 1357 1356 1355 1354 1353 1352 1351 1350 1349 1348 1347 1346 1345 1344 1343 1342 1341 1340 1339 1338 1337 1336 1335 1334 1333 1332 1331 1330 1329 1328 1327 1326 1325 1324 1323 1322 1321 1320 1319 1318 1317 1316 1315 1314 1313 1132  943  746  541  328  107
 174  391  600  801  994 1179 1178 1177 1176 1175 1174 1173 1172 1171 1170 1169 1168 1167 1166 1165 1164 1163 1162 1161 1160 1159 1158 1157 1156 1155 1154 1153 1152 1151 1150 1149 1148 1147 1146 1145 1144 1143 1142 1141 1140 1139 1138 1137 1136 1135 1134 1133  944  747  542  329  108
 173  390  599  800  993  992  991  990  989  988  987  986  985  984  983  982  981  980  979  978  977  976  975  974  973  972  971  970  969  968  967  966  965  964  963  962  961  960  959  958  957  956  955  954  953  952  951  950  949  948  947  946  945  748  543  330  109
 172  389  598  799  798  797  796  795  794  793  792  791  790  789  788  787  786  785  784  783  782  781  780  779  778  777  776  775  774  773  772  771  770  769  768  767  766  765  764  763  762  761  760  759  758  757  756  755  754  753  752  751  750  749  544  331  110
 171  388  597  596  595  594  593  592  591  590  589  588  587  586  585  584  583  582  581  580  579  578  577  576  575  574  573  572  571  570  569  568  567  566  565  564  563  562  561  560  559  558  557  556  555  554  553  552  551  550  549  548  547  546  545  332  111
 170  387  386  385  384  383  382  381  380  379  378  377  376  375  374  373  372  371  370  369  368  367  366  365  364  363  362  361  360  359  358  357  356  355  354  353  352  351  350  349  348  347  346  345  344  343  342  341  340  339  338  337  336  335  334  333  112
 169  168  167  166  165  164  163  162  161  160  159  158  157  156  155  154  153  152  151  150  149  148  147  146  145  144  143  142  141  140  139  138  137  136  135  134  133  132  131  130  129  128  127  126  125  124  123  122  121  120  119  118  117  116  115  114  113
