# This puzzle is unsolvable
70
 277    2    1    3  546    5    6    8    9   10   11   13  288   14   15  290   17   18   19   20   21   22   23   24   25   26   27   28   29   30   31   32   33   34   35   36   37   38   39   40   41   42   43   44   45   46   47   48   49   50   51   52   53   54   55   56   57   58   59   60   61   62   63   64   65   66   67   68   69   70
 276  279  278    4  281  549    7  282  285  286  553  287   12  289  291   16  292  293  294  295  296  297  298  299  300  301  302  303  304  305  306  307  308  309  310  311  312  313  314  315  316  317  318  319  320  321  322  323  324  325  326  327  328  329  330  331  332  333  334  335  336  337  338  339  340  341  342  343  344   71
 544  545 1055  548  280  283  551  810  284  552  813  554  814  556  557  558  559  560  561  562  563  564  565  566  567  568  569  570  571  572  573  574  575  576  577  578  579  580  581  582  583  584  585  586  587  588  589  590  591  592  593  594  595  596  597  598  599  600  601  602  603  604  605  606  607  608  609  610  345   72
 801  804  543  806 1058 1056  808 1060  809  811  555 1308  815  816 1067  817  818  819  820  821  822  823  824  825  826  827  828  829  830  831  832  833  834  835  836  837  838  839  840  841  842  843  844  845  846  847  848  849  850  851  852  853  854  855  856  857  858  859  860  861  862  863  864  865  866  867  868  611  346   73
 803 1054  805  547  807  550 1059 1538 1061 1063  812 1065 1064 1066 1068 1069 1312 1070 1071 1072 1073 1074 1075 1076 1077 1078 1079 1080 1081 1082 1083 1084 1085 1086 1087 1088 1089 1090 1091 1092 1093 1094 1095 1096 1097 1098 1099 1100 1101 1102 1103 1104 1105 1106 1107 1108 1109 1110 1111 1112 1113 1114 1115 1116 1117 1118  869  612  347   74
 275  542  270  540 1301 1300 1303 1539 1304 1062 1305 1307 1543 1309 1310 1311 1547 1313 1314 1315 1316 1317 1318 1319 1320 1321 1322 1323 1324 1325 1326 1327 1328 1329 1330 1331 1332 1333 1334 1335 1336 1337 1338 1339 1340 1341 1342 1343 1344 1345 1346 1347 1348 1349 1350 1351 1352 1353 1354 1355 1356 1357 1358 1359 1360 1119  870  613  348   75
 274  541  802 1057 1537 1535 1302 1765 1984 1766 1306 1541 1542 1544 1772 1545 1546 1548 1549 1550 1551 1552 1553 1554 1555 1556 1557 1558 1559 1560 1561 1562 1563 1564 1565 1566 1567 1568 1569 1570 1571 1572 1573 1574 1575 1576 1577 1578 1579 1580 1581 1582 1583 1584 1585 1586 1587 1588 1589 1590 1591 1592 1593 1594 1361 1120  871  614  349   76
 800  273 1297 1299 1536 1053 1764 1985 1986 1540 1767 1988 1768 1769 1771 1773 1774 1775 1776 1777 1778 1779 1780 1781 1782 1783 1784 1785 1786 1787 1788 1789 1790 1791 1792 1793 1794 1795 1796 1797 1798 1799 1800 1801 1802 1803 1804 1805 1806 1807 1808 1809 1810 1811 1812 1813 1814 1815 1816 1817 1818 1819 1820 1595 1362 1121  872  615  350   77
 272  538  539 1052  799 1532 1534 1983 2197 2400 1987 2199 1770 1989 1991 1992 1993 1994 1995 1996 1997 1998 1999 2000 2001 2002 2003 2004 2005 2006 2007 2008 2009 2010 2011 2012 2013 2014 2015 2016 2017 2018 2019 2020 2021 2022 2023 2024 2025 2026 2027 2028 2029 2030 2031 2032 2033 2034 2035 2036 2037 2038 1821 1596 1363 1122  873  616  351   78
 269  271  797  537 1533 1298 1763 1982 1762 2196 2401 2198 2403 1990 2202 2203 2204 2205 2206 2207 2208 2209 2210 2211 2212 2213 2214 2215 2216 2217 2218 2219 2220 2221 2222 2223 2224 2225 2226 2227 2228 2229 2230 2231 2232 2233 2234 2235 2236 2237 2238 2239 2240 2241 2242 2243 2244 2245 2246 2247 2248 2039 1822 1597 1364 1123  874  617  352   79
 267  268 1050  536  798 1051 1295 1761 2195 2399 2402 2201 2598 2597 2404 2406 2407 2408 2409 2410 2411 2412 2413 2414 2415 2416 2417 2418 2419 2420 2421 2422 2423 2424 2425 2426 2427 2428 2429 2430 2431 2432 2433 2434 2435 2436 2437 2438 2439 2440 2441 2442 2443 2444 2445 2446 2447 2448 2449 2450 2249 2040 1823 1598 1365 1124  875  618  353   80
 266  264  535 1049 1530 1296 1760 1981 2194 2398 2596 2600 2785 2200 2599 2601 2602 2603 2604 2605 2606 2607 2608 2609 2610 2611 2612 2613 2614 2615 2616 2617 2618 2619 2620 2621 2622 2623 2624 2625 2626 2627 2628 2629 2630 2631 2632 2633 2634 2635 2636 2637 2638 2639 2640 2641 2642 2643 2644 2451 2250 2041 1824 1599 1366 1125  876  619  354   81
 794  793  533 1048 1294 1531 1759 1757 1980 2193 2594 2595 2786 2965 2405 2788 2789 2790 2791 2792 2793 2794 2795 2796 2797 2798 2799 2800 2801 2802 2803 2804 2805 2806 2807 2808 2809 2810 2811 2812 2813 2814 2815 2816 2817 2818 2819 2820 2821 2822 2823 2824 2825 2826 2827 2828 2829 2830 2645 2452 2251 2042 1825 1600 1367 1126  877  620  355   82
 265  795 1046  796 1047 1291 1758 1978 2192 2397 2783 2964 2963 2784 2787 2967 2968 2969 2970 2971 2972 2973 2974 2975 2976 2977 2978 2979 2980 2981 2982 2983 2984 2985 2986 2987 2988 2989 2990 2991 2992 2993 2994 2995 2996 2997 2998 2999 3000 3001 3002 3003 3004 3005 3006 3007 3008 2831 2646 2453 2252 2043 1826 1601 1368 1127  878  621  356   83
1529  263  532  792 1293 1292 1979 1977 2191 2396 2593 2782 3136 3137 2966 3301 3139 3141 3142 3305 3144 3307 3145 3146 3147 3148 3149 3150 3151 3152 3153 3154 3155 3156 3157 3158 3159 3160 3161 3162 3163 3164 3165 3166 3167 3168 3169 3170 3171 3172 3173 3174 3175 3176 3177 3178 3009 2832 2647 2454 2253 2044 1827 1602 1369 1128  879  622  357   84
 262  531  791  790  534 1290 1525 1755 2190 2395 2592 2781 2962 3135 3138 3302 3303 3140 3459 3304 3306 3143 3308 3309 3310 3311 3312 3313 3314 3315 3316 3317 3318 3319 3320 3321 3322 3323 3324 3325 3326 3327 3328 3329 3330 3331 3332 3333 3334 3335 3336 3337 3338 3339 3340 3179 3010 2833 2648 2455 2254 2045 1828 1603 1370 1129  880  623  358   85
 789  260 1287 1527  530 1756 1976 1528 2189 2394 2591 2780 2961 3134 3300 3299 3457 3605 3458 3460 3461 3462 3463 3464 3465 3466 3467 3468 3469 3470 3471 3472 3473 3474 3475 3476 3477 3478 3479 3480 3481 3482 3483 3484 3485 3486 3487 3488 3489 3490 3491 3492 3493 3494 3341 3180 3011 2834 2649 2456 2255 2046 1829 1604 1371 1130  881  624  359   86
 529  528  261 1045 1526 1043 1289 1975 2393 2392 2590 2779 2960 3133 3298 3456 3455 3744 3606 3607 3608 3609 3610 3611 3612 3613 3614 3615 3616 3617 3618 3619 3620 3621 3622 3623 3624 3625 3626 3627 3628 3629 3630 3631 3632 3633 3634 3635 3636 3637 3638 3639 3640 3495 3342 3181 3012 2835 2650 2457 2256 2047 1830 1605 1372 1131  882  625  360   87
 525 1041  258 1750 1524 2183 1044 1972 2188 2589 2778 2959 2958 3132 3297 3454 3604 3603 3743 3746 3747 3748 3749 3750 3751 3752 3753 3754 3755 3756 3757 3759 3890 3760 3761 3762 3763 3764 3765 3766 3767 3768 3769 3770 3771 3772 3773 3774 3775 3776 3777 3778 3641 3496 3182 3344 3013 2836 2651 2458 2257 2048 1831 1606 1373 1132  883  626  361   88
 259  785 1042  788 1752 1285 1522 2187 1973 2773 2390 3131 2588 3130 3296 3453 3602 3876 3745 3877 4001 3878 3880 3881 3882 3884 4124 3885 3886 3887 3889 4012 3758 3892 4015 3893 3894 3895 3896 3897 3898 3899 3900 3901 3902 3903 3904 3905 3906 3907 3908 3779 3642 3497 3343 3014 3015 2837 2652 2459 2258 2049 1832 1607 1374 1133  884  627  362   89
 257 1040  255  527 1288 1521 1754 2186 1751 1753 2587 2777 2956 2957 3295 3452 3601 3742 3875 4000 4116 3879 4003 4004 3883 4006 4121 4007 4009 4126 4010 3888 3891 4013 4014 4016 4017 4018 4019 4020 4021 4022 4023 4024 4025 4026 4027 4028 4029 4030 3909 3780 3643 3498 3184 3186 3183 2838 2653 2460 2259 2050 1833 1608 1375 1134  885  628  363   90
 786  523  521 1039 1519 1971 2184 2389 1974 2586 2775 2776 2955 3129 3294 3451 3600 3741 3874 3999 4002 4117 4118 4119 4005 4123 4122 4231 4331 4125 4233 4127 4128 4129 4130 4131 4132 4133 4134 4135 4136 4137 4138 4139 4140 4141 4142 4143 4144 4031 3910 3781 3644 3500 3345 3185 2840 3016 2654 2461 2260 2051 1834 1609 1376 1135  886  629  364   91
 256  784 1523  787 1280 1284 2584 2181 2185 2772 2391 2774 2954 3128 3293 3450 3599 3740 3873 3998 4115 4224 4225 4226 4120 4227 4328 4008 4422 4235 4011 4334 4423 4426 4237 4238 4239 4240 4241 4242 4243 4244 4245 4246 4247 4248 4249 4250 4145 4032 3911 3782 3645 3346 3499 2841 3017 2839 2655 2462 2261 2052 1835 1610 1377 1136  887  630  365   92
1038  526 1037 1282 1283 1034 1970 1749 2388 2387 2582 2585 2953 3127 3292 3449 3598 3739 3872 3996 3997 4223 4324 4325 4326 4229 4329 4504 4230 4330 4424 4236 4234 4427 4336 4337 4338 4339 4340 4341 4342 4343 4435 4344 4346 4347 4348 4251 4146 4033 3912 3783 3646 3501 3347 3187 3020 3018 2657 2463 2262 2053 1836 1611 1378 1137  888  631  366   93
 254  524 1281 1518 1286 1036 1969 1967 1748 1520 2386 2583 3126 3291 3447 3448 3597 3738 3871 4114 4113 4323 4416 4417 4418 4228 4419 4421 4232 4579 4332 4582 4335 4333 4510 4428 4429 4430 4432 4515 4433 4517 4434 4345 4437 4438 4349 4252 4147 4034 3913 3784 3647 3502 3348 3019 3188 2656 2264 2658 2263 2054 1837 1612 1379 1138  889  632  367   94
 522  783  782 1744 1747 1035  779 1966 2180 2182 2770 2771 3125 3123 3290 3596 3737 3870 3995 3993 4111 4222 4322 4415 4500 4327 4501 4420 4578 4506 4507 4425 4508 4509 4653 4585 4511 4513 4431 4516 4590 4718 4518 4436 4520 4439 4350 4253 4148 4035 3914 3785 3648 3503 3349 3190 2465 3022 2843 2464 2265 2055 1838 1613 1380 1139  890  633  368   95
 253  251  781  252  520 1515 1517 1746 1968 2385 2179 2951 2952 3124 3446 3445 3595 3869 4221 4320 4219 4112 4220 4414 4499 4576 4503 4577 4646 4580 4707 4505 4583 4584 4651 4652 4512 4588 4514 4717 4589 4592 4593 4519 4521 4440 4351 4254 4150 3786 3649 3787 3504 3351 3506 2842 3353 2844 2845 2659 2466 2056 1839 1614 1381 1140  891  634  369   96
 250 1277  519  778 1276 1516 1514 2177 2178 2581 2384 2769 2948 2950 3289 3287 3594 3994 3736 3735 4110 4218 4321 4413 4498 4575 4644 4502 4645 4581 4647 4708 4648 4761 4711 4712 4763 4586 4656 4659 4768 4594 4596 4661 4522 4441 4352 4255 4036 3915 3651 3788 3650 3189 3191 3350 3194 3021 2661 2467 2266 2057 1840 1615 1382 1141  892  635  370   97
 248  515  518  780 1278 1745 1964 1743 1965 2383 2382 2580 2766 2768 3288 3443 3442 3593 3868 3867 3866 3991 4217 4411 4412 4497 4704 4574 4755 4757 4709 4710 4649 4650 4805 4587 4654 4806 4655 4770 4662 4660 4595 4591 4443 4523 4442 4151 4038 4149 3916 3917 3652 3505 3352 3192 3025 2660 2846 2468 2267 2058 1841 1616 1383 1142  893  636  371   98
 247  249 1033  776 1032 1741 1742 1963 2175 2381 2579 2767 3286 2949 3122 3285 3734 3592 3732 3990 4106 4319 4318 4410 4496 4572 4573 4702 4703 4705 4759 4760 4802 4801 4804 4762 4765 4764 4657 4715 4658 4767 4663 4719 4524 4257 4353 4444 4256 4037 3918 4039 3789 3354 3355 3023 3024 2664 2470 2847 2469 2268 1842 1617 1384 1143  894  637  372   99
 246  516 1275  777 1279 1740 1739 2176 1962 2380 2578 2577 2947 3121 3120 3591 3444 3733 3989 3992 4108 4109 4216 4317 4494 4495 4641 4756 4643 4706 4798 4885 4803 4837 4807 4713 4808 4714 4722 4811 4716 4810 4720 4597 4525 4354 4259 4355 4152 4153 4041 3791 3653 3790 3026 3196 2849 3193 2663 2662 2061 2059 1843 1618 1385 1144  895  638  373  100
 245 1031 1030 1512 1513 1274 1511 1961 2174 2379 2575 2765 2946 3119 3284 3441 3590 3865 3731 4105 4215 4107 4316 4409 4493 4639 4571 4752 4799 4836 4835 4758 4838 4886 4841 4868 4842 4809 4766 4721 4769 4664 4598 4665 4526 4356 4357 4155 4260 4154 3919 4040 3655 3654 3507 3027 2850 2848 2269 2270 2271 2060 1844 1619 1386 1145  896  639  374  101
 514  513  775  517 1028 1272 1029 1960 2173 2377 2378 2576 2945 3283 3282 3440 3589 3730 3863 3864 3988 4214 4314 4315 4640 4642 4754 4753 4864 4699 4863 4865 4840 4887 4867 4869 4888 4843 4845 4813 4812 4771 4723 4599 4528 4527 4445 4261 4258 3920 3921 4042 3511 3510 3508 3195 3356 2474 3028 2471 2062 2063 2272 1620 1387 1146  897  640  375  102
 244  774 1027 1273 1508 1510 1738 1959 2171 2172 2574 2764 2942 2944 3118 3439 3588 3729 3862 3987 4104 4213 4405 4491 4492 4570 4637 4697 4797 4751 4862 4834 4866 4884 4839 4898 4844 4847    0 4846 4772 4724 4666 4600 4601 4446 4359 4358 4156 4044 3793 3922 3792 3509 3794 3357 2852 3198 2667 2476 2666 1846 1845 1621 1388 1147  898  641  376  103
 243  512 1026 1509 1270 1737 1958 2376 2573 2762 2943 2763 2761 3117 3116 3438 3587 3728 3861 3986 4103 4212 4407 4408 4406 4568 4636 4638 4833 4700 4800 4861 4883 4896 4889 4872 4873 4870 4871 4814 4773 4667 4669 4604 4668 4602 4361 4262 4157 3923 4043 3360 3656 3358 3197 2855 2472 2668 2473 2854 2273 2064 1847 1622 1389 1148  899  642  377  104
 242  511  773  772 1271 1507 1736 1957 2170 2375 2572 2760 2940 3115 3281 3437 3586 3727 3860 3985 4101 4102 4313 4404 4311 4635 4696 4750 4701 4795 4749 4882 4895 4856 4897 4899 4890 4848 4849 4815 4725 4603 4605 4531 4529 4448 4447 4263 4158 4045 3924 3657 3795 3359 3514 3200 2671 2851 2856 2665 2475 2274 2065 1623 1390 1149  900  643  378  105
 241  510  771 1025 1269 1734 1505 1506 2169 2373 2374 2759 2941 3114 3280 3436 3585 3858 3725 3859 3984 4211 4310 4312 4489 4567 4565 4569 4695 4748 4694 4860 4879 4881 4892 4878 4876 4874 4816 4775 4774 4727 4671 4530 4360 4450 4449 4264 4159 4046 3796 3798 3658 3517 3659 3512 3199 3029 2853 1849 2066 2067 1848 1624 1391 1150  901  644  379  106
 240  509  770 1024 1023 1268 1955 1735 2167 2168 2570 3113 2939 3278 3279 3435 3584 3726 3857 3983 4100 4210 4403 4487 4308 4490 4488 4566 4796 4698 4792 4831 4830 4893 4823 4894 4877 4891 4850 4817 4726 4776 4672 4670 4451 4452 4362 4162 4161 4047 3925 3797 3660 3362 3513 3031 3201 2479 3203 2669 2276 2275 1850 1625 1392 1151  902  645  380  107
 239  508  769 1022 1267 1504 1956 1733 2372 2569 2571 2758 2938 3277 3434 3433 3583 3724 3856 4099 4097 4209 4098 4486 4634 4632 4747 4633 4829 4794 4832 4793 4857 4880 4855 4854 4852 4875 4818 4819 4777 4728 4607 4606 4532 4265 4160 4266 4048 3926 3800 3927 3661 3363 3034 3032 3030 2673 2672 2278 2857 2068 1851 1626 1393 1152  903  646  381  108
 238  507  768 1021 1266 1503 1732 2166 1954 2371 2568 2757 3111 3112 3276 3432 3582 3723 3981 3982 4096 4208 4207 4309 4401 4564 4631 4693 4691 4791 4828 4859 4858 4826 4825 4824 4853 4851 4820 4778 4732 4779 4534 4533 4453 4363 4364 4267 4049 3799 3516 3361 3519 3366 3035 2858 2674 2670 2478 3033 2277 2069 1852 1627 1394 1153  904  647  382  109
 237  767  505 1265 1264 1502 1952 1953 2165 2370 2567 2756 2937 3110 3275 3431 3581 3722 3980 4095 4094 4206 4307 4399 4402 4563 4692 4690 4746 4790 4789 4787 4827 4786 4681 4784 4783 4822 4821 4734 4730 4608 4729 4535 4454 4536 4269 3929 4164 4050 3928 3930 3663 3515 3518 3202 3364 3205 2477 2480 2279 2070 1853 1628 1395 1154  905  648  383  110
 236  504  506 1019 1263 1730 1731 1951 2164 2369 2566 2755 2936 3109 3274 3580 3579 3721 3855 4204 4398 3979 4205 4306 4400 4485 4630 4744 4745 4743 4742 4788 4741 4740 4785 4737 4738 4782 4780 4781 4733 4676 4673 4609 4537 4455 4366 4365 4163 4051 4268 3801 3365 3662 3367 3204 2859 3036 2675 2481 2280 2071 1854 1629 1396 1155  906  649  384  111
 234 1017  235 1020 1500 1501 1729 1950 2163 2368 2565 2754 2935 3108 3273 3430 3720 3978 3854 4203 4092 4305 4483 4484 4562 4560 4561 4627 4689 4688 4687 4686 4685 4739 4684 4683 4618 4736 4679 4682 4677 4674 4731 4675 4610 4368 4270 4167 4367 4052 3802 3931 3665 3664 3520 3207 3206 3037 2861 2482 2281 2072 1855 1630 1397 1156  907  650  385  112
 503  766 1018 1016  765 1499 1728 1949 2162 2367 2564 2753 2934 3107 3272 3429 3578 3853 3719 3975 3977 4202 4303 4304 4397 4559 4629 4556 4626 4625 4624 4623 4622 4621 4620 4619 4680 4546 4617 4678 4614 4613 4612 4538 4369 4457 4456 4169 4053 4272 3932 3803 3667 3666 3368 3038 2860 2862 2676 2483 2282 2073 1856 1631 1398 1157  908  651  386  113
 233  502  764 1261 1262 1498 1727 1948 2161 2366 2563 2752 2933 3106 3271 3428 3577 3718 3852 3976 4093 4302 4396 4479 4480 4481 4628 4558 4555 4554 4553 4552 4551 4471 4550 4548 4547 4465 4735 4615 4544 4543 4541 4540 4458 4460 4271 4459 4166 4165 3933 3804 3934 3521 3369 3208 3039 2677 2678 2484 2283 2074 1857 1632 1399 1158  909  652  387  114
 232  501  763 1015 1260 1497 1726 1947 2160 2365 2562 2751 2932 3105 3270 3427 3576 3717 3851 4091 3849 4201 4301 4482 4394 4478 4557 4477 4475 4474 4292 4473 4472 4383 4470 4468 4469 4467 4616 4545 4463 4542 4375 4539 4374 4462 4371 4274 4370 4168 4055 3935 3805 3522 3523 3370 3209 3040 2863 2485 2284 2075 1858 1633 1400 1159  910  653  388  115
 231  500  762 1014 1259 1496 1725 1946 2159 2364 2561 2750 2931 3104 3269 3426 3574 3973 3850 3848 4090 4200 4395 4393 4392 4298 4391 4390 4476 4388 4386 4387 4385 4289 4286 4549 4381 4380 4466 4379 4378 4464 4280 4611 4461 4372 4373 4273 4170 4056 4054 3806 3524 3668 3371 3210 3041 2864 2679 2486 2285 2076 1859 1634 1401 1160  911  654  389  116
 230  499  761 1013 1258 1495 1724 1945 2158 2363 2560 2749 2930 3103 3268 3425 3716 3575 3847 3972 3974 4087 4300 4196 4197 4296 4193 4294 3960 4389 4293 4290 4075 4288 4184 4382 4285 4284 4283 4282 4281 4377 4376 4279 4278 4277 4276 4275 4057 4058 3936 3807 3669 3525 3372 3211 3042 2865 2680 2487 2286 2077 1860 1635 1402 1161  912  655  390  117
 229  498  760  759 1257 1494 1723 1944 2157 2362 2559 2748 2929 3102 3267 3424 3573 3715 3714 4199 4089 4299 4198 4086 4194 4083 4192 4079 4295 4190 4189 4077 4187 4384 4287 4073 4183 4182 4181 4180 4179 4178 4177 4176 4175 4174 4173 4172 4171 3937 3938 3671 3670 3526 3373 3212 3043 2866 2681 2488 2287 2078 1861 1636 1403 1162  913  656  391  118
 228  226 1011 1012 1256 1493 1722 1943 2156 2361 2558 2747 2928 3101 3266 3423 3572 3970 3846 3971 3969 4088 4085 4084 4082 4081 4297 3836 4191 4080 4078 4291 4188 4074 4186 4072 4185 4071 4070 4069 4068 4067 4066 4065 4064 4063 4062 4061 4060 4059 3809 3808 3672 3527 3374 3213 3044 2867 2682 2489 2288 2079 1862 1637 1404 1163  914  657  392  119
 496  758  497 1010 1255 1492 1721 1942 2155 2360 2557 2746 2927 3100 3265 3422 3571 3713 3712 3844 3842 3968 3967 3966 4195 3965 3963 3406 3962 3959 3832 3958 4076 3957 3955 3954 3953 3952 3951 3950 3949 3948 3947 3946 3945 3944 3943 3942 3941 3940 3939 3810 3673 3528 3375 3214 3045 2868 2683 2490 2289 2080 1863 1638 1405 1164  915  658  393  120
 227  495  757 1254 1489 1491 1720 1941 2154 2359 2556 2926 2744 3099 3264 3421 3569 3570 3711 3843 3841 3706 3840 3839 3838 3835 3701 3699 3833 3961 3831 3830 3553 3956 3828 3827 3826 3825 3824 3823 3822 3821 3820 3819 3818 3817 3816 3815 3814 3813 3812 3811 3674 3529 3376 3215 3046 2869 2684 2491 2290 2081 1864 1639 1406 1165  916  659  394  121
 225  494  756 1009 1253 1252 1490 1719 1940 2153 2358 2745 2925 3420 3262 3098 3567 3568 3845 3565 3708 3707 3705 3704 3837 3964 3702 3700 3834 3697 3556 3552 3829 3691 3696 3549 3548 3690 3689 3688 3687 3686 3685 3684 3683 3682 3681 3680 3679 3678 3677 3676 3675 3530 3377 3216 3047 2870 2685 2492 2291 2082 1865 1640 1407 1166  917  660  395  122
 493  754 1008  753 1488 1487 1718 1939 2152 2357 2555 2554 2743 2924 3097 3096 3419 3710 3709 3566 3564 3563 3562 3561 3560 3703 3558 3248 3557 3555 3698 3554 3694 3551 3692 3400 3397 3547 3546 3545 3544 3543 3542 3541 3540 3539 3538 3537 3536 3535 3534 3533 3532 3531 3378 3217 3048 2871 2686 2493 2292 2083 1866 1641 1408 1167  918  661  396  123
 492  224 1003  755 1007 1486 1717 1938 2151 2356 2553 2742 2923 3261 3263 3418 3417 3416 3415 3414 3413 3412 3411 3410 3409 3559 3408 3246 3247 3404 3403 3401 3402 3241 3693 3398 3238 3396 3395 3394 3393 3392 3391 3390 3389 3388 3387 3386 3385 3384 3383 3382 3381 3380 3379 3218 3049 2872 2687 2494 2293 2084 1867 1642 1409 1168  919  662  397  124
 221 1006  752 1005  223 1251 1250 1714 2150 2355 2552 2741 2922 3095 3260 3259 3258 3257 3256 3255 3254 3253 3252 3251 3250 3249 3407 3405 3245 3244 3243 3075 3695 3239 3240 3073 3071 3237 3236 3235 3234 3233 3232 3231 3230 3229 3228 3227 3226 3225 3224 3223 3222 3221 3220 3219 3050 2873 2688 2495 2294 2085 1868 1643 1410 1169  920  663  398  125
 491  490  220 1249 1937 1715 1713 1716 2148 2354 2551 2740 2921 3094 3093 3092 3091 3090 3089 3088 3087 3086 3085 3084 3083 3082 3081 3080 3079 3078 3242 3077 2717 3074 3550 3399 3072 3069 2894 3068 3067 3066 3065 3064 3063 3062 3061 3060 3059 3058 3057 3056 3055 3054 3053 3052 3051 2874 2689 2496 2295 2086 1869 1644 1411 1170  921  664  399  126
 489  751  747  488  746 2149 1934 1933 1936 2353 2550 2739 2920 2919 2918 2917 2916 2915 2914 2913 2912 2911 2910 2909 2908 2907 2906 2905 2904 2903 2902 3076 2900 2899 2898 2897 2896 3070 2711 2893 2892 2891 2890 2889 2888 2887 2886 2885 2884 2883 2882 2881 2880 2879 2878 2877 2876 2875 2690 2497 2296 2087 1870 1645 1412 1171  922  665  400  127
 222  219  218 1004  750 1248 1247 1485 2352 2351 2549 2738 2737 2736 2735 2734 2733 2732 2731 2730 2729 2728 2727 2726 2725 2724 2723 2722 2721 2720 2719 2901 2718 2716 2715 2713 2712 2714 2895 2710 2709 2708 2707 2706 2705 2704 2703 2702 2701 2700 2699 2698 2697 2696 2695 2694 2693 2692 2691 2498 2297 2088 1871 1646 1413 1172  923  666  401  128
 487  748  749 1002 1000 1246 1483 1935 1932 2147 2548 2547 2546 2545 2544 2543 2542 2541 2540 2539 2538 2537 2536 2535 2534 2533 2532 2531 2530 2529 2528 2527 2526 2525 2524 2523 2522 2521 2520 2519 2518 2517 2516 2515 2514 2513 2512 2511 2510 2509 2508 2507 2506 2505 2504 2503 2502 2501 2500 2499 2298 2089 1872 1647 1414 1173  924  667  402  129
 217  486 1482  485 1711 1712 1484 2145 2146 2350 2349 2348 2347 2346 2345 2344 2343 2342 2341 2340 2339 2338 2337 2336 2335 2334 2333 2332 2331 2330 2329 2328 2327 2326 2325 2324 2323 2322 2321 2320 2319 2318 2317 2316 2315 2314 2313 2312 2311 2310 2309 2308 2307 2306 2305 2304 2303 2302 2301 2300 2299 2090 1873 1648 1415 1174  925  668  403  130
 216  484  999 1001 1245 1481 1710 1931 2144 2143 2142 2141 2140 2139 2138 2137 2136 2135 2134 2133 2132 2131 2130 2129 2128 2127 2126 2125 2124 2123 2122 2121 2120 2119 2118 2117 2116 2115 2114 2113 2112 2111 2110 2109 2108 2107 2106 2105 2104 2103 2102 2101 2100 2099 2098 2097 2096 2095 2094 2093 2092 2091 1874 1649 1416 1175  926  669  404  131
 483  745  744  998 1244 1480 1709 1930 1929 1928 1927 1926 1925 1924 1923 1922 1921 1920 1919 1918 1917 1916 1915 1914 1913 1912 1911 1910 1909 1908 1907 1906 1905 1904 1903 1902 1901 1900 1899 1898 1897 1896 1895 1894 1893 1892 1891 1890 1889 1888 1887 1886 1885 1884 1883 1882 1881 1880 1879 1878 1877 1876 1875 1650 1417 1176  927  670  405  132
 215  214  997 1242 1243 1479 1708 1707 1706 1705 1704 1703 1702 1701 1700 1699 1698 1697 1696 1695 1694 1693 1692 1691 1690 1689 1688 1687 1686 1685 1684 1683 1682 1681 1680 1679 1678 1677 1676 1675 1674 1673 1672 1671 1670 1669 1668 1667 1666 1665 1664 1663 1662 1661 1660 1659 1658 1657 1656 1655 1654 1653 1652 1651 1418 1177  928  671  406  133
 213  482  743  996 1241 1478 1477 1476 1475 1474 1473 1472 1471 1470 1469 1468 1467 1466 1465 1464 1463 1462 1461 1460 1459 1458 1457 1456 1455 1454 1453 1452 1451 1450 1449 1448 1447 1446 1445 1444 1443 1442 1441 1440 1439 1438 1437 1436 1435 1434 1433 1432 1431 1430 1429 1428 1427 1426 1425 1424 1423 1422 1421 1420 1419 1178  929  672  407  134
 212  481  742  995 1240 1239 1238 1237 1236 1235 1234 1233 1232 1231 1230 1229 1228 1227 1226 1225 1224 1223 1222 1221 1220 1219 1218 1217 1216 1215 1214 1213 1212 1211 1210 1209 1208 1207 1206 1205 1204 1203 1202 1201 1200 1199 1198 1197 1196 1195 1194 1193 1192 1191 1190 1189 1188 1187 1186 1185 1184 1183 1182 1181 1180 1179  930  673  408  135
 211  480  741  994  993  992  991  990  989  988  987  986  985  984  983  982  981  980  979  978  977  976  975  974  973  972  971  970  969  968  967  966  965  964  963  962  961  960  959  958  957  956  955  954  953  952  951  950  949  948  947  946  945  944  943  942  941  940  939  938  937  936  935  934  933  932  931  674  409  136
 210  479  740  739  738  737  736  735  734  733  732  731  730  729  728  727  726  725  724  723  722  721  720  719  718  717  716  715  714  713  712  711  710  709  708  707  706  705  704  703  702  701  700  699  698  697  696  695  694  693  692  691  690  689  688  687  686  685  684  683  682  681  680  679  678  677  676  675  410  137
 209  478  477  476  475  474  473  472  471  470  469  468  467  466  465  464  463  462  461  460  459  458  457  456  455  454  453  452  451  450  449  448  447  446  445  444  443  442  441  440  439  438  437  436  435  434  433  432  431  430  429  428  427  426  425  424  423  422  421  420  419  418  417  416  415  414  413  412  411  138
 208  207  206  205  204  203  202  201  200  199  198  197  196  195  194  193  192  191  190  189  188  187  186  185  184  183  182  181  180  179  178  177  176  175  174  173  172  171  170  169  168  167  166  165  164  163  162  161  160  159  158  157  156  155  154  153  152  151  150  149  148  147  146  145  144  143  142  141  140  139
