# This puzzle is unsolvable
40
   1  156  446  158  160    3    5    6    9  165   10   12   14  316  171   15   17  175  321   19   21  176   23  180  327   25  186  183   26  184  187  188   34  336   35   36   37   38   39   40
 306    4    2  445  161  309  162  310  166  312  164  169   13  585  170   16  461   18  594  462  178   20   24  326  179  182   31  721   28  333   32   33  189  335  190  191  339  192   42  194
 307  157  444  447    7  159    8  449  311  582   11  167  455  313  319  456  172  458  177   22  463  323  324  595  465  837  330   27  332   30   29  185  473  337  607  338  193  340   41  196
 155  304  305  579  578  701  308  163  314  168  583  315  584  317  826  459  457  589  173  322  464  460  325  941  598  328  722  835  331  469  334  726  474  476  609  608  477  341  195   43
 154  303  443  576  439  581  704 1024  451  452  709  710 1030  586  454  588  590  318  174  320  591  718  592  720  596  329  467  470  468  471  724  727  475  606  730  480  481  479   44  198
 301  442  302  573  700  577  580  923  703  450  927  453  821  707  824  825  713  714  715  830  717  836  833  597  181  719  946  600  840  725  841  472  605  728  604  478   45  199  201  197
 153  570  574  575  441  816  819  925  448  705  817  823  928  708  822  711  934 1034  938  937  832  593  834 1039  599  838  944  602  723  601 1046  603  845  729  482  731  345  344  610  343
 148  152  300  440  150  697  820  814 1026  818  926  587  706  931  827  933  932  935  712  829  828 1126  940 1129  942  466 1042  947  839 1047  950  951  952  842  843  342  346  347  200   46
 147  146  572  149  695 1025  924  699  815 1027  702 1203 1120 1029 1031 1032  936 1125 1036  939  831 1037 1214  943 1288 1041 1134  945 1137 1219  948  949  953  844  732  846  483  348  485  484
 436  298  698  812  813  811  571  922 1201 1028 1119  930  929 1121 1206 1123 1033 1124 1210 1128 1130  716 1040 1132 1043 1216 1133 1218 1045 1048 1136 1138 1049  847  733  611  613  205   47   48
 151  435  437  295  297 1021  696 1023 1200 1116 1117 1118 1204 1278 1122 1205 1281 1207 1035 1283 1209 1215 1291 1211 1292 1131 1359 1044 1135 1220 1050  955  954  848  737  349  486  614   50  202
 144  694  299  810  568 1022  920  921 1115 1199 1276 1202 1277 1346 1279 1280 1409 1350 1349 1127 1284 1213 1506 1354 1416 1357 1290 1361 1217 1139 1221 1140 1052  618  956  612  206  736   49   51
 293  294  434  143  919  569  809 1020 1113 1114 1198 1275 1344 1345 1347 1348 1282 1410 1352 1208 1353 1286 1038 1289 1355 1358 1360 1293 1294 1295 1222 1141 1051  735  850  734  487  615  352  203
 145  432  433  690  438  808  918 1019 1112 1197 1274 1343 1403 1404 1406 1458 1408 1407 1351 1460 1285 1413 1212 1414 1356 1466 1415 1420 1418 1142 1223 1053  957  849  851  617  488  351   53   52
 290  296  142  566  567  692  917 1018 1111 1196 1273 1342 1405 1457 1455 1501 1459 1502 1461 1540 1505 1465 1287 1419 1513 1417 1468 1363 1297 1362 1143  958 1055  738  616  350  489  204  207   54
 291  565  691  693  689  807  916 1017 1110 1195 1272 1341 1402 1456 1500 1499 1537 1462 1539 1463 1508 1545 1464 1467 1544 1469 1470 1364 1224 1225 1144  960  853  959  852  490  739  491  208   55
 292  141  431  564  806  915 1108 1015 1016 1194 1271 1340 1401 1453 1498 1504 1583 1562 1412 1568 1541 1507 1569 1509 1424 1510 1421 1296 1226 1298 1145 1056  854 1054  621  743  620  353  354  209
 139  140  289  430  563  805  914 1109 1193 1107 1270 1339 1399 1452 1454 1564 1536 1587 1503 1538 1543 1473 1542 1512 1471 1472 1422 1365 1299 1227 1146 1057  856  740  622  619  742  355  210   56
 138  288  429  562  688  804  912  913 1014 1192 1337 1338 1398 1496 1497 1535 1565 1582 1586 1584 1566 1598 1411 1511 1549 1547 1423 1301 1300 1228 1147 1058  961  855  857  741  358  356  357   59
 137  287  428  561  687  686 1013 1012 1106 1191 1269 1451 1450 1449 1400 1563 1534 1596 1533 1567 1571 1588 1570 1573 1475 1514 1367 1366 1302 1229 1148 1059  962  744  493  623  496  492   58   57
 136  286  427  560  685  911  803  802 1105 1267 1268 1336 1396 1397 1495 1560 1531 1593 1578 1592 1591 1589 1548 1572 1574 1474 1425 1368 1303 1230 1149 1060  963  859  858  495  213  359  211   60
 285  426  559  684  683  801  910 1011 1104 1190 1266 1335 1395 1494 1532 1581 1561 1595 1597 1599 1590 1579 1516 1546 1515 1476 1426 1369 1304 1231 1150 1061  964  860  745  494  624  746  214  361
 135  284  425  558  682  800  909 1010 1103 1189 1188 1333 1334 1448 1493 1530 1559 1553 1557 1554 1585 1577 1575 1551 1520 1479 1428 1427 1305 1232 1151 1062  965  861  747  626  625  363  212  215
 134  283  424  557  799  798  908 1009 1102 1187 1263 1265 1447 1492 1491 1529 1558 1580 1594 1523    0 1556 1519 1552 1517 1430 1432 1370 1371 1233 1152 1063  966  748  627  628  497  360   62   61
 133  282  423  556  680  681  907 1008 1101 1186 1264 1445 1394 1446 1488 1489 1527 1486 1526 1484 1482 1576 1380 1436 1477 1478 1308 1429 1235 1306 1153 1064  967  862  749  499  498  216  362   63
 132  281  422  555  679  797  906 1007 1100 1332 1392 1184 1443 1393 1444 1487 1441 1485 1524 1555 1382 1521 1522 1434 1314 1550 1480 1307 1234 1236 1154 1065  968  863  750  629  500  218  217   64
 131  280  421  678  553  796  795  905 1006 1182 1262 1328 1330 1255 1490 1528 1387 1384 1525 1439 1483 1437 1481 1435 1381 1378 1376 1163 1374 1155 1237 1066  969  864  751  630  501  364   67   66
 130  279  552  420  554  794  904 1005 1185 1099 1331 1097 1391 1326 1325 1388 1386 1440 1385 1383 1318 1438 1246 1377 1373 1518 1241 1375 1309 1310 1156  970  865  752  753  631  502  365   65   68
 129  419  277  676  551  677  903 1004 1098 1261 1183 1256 1257 1329 1389 1442 1323 1322 1321 1320 1168 1248 1379 1433 1372 1240 1244 1243 1431 1238 1157 1067  972  866  754  632  503  220  219  221
 278  276  418  550  675  793  902 1003 1095 1258 1260 1259 1176 1390 1254 1174 1324 1253 1250 1251 1247 1245 1166 1315 1317 1080 1077 1312 1242 1161 1311  971  973 1070  633  504  367  366  222   69
 127  128  417  674  673  792  901 1002 1094 1096 1180 1178 1090 1327 1177 1173 1252 1171 1249  885 1169 1319 1165 1164 1316 1313 1076 1160 1159 1239  875 1068 1071  756  867  635  505  223  224   70
 126  275  416  549  791  900 1001 1000 1093 1181  893 1179 1092 1088 1087 1175 1086 1170 1084  886  986 1081  770  882 1078  982  984 1162 1075 1072 1158  978  755  868  634  636  506  225  369   71
 125  274  415  548  672  999  897  894  896  998  891  996  993 1089  661  992  991 1085  990 1083  988 1167 1079 1082  983  878  880  980 1073 1069  765  763  869  974  872  757  370  371  368   72
 123  124  273  414  547  790  898 1091  784  786  997  892  994  995  778  888  658  887 1172  773  989  774  881  769  985  768 1074  981  876  874  238  975  976  870  871  758  507  509  227   73
 272  413  412  546  671  789  899  895  785  538  664  783  780  660  889  532  659  777  776  775  883  987  651  648  649  520  766  877  519  645  647  873  638  760  639  637  234  226  228   74
 122  121  411  545  670  788  669  787  539  665  402  663  781  890  535  533  657  656  655  654  884  653  525  771  522  386  241  879   89  379  518  761  977  510  759  512  229  508  372   75
 270  271  544  409  542  668  541  540  667  666  259  782  401  662  779  398  529  528  395  527  391  652  772  524  388  244  521  385  383  236  979  762  642  643  513  375  373  511   76   78
 120  269  410  266  543  407  406  405  404  403  536  537  257  400  534  399  397  531  394  251  393  526  390  650  523  387   90  646  515  644  239  517  764  235  381  376  377   81   84  374
 119  268  267  265  408  264  263  262  261  260  258  107  256  104  255  530  396  102  250  249  392   95   96  389  246  245  243  384  767  516   88  514  240  237  640  232   83   77  231  230
 118  117  116  115  114  113  112  111  110  109  108  106  105  103  254  253  101  252  100   99   98  248   97  247   94   92   91   93  242  382   87   85  380  641   86  378  233   82   80   79
