# This puzzle is unsolvable
55
 624    3  216  625  223  219  431    6    9  432    8   11   15  228  231  229   17   18   19   20  236  238   21   23   24  241   27  244   28   30   31   32   33   34   35   36   37   38   39  255   40  466   42   43   46   44   47   48   49   50   51   52   53   54   55
   4  214  426  218  428  429  221    7   10  226  225  634  632   14   16  232  233  640  234  443  237   22  239  447  450   26  242   25   29  245  246  247  248  249  250  251  252  253  254  462  256   41  258  261   45  468  262  263  264  265  266  267  268  269   56
   1  424    2    5  425  427  626  628  631  433  434 1008  230  435  437  828  637  639  235  641  442  444  445  240  646  647  243  839  451  452  453  454  455  456  457  458  459  460  461  257  463  464  467  665  259  260  469  470  471  472  473  474  475  270   57
 423  215  816  222  220  818  224 1002  629  633 1009 1179  227  635  826  436  439  440  831  832  642  643  644  446  448  645  449  649  650  651  652  653  654  655  656  657  658  659  660  661  662  663  465  856  666  667  668  669  670  671  672  673  476  271   58
 815  621  813  217  817  623 1001  430  822  820  825   13   12 1010  827  638 1013  438  830 1015  833  834  835  836  837  838 1021 1023  648  842  843 1027  844  845  846  848  849  850  851  852  853  854  664 1039  857  858  859  860  861  862  863  674  477  272   59
 419  213  212  997  814  627 1000 1173  630 1003  824 1005  823 1352 1350  441  829 1188 1014 1190 1016 1017 1193 1018 1020 1022  840 1198  841 1025 1026 1202 1028 1029  847 1030 1032 1033 1034 1211 1036 1037  855 1214 1040 1041 1042 1043 1044 1045  864  675  478  273   60
 418  421  622  995 1176  620 2061  819  999 1180 1178 1006 1182 1186  636 1012 1355 1514 1356 1189 1359 1191 1192 1019 1195 1363 1196 1365 1024 1200 1201 1369 1203 1204 1205 1031 1373 1207 1377 1376 1035 1213 1038 1381 1215 1216 1217 1218 1219 1046  865  676  479  274   61
 422  998  812  208 1177 1343 1503 1004 1802  821 1346 1347 1184 1183 1011 1185 1187 1665 1516 1358 1357 1669 1361 1519 1362 1522 1197 1364 1199 1367 1368 1528 1370 1371 1372 1374 1206 1208 1375 1537 1379 1378 1212 1380 1382 1383 1384 1385 1220 1047  866  677  480  275   62
 619  211  420 1175  996 1172 1341 1507 1345 1348 1349 1007 1658 1510 1354 1512 1513 1515 1807 1194 1517 1668 1360 1520 1521 1673 1674 1524 1366 1525 1526 1527 1529 1530 1531 1532 1533 1684 1209 1210 1688 1539 1690 1540 1541 1542 1543 1386 1221 1048  867  678  481  276   63
 415  210  417  811 1344 1342 2065 1506 1799 1934 1505 1939 1662 1181 1353 1806 1663 1666 1808 1667 1811 1947 1518 1670 1523 1672 1817 1675 1676 1677 1678 1679 1680 1681 1682 1683 1686 1685 1535 1687 1830 1689 1538 1691 1692 1693 1544 1387 1222 1049  868  679  482  277   64
 414  810  205  618  616 1504 1502 1656 1655 1937 1804 1659 1509 1351 1660 1941 1944 1942 2301 1810 2194 1809 2074 1812 1814 1815 1816 1818 1819 1820 1821 1822 1823 1824 1825 1826 1827 1828 1534 1536 1829 1832 1833 1834 1835 1694 1545 1388 1223 1050  869  680  483  278   65
 209  617  808  994 1336 1170 1339 2297 1500 1174 1657 1801 1805 1938 2299 2067 1664 2302 2191 2072 2193 1949 1671 1813 1950 1952 2079 1953 1954 1955 1956 1957 1958 1959 1960 1961 1963 2089 1964 1965 1831 1967 1968 1969 1836 1695 1546 1389 1224 1051  870  681  484  279   66
 207  615  416 1171  206 1169  991 1936 1653 1652 1798 1803 2063 1661 1511 2068 2187 2069 2303 2406 1946 2304 1948 2075 1951 2077 2078 2199 2080 2082 2083 2084 2085 2086 2087 2088 1962 2091 2092 2211 1966 2094 2095 1970 1837 1696 1547 1390 1225 1052  871  682  485  280   67
 204  992  413  614 1338 1499 1168 1651 1167 1935 1933 1794 2062 2184 1940 1943 2405 2401 2585 2188 2192 2305 2306 2076 2195 2197 2196 2198 2081 2200 2201 2203 2204 2205 2206 2207 2208 2090 2210 2212 2093 2323 2096 1971 1838 1697 1548 1391 1226 1053  872  683  486  281   68
 805  411  613  804  807 1931 1654 1501  993 1508 1800 1932 1797 2066 2185 2584 2071 2070 2403 1945 2073 2501 2587 2409 2307 2308 2309 2310 2312 2313 2202 2314 2315 2316 2317 2318 2319 2209 2321 2322 2214 2213 2097 1972 1839 1698 1549 1392 1227 1054  873  684  487  282   69
 412  410  610  989  809  611 1496 1795 1793 1340 1796 2064 2059 2298 2182 2189 2499 2664 2190 2404 2588 2502 2408 2503 2592 2412 2508 2414 2311 2415 2416 2417 2418 2419 2420 2421 2422 2320 2424 2425 2324 2215 2098 1973 1840 1699 1550 1393 1228 1055  874  685  488  283   70
 203  201  612  806  988 1497  990 1335 1498 1495 1650 2181 2296 2398 1930 2186 2583 2399 2402 2300 2407 2668 2590 2504 2506 2410 2595 2413 2509 2510 2511 2512 2513 2514 2515 2516 2517 2423 2519 2426 2325 2216 2099 1974 1841 1700 1551 1394 1229 1056  875  686  489  284   71
 200  202  609  801 1334 1165 1648 1649 1337 1791 1929 1792 2180 2292 2291 2495 2735 2293 2586 2498 2739 2737 2589 2591 2505 2593 2411 2596 2675 2597 2598 2599 2600 2601 2602 2603 2604 2518 2520 2427 2326 2217 2100 1975 1842 1701 1552 1395 1230 1057  876  687  490  285   72
 407  408  198  986 1166  987 1494 1164 1493 2058 2294 2183 2396 2295 2400 2397 2494 2734 2497 2665 2500 2738 2669 2670 2671 2743 2673 2594 2674 2676 2677 2678 2679 2680 2681 2682 2683 2605 2521 2428 2327 2218 2101 1976 1843 1702 1553 1396 1231 1058  877  688  491  286   73
 199  803  409  608  985 1330  802 1646 1332 2057 1647 1928 2056 2060 2179 2395 2578 2290 2496 2801 2798 2667 2740 2805 2741 2507 2744 2745 2746 2747 2748 2749 2750 2751 2752 2753 2684 2606 2522 2429 2328 2219 2102 1977 1844 1703 1554 1397 1232 1059  878  689  492  287   74
 406  197  607  799  800 1160 1159 1491 1788 1790 1644 1927 2055 2394 2289 2659 2492 2666 2663 2800 2582 2736 2662 2858 2742 2672 2807 2808 2809 2810 2811 2812 2813 2814 2815 2754 2608 2607 2523 2430 2329 2220 2103 1978 1845 1704 1555 1398 1233 1060  879  690  493  288   75
 195  605 1162  798  983 1492 1161 1333 1645 1789 2178 1926 2054 2493 2176 2581 2489 2491 2799 2856 2802 2803 2804 2945 2861 2806 2862 2863 2864 2913 2865 2868 2914 2816 2755 2756 2685 2609 2524 2432 2431 2221 2104 1979 1846 1705 1556 1399 1234 1061  880  691  494  289   76
 606  196  402  794 1329 1331 1163  982 1642 1489 1925 2174 2490 2287 2177 2488 2577 2660 2580 2797 2855 2905 2859 2860 2907 2908 2909 2910 2911 2912 2866 2867 2870 2869 2817 2757 2686 2687 2610 2525 2330 2222 2105 1980 1847 1706 1557 1400 1235 1062  881  692  495  290   77
 405  604  797  404  984 1328 1327 1643 1490 1787 1924 2288 2175 2392 2393 2661 2576 2579 2733 2732 2904 2857 2903 2944 2906 2948 2949 2981 2951 2950 2952 2953 2915 2871 2818 2688 2611 2526 2433 2332 2331 2223 2106 1981 1848 1707 1558 1401 1236 1063  882  693  496  291   78
 194  192  193  403  981  980 1157 1326 1641 1786 1923 2052 2172 2173 2285 2286 2390 2487 2658 2731 2853 2854 2943 2976 2946 2947 2979 3005 3003 2980 2983 2917 2916 2872 2819 2758 2689 2612 2527 2434 2333 2224 2107 1982 1849 1708 1559 1402 1237 1064  883  694  497  292   79
 401  400  602  603  795 1158 1488 1487 1640 1785 1922 2053 2050 2391 2389 2575 2730 2729 2796 2852 2942 2902 2941 2975 2977 2978 3002 3004 3007 2982 2956 2954 2918 2873 2820 2759 2690 2613 2528 2435 2334 2225 2108 1983 1850 1709 1560 1403 1238 1065  884  695  498  293   80
 191  793  978  796 1155  601 1156 1486 1639 1784 1921 2049 2051 2284 2486 2656 2574 2657 2728 2795 2851 2940 2973 2999 3000 3016 3018 2985 3006 2957 2984 2955 2919 2874 2821 2760 2691 2614 2529 2436 2335 2226 2109 1984 1851 1710 1561 1404 1239 1066  885  696  499  294   81
 190  399  979  599  600 1325 1324 1483 1485 1783 2047 2281 2169 2170 2388 2485 2573 2655 2793 2794 2900 2850 2974 2899 2997 3001 2998 3024 3019 3021 2986 2920 2921 2875 2822 2761 2692 2615 2530 2437 2336 2227 2110 1985 1852 1711 1562 1405 1240 1067  886  697  500  295   82
 188  187  792 1152 1153 1322  977 1634 1482 1638 2171 1920 2048 2283 2282 2484 2572 2727 2653 2792 2849 2901 2971 2939 2996 3014 3017 3020 3010 3009 3008 2959 2958 2876 2823 2762 2693 2616 2531 2438 2337 2228 2111 1986 1853 1712 1563 1406 1241 1068  887  698  501  296   83
 396  189  975  791  598 1321 1323 1484 1637 1782 1918 1919 2046 2168 2387 2385 2386 2571 2654 2791 2848 2898 2938 2972 3012 3011 3015 3022 2991 2987 2989 2988 2877 2824 2825 2763 2694 2617 2532 2439 2338 2229 2112 1987 1854 1713 1564 1407 1242 1069  888  699  502  297   84
 597  398  397 1154  789  976 1320 1636 1633 1916 1781 1917 2167 2280 2483 2482 2652 2570 2726 2790 2846 2897 2896 2970 2995 3013 3023 2993 2964 2992 2990 2960 2923 2922 2764 2765 2695 2618 2533 2440 2339 2230 2113 1988 1855 1714 1565 1408 1243 1070  889  700  503  298   85
 395  182  788  186  972 1151 1150 1481 1915 1914 1635 2166 2279 2278 2384 2382 2480 2788 2725 2651 2895 2847 2937 2969 2968 2994 2966 2965 2930 2963 2962 2961 2924 2878 2879 2826 2696 2619 2534 2441 2340 2231 2114 1989 1856 1715 1566 1409 1244 1071  890  701  504  299   86
 595  393  185  973  790 1148 1319 1778 2045 1777 1779 2163 2165 2276 2383 2481 2650 2478 2789 2724 2894 2893 2936 2934 2890 2967 2932 2931 2929 2928 2927 2926 2925 2880 2827 2766 2697 2620 2535 2442 2341 2232 2115 1990 1857 1716 1567 1410 1245 1072  891  702  505  300   87
 394  183  596  184  971  974 1318 1480 1780 1478 2043 2044 2277 2275 2381 2568 2649 2845 2723 2844 2722 2892 2935 2891 2839 2933 2888 2887 2886 2885 2884 2883 2882 2881 2828 2767 2698 2621 2536 2443 2342 2233 2116 1991 1858 1717 1568 1411 1246 1073  892  703  506  301   88
 181  392  592 1149  787  786  970 1479 1632 1631 1912 2164 2042 2477 2479 2476 2569 2648 2785 2843 2783 2787 2841 2840 2780 2838 2836 2777 2835 2834 2833 2832 2831 2830 2829 2768 2699 2622 2537 2444 2343 2234 2117 1992 1859 1718 1569 1412 1247 1074  893  704  507  302   89
 389  388  783  594  784  591 1477 1315 1630 1911 1775 1776 2041 2162 2274 2565 2647 2719 2720 2717 2784 2641 2842 2716 2781 2779 2778 2837 2776 2775 2774 2773 2772 2771 2770 2769 2700 2623 2538 2445 2344 2235 2118 1993 1860 1719 1570 1413 1248 1075  894  705  508  303   90
 391  390  782  593 1145 1317 1146 1313 1475 1628 1913 2160 2040 2380 2566 2475 2646 2643 2644 2567 2715 2782 2558 2714 2713 2711 2889 2710 2709 2708 2707 2706 2705 2704 2703 2702 2701 2624 2539 2446 2345 2236 2119 1994 1861 1720 1571 1414 1249 1076  895  706  509  304   91
 180  588 1312  785 1316 1772 1314 1629 1773 1909 2039 1476 2161 2379 2377 2378 2645 2721 2718 2786 2468 2642 2640 2638 2637 2712 2636 2635 2634 2633 2632 2631 2630 2629 2628 2627 2626 2625 2540 2447 2346 2237 2120 1995 1862 1721 1572 1415 1250 1077  896  707  510  305   92
 179  178  968  965  969  967 1143 1147 1774 1908 1910 2159 2273 2271 2272 2474 2564 2563 2562 2561 2560 2559 2557 2639 2365 2464 2554 2552 2551 2550 2549 2548 2547 2546 2545 2544 2543 2542 2541 2448 2347 2238 2121 1996 1863 1722 1573 1416 1251 1078  897  708  511  306   93
 177  589  590  587  777 1142 1144 1627 1626 1771 2037 2038 2158 2270 2376 2473 2472 2471 2470 2469 2467 2368 2556 2555 2366 2364 2553 2461 2460 2459 2458 2457 2456 2455 2454 2453 2452 2451 2450 2449 2348 2239 2122 1997 1864 1723 1574 1417 1252 1079  898  709  512  307   94
 176  386  966  780  964 1311 1473 1474 1625 1770 1907 2036 2157 2269 2375 2373 2372 2264 2371 2370 2367 2262 2466 2465 2363 2463 2257 2462 2361 2360 2359 2358 2357 2356 2355 2354 2353 2352 2351 2350 2349 2240 2123 1998 1865 1724 1575 1418 1253 1080  899  710  513  308   95
 385  585  586  781  387 1471 1472 1470 1624 1769 1906 2035 2156 2154 2267 2374 2151 2266 2263 2148 2369 2260 2145 2259 2258 2142 2255 2362 2016 2254 2252 2251 2250 2249 2248 2247 2246 2245 2244 2243 2242 2241 2124 1999 1866 1725 1576 1419 1254 1081  900  711  514  309   96
 175  384  778 1310 1140 1309 1308 1141 1623 1768 1905 2034 2155 2153 2268 2152 2265 2027 1895 1896 2147 2146 2261 2144 2143 2019 2256 2140 1884 2253 2014 2137 2135 2134 2133 2132 2131 2130 2129 2128 2127 2126 2125 2000 1867 1726 1577 1420 1255 1082  901  712  515  310   97
 174  381  383  963  961  779 1307 1469 1622 1767 1904 2033 2032 2031 2030 2028 2150 2149 1609 2026 1754 2024 2022 1891 2020 2018 2141 2017 1745 2139 2138 2136 2013 2011 2010 2009 2008 2007 2006 2005 2004 2003 2002 2001 1868 1727 1578 1421 1256 1083  902  713  516  311   98
 172  583  776  962  584 1139 1138 1468 1621 1903 1765 1902 1901 1761 1900 2029 1898 1897 2023 1894 2025 1605 1890 1889 1602 1888 1887 1747 1886 1883 2015 1882 2012 1881 1880 1878 1738 1876 1875 1874 1873 1872 1871 1870 1869 1728 1579 1422 1257 1084  903  714  517  312   99
 582  173  380  775  960 1137 1306 1467 1620 1766 1764 1763 1615 1762 1899 1759 1758 1610 1757 1893 1608 1752 1606 1750 2021 1749 1601 1599 1885 1598 1744 1742 1741 1594 1879 1877 1740 1737 1736 1735 1734 1733 1732 1731 1730 1729 1580 1423 1258 1085  904  715  518  313  100
 171  581  382  774  959 1136 1305 1466 1619 1618 1617 1461 1616 1614 1760 1613 1611 1456 1455 1453 1452 1892 1753 1751 1603 1748 1600 1445 1746 1597 1596 1743 1595 1439 1592 1739 1591 1590 1589 1588 1587 1586 1585 1584 1583 1582 1581 1424 1259 1086  905  716  519  314  101
 170  379  580  773  958 1135 1304 1465 1464 1463 1462 1298 1460 1459 1458 1612 1457 1292 1756 1290 1607 1450 1115 1287 1755 1284 1285 1447 1443 1280 1442 1441 1440 1275 1593 1437 1436 1435 1434 1433 1432 1431 1430 1429 1428 1427 1426 1425 1260 1087  906  717  520  315  102
 169  378  579  772  957 1134 1303 1302 1301 1300 1128 1299 1297 1296 1295 1294 1122 1293 1291 1288 1454 1116 1451 1449 1114 1286 1283 1446 1444 1281 1279 1278 1277 1105 1276 1274 1273 1272 1271 1270 1269 1268 1267 1266 1265 1264 1263 1262 1261 1088  907  718  521  316  103
 168  377  578  771  956 1133 1132 1131 1130  950 1129  948 1126 1125 1124 1123  943 1121 1120 1604 1118  751 1448  749  750 1113 1112 1111 1282 1109 1108 1107 1106 1104 1438 1103 1102 1101 1100 1099 1098 1097 1096 1095 1094 1093 1092 1091 1090 1089  908  719  522  317  104
 167  376  577  770  955  954  953  952  764  951 1127  949  947  946  758  945  944  942  941 1119 1289  939  937 1117  748  936  934  745 1110  932  929  928  927  926  925  924  923  922  921  920  919  918  917  916  915  914  913  912  911  910  909  720  523  318  105
 166  375  576  769  768  767  766  765  568  762  567  761  565  760  759  757  756  754  753  940  938  555  554  350  747  935  933  746  743  931  742  741  740  739  738  737  736  735  734  733  732  731  730  729  728  727  726  725  724  723  722  721  524  319  106
 165  374  575  574  573  572  571  570  763  569  566  363  361  564  359  560  755  357  559  354  558  752  353  553  348  552  550  744  548  930  547  546  545  544  543  542  541  540  539  538  537  536  535  534  533  532  531  530  529  528  527  526  525  320  107
 164  373  372  371  370  369  368  367  366  365  364  362  360  563  562  148  561    0  355  144  557  142  556  351  139  349  551  549  346  345  344  343  342  341  340  339  338  337  336  335  334  333  332  331  330  329  328  327  326  325  324  323  322  321  108
 163  162  161  160  159  158  157  156  155  154  153  152  151  150  149  147  358  146  145  356  143  141  352  140  138  137  136  347  135  134  133  132  131  130  129  128  127  126  125  124  123  122  121  120  119  118  117  116  115  114  113  112  111  110  109
