# This puzzle is unsolvable
58
   2    1    3    4    5    6    7    8    9   10   11   12   14   15  244  242  243   18  466   19  678  247   22  250   24  254   25   28   29   30   32  259   33   34   35   36   37   38   39   40   41   42   43   44   46   48  493  275   49   50   51   52   53   54   55   56   57   58
 228  229  230  231  232  233  234  235  237  872  238  239   13  462  461   16  463   17  245  467   21  249  248  251  472  471   27  255  256  257   31  478  260  261  262  263  264  265  266  267  268  269  270  272  492  491  274   47  276  277  278  279  280  281  282  283  284   59
 448  226  449  450  452  453  664  666  236  668  455  458  459  240  460  241  464  677   20  465  469   23  252  253  884   26  473  474  475  477  258  689  690  480  481  482  483  484  485  486  487  488  489  271   45  273  703  495  909  496  497  499  500  711  501  502  285   60
 227  447  864  662  451  663  665  454  667 1252  456  457  669  671  672  673  674  676  246  880  881  468  680  470  681  682  684  685  687  476  891  688  893  479  692  693  694  695  696  697  698  699  701  490  702  907  705  908  706  707  708  498  710  914  712  503  286   61
 225  659  661  660  865 1061  866  868  871  870 1065  873  670  874 1069  875  876  878  675  879 1076  679  882  885  886  683  887  889  686  890 1087  892  691  894  895  896  897  898  899  900  901  902  700  903  904  905  704 1104 1103  910  912  709 1108  913  713  504  287   62
 224  446  445  658  863 1060 1063  867 1062 1253 1433 1067 1068 1256    0 1070 1071 1072 1073 1075 1263 1077 1078  883 1080 1082 1083  888 1084 1085 1086 1274 1088 1276 1089 1279 1090 1093 1094 1095 1096 1097 1098 1100 1287  906 1102  494 1291 1105  911 1107 1109  915  714  505  288   63
 223  444  657  862 1059 1248 1249 1251  869 1430 1431 1066 1254 1257 1436 1258  877 1260 1074 1264 1265 1443 1079 1267 1268 1081 1269 1270 1271 1272 1273 1453 1275 1278 1277 1091 1092 1280 1281 1282 1283 1284 1285 1099 1288 1101 1289 1290 1292 1471 1106 1294  916  716  917  715  289   64
 222  443  656  861 1246 1247 1428 1250 1064 1602 1603 1432 1434 1255 1607 1609 1259 1261 1441 1262 1613 1442 1445 1266 1446 1447 1448 1449 1450 1451 1452 1454 1625 1455 1456 1457 1458 1459 1460 1461 1462 1463 1464 1286 1466 1467 1468 1469 1470 1472 1293 1295 1110  918  507  506  291   65
 221  442  655  860 1058 1057 1427 1600 1764 1429 1601 1922 1767 1435 1770 1438 1437 1440 1611 1931 1776 1615 1444 1616 1617 1618 1619 1620 1784 1621 1622 1623 1624 1789 1626 1629 1630 1949 1631 1632 1633 1634 1635 1465 1636 1637 1802 1640 1641 1642 1473 1296 1111  717  718  290  292   66
 220  441  654  859 1056 1245 1426 1763 1765 1920 1604 1605 1606 1771 1772 1926 1439 1774 1929 1612 1775 1614 1778 1779 1780 1781 1782 1783 1785 1940 1786 1787 1943 1788 1627 1628 2097 1791 1794 1795 1796 1797 1798 1799 1800 1639 1638 1803 1804 1643 1474 1297 1112  919  719  508  509   67
 219  440  653  858 1055 1244 1425 1599 1919 1918 1921 1766 1768 1769 1923 2073 1608 1928 2076 1930 1777 2080 1932 1934 1935 1936 1937 1938 1939 1941 2088 1942 1944 1790 2093 2092 1793 1792 2094 1950 1951 1952 1953 1954 1955 1801 1957 1958 1805 1644 1475 1298 1113  920  510  511  293   68
 218  439  652  857 1054 1243 1424 1597 1598 1761 2068 2071 2070 2072 1925 2212 1773 1927 2074 2077 2215 2078 1933 2081 2082 2083 2084 2085 2225 2086 2087 2089 2090 2091 1946 1945 2486 2234 1947 2236 2098 2099 2100 2101 2102 1956 2104 1959 1806 1645 1476 1299 1114  921  720  294   69   70
 217  438  651  856 1053 1242 1423 1595 1762 2066 2208 1924 2209 2210 2211 2213 1610 2214 2346 2075 2079 2219 2350 2221 2222 2353 2223 2224 2356 2226 2227 2228 2229 2230 2231 1948 2363 2095 2366 2096 2237 2238 2240 2242 2371 2103 2105 1960 1807 1646 1477 1116 1300  922  721  513  512  295
 216  437  650  855 1052 1241 1422 1917 1596 2067 2207 2069 2340 2341 2342 2343 2344 2345 2216 2218 2217 2348 2349 2476 2220 2352 2354 2355 2357 2480 2358 2359 2360 2361 2362 2233 2365 2235 2364 2491 2367 2239 2372 2493 2241 2243 2106 1961 1808 1647 1478 1115 1302  923  722  296   71   72
 215  436  649  854 1051 1240 1421 1594 1760 1916 2064 1915 2339 2464 2465 2466 2467 2468 2469 2347 2471 2472 2351 2473 2591 2475 2698 2478 2479 2595 2481 2482 2483 2484 2485 2487 2232 2488 2489 2492 2490 2370 2494 2495 2373 2244 2107 1962 1809 1648 1479 1301  924 1118  723  514  297   73
 214  435  648  853 1050 1239 1420 1593 1759 2065 2205 2206 2338 2463 2580 2581 2582 2583 2584 2470 2585 2586 2588 2474 2699 2796 2697 2477 2592 2594 2702 2597 2598 2599 2600 2708 2601 2603 2605 2811 2712 2368 2608 2714 2374 2245 2108 1963 1810 1649 1480 1303 1117  516  926  725  515  298
 213  434  647  852 1049 1238 1419 1592 1758 1914 2063 2204 2337 2462 2579 2688 2689 2690 2691 2692 2693 2587 2793 2589 2590 2887 2798 2889 2593 2701 2596 2704 2705 2706 2707 2807 2710 2808 2604 2606 2813 2369 2607 2713 2375 2248 2247 2109 1811 1650 1481 1304 1119  925  726  724  299   74
 212  433  646  851 1048 1237 1418 1591 1757 1913 2062 2203 2336 2461 2578 2687 2788 2789 2790 2791 2792 2695 2694 2794 2969 2797 3115 2974 2700 2802 2703 2803 2804 2805 2806 2709 2602 2983 2902 2711 2715 2610 2497 2609 2246 2376 2110 1964 1965 1651 1482 1305 1120  927  727  517  300   75
 211  432  645  850 1047 1236 1417 1755 1756 1912 2061 2202 2335 2460 2577 2686 2787 2880 2881 2882 2883 2884 2885 2696 2970 2886 3116 2799 2892 2801 2893 2978 2894 2897 2896 2980 2898 2899 2809 2810 2901 2717 2498 2496 2377 2112 2111 1966 1812 1652 1307 1484 1306 1121  928  518  301   76
 210  431  644  849 1046 1235 1416 1590 1589 1911 2060 2201 2334 2459 2576 2685 2786 2879 2964 2965 2966 2967 2968 3046 2972 3045 2891 3051 2800 2976 3049 2977 3053 3054 3055 2981 2982 2984 2903 2815 2812 2814 2716 2612 2378 2250 1967 1968 1813 1815 1485 1483 1122  930  929  519  302   77
 209  430  643  848 1045 1234 1415 1588 1754 1910 2059 2200 2333 2458 2575 2684 2785 2878 2963 3040 3041 3042 3043 2795 3044 2973 2975 2888 3177 3227 3050 2895 3121 2979 3119 3124 3057 3058 2900 2816 2817 2379 2611 2499 2501 1969 2113 1814 1653 1654 1486 1308 1309 1123  728  729  303   78
 208  429  642  847 1044 1233 1587 1586 1753 1909 2058 2199 2332 2457 2574 2683 2784 2877 2962 3039 3108 3109 3110 3170 2971 3111 3047 2890 3048 3174 3052 3117 3179 3180 3056 3122 2986 2905 2985 2906 2720 2718 2613 2502 2251 2249 2380 1817 2114 1816 1655 1124 1125  931  730  520   80  304
 207  428  641  846 1043 1232 1414 1412 1752 1908 2057 2198 2331 2456 2573 2682 2783 2876 2961 3038 3107 3168 3220 3222 3113 3112 3171 3114 3269 3175 3118 3120 3176 3181 3182 3059 3123 3125 3060 2904 2987 2719 2614 2615 2500 2381 2117 2116 2115 1656 1487 1311 1310  932  522  521  306   79
 206  427  640  845 1042 1230 1413 1750 1751 1907 2056 2197 2330 2455 2572 2681 2782 2875 2960 3037 3106 3167 3221 3169 3172 3224 3173 3268 3225 3226 3228 3230 3178 3231 3232 3183 3184 2988 2819 2907 2818 2721 2616 2503 2382 2252 1818 1819 1970 1657 1488 1312 1126  733  731  305  523   81
 205  426  639  844 1041 1411 1231 1585 1749 1906 2055 2196 2329 2454 2571 2680 2781 2874 2959 3036 3105 3166 3219 3264 3265 3223 3267 3270 3330 3305 3308 3229 3272 3274 3233 3127 3126 3128 3061 2820 2722 2617 2504 2255 2506 2383 2253 1971 1972 1658 1490 1489  934  935  933  524  307   82
 204  425  638 1040 1229 1228 1410 1584 1748 1905 2054 2195 2328 2453 2570 2679 2780 2873 2958 3035 3104 3165 3218 3263 3300 3301 3328 3303 3302 3306 3307 3273 3275 3278 3234 3186 3062 3185 2908 2989 2909 2724 2505 2620 2118 2254 1973 1974 2119 1659 1491 1128 1127  734  732  525  308   83
 203  424  637  843 1039 1227 1582 1583 1747 1904 2053 2194 2327 2452 2569 2678 2779 2872 2957 3034 3103 3164 3217 3262 3299 3266 3348 3329 3331 3304 3332 3271 3309 3277 3276 3187 3129 3064 2991 3063 2911 2723 2619 2618 2384 1823 2256 2120 1820 1660 1314 1313 1129  936  735  526  309   84
 202  423  841  842 1038 1408 1409 1581 1746 1903 2052 2193 2326 2451 2568 2677 2778 2871 2956 3102 3163 3216 3214 3261 3298 3327 3360 3351 3357 3362 3333 3334 3335 3337 3235 3131 2994 2912 3066 2910 2992 2725 2990 2507 2386 2385 2259 1975 1821 1661 1492 1315 1130  937  736  527  310   85
 201  422  636  635 1036 1037 1407 1580 1745 1902 2051 2192 2325 2450 2567 2676 2777 2870 2955 3033 3031 3162 3259 3260 3326 3325 3359 3350 3349 3336 3352 3312 3340 3310 3279 3237 3188 3065 3067 2822 2823 2821 2726 2621 2387 2258 2257 1822 1662 1663 1493 1316 1131  938  737  528  311   86
 200  421  634  840  839 1226 1225 1406 1744 1901 2050 2191 2324 2449 2675 2565 2776 2869 2954 3101 3032 3161 3215 3258 3296 3297 3324 3347 3346 3363 3353 3311 3236 3280 3313 3239 3189 3068 2995 2913 2824 2727 2622 2508 2509 2389 1976 1978 1664 2121 1494 1317 1132  939  738  529  312   87
 199  420  633  838 1035 1224 1405 1579 1578 1899 1900 2049 2323 2447 2448 2566 2674 2868 2953 3099 3160 3100 3159 3213 3257 3323 3358 3361 3356 3287 3343 3354 3192 3355 3190 3238 3130 2993 3134 2914 2825 2728 2511 2510 1977 2388 2260 2122 1825 1824 1495 1318 1133  940  739  530  313   88
 198  419  632  837 1034 1223 1404 1577 1743 1742 2048 2190 2322 2446 2564 2673 2775 2774 2867 2952 3030 3212 3209 3096 3295 3321 3322 3345 3319 3318 3342 3316 3338 3281 3132 3133 3069 3135 2997 2915 2826 2729 2623 2512 2391 2261 2123 1979 1826 1665 1496 1319 1134  941  740  531  314   89
 418  631  630  836 1222 1220 1576 1402 1741 1898 2047 2189 2188 2321 2563 2672 2773 2866 3029 2865 3098 3097 3028 3211 3256 3293 3294 3344 3289 3317 3341 3284 3314 3282 3241 3191 3070 2996 2916 2917 2827 2626 2624 2513 2625 2390 2124 1980 1827 1666 1497 1320 1135  942  741  532  315   90
 197  196  835  834 1033 1219 1221 1403 1740 1897 2046 2187 2320 2445 2562 2671 2772 3027 2951 3157 3156 3095 3210 3254 3255 3291 3290 3288 3320 3244 3283 3315 3286 3194 3240 3193 3136 2998 2999 2828 2829 2730 2731 2392 2263 2262 2125 1981 1828 1667 1498 1321 1136  943  742  533  316   91
 195  417  629  416 1032 1401 1400 1575 1574 1896 2045 2186 2319 2444 2561 2670 2771 2864 2950 3026 3025 3253 3158 3206 3252 3205 3251 3250 3249 3248 3200 3246 3285 3142 3242 3243 3072 3139 3071 2918 2830 2732 2627 2514 2393 2264 2126 2127 1668 1669 1499 1322 1137  944  743  534  317   92
 194  192  415  832 1031  833 1218 1573 1895 1739 1738 2044 2318 2443 2560 2669 2770 2863 2949 2948 3093 3208 3153 3207 3292 3204 3203 3202 3201 3199 3146 3197 3339 3245 3138 3195 3137 3073 3000 2919 2733 2734 2628 2515 2394 2128 1983 1982 1830 1829 1500 1323 1138  945  744  535  318   93
 414  829  628 1028  626 1030 1399 1572 1736 1894 2184 2317 2442 2440 2559 2668 2769 2862 2946 3024 3155 3094 3091 3152 3151 3150 3149 3148 3247 3147 3144 3198 3143 3141 3078 3077 3074 3075 3001 2920 2831 2735 2629 2516 2395 2130 2266 2129 1984 1831 1670 1501 1139  946  745  536  319   94
 193  413  830 1217 1024 1029 1398 1571 1737 2043 2183 2185 2441 2558 2667 2666 2768 2861 3023 2947 3092 3154 3090 3089 3088 3087 3014 3086 3084 3011 3083 3145 3080 3009 3079 3140 3076 3004 3002 2921 2832 2736 2517 2631 2396 2265 2268 1833 1832 1503 1671 1324 1140  947  746  537  320   95
 624  190  831  627 1397 1570 1214 1892 1565 1893 2041 2039 2316 2439 2556 2557 2767 2860 2945 3022 3021 3020 3019 3017 2939 3016 3015 3085 3013 3012 3082 3081 3008 3007 3196 3006 3005 2925 3003 2923 2922 2833 2630 2518 2397 2131 1985 2267 1673 1676 1325 1502 1141  948  747  538  321   96
 191  411  412 1216 1027 1026 1393 1735 2042 2313 1569 2314 2438 2554 2312 2665 2766 2859 2944 2856 2943 2942 2941 3018 2937 2934 2935 2936 2847 2932 2931 3010 2930 2929 2928 2927 2926 2924 2837 2834 2633 2737 2519 2400 2402 2398 1677 1986 1987 1326 1504 1327 1142  949  748  539  322   97
 189  623  625  828 1025 1396 1213 1734 1392 1733 2040 2182 2315 2437 2664 2663 2765 2858 2762 2857 2853 2759 2758 2654 2940 2755 2751 2752 2846 2933 2845 2749 2843 2842 2841 2840 2839 2838 2836 2835 2741 2520 2271 2399 2269 2133 2132 1834 1836 1835 1672 1674 1143  950  749  540  323   98
 188  410  622  827 1023 1215 1564 1731 1395 2181 1568 2180 2555 2435 2552 2553 2661 2764 2659 2761 2855 2851 2852 2655 2850 2938 2651 2848 2648 2844 2647 2750 2646 2748 2746 2745 2744 2743 2742 2638 2739 2738 2632 2274 2523 1988 2270 2134 1990 1505 1144 1328 1145  951  750  541  324   99
 187  409  408  621  826 1394  823 2037 2179 1891 2177 2176 2038 2436 2433 2662 2763 2548 2657 2546 2854 2760 2543 2297 2754 2849 2653 2650 2538 2753 2535 2534 2643 2747 2532 2642 2641 2640 2639 2527 2740 2636 2634 2521 2522 2401 2272 1989 1675 1508 1329 1331 1146  952  751  542  325  100
 186  407  620  825 1211 1212 2036 1567 2035 1732 1888 1890 2178 2311 2432 2550 2549 2658 2660 2427 2656 2757 2544 2542 2541 2756 2420 2421 2417 2537 2536 2649 2645 2416 2644 2531 2530 2528 2408 2407 2406 2526 2635 2273 2135 2137 1992 1838 1837 1678 1506 1330 1507  953  752  543  326  101
 185  406  619 1021 1022 1728 1885 1730 1886 1729 2033 1889 2034 2310 2309 2551 2170 2430 2429 2547 2426 2299 2424 2423 2293 2652 2540 2159 2539 2418 2291 2289 2415 2533 2413 2412 2410 2529 2282 2281 2637 2525 2524 2277 2278 2136 2138 1993 1839 1509 1510 1332 1147  954  753  544  327  102
 184  405  618 1209  822 1391 1562 1726 1887 1566 1884 2175 2174 2026 2434 2431 2306 2304 2302 2428 2545 2300 2163 2425 2296 2422 2294 2158 2419 2292 2014 2288 2414 2287 2286 2285 2411 2148 2283 2146 2409 2279 2143 2405 2403 2275 1996 1994 1991 1512 1679 1334 1148  955  754  545  328  103
 183  404  617  824 1020 1210 1207 1390 1388 2032 2031 2029 2307 2171 1878 2168 2303 2167 2166 2301 2165 2298 2164 2019 2161 2295 2016 2160 2157 2013 2011 2290 2153 2008 2009 2151 2150 2284 2005 2147 2003 2000 2002 2404 1998 2276 1845 1840 1995 1841 1333 1335 1149  956  755  546  329  104
 182  615  403 1017 1016 1389 1208 1559 1881 1883 2030 2308 2173 2172 1876 2027 2305 2025 2024 2023 2022 2021 2162 2020 2018 2017 1865 2015 1863 1861 2154 2156 2010 2152 1857 1856 2149 1853 1854 2144 2280 2004 2141 2142 1999 2140 2139 1997 1843 1842 1511 1151 1336  957  756  547  330  105
 402  180  616  614 1019 1206  821 1725 1727 1882 1880 1554 1721 1877 2028 1875 2169 1874 1873 1872 1871 1870 1869 1868 1867 1866 1864 1862 1703 2012 2155 1860 1859 1858 1531 2006 2007 1695 1693 1694 2145 2001 1850 1849 1847 1519 1846 1844 1684 1680 1681 1337 1150  958  757  548  331  106
 181  820  401  817 1018 1205 1387 1386 1724 1563 1381 1555 1879 1719 1551 1718 1550 1715 1714 1713 1712 1711 1710 1709 1708 1707 1539 1706 1705 1537 1702 1700 1699 1698 1530 1697 1855 1696 1527 1525 1851 1852 1690 1687 1688 1686 1685 1516 1683 1682 1513 1152 1153  959  758  549  332  107
 178  819  613  400 1015 1385 1557 1560 1561 1723 1722 1553 1720 1379 1375 1716 1717 1549 1547 1546 1545 1544 1543 1184 1542 1538 1180 1363 1536 1704 1701 1534 1533 1357 1532 1355 1354 1529 1528 1692 1167 1689 1691 1848 1349 1521 1344 1518 1517 1514 1338 1339  961  960  759  550  333  108
 397  179  398  818 1203 1204 1558 1384 1383 1200 1556 1380 1378 1552 1003 1376 1374 1191 1189 1372 1370 1185 1369 1367 1541 1365  990 1362 1361 1178 1360 1535 1358 1174 1173 1356 1353 1170 1351 1352 1526 1524 1522 1164 1345 1520  970 1161 1157 1515 1340  965 1155  962  760  551  334  109
 612  176  399  611 1014 1013  810 1009  809 1199 1198 1197 1195 1192 1377 1194  592 1548 1373 1190 1188 1186  995 1368 1181 1540  991 1364 1182 1179 1359  786 1175  985  982 1172 1171  979 1169 1350 1166 1348 1347 1163 1346 1162 1343 1160 1159 1158 1341 1156  964 1154  761  552  335  110
 177  396  815 1012  816 1010 1202 1382  601 1007 1004 1196  806  803 1193 1001  801 1000  155  590  996 1371 1187 1366  992 1183  989  988  789  987  986  579 1177 1176  983  981  781  978  977 1168  976  975 1165  972  971  774  771  969  968  769 1342  765  963  764  762  553  336  111
 175  395  610  814  606 1011 1201  603 1008 1006  600  599 1005  804 1002  802  997  999  379  378  589  797  993  994  794  586  584  792  583  790  788  787  785  984  783  782  780  980  779  778  777  776 1523  974  973  775  773  772  562  561  967  767  766  557  763  554  337  112
 171  173  609  392  166  811  167  602  605  808  386  807  805  598  596  595  998  593  153  156  799  588  372  793  587  791  367  366  368  580  365  578  577  784  576  575  574  573  572  571  570  569  568  567  566  565  564  770  563  560  345  966  343  558  556  555  338  113
 172  174  394  607  390  813  608  389  388  387  385  384  383  597  382  381  380  800  375  152  798  376  371  795  149  369  147  370  146  143  581  364  363  362  361  360  359  358  357  356  355  354  353  352  351  350  125  348  347  768  346  559  342  119  341  340  339  114
 170  169  393  168  812  391  604  165  164  163  162  161  160  159  158  157  594  377  154  591  374  796  151  373  150  148  585  582  145  144  142  141  140  139  138  137  136  135  134  133  132  131  130  129  128  127  349  126  124  122  123  121  344  120  118  117  116  115
