# This puzzle is unsolvable
68
   2    1    3    4    5    6    7    8    9   10   11   12   13   14   15   16   17   18   19   20   21   22   23   24   26  292   28   30  299  297  300  560   35   34   36  302   38   40  305  308   42  309   43   44   45   46  314   47   48   50   51   52   54   55   56  322   62  586  584  326  587   63  839   64   65  331   68   66
 268  269  270  271  272  273  274  534  535  275  280  539  281  540  282  283  284  285  286  287  288  289  290  291   25  293   27  553  557   29   32  813  808   33  301  559  564  563  307  304  566  817  310  311  312  313  573  315  317  318  576  319   53  580  321  324   57   58 1077   61   60  330  328  329  333   67  332  334
 267  528  529  530  531  532  533  276  277  537  279  278  538  541  792  542  543  544  545  546  547  548  549  550  551  803  552  294  296  806  558   31  807  814 1056  303 1291  819  816  306   41  568  569  570  571  572  574  826   49  316  578  828  831  579  581  833 1080  323  585   59  840  327  591  842  590   69  592  335
 266  527  780  781  782  783  784  785  786  787    0  789  790  791 1035  793  794  795  796  797  798  799  800  801  802 1046  554  295  805  555  298  809 1288 1292  812 1290  815 1055   39  565  567  818 1298  820  821  822  824  575 1069 1071  827  577  830  320  832 1312  583  834  836  837 1081  838  588  594  336  841   71   70
 265  526  779 1024 1025 1026 1027 1028 1030  536  788 1031 1033 1034 1270 1036 1037 1038 1039 1040 1041 1042 1043 1044 1045 1284  804 1282 1049  556 1287 1050 1051  811  810 1053 1059  561 1058 1060 1294 1521 1061 1063 1064  823 1068  825 1070 1305 1072  829 1073 1075  325 1076  582 1078 1314  835 1317 1082 1083  589 1084  593  337   72
 264  525  778 1023 1260 1261 1262 1263 1029 1264 1265 1032 1496 1712 1268 1271 1272 1273 1274 1275 1276 1277 1278 1279 1280 1281 1283 1509 1048 1285 1286 1052 1515 1517 1735 1289 1057   37 1293 1523 1295 1062 1297 1299 1300 1066 1302 1067 1531 1304 1306 1307 1308 1074 1309 1310 1311 1313 1079 1542 1316 1315 1318  844  843  595  338   73
 263  777 1022 1021 1259 1488 1489 1490 1491 1493 1266 1267 1495 1269 1716 1498 1499 1500 1501 1502 1503 1504 1505 1506 1507 1508 1510 1047 1511 1732 1513 1512 1516 1736 1945 1054 1519 1739 1522 1296 1951 1524 1526 1527 1065 1747 1301 1303 1529 1532 1533 1534 1535 1536 1537 1538 1970 1539 1759 1543 1762 1544 1086 1085  845  596  339   74
 261  262  524  776 1486 1257 1487 1708 1711 1922 1494 1713 1714 1497 1715 1717 1718 1719 1720 1721 1722 1723 1724 1725 1726 1727 1728 1729 1730 1731 1942 1733 2531 1518 1738 1737 1949 1742 1520 1952 1741 1743 1525 1744 1528 1958 1960 1530 1749 1750 1752 1753 1754 1755 1756 1757 1541 1969 1540 1972 1761 1545 1319 1087  846  597  340   75
 523  521  522 1020 1258 1485 1707 1709 1710 1923 1492 1924 1925 1926 1927 1928 1929 1930 1931 1932 1933 1934 1935 1936 1937 1938 1939 1940 1941 2145 1514 2146 1734 1946 1948  562 1947 1740 2154 2351 2347 1956 1745 1957 1746 2161 1748 2163 1961 1751 1962 1964 1965 1967 2172 2365 2367 2171 1758 1763 1764 1546 1320 1088  847  598  341   76
 259  260  775 1019 1256 1706 1705 1920 1919 2125 2126 2127 2128 2129 2130 2131 2132 2133 2134 2135 2136 2137 2138 2139 2140 2141 2142 2143 2144 2147 2343 2529 2149 1944 2344 2153 2152 1950 2350 2156 1954 2539 2157 2159 2160 2356 1959 2162 2164 2165 1963 2166 2167 2732 1966 1968 2557 1971 1760 2174 1973 1547 1321 1322  342  599   77   78
 520  774  771 1018 1255 1484 1918 2124 2123 1921 2321 2322 2323 2324 2325 2326 2327 2328 2329 2330 2331 2332 2333 2334 2335 2336 2337 2338 2339 2340 2341 2530 2342 2148 2151 2150 2346 2348 2537 2536 1953 2352 2717 1955 2158 2355 2357 2358 2359 2360 2362 2363 2168 2729 2169 2364 2368 2173 2175 1974 1765 1548  848  849 1089  343  601  344
 258  519  518  772 1254 1482 1483 1704 2122 2320 2508 2509 2510 2511 2512 2513 2514 2515 2516 2517 2518 2519 2520 2521 2522 2523 2703 2524 2525 2527 2528 2707 2708 1943 2710 2533 2534 2535 2155 2349 2888 2538 2719 2354 2542 2543 2544 2546 2725 2547 2361 2549 2550 2551 2366 2552 2370 2369 2176 1975 1766 1549 1323 1324  600  602  850   79
 257  773 1017 1016 1253 1703 1702 1917 2318 2319 2507 2688 2689 2690 2691 2692 2693 2694 2695 2696 2697 2698 2699 2700 2701 2702 2875 2874 2526 2877 2706 3043 2709 2345 2532 2882 2713 2714 3048 2715 2540 3054 2353 2890 2721 2722 2724 2545 2897 2898 2548 2728 2901 2553 2554 2730 2170 2555 2177 1977 1767 1550 1091  851 1090   80  347  345
 256  517  770 1015 1252 1481 1915 2121 1916 2317 2506 2687 2860 2861 2862 2863 2864 2865 2866 2867 2868 2869 2870 2871 2872 3036 2873 2704 2705 2876 2878 2879 3198 2881 2711 2712 2884 2885 3049 2886 2718 2889 2541 2892 2893 2894 2723 2895 3059 2726 3214 2899 3063 2900 2734 2735 2733 2556 2371 1768 1976 1092 1327 1093  605  604  852   81
 255  516  769 1014 1251 1480 1701 1914 2120 2316 2505 2686 2859 3024 3025 3026 3027 3028 3029 3030 3031 3032 3033 3034 3338 3191 3192 3038 3194 3040 3044 3042 2880 3045 3200 2883 3047 3050 2716 3206 3207 3053 2720 2891 3055 3056 3213 3058 3215 3060 2727 3062 3064 2731 2903 2902 2372 2373 2178 1978 1769 1551 1325 1096 1095   83   82  346
 254  515  768 1013 1250 1479 1700 1913 2119 2118 2315 2685 2858 3023 3180 3327 3181 3183 3184 3185 3186 3187 3188 3189 3335 3037 3340 3039 3193 3195 3041 3344 3197 3347 3201 3046 3202 3203 3204 3052 2887 3051 3355 3208 3210 3357 3212 3211 3216 3061 2896 3217 3218 3065 2905 2904 2558 2374 2179 2180 1979 1552 1770 1326 1094  856  603  348
 253  514  767 1012 1249 1478 1699 1912 2117 2314 2504 2856 2683 2857 3022 3179 3182 3331 3469 3332 3472 3333 3334 3475 3035 3337 3478 3339 3341 3342 3196 3343 3345 3199 3348 3349 3489 3490 3351 3205 3352 3353 3354 3209 3497 3496 3358 3359 3057 3362 3363 3364 3219 3066 2736 2737 2559 2375 2181 1980 1771 1554 1328 1553  854  853  606   84
 252  513  766 1011 1248 1477 1698 1911 2116 2313 2503 2682 2684 3021 3178 3329 3328 3330 3601 3470 3602 3603 3476 3190 3336 3608 3477 3479 3480 3482 3612 3483 3484 3346 3485 3486 3488 3620 3350 3491 3492 3493 3494 3626 3495 3356 3499 3360 3361 3501 3502 3365 3220 3067 2906 2738 2560 2182 1981 1982 1772 1555 1097 1329  607  855  608   85
 251  512  765 1010 1247 1476 1697 1910 2115 2312 2502 2501 2855 3020 3177 3326 3468 3467 3600 3604 3471 3473 3474 3606 3730 3607 3609 3610 3611 3735 3481 3613 3615 3618 3741 3487 3619 3743 3621 3622 3623 3624 3748 3625 3627 3628 3498 3630 3500 3631 3632 3366 3221 3068 2907 2561 2376 2183 2377 1983 1773 1556 1330 1331  857  350  349   87
 250  511  764 1009 1246 1475 1696 1909 2114 2311 2500 2681 2854 3019 3176 3325 3466 3599 3724 3725 3726 3727 3605 3729 3731 3846 3732 3733 3734 3850 3736 3614 3737 3616 3740 3617 3742 3858 3744 3745 3746 3747 3749 3864 3750 3751 3629 3753 3754 3633 3503 3367 3222 2908 2739 2562 2563 2378 2185 2184 1774 1557 1099 1098  609  610   86  351
 249  510  763 1008 1245 1474 1695 1908 2113 2310 2499 2680 2853 3018 3175 3324 3465 3598 3723 3840 3841 3842 3728 3950 3844 3845 3847 3848 3956 3849 3852 3959 3853 3738 3739 3854 3855 3857 3859 3860 3861 3862 3863 3865 3972 3866 3752 3867 3755 3634 3504 3368 3070 3069 2909 2740 2564 2379 2187 1984 1775 1334 1332 1333  858  352  354   89
 248  509  762 1007 1244 1473 1694 1907 2112 2309 2498 2679 2852 3017 3174 3323 3464 3597 3722 3839 3948 3949 3951 3843 3952 3953 3954 3955 4055 3957 3851 4058 3961 3962 4061 3856 3963 3966 3967 4066 4067 3968 3970 3971 3973 3869 3868 3756 3635 3506 3505 3224 3223 3071 2910 2741 2565 2186 1985 1986 1776 1558 1102 1100 1101  859  611  353
 247  508  761 1006 1243 1472 1693 1906 2111 2308 2497 2678 2851 3016 3173 3322 3463 3596 3721 3838 3947 4048 4049 4050 4051 4052 4053 4054 4056 4057 3958 4149 3960 4060 4062 4154 4064 3965 3964 4065 4157 3969 4069 4070 4071 4072 3974 3870 3757 3636 3758 3370 3225 3072 2912 2911 2567 2380 2188 1988 1777 1559 1335  860  862  612   88   90
 246  507  760 1005 1242 1471 1692 1905 2110 2307 2496 2677 2850 3015 3172 3321 3462 3595 3720 3837 3946 4047 4140 4141 4142 4143 4144 4145 4146 4147 4148 4150 4059 4151 4152 4063 4155 4311 4156 4158 4159 4068 4160 4161 4162 4073 3975 3872 3871 3507 3369 3226 3227 3073 3074 2913 2742 2381 1987 2189 1778 1560 1103  861  863  613   92   91
 245  506  759 1004 1241 1470 1691 1904 2109 2306 2495 2676 2849 3014 3171 3320 3461 3594 3719 3836 3945 4046 4139 4224 4225 4226 4227 4228 4229 4230 4231 4232 4233 4234 4236 4153 4313 4239 4314 4240 4241 4242 4243 4244 4163 4074 3976 3638 3759 3509 3371 3372 3373 3075 2914 2743 2744 2566 2191 1779 1561 1336 1562 1104 1337  614  356  355
 244  505  758 1003 1240 1469 1690 1903 2108 2305 2494 2675 2848 3013 3170 3319 3460 3593 3718 3835 3944 4044 4300 4301 4221 4367 4302 4303 4304 4305 4306 4307 4308 4309 4235 4237 4310 4238 4381 4316 4317 4318 4384 4246 4245 3979 3977 3978 3873 3637 3508 3229 3228 3077 3076 2745 2568 2382 1990 1989 1563 1105 1338  864  615  616  357  359
 243  504  757 1002 1239 1468 1689 1902 2107 2304 2493 2674 2847 3012 3169 3318 3459 3592 3717 3834 3943 4138 4223 4045 4368 4299 4369 4370 4371 4372 4373 4374 4376 4436 4434 4378 4312 4440 4491 4315 4383 4443 4319 4321 4164 4165 4075 3760 3640 3639 3510 3230 3374 3231 2915 2746 2569 2190 2383 2192 1780 1564 1339 1106  866  617   94  358
 242  503  756 1001 1238 1467 1688 1901 2106 2303 2492 2673 2846 3011 3168 3317 3458 3591 3716 3833 3942 4043 4137 4135 4222 4366 4428 4480 4429 4430 4482 4432 4375 4377 4437 4438 4490 4380 4441 4385 4382 4442 4248 4320 4077 4076 3875 3874 3762 3761 3511 3642 3512 3078 2916 2747 2570 2384 2193 1992 1994 1782 1340 1341 1107   93   95  361
 241  502  755 1000 1237 1466 1687 1900 2105 2302 2491 2672 2845 3010 3167 3316 3457 3590 3715 3832 3941 4041 4136 4220 4298 4296 4427 4479 4481 4431 4483 4484 4433 4435 4487 4488 4439 4379 4492 4570 4322 4386 4323 4247 4168 4167 3980 3879 3876 3641 3513 3376 2917 3232 2918 2748 2571 2385 2388 1343 1991 1781 1565 1108  865  619  360  363
 240  501  754  999 1236 1465 1686 1899 2104 2301 2490 2671 2844 3009 3166 3315 3456 3589 3713 3714 3831 4042 3939 4219 4218 4297 4365 4426 4524 4525 4526 4527 4485 4486 4528 4532 4489 4567 4533 4389 4493 4388 4249 4166 4169 4078 4079 3981 3982 3763 3645 3514 3375 3079 2919 2749 2387 2386 1995 1342 1566 1783 1570  868  618  620  362   96
 239  500  753  998 1235 1464 1685 1898 2103 2300 2489 2670 2843 3008 3165 3314 3455 3587 3588 3830 3940 4132 4134 4133 4363 4295 4425 4478 4559 4523 4561 4562 4529 4591 4565 4531 4566 4536 4534 4495 4387 4494 4324 3983 4250 4170 3877 3643 3764 3766 3517 3233 3377 3234 3080 2750 2572 1993 2194 1567 1786 1785 1568 1112  869  621   98   97
 238  499  752  997 1234 1463 1684 1897 2102 2299 2488 2669 2842 3007 3164 3313 3454 3712 3829 3938 4039 4217 4040 4294 4293 4424 4477 4522 4560 4588 4586 4587 4564 4593 4612 4530 4614 4594 4568 4535 4390 4444 4325 4251 4171 4080 3984 3765 3878 3516 3644 3379 2920 2922 3081 2574 2573 2195 2196 2389 1784 1344  870 1109  867  622  364   99
 237  498  751  996 1233 1462 1683 1896 2101 2298 2487 2668 2841 3006 3163 3312 3453 3586 3711 3828 3937 4038 4131 4216 4362 4364 4423 4476 4521 4558 4585 4609 4563 4590 4592 4571 4595 4569 4496 4497 4446 4445 4326 4252 4082 4081 3985 3880 3767 3646 3378 3515 3235 3083 2921 2751 2575 2390 2391 1787 2197 1571 1569 1110  871 1113  365  100
 236  497  750  995 1232 1461 1682 1895 2100 2297 2486 2667 2840 3005 3162 3311 3452 3585 3710 3827 3936 4037 4130 4215 4292 4361 4422 4475 4520 4557 4608 4589 4622 4607 4611 4610 4596 4613 4538 4537 4392 4447 4327 4253 4172 4083 3986 3881 3768 3647 3518 3082 3237 3086 2923 2752 2576 2392 2200 2198 1996 1345 1111 1346 1114  872  366  101
 235  496  749  994 1231 1460 1681 1894 2099 2296 2485 2666 2839 3004 3161 3310 3451 3584 3709 3826 3935 4036 4129 4214 4291 4360 4421 4474 4519 4556 4606 4620 4621 4619 4623 4600 4572 4539 4500 4498 4391 4329 4330 4174 4173 4084 3987 3769 3770 3648 3382 3380 3381 3241 2754 2755 2753 2393 2199 2201 1997 1999  873 1115  624  623  367  102
 234  495  748  993 1230 1459 1680 1893 2098 2295 2484 2665 2838 3003 3160 3309 3450 3583 3708 3825 3934 4035 4128 4213 4290 4359 4420 4473 4518 4555 4584 4605 4618 4617 4616 4615 4597 4576 4573 4540 4449 4452 4394 4254 4257 4085 3988 3882 3649 3519 3520 3084 3085 2926 3239 2577 2756 2202 2203 1998 1788 1789 1347 1348  874  625  368  103
 233  494  747  992 1229 1458 1679 1892 2097 2294 2483 2664 2837 3002 3159 3308 3449 3582 3707 3824 3933 4034 4127 4212 4289 4358 4419 4472 4517 4554 4583 4604 4603 4602 4601 4598 4577 4499 4541 4451 4448 4395 4450 4178 4176 4255 3885 3883 3521 3650 3384 3236 3383 3238 2924 2581 2394 1790 1791 2001 1574 1572 1349 1573  626  627  369  104
 232  493  746  991 1228 1457 1678 1891 2096 2293 2482 2663 2836 3001 3158 3307 3448 3581 3706 3823 3932 4033 4126 4211 4288 4357 4418 4471 4516 4553 4582 4581 4580 4579 4578 4599 4574 4575 4542 4501 4453 4393 4256 4328 4087 4086 3989 3884 3990 3387 3522 3240 3385 2925 3242 2578 2579 2582 2396 2580 1350 1575 1351 1116  370  105  106  107
 231  492  745  990 1227 1456 1677 1890 2095 2292 2481 2662 2835 3000 3157 3306 3447 3580 3705 3822 3931 4032 4125 4210 4287 4356 4417 4470 4515 4552 4551 4550 4549 4548 4547 4546 4544 4458 4545 4543 4502 4396 4331 4177 4175 4088 3992 3886 3991 3771 3652 3523 3088 3386 3089 3087 2757 2000 2395 1576 1354 1793 1352  876  875  628  629  371
 230  491  744  989 1226 1455 1676 1889 2094 2291 2480 2661 2834 2999 3156 3305 3446 3579 3704 3821 3930 4031 4124 4209 4286 4355 4416 4469 4514 4513 4512 4511 4510 4509 4508 4507 4506 4504 4503 4456 4333 4397 4179 4259 4258 3993 3774 3772 3654 3651 3775 3524 3388 2928 2927 2929 2758 2205 1792 2206 1795 2002 1118 1794  877  630  878  372
 229  490  743  988 1225 1454 1675 1888 2093 2290 2479 2660 2833 2998 3155 3304 3445 3578 3703 3820 3929 4030 4123 4208 4285 4354 4415 4468 4467 4466 4465 4464 4463 4462 4406 4461 4505 4459 4403 4454 4263 4398 4090 4260 3888 3776 4089 3994 3653 3528 3525 3390 3091 2761 2584 2762 2759 2583 2004 2003 1796  879 1119 1117 1353 1120  373  108
 228  489  742  987 1224 1453 1674 1887 2092 2289 2478 2659 2832 2997 3154 3303 3444 3577 3702 3819 3928 4029 4122 4207 4284 4353 4414 4413 4412 4411 4410 4409 4408 4407 4343 4460 4405 4341 4402 4455 4401 4336 4335 4334 4180 3995 3890 3889 3773 3655 3389 3244 3243 3092 2760 3090 2397 2398 2207 1581 1578 1577 2204 1123 1121  631  374  109
 227  488  741  986 1223 1452 1673 1886 2091 2288 2477 2658 2831 2996 3153 3302 3443 3576 3701 3818 3927 4028 4121 4206 4283 4352 4351 4350 4349 4348 4347 4346 4345 4344 4272 4342 4404 4340 4457 4262 4400 4332 4264 4182 4091 4092 4093 3887 3656 3526 3657 2930 3245 3094 2931 2585 2400 2586 2006 1580 1797 2005 1582 1122  880  632  375  110
 226  487  740  985 1222 1451 1672 1885 2090 2287 2476 2657 2830 2995 3152 3301 3442 3575 3700 3817 3926 4027 4120 4205 4282 4281 4280 4279 4278 4277 4276 4275 4273 4193 4195 4192 4190 4270 4266 4339 4399 4338 4265 4181 4261 3998 3996 3997 3777 3778 3527 3392 3391 3093 2932 2763 2401 2403 2399 2007 1798 1357 1356 1355  882  633  376  111
 225  486  739  984 1221 1450 1671 1884 2089 2286 2475 2656 2829 2994 3151 3300 3441 3574 3699 3816 3925 4026 4119 4204 4203 4202 4201 4200 4199 4198 4197 4196 4194 4108 4105 4271 4191 4269 4268 4189 4337 4100 4185 4095 4096 4094 3891 3780 3892 3530 3246 3248 3393 3529 2933 2764 2587 2402 2208 2008 1799  883 1579 1358  884  634  377  112
 224  485  738  983 1220 1449 1670 1883 2088 2285 2474 2655 2828 2993 3150 3299 3440 3573 3698 3815 3924 4025 4118 4117 4116 4115 4114 4113 4112 4111 4110 4109 4107 4274 4106 4104 4103 4102 4101 4188 4006 4004 4184 4099 4001 3999 3893 3898 3659 3779 3658 3247 3249 3097 3095 2766 2935 2590 2209 2009 1800  881 1583 1124 1125  635  378  113
 223  484  737  982 1219 1448 1669 1882 2087 2284 2473 2654 2827 2992 3149 3298 3439 3572 3697 3814 3923 4024 4023 4022 4021 4020 4019 4018 4017 4016 4015 4014 4013 4012 4011 4010 4009 3906 3904 4267 4187 3901 4183 3900 4186 4000 3894 3666 3895 3781 3531 3394 2934 3096 2936 2588 2765 2211 2210 2010 1801 1584 1359 1126  885  636  379  114
 222  483  736  981 1218 1447 1668 1881 2086 2283 2472 2653 2826 2991 3148 3297 3438 3571 3696 3813 3922 3921 3920 3919 3918 3917 3916 3915 3914 3913 3912 3911 3910 3909 3908 3907 4008 3903 3905 3792 3790 4003 4097 4002 4098 3896 3786 3782 3665 3662 3660 3395 3250 2937 3098 2589 2591 2404 2212 2011 1802 1585 1360 1127  886  637  380  115
 221  482  735  980 1217 1446 1667 1880 2085 2282 2471 2652 2825 2990 3147 3296 3437 3570 3695 3812 3811 3810 3809 3808 3807 3806 3805 3804 3803 3802 3801 3800 3799 3798 3797 3796 3795 3794 3902 4005 3793 3789 3546 3788 3897 3783 3784 3661 3664 3532 3533 3396 3252 3251 2768 2767 2406 2405 2213 2012 1803 1586 1361 1128  887  638  381  116
 220  481  734  979 1216 1445 1666 1879 2084 2281 2470 2651 2824 2989 3146 3295 3436 3569 3694 3693 3692 3691 3690 3689 3688 3687 3686 3685 3684 3683 3682 3681 3680 3679 3678 3677 3676 3675 3674 4007 3673 3545 3669 3671 3787 3667 3539 3785 3663 3536 3534 3397 3253 3099 2938 2769 2592 2214 2013 1806 2014 1587 1362 1129  888  639  382  117
 219  480  733  978 1215 1444 1665 1878 2083 2280 2469 2650 2823 2988 3145 3294 3435 3568 3567 3566 3565 3564 3563 3562 3561 3560 3559 3558 3557 3556 3555 3554 3553 3552 3551 3550 3549 3548 3411 3791 3410 3672 3542 3543 3407 3668 3540 3538 3537 3399 3258 3535 3254 3100 2939 2770 2594 2408 2215 2593 1804 1589 1363 1130  889  640  383  118
 218  479  732  977 1214 1443 1664 1877 2082 2279 2468 2649 2822 2987 3144 3293 3434 3433 3432 3431 3430 3429 3428 3427 3426 3425 3424 3423 3422 3421 3420 3419 3418 3417 3416 3415 3414 3413 3547 3412 3269 3670 3544 3899 3406 3541 3404 3403 3402 3257 3401 3398 3101 2940 2941 2771 2407 2595 1805 2217 1588 1591 1364 1131  890  641  384  119
 217  478  731  976 1213 1442 1663 1876 2081 2278 2467 2648 2821 2986 3143 3292 3291 3290 3289 3288 3287 3286 3285 3284 3283 3282 3281 3280 3279 3278 3277 3276 3275 3274 3273 3272 3271 3270 3118 3116 3267 3266 3265 3408 3405 3263 3261 3109 3260 3259 3400 3256 3104 3255 3102 2772 2015 2409 2216 2017 1590 1807 1365 1132  891  642  385  120
 216  477  730  975 1212 1441 1662 1875 2080 2277 2466 2647 2820 2985 3142 3141 3140 3139 3138 3137 3136 3135 3134 3133 3132 3131 3130 3129 3128 3127 3126 3125 3124 3123 3122 3121 3120 3119 3268 2958 3409 3115 3114 3264 3113 3262 3111 3110 3108 3107 2946 3106 3103 2942 2943 2773 2411 2410 2218 2016 1810 1809 1366 1133  892  643  386  121
 215  476  729  974 1211 1440 1661 1874 2079 2276 2465 2646 2819 2984 2983 2982 2981 2980 2979 2978 2977 2976 2975 2974 2973 2972 2971 2970 2969 2968 2967 2966 2965 2964 2963 2962 2961 2960 2959 2791 3117 2956 2787 2954 2952 2953 2609 2951 2949 2781 2947 3105 2945 2777 2944 2596 2774 2412 2220 2219 2018 1808 1367 1134  893  644  387  122
 214  475  728  973 1210 1439 1660 1873 2078 2275 2464 2645 2818 2817 2816 2815 2814 2813 2812 2811 2810 2809 2808 2807 2806 2805 2804 2803 2802 2801 2800 2799 2798 2797 2796 2795 2794 2793 2617 2792 2957 2955 2613 2788 3112 2611 2950 2784 2608 2948 2782 2780 2779 2778 2776 2600 2597 2775 2413 2019 1593 1592 1368 1135  894  645  388  123
 213  474  727  972 1209 1438 1659 1872 2077 2274 2463 2644 2643 2642 2641 2640 2639 2638 2637 2636 2635 2634 2633 2632 2631 2630 2629 2628 2627 2626 2625 2624 2623 2622 2621 2620 2619 2618 2434 2616 2789 2612 2239 2614 2786 2785 2610 2607 2783 2606 2605 2604 2603 2602 2601 2417 2599 2598 2221 2020 1811 1594 1369 1136  895  646  389  124
 212  473  726  971 1208 1437 1658 1871 2076 2273 2462 2461 2460 2459 2458 2457 2456 2455 2454 2453 2452 2451 2450 2449 2448 2447 2446 2445 2444 2443 2442 2441 2440 2439 2438 2437 2436 2435 2433 2432 2790 2430 2615 2429 2428 2427 2426 2425 2424 2423 2422 2421 2420 2419 2418 2226 2415 2414 2222 2021 1812 1595 1370 1137  896  647  390  125
 211  472  725  970 1207 1436 1657 1870 2075 2272 2271 2270 2269 2268 2267 2266 2265 2264 2263 2262 2261 2260 2259 2258 2257 2256 2255 2254 2253 2252 2251 2250 2249 2248 2247 2246 2245 2244 2243 2242 2241 2431 2240 2238 2237 2236 2235 2234 2233 2232 2231 2230 2229 2228 2227 2027 2416 2224 2223 2022 1813 1596 1371 1138  897  648  391  126
 210  471  724  969 1206 1435 1656 1869 2074 2073 2072 2071 2070 2069 2068 2067 2066 2065 2064 2063 2062 2061 2060 2059 2058 2057 2056 2055 2054 2053 2052 2051 2050 2049 2048 2047 2046 2045 2044 2043 2042 2041 2040 2039 2038 2037 2036 2035 2034 2033 2032 2031 2030 2029 2028 1820 2225 2025 2024 2023 1814 1597 1372 1139  898  649  392  127
 209  470  723  968 1205 1434 1655 1868 1867 1866 1865 1864 1863 1862 1861 1860 1859 1858 1857 1856 1855 1854 1853 1852 1851 1850 1849 1848 1847 1846 1845 1844 1843 1842 1841 1840 1839 1838 1837 1836 1835 1834 1833 1832 1831 1830 1829 1828 1827 1826 1825 1824 1823 1822 1821 1819 2026 1818 1817 1816 1815 1598 1373 1140  899  650  393  128
 208  469  722  967 1204 1433 1654 1653 1652 1651 1650 1649 1648 1647 1646 1645 1644 1643 1642 1641 1640 1639 1638 1637 1636 1635 1634 1633 1632 1631 1630 1629 1628 1627 1626 1625 1624 1623 1622 1621 1620 1619 1618 1617 1616 1615 1614 1613 1612 1611 1610 1609 1608 1607 1606 1605 1604 1603 1602 1601 1600 1599 1374 1141  900  651  394  129
 207  468  721  966 1203 1432 1431 1430 1429 1428 1427 1426 1425 1424 1423 1422 1421 1420 1419 1418 1417 1416 1415 1414 1413 1412 1411 1410 1409 1408 1407 1406 1405 1404 1403 1402 1401 1400 1399 1398 1397 1396 1395 1394 1393 1392 1391 1390 1389 1388 1387 1386 1385 1384 1383 1382 1381 1380 1379 1378 1377 1376 1375 1142  901  652  395  130
 206  467  720  965 1202 1201 1200 1199 1198 1197 1196 1195 1194 1193 1192 1191 1190 1189 1188 1187 1186 1185 1184 1183 1182 1181 1180 1179 1178 1177 1176 1175 1174 1173 1172 1171 1170 1169 1168 1167 1166 1165 1164 1163 1162 1161 1160 1159 1158 1157 1156 1155 1154 1153 1152 1151 1150 1149 1148 1147 1146 1145 1144 1143  902  653  396  131
 205  466  719  964  963  962  961  960  959  958  957  956  955  954  953  952  951  950  949  948  947  946  945  944  943  942  941  940  939  938  937  936  935  934  933  932  931  930  929  928  927  926  925  924  923  922  921  920  919  918  917  916  915  914  913  912  911  910  909  908  907  906  905  904  903  654  397  132
 204  465  718  717  716  715  714  713  712  711  710  709  708  707  706  705  704  703  702  701  700  699  698  697  696  695  694  693  692  691  690  689  688  687  686  685  684  683  682  681  680  679  678  677  676  675  674  673  672  671  670  669  668  667  666  665  664  663  662  661  660  659  658  657  656  655  398  133
 203  464  463  462  461  460  459  458  457  456  455  454  453  452  451  450  449  448  447  446  445  444  443  442  441  440  439  438  437  436  435  434  433  432  431  430  429  428  427  426  425  424  423  422  421  420  419  418  417  416  415  414  413  412  411  410  409  408  407  406  405  404  403  402  401  400  399  134
 202  201  200  199  198  197  196  195  194  193  192  191  190  189  188  187  186  185  184  183  182  181  180  179  178  177  176  175  174  173  172  171  170  169  168  167  166  165  164  163  162  161  160  159  158  157  156  155  154  153  152  151  150  149  148  147  146  145  144  143  142  141  140  139  138  137  136  135
