# This puzzle is unsolvable
37
 145  144    1    4    5  149    6    9  289  152   11   12   13   14   15   16   17   18   19   20  165   21   25   24  168   27  170   28   29   30  174   31   34  176   35   37   38
   2    3  146  147  409  283  148    7  288  532  153  155  156  157  158  159  160  161  163  164  298   23   22  303  430   26  171  307  172  173  308   32   33  177  313   36   40
 142  143  282  411  641  284    8  151   10  534  414  290  291  292  293  294  295  296  162  297  544  428  167  427  166  169  305  306  553  434  435  310  440  315  180   39  179
 141  408  281  529  531  530  285  150  286  154  287  416  418  419  538  420  850  421  424  543  425  299  300  547  550  304  432  549  433  437  175  311  178  557  316  181  182
 280  407  279  528  643  639  412  644  747  415  535  417  648  649  537  541  650  651  542  653  759  659  657  302  431  660  552  662  309  664  554  438  558  184  439  314   41
 140  276  275  278  640  841  410  413  533  645  748  536  752  755  751  539  422  654  545  760  546  762  301 1026  763  856  860  765  767  312  436  442  555   43  441  317   42
 139  405  277  527  526  744  743  842  642  844  646  647  753  754  847  652  938  423  853  854  426  761  429  943  658  551  766  861  663  863  769  666  556  559   45  319  318
 273  274  524  523  525  137  840  746  843  749 1010  845  846 1012  750  758  851  655  656  940 1092 1020  548  859  945  949 1099 1027  768  862  667  865  671  668   46  560  183
 401  404  406  838  739  135  839  745  928  930  932 1013 1014 1084  756  934  849  939  757 1021  941 1023  942  858 1024  661  944 1030  948  665  561  772  669  563  320  186   44
 402  271  403  638  837  522  927  929 1008  931 1009 1082  933  935  848  936  540  852 1019 1018 1091 1022  855 1095 1158  947  764  775  771  770  773  444  564  448  321  185  445
 272  400  741  742  635  634  636 1007 1079 1081 1144 1145 1011 1147 1289 1149 1016 1088  937 1017 1089 1154 1210  857 1157 1025 1029  950  867  670  951  565  189  443  672  324   47
 133  136  134  520  521  740  637  925  926 1080 1146 1201 1083 1086 1206 1015 1151 1087 1252 1207 1255 1153 1156 1028 1161 1097  953 1096  946  864  866  674  447  322  187   48  190
 270  269  519  398  399  835  836 1005 1006 1078 1200 1142 1203 1249 1150 1205 1291 1152 1253 1090 1208 1215 1094 1093 1213 1032 1159 1098  868  774  562  777  449  566  452  188   49
 138  633  268  632  737  738  924  923 1004 1076 1143 1077 1248 1287 1085 1148 1254 1251 1323 1209 1293 1256 1258 1212 1214 1100 1216 1101  872  673  675  676  677  446   54   50  193
 132  130  631  517  518  736  834  832 1003 1141 1140 1199 1246 1250 1204 1286 1324 1326 1295 1296 1298 1155 1328 1260 1301 1031 1164  954  781  956  871  776  323  451   52   55  192
 267  131  397  629  630  735  831  833  921 1001 1075 1198 1197 1247 1202 1290 1342 1322 1292 1294 1257 1217 1261 1162 1259 1211 1102 1160  955  957 1033  778  326  450  327  325  329
 129  396  395  516  265  734  920  922 1000 1002 1139 1196 1320 1319 1288 1358 1345 1347 1325 1362 1329 1297 1299 1219 1104 1262 1163  952  873  678  870  869  679  191  568  194   53
 128  266  393  515  628  733  918  829  919 1072 1138 1244 1245 1321 1343 1344 1346 1364 1354 1300 1327 1367 1351 1352 1218 1165  960  958 1105 1035  779   51  453  196  567  328  195
 127  264  263  627  513  732  830  917  999 1074 1137 1195 1243 1284 1285 1318 1316 1360 1363 1361 1348 1266 1222 1349 1264 1263 1103 1034 1166  569  959  782  570  875  197  198   56
 126  262  514  392  394  731  828  916  998 1073 1136 1194 1242 1283 1317 1341 1359 1356 1368 1350 1332 1333 1267 1353 1265 1220 1037 1036 1038  681  780  454  571  455  874  573  330
 125  391  512  625  626  730  827  997  996 1071 1135 1193 1192 1241 1282 1315 1340 1366 1336 1365 1221 1330 1302 1303 1167 1168 1106  961  877  683  682  458  680  574  572  331   57
 124  261  390  511  624  729  826  914  915 1070 1069 1134 1240 1281 1314 1339 1357 1311 1307 1334 1308 1306 1273 1227 1304 1108 1107  963  876 1040  783  457  684  575  332  200  199
 123  260  389  510  623  728  824  825  912 1068 1191 1132 1239 1280 1313 1309 1338 1355 1310 1331 1305 1270 1178 1268 1223 1170 1109 1041  962  785  879  784  878  456  333  203   58
 122  259  388  509  622  727  823  994 1067  995 1133 1238 1279 1236 1235 1312 1337 1233 1232 1274 1335 1271 1226 1225 1269 1169 1110 1039  788  687  686  786  576  459  334   59  201
 121  258  387  508  621  726  822  913  993 1131 1188 1237 1187 1277 1234 1278 1183 1275 1276 1229 1176 1119 1272 1115 1175 1224 1111  964  787  880  685  460  337   63   62  335  577
 120  257  386  507  620  725  911  992 1065 1066 1189 1190 1185 1126 1184 1123 1181 1180 1054 1230 1177 1228 1174 1171 1114 1172 1112 1042  967  965  966  881  339  462  202  461   60
 119  256  385  506  619  724  821  910  991 1064 1130 1129 1128  983 1059 1124 1182 1122 1055 1179 1231 1117 1050 1116 1048 1113 1043 1173  883  789  968  688  338  578  581  206   61
 118  255  384  505  618  820  909  990  908 1063  985 1061 1062 1058 1060  981 1056 1121  979 1053 1118 1052 1049  973  799 1046  890  882 1045  792  579  690  341  204  340   64  207
 117  254  383  617  722  723  818  907  989  988  904 1186  987  901 1057 1125  982  980  896 1120  978  894  892  975  974  972 1047  886  887  970  689  793  209  580  342  468  205
 116  253  382  504  503  616  721  906  819  905  986  903 1127  900  809  984  898  897  805  895  977  976 1051  800  891  699  795 1044  969  885  587  884  464  582   65   66  336
 115  252  381  502  615  720  817  609  815  814  813  902  604  811  810  899  807  806  706  804  803  802  893  798  700  594  889  796  794  697  586  463  791  584   69  208  466
 114  251  380  501  614  719  718  816  494  716  812  715  712  710  709  808  708  600  705  598  703  481  701  801  595    0  698  691  971  476  695  583  692  345  348   70  344
 113  250  379  500  613  497  612  608  610  714  492  713  711  606  603  602  601  599  707  597  482  704  596  593  702  591  888  797  475  589  696  790  465  585  469  210   67
 112  249  378  499  498  611  496  371  717  493  491  607  605  490  488  487  486  485  484  483  359  357  479  225  478  592  353  590  474  588  472  473  693  214  467   74   68
 111  248  377  376  375  374  373  495  372  370  369  366  365  489  367   94  232  363  361  360  358  480   87  226  355  477  222  352  351  217   76  349  694  471  343   73  212
 110  247  246  245  244  243  242  241  240  239  237  368  236   97   96  364  233  362  231  230  229  227   86   85  356  354   83  221  220   79  350  211  470  215  216   72  213
 109  108  107  106  105  104  103  102  101  100  238   99   98   95  234  235   93   92   91   90  228   89   88  224   82  223   84   81  219  218   77  347   80   78  346   71   75
