# This puzzle is unsolvable
73
   2    1    3    4    5    6    7    8    9   10   11   12   13   14   15   16   17   18   19   20   21   22   23   24   25   26   27   28   29   30   31   32   33   34   35   36   37   38   39   40   41   42   43   44   45   46   47   48   49   50   51   52   53   54   55   56   57   58   59   60   61   62   63   64   65   66   67   68   69   70   71   72   73
 288  289  290  291  292  293  294  295  296  297  298  299  300  301  302  303  304  305  306  307  308  309  310  311  312  313  314  315  316  317  318  319  320  321  322  323  324  325  326  327  328  329  330  331  332  333  334  335  336  337  338  339  340  341  342  343  344  345  346  347  348  349  350  351  352  353  354  355  356  357  358  359   74
 287  568  569  570  571  572  573  574  575  576  577  578  579  580  581  582  583  584  585  586  587  588  589  590  591  592  593  594  595  596  597  598  599  600  601  602  603  604  605  606  607  608  609  610  611  612  613  614  615  616  617  618  619  620  621  622  623  624  625  626  627  628  629  630  631  632  633  634  635  636  637  360   75
 286  567  840  841  842  843  844  845  846  847  848  849  850  851  852  853  854  855  856  857  858  859  860  861  862  863  864  865  866  867  868  869  870  871  872  873  874  875  876  877  878  879  880  881  882  883  884  885  886  887  888  889  890  891  892  893  894  895  896  897  898  899  900  901  902  903  904  905  906  907  638  361   76
 285  566  839 1104 1105 1106 1107 1108 1109 1110 1111 1112 1113 1114 1115 1116 1117 1118 1119 1120 1121 1122 1123 1124 1125 1126 1127 1128 1129 1130 1131 1132 1133 1134 1135 1136 1137 1138 1139 1140 1141 1142 1143 1144 1145 1146 1147 1148 1149 1150 1151 1152 1153 1154 1155 1156 1157 1158 1159 1160 1161 1162 1163 1164 1165 1166 1167 1168 1169  908  639  362   77
 284  565  838 1103 1360 1361 1362 1363 1364 1365 1366 1367 1368 1369 1370 1371 1372 1373 1374 1375 1376 1377 1378 1379 1380 1381 1382 1383 1384 1385 1386 1387 1388 1389 1390 1391 1392 1393 1394 1395 1396 1397 1398 1399 1400 1401 1402 1403 1404 1405 1406 1407 1408 1409 1410 1411 1412 1413 1414 1415 1416 1417 1418 1419 1420 1421 1422 1423 1170  909  640  363   78
 283  564  837 1102 1359 1608 1609 1610 1611 1612 1613 1614 1615 1616 1617 1618 1619 1620 1621 1622 1623 1624 1625 1626 1627 1628 1629 1630 1631 1632 1633 1634 1635 1636 1637 1638 1639 1640 1641 1642 1643 1644 1645 1646 1647 1648 1649 1650 1651 1652 1653 1654 1655 1656 1657 1658 1659 1660 1661 1662 1663 1664 1665 1666 1667 1668 1669 1424 1171  910  641  364   79
 282  563  836 1101 1358 1607 1848 1849 1850 1851 1852 1853 1854 1855 1856 1857 1858 1859 1860 1861 1862 1863 1864 1865 1866 1867 1868 1869 1870 1871 1872 1873 1874 1875 1876 1877 1878 1879 1880 1881 1882 1883 1884 1885 1886 1887 1888 1889 1890 1891 1892 1893 1894 1895 1896 1897 1898 1899 1900 1901 1902 1903 1904 1905 1906 1907 1670 1425 1172  911  642  365   80
 281  562  835 1100 1357 1606 1847 2080 2081 2082 2083 2084 2085 2086 2087 2088 2089 2090 2091 2092 2093 2094 2095 2096 2097 2098 2099 2100 2101 2102 2103 2104 2105 2106 2107 2108 2109 2110 2111 2112 2113 2114 2115 2116 2117 2118 2119 2120 2121 2122 2123 2124 2125 2126 2127 2128 2129 2130 2131 2132 2133 2134 2135 2136 2137 1908 1671 1426 1173  912  643  366   81
 280  561  834 1099 1356 1605 1846 2079 2304 2305 2306 2307 2308 2309 2310 2311 2312 2313 2314 2315 2316 2317 2318 2319 2320 2321 2322 2323 2324 2325 2326 2327 2328 2329 2330 2331 2332 2333 2334 2335 2336 2337 2338 2339 2340 2341 2342 2343 2344 2345 2346 2347 2348 2349 2350 2351 2352 2353 2354 2355 2356 2357 2358 2359 2138 1909 1672 1427 1174  913  644  367   82
 279  560  833 1098 1355 1604 1845 2078 2303 2520 2521 2522 2523 2524 2525 2526 2527 2528 2529 2530 2531 2532 2533 2534 2535 2536 2537 2538 2539 2540 2541 2542 2543 2544 2545 2546 2547 2548 2549 2550 2551 2552 2553 2554 2555 2556 2557 2558 2559 2560 2561 2562 2563 2564 2565 2566 2567 2568 2569 2570 2571 2572 2573 2360 2139 1910 1673 1428 1175  914  645  368   83
 278  559  832 1097 1354 1603 1844 2077 2302 2519 2728 2729 2730 2731 2732 2733 2734 2735 2736 2737 2738 2739 2740 2741 2742 2743 2744 2745 2746 2747 2748 2749 2750 2751 2752 2753 2754 2755 2756 2757 2758 2759 2760 2761 2762 2763 2764 2765 2766 2767 2768 2769 2770 2771 2772 2773 2774 2775 2776 2777 2778 2779 2574 2361 2140 1911 1674 1429 1176  915  646  369   84
 277  558  831 1096 1353 1602 1843 2076 2301 2518 2727 2928 2929 2930 2931 2932 2933 2934 2935 2936 2937 2938 2939 2940 2941 2942 2943 2944 2945 2946 2947 2948 2949 2950 2951 2952 2953 2954 2955 2956 2957 2958 2959 2960 2961 2962 2963 2964 2965 2966 2967 2968 2969 2970 2971 2972 2973 2974 2975 2976 2977 2780 2575 2362 2141 1912 1675 1430 1177  916  647  370   85
 276  557  830 1095 1352 1601 1842 2075 2300 2517 2726 2927 3120 3121 3122 3123 3124 3125 3126 3127 3128 3129 3130 3131 3132 3133 3134 3135 3136 3137 3138 3139 3324 3499 3141 3142 3143 3145 3146 3147 3148 3149 3150 3151 3152 3153 3154 3155 3156 3157 3158 3159 3160 3161 3162 3163 3164 3165 3166 3167 2978 2781 2576 2363 2142 1913 1676 1431 1178  917  648  371   86
 275  556  829 1094 1351 1600 1841 2074 2299 2516 2725 2926 3119 3304 3305 3306 3307 3308 3309 3310 3311 3312 3313 3314 3490 3315 3316 3317 3318 3320 3321 3322 3323 3140 3325 3326 3144 3329 3503 3330 3331 3332 3333 3334 3335 3336 3337 3338 3339 3340 3341 3342 3343 3344 3345 3346 3347 3348 3349 3168 2979 2782 2577 2364 2143 1914 1677 1432 1179  918  649  372   87
 274  555  828 1093 1350 1599 1840 2073 2298 2515 2724 2925 3118 3303 3480 3481 3482 3483 3485 3651 3486 3487 3488 3657 3656 3491 3492 3493 3319 3494 3495 3496 3665 3498 3500 3501 3327 3502 3504 3505 3506 3507 3508 3509 3510 3511 3512 3513 3514 3515 3516 3517 3518 3519 3520 3521 3522 3523 3350 3169 2980 2783 2578 2365 2144 1915 1678 1433 1180  919  650  373   88
 273  554  827 1092 1349 1598 1839 2072 2297 2514 2723 2924 3117 3302 3479 3648 3649 3650 3484 3811 3652 3653 3655 3815 3489 3817 3659 3660 3661 3662 3663 3497 3823 3666 3667 3670 3829 3328 3671 3672 3673 3674 3675 3676 3677 3678 3679 3680 3681 3682 3683 3684 3685 3686 3687 3688 3689 3524 3351 3170 2981 2784 2579 2366 2145 1916 1679 1434 1181  920  651  374   89
 272  553  826 1091 1348 1596 1597 2071 2295 2296 2722 2923 3116 3301 3478 3647 3808 3809 3810 3962 3812 3654 3813 3814 3658 3816 3818 3819 3820 3821 3822 3824 3664 3825 3826 3668 3827 3669 3830 3831 3832 3833 3834 3835 3836 3837 3838 3839 3840 3841 3842 3843 3844 3845 3846 3847 3690 3525 3352 3171 2982 2785 2580 2367 2146 1917 1680 1435 1182  921  652  375   90
 271  552  825 1090 1347 1595 1838 1837 2070 2513 2512 2721 3115 3476 3300 3646 3807 3960 3961 4105 3963 3964 3965 3966 3967 3968 3969 3970 3971 3972 3973 3974 3975 3976 3977 3979 3828 3980 3981 3982 3983 3984 3985 3986 3987 3988 3989 3990 3991 3992 3993 3994 3995 3996 3997 3848 3691 3692 3526 3172 2983 2786 2581 2368 2147 1918 1681 1436 1183  922  653  376   91
 270  551  824 1089 1346 1836 1835 2069 2294 2511 2720 2922 2921 3114 3477 3645 3806 3959 4104 4106 4241 4107 4108 4109 4110 4111 4112 4113 4114 4115 4116 4117 4118 4119 4120 3978 4122 4123 4124 4125 4126 4127 4128 4129 4130 4131 4132 4133 4134 4135 4136 4137 4138 4139 3998 3850 3849 3353 3354 2984 2787 2582 2583 2369 2148 1919 1682 1437 1184  923  654  377   92
 269  550  823 1088 1345 1594 2068 2293 2292 2510 2719 2920 3298 3299 3475 3804 3643 3805 3958 4103 4238 4242 4243 4244 4245 4246 4247 4248 4249 4250 4251 4252 4253 4254 4255 4121 4256 4257 4258 4260 4261 4262 4263 4264 4265 4266 4267 4268 4269 4270 4271 4399 4140 4142 4274 3999 3693 3174 3175 3173 2985 2788 2584 2370 2149 1920 1683 1438 1185  924  655  378   93
 268  549  822 1087 1344 1593 1834 2067 2509 2508 2718 2919 3113 3297 3474 3956 3644 3957 4102 4240 4239 4369 4488 4370 4372 4373 4374 4375 4376 4377 4378 4379 4380 4381 4382 4383 4384 4385 4259 4387 4388 4389 4390 4391 4392 4393 4394 4395 4396 4397 4517 4398 4272 4000 4141 3851 3694 3527 3356 3355 2986 2789 2585 2371 2150 1921 1684 1439 1186  925  656   94  380
 267  548  821 1086 1343 1592 1833 2066 2291 2507 2918 2917 3112 3296 3473 3642 3803 3955 4101 4367 4368 4487 4489 4371 4491 4492 4493 4494 4495 4496 4497 4498 4499 4500 4501 4502 4503 4505 4386 4506 4507 4508 4509 4510 4511 4512 4513 4514 4515 4516 4400 4275 4273 4143 4001 3852 3357 3529 3531 3528 2987 2790 2586 2372 2151 1922 1685 1440 1187  657  658  379   95
 266  547  820 1085 1342 1591 1832 2065 2290 2716 2717 2916 3111 3110 3295 3472 3802 3954 4100 4237 4365 4600 4601 4490 4602 4603 4604 4605 4606 4607 4608 4609 4610 4611 4612 4613 4614 4504 4616 4617 4618 4619 4620 4621 4622 4623 4624 4625 4626 4627 4518 4401 4276 4003 3853 3854 3530 3359 3696 3176 2988 2791 2587 2373 2152 1923 1686 1441 1188  926  381   97  382
 265  546  819 1084 1341 1590 1831 2064 2289 2506 2715 3109 3108 3470 3294 3641 3640 3953 4099 4236 4486 4366 4599 4704 4705 4706 4707 4708 4709 4710 4711 4712 4713 4714 4715 4716 4717 4615 4719 4720 4721 4722 4723 4724 4725 4726 4727 4728 4729 4628 4519 4277 4403 4002 4144 4004 3695 3358 3533 3177 2989 2792 2588 2153 1924 2154 1687 1442 1191 1189  383   98  660
 264  545  818 1083 1340 1589 1830 2063 2288 2505 2714 2915 3293 3471 3469 3639 4098 3801 4235 4234 4364 4485 4598 4703 4800 4801 4802 4803 4804 4805 4806 4807 4808 4809 4810 4811 4899 4718 4813 4815 4816 4817 4818 4819 4821 4908 4822 4823 4731 4730 4629 4520 4278 4005 4006 3698 3697 3532 3178 3180 3360 3179 2793 2374 2155 1925 1443 1190  927  928  659  384   96
 263  544  817 1082 1339 1588 1829 2062 2287 2504 2713 2914 3107 3292 3638 3637 3952 3799 3800 4097 4363 4484 4597 4702 4799 4888 4889 4890 4891 4892 4893 4894 4895 4896 4897 4898 4900 4812 4814 4901 4903 4904 4905 4985 4906 4820 4909 4825 4824 4630 4521 4402 4404 4146 4145 3856 3855 3534 3181 2794 2376 2375 2591 2377 1926 1445 1688 1444  931  930  665  662   99
 262  543  816 1081 1338 1587 1828 2061 2286 2503 2712 2913 3106 3291 3468 3636 3798 3951 4096 4233 4362 4483 4596 4701 4798 4887 4968 4969 4970 4971 4972 4973 4974 4975 4976 4977 4978 4979 4980 4902 4981 4983 4984 5056 4907 4986 4910 4732 4733 4631 4522 4281 4280 4007 3857 3700 3699 3362 3361 3364 2990 2795 2589 2592 2590 1927 1690 1446  929  663  386  661  385
 261  542  815 1080 1337 1586 1827 2060 2285 2502 2711 2912 3105 3290 3635 3634 3950 3949 4095 4232 4361 4482 4595 4700 4797 4886 4967 5040 5041 5042 5043 5044 5045 5046 5047 5048 5049 5050 5051 5052 4982 5054 5119 5057 4988 4911 4987 4826 4632 4523 4407 4147 4279 4405 4010 4148 3535 3858 3363 3182 2991 2796 2994 2593 1691 2158 1928 1192 1447 1193  932  101  100
 260  541  814 1079 1336 1585 1826 2059 2284 2501 2710 2911 3103 3467 3796 3797 3465 4094 4093 4231 4360 4481 4594 4699 4796 4885 4966 5039 5104 5105 5106 5107 5108 5109 5110 5111 5113 5168 5115 5116 5053 5117 5055 5118 5058 4989 4912 4827 4734 4633 4406 4524 4149 4008 3860 3859 3701 3537 3536 3183 2992 2798 2157 2797 2156 1931 2378 1692 1693  934  933  389  387
 259  540  813 1078 1335 1584 1825 2058 2283 2500 2709 2910 3104 3289 3464 3466 3795 3947 3948 4230 4359 4480 4593 4698 4795 4884 4965 5038 5103 5160 5161 5162 5163 5165 5251 5213 5112 5215 5114 5218 5170 5171 5173 5120 5059 4990 4913 4828 4735 4634 4525 4409 4408 4009 4150 3703 3702 3538 3365 3184 2993 2995 2380 2159 1929 2160 1689 1195 1194  935  664  103  102
 258  539  812 1077 1334 1583 1824 2057 2282 2708 2908 2707 3288 3102 3287 3632 3633 3794 4092 4229 4358 4479 4592 4697 4794 4883 4964 5037 5102 5159 5208 5209 5211 5164 5212 5167 5166 5216 5169 5217 5220 5172 5174 5121 5060 4991 4914 4829 4736 4635 4282 4526 4283 4284 4151 3861 3704 3539 3366 3185 2996 2799 2594 2381 2379 1930 1448 1449 1196 1197  388  104  390
 257  538  811 1076 1333 1582 1823 2056 2281 2499 2498 3101 2909 3286 3463 3631 3793 3946 4091 4228 4357 4478 4591 4696 4793 4882 4963 5036 5101 5158 5207 5249 5210 5250 5281 5252 5214 5254 5255 5256 5219 5257 5175 5122 5061 4992 4915 4830 4737 4636 4527 4410 4285 4152 4011 3862 3705 3540 3367 3186 2997 2800 2595 2382 2161 1932 1694 1695  937 1450  666  668  105
 256  537  810 1075 1332 1581 1822 2055 2280 2497 2706 2907 3100 3285 3461 3462 3792 3945 4090 4227 4356 4477 4590 4695 4792 4881 4962 5035 5100 5157 5206 5248 5280 5304 5283 5306 5253 5285 5286 5288 5258 5221 5176 5123 5062 4993 4916 4831 4738 4637 4411 4286 4287 4153 4012 3863 3706 3541 3368 3187 2998 2801 2596 2383 2162 1697 1934 1933 1451 1199  669  106  107
 255  536  809 1074 1331 1580 1821 2054 2279 2496 2705 2906 3099 3283 3284 3630 3791 3944 4089 4226 4355 4476 4589 4694 4791 4880 4961 5034 5099 5156 5205 5247 5279 5305 5282 5322 5284 5323 5287 5310 5259 5222 5177 5124 5063 4994 4917 4832 4739 4638 4528 4414 4412 4154 4013 3864 3707 3542 3369 3000 3189 2999 2802 2597 2384 2163 1698 1696 1200  667  394  108  109
 254  535  808 1073 1330 1579 1820 2053 2278 2495 2704 2904 2905 3098 3460 3629 3790 3943 4088 4225 4354 4475 4588 4693 4790 4879 4960 5033 5098 5155 5204 5246 5245 5278 5302 5320 5308 5289 5309 5262 5260 5223 5178 5125 5064 4995 4918 4833 4740 4639 4288 4529 4156 4155 4014 3865 3708 3543 3370 3188 2803 2598 2599 2385 2164 1935 1201 1452 1198  936  671  938  393
 253  534  807 1072 1329 1578 1819 2052 2277 2494 2703 2903 3097 3282 3459 3628 3789 3942 4087 4224 4353 4474 4587 4692 4789 4878 4959 5032 5097 5154 5203 5244 5277 5319 5303 5318 5321 5307 5324 5290 5261 5224 5179 5126 5065 4996 4919 4835 4834 4741 4289 4413 4530 4015 4016 3866 3709 3544 3371 3190 3001 2804 2600 2386 2165 1936 1699 1453  939  395  670  391  392
 252  533  806 1071 1328 1577 1818 2051 2276 2493 2702 2902 3096 3281 3458 3627 3788 3941 4086 4223 4352 4473 4586 4691 4788 4877 4958 5031 5096 5153 5202 5243 5276 5301 5327 5326 5328 5325 5311 5312 5291 5225 5180 5127 5066 4997 4921 4920 4641 4531 4532 4415 4290 4157 3867 3711 3710 3372 3193 3191 3002 2805 2601 2387 2166 1937 1700 1456 1455 1202  673  111  110
 251  532  805 1070 1327 1576 1817 2050 2275 2492 2701 2901 3095 3280 3626 3787 3786 3940 4085 4222 4351 4472 4585 4690 4787 4876 4957 5030 5095 5152 5201 5242 5275 5300 5317 5316 5315 5314 5313 5292 5263 5226 5181 5128 5067 4998 4836 4742 4743 4642 4640 4533 4291 4158 4017 3712 3547 3373 3545 3192 3003 2806 2602 2388 2167 1938 1701 1702  942  940 1454  675  397
 250  531  804 1069 1326 1575 1816 2049 2274 2491 2700 2900 3094 3279 3457 3625 3939 3938 4084 4221 4350 4471 4584 4689 4786 4875 4956 5029 5094 5151 5200 5241 5274 5299 5298 5297 5296 5295 5294 5293 5264 5227 5182 5129 5068 4999 4922 4923 4837 4643 4534 4416 4292 4159 3869 3871 3374 3868 3548 3375 3004 2807 2603 2389 2168 1703 1939 1203 1457  943  398  396  112
 249  530  803 1068 1325 1574 1815 2048 2273 2490 2699 3093 3278 3454 3456 3624 3785 4083 4082 4220 4349 4470 4583 4688 4785 4874 4955 5028 5093 5150 5199 5240 5273 5272 5271 5270 5269 5268 5267 5266 5265 5228 5183 5130 5070 5069 5000 4745 4744 4644 4535 4417 4293 4160 4018 4020 3546 3549 3713 3376 3005 2809 2808 2390 1940 1941 1458 1204 1206  941 1205  399  674
 248  529  802 1067 1324 1573 1814 2047 2272 2489 2698 2899 3092 3455 3277 3623 3784 3937 4081 4219 4348 4469 4582 4687 4784 4873 4954 5027 5092 5149 5198 5239 5238 5237 5236 5235 5234 5233 5232 5231 5230 5229 5131 5071 5132 4924 4839 4838 4747 4645 4536 4418 4420 4021 4162 4019 3870 3716 3550 3194 3195 3006 2604 2391 2169 1704 1705 1459 1207  945  944  672  113
 247  528  801 1066 1323 1572 1813 2046 2271 2488 2697 2898 3091 3276 3453 3622 3783 4080 4079 4347 4468 4467 4581 4686 4783 4872 4953 5026 5091 5148 5197 5196 5195 5194 5193 5192 5191 5190 5189 5188 5187 5185 5184 5133 5002 5001 4925 4746 4840 4646 4537 4294 4419 4295 4161 3714 3715 3379 3196 3378 3007 2810 2605 2392 2171 2172 1942 1460  946  677  676  400  114
 246  527  800 1065 1322 1571 1812 2045 2270 2487 2696 2897 3090 3275 3451 3781 3935 3936 4217 4218 4346 4466 4580 4685 4782 4871 4952 5025 5090 5147 5146 5145 5144 5143 5142 5141 5140 5139 5138 5077 5136 5186 5135 5074 5072 5003 4926 4842 4748 4647 4538 4421 4296 4163 4022 3872 3873 3010 3377 3197 2811 2814 2606 2394 2393 2170 1706 1210  947  679  401  402  115
 245  526  799 1064 1321 1570 1811 2044 2269 2486 2695 2896 3089 3274 3450 3618 3452 3780 4078 3934 4216 4345 4579 4684 4781 4870 4951 5024 5089 5088 5087 5086 5085 5084 5083 5082 5081 5080 5079 5137 5078 5076 5134 5075 5073 5004 4927 4843 4841 4749 4539 4422 4297 4164 4023 3718 4165 3874 3875 3008 3199 3011 2607 2173 2175 1707 1208 1708  948  949  678  117  116
 244  525  798 1063 1320 1569 1810 2043 2268 2485 2694 2895 3088 3273 3449 3619 3782 3933 4344 4213 4343 4465 4578 4683 4780 4869 4950 5023 5022 5021 5020 5019 5018 5017 5016 5015 5014 5013 5012 5011 5010 5009 5008 5007 5006 5005 4928 4750 4751 4648 4540 4423 4298 4024 4027 3876 3717 3551 3200 3009 2812 2609 2396 2174 1944 1464 1461 1211 1462  680  681  403  118
 243  524  797 1062 1319 1568 1809 2042 2267 2484 2693 2894 3086 3087 3272 3620 3621 3931 4215 4214 4342 4464 4577 4682 4779 4868 4949 4948 4947 4946 4945 4944 4943 4942 4941 4940 4939 4938 4937 4936 4935 4934 4933 4932 4931 4930 4929 4844 4650 4649 4541 4424 4299 3553 4025 3554 3719 3552 3381 3198 2813 2815 2395 2608 2176 1943 1212 1463  950  951  406  682  119
 242  523  796 1061 1318 1567 1808 2041 2266 2483 2692 2893 3271 3448 3617 3616 3779 3932 4077 4212 4575 4341 4463 4681 4778 4867 4866 4865 4863 4862 4771 4861 4860 4859 4858 4857 4856 4855 4854 4853 4852 4851 4850 4849 4848 4847 4846 4845 4752 4651 4542 4425 4300 4167 3877 4026 3382 3555 3384 3380 3013 2610 2611 1710 1947 1945 1946 1209 1711  952  404  683  120
 241  522  795 1060 1317 1566 1807 2040 2265 2482 2691 2892 3085 3269 3270 3447 3929 3777 3778 4075 4211 4576 4680 4574 4777 4776 4774 4675 4772 4673 4770 4769 4670 4768 4767 4766 4765 4764 4763 4762 4761 4760 4759 4757 4756 4755 4754 4753 4543 4654 4544 4426 4301 4166 3878 3557 3720 3012 3383 3201 3202 2816 2614 2398 2177 1709 1712 1948 1213 1466  405  954  121
 240  521  794 1059 1316 1565 1806 2039 2263 2264 2481 2690 2891 3084 3775 3615 3614 3930 4076 4210 4461 4340 4678 4571 4677 4676 4775 4674 4864 4565 4450 4672 4671 4669 4668 4667 4666 4665 4664 4663 4662 4661 4552 4758 4658 4657 4656 4655 4652 4653 4431 4427 4302 4168 4169 3722 3556 3014 3558 3203 2817 2818 2612 2181 2399 2397 2179 1949 1215 1214  408  953  407
 239  520  793 1315 1564 1563 1805 2038 2262 2480 2889 3083 3082 3268 3446 3445 3776 3928 4074 4073 4460 4573 4462 4572 4679 4570 4569 4453 4568 4773 4566 4564 4563 4562 4561 4560 4559 4558 4557 4556 4555 4554 4659 4660 4551 4435 4550 4549 4547 4546 4429 4545 4428 4029 4028 3879 3723 3721 3015 3385 3205 2400 2402 3016 1716 2403 1465 1713 1468  686  684  123  122
 238  519  792 1058 1314 1562 1804 2261 2036 2688 2890 2888 2689 3267 3444 3613 3774 3927 4072 4209 4339 4459 4458 4456 4334 4455 4330 4452 4329 4327 4567 4449 4448 4447 4446 4445 4444 4443 4442 4441 4440 4439 4553 4314 4437 4436 4434 4548 4433 4308 4432 4430 4303 4170 4031 4030 3881 3560 3559 3391 3204 2613 1953 1714 2178 2401 1950 1469 1952 1216  685  409  124
 237  518  791 1057 1313 1056 1803 2037 2478 2479 2687 2887 3081 3443 3612 3611 3773 3926 4071 4337 4338 4066 4336 4457 4333 4201 4332 4200 4331 4451 4328 4326 4325 4324 4323 4322 4321 4320 4319 4318 4317 4316 4438 4315 4313 4312 4311 4310 4309 4177 4307 4306 4304 4171 4305 3882 3724 3386 3880 3561 3017 2615 2182 1951 1954 1470 1715 1467  955  956  687  689  125
 236  517  790 1055 1561 1560 1802 2035 2260 2477 2686 3080 3079 3266 3442 3772 3925 4070 4207 4206 4205 3920 4335 4203 4202 4062 4199 4454 4198 4197 4196 4195 4194 4193 4192 4191 4190 4189 4188 4187 4186 4185 4184 4183 4182 4181 4180 4179 4178 4038 4176 4175 4034 4174 4172 3884 3883 3018 3725 3388 3387 3020 2820 2404 2405 1472 1717 2617 1217 1218  410  690  126
 235  516  789 1311 1312 1801 2034 2032 2259 2476 2685 2886 3264 3265 3441 3610 3771 3924 4069 4208 4067 4204 4065 3917 4064 4063 4061 4060 4059 4058 4057 4056 4055 4054 4053 4052 4051 4050 4049 4048 4047 4046 4045 4044 4043 4042 4041 4040 4039 4037 4036 3889 4035 4173 4032 4033 3726 3728 3727 3389 3019 2616 3206 3394 1476 2183 2180 1471 1219  957  958  688  128
 234 1052  787 1054 1310 1800 2033 2257 2258 2684 2683 2885 3078 3263 3440 3609 3770 3922 3921 4068 3765 3430 3918 3916 3761 3915 3914 3913 3912 3911 3910 3909 3908 3907 3905 3749 3750 3904 3902 3901 3900 3899 3898 3897 3896 3895 3894 3893 3892 3891 3890 3734 3888 3887 3886 3885 3562 3730 3210 3021 2824 1958 2621 2823 2184 2618 2185 1474 1220  412  692    0  413
 233  515 1053  788 1557 1309 1559 2031 2474 2473 2475 2884 3077 3262 3439 3608 3769 3923 3767 3766 3601 3764 3763 3762 3598 3760 3759 3758 3757 3756 3755 3754 3753 3752 3751 3906 3587 3903 3747 3746 3745 3744 3743 3742 3741 3740 3739 3738 3737 3573 3736 3571 3733 3732 3731 3565 3563 3393 3211 2623 2828 2821 2406 2819 1223 1956 1718 1473 1221  960  415  411  127
 232  514  786 1051 1308 1558 1799 1798 2256 2472 2682 3076 2681 3261 3438 3607 3606 3768 3604 3603 3602 3919 3600 3599 3427 3597 3596 3595 3594 3593 3592 3591 3590 3589 3748 3588 3415 3586 3584 3583 3582 3581 3580 3579 3578 3577 3576 3575 3403 3574 3735 3400 3570 3569 3568 3729 3215 3023 3207 3212 2822 2407 2826 3208 2186 2188 1227 1957  962  959  695  129  133
 231  513  785 1050 1307 1556 1797 2030 2255 2471 2881 2883 2882 3075 3437 3436 3435 3605 3433 3432 3431 3429 3250 3428 3426 3247 3425 3424 3423 3422 3420 3054 3241 3418 3417 3237 3416 3413 3047 3412 3411 3410 3409 3408 3407 3406 3405 3404 3224 3222 3035 3399 3398 3034 3396 3566 3209 3392 3390 2827 2825 2829 2408 1719 1959 1955 1477 1722  132  130  693  416  414
 230  512  511 1048 1049 1306 1796 2028 2029 2254 3259 2680 3074 3260 3072 3258 3256 3434 3254 3066 3253 3252 3251 3249 3248 3246 3245 3244 3243 3242 3053 3421 3419 3240 3049 3050 3235 3585 3234 3046 3233 3231 3230 3229 3228 3227 3226 3225 3037 3402 3036 3401 3220 3397 3218 3567 3395 3217 3564 3027 3022 2415 3213 2409 2411 1725 1721  691  961  417 1224  966  418
 229  510  784  783 1047 1555 1554 2253 2470 2679 2880 2879 3071 2877 3257 3069 2873 3255 3068 3067 3065 3064 3063 3062 3061 3060 3059 3058 3057 3056 3055 2858 3052 3238 3239 3051 2855 3414 3048 3232 2849 3045 3043 3042 3040 2846 3039 3038 3223 3572 2637 2635 3221 3032 3219 3029 3216 3214 3028 3026 1720 2831 2620 2622 1478 1723 1475 2187 1222  963  419  131  697
 228  509  782 1304 1305 1553 1795 1794 2027 2469 2678 2878 2675 2673 2876 3070 2875 2874 2872 2871 2870 2869 2868 2867 2866 2865 2864 2863 2862 2861 2657 2860 2859 2857 2856 2854 3236 2853 2852 2851 2850 3044 2848 2847 3041 2844 2641 2843 2842 2840 3031 3033 3030 2836 2421 2835 2834 2630 2833 2832 3025 2190 2619 2410 1960 2193 1483  694 1481  967  136  134  420
 227  508  781 1046 1303 1551 1552 1793 2252 2468 2677 2676 2674 3073 2462 2672 2671 2670 2669 2668 2667 2666 2665 2664 2663 2662 2661 2660 2659 2446 2447 2656 2655 2654 2653 2652 2651 2650 2649 2648 2436 2646 2644 2433 2643 2642 2845 2640 2429 2841 2636 2838 2638 2839 2837 2632 2423 2631 2830 2627 1970 2414 3024 2412 2189 2413 1963 1479 1480 1225  964  135  422
 226  507  780 1045 1302 1792 2025 2467 2026 2466 2247 2465 2464 2463 2461 2460 2241 2459 2458 2457 2456 2455 2454 2453 2452 2451 2450 2449 2448 2228 2445 2444 2225 2443 2442 2441 2440 2439 2438 2437 2435 2647 2645 2215 2432 2431 2428 2209 2639 2427 2426 1978 2425 2206 2634 2420 2419 1974 2629 2416 2625 1961 2626 2624 1731 1727 2192  965 1226  968  698 1230  137
 225  506  779 1044 1301 1550 1791 2251 2024 2250 2248 2246 2245 2244 2243 2015 2242 2240 2239 2238 2237 2236 2235 2234 2233 2232 2231 2230 2229 2227 2658 2226 1998 2224 2223 2222 2221 2220 2219 2218 2217 2216 2434 1987 2214 2212 2430 2211 2210 2208 2424 1501 2204 1977 2202 2633 2201 2197 2628 2198 2417 2195 2196 1236 1726 1724 1729 1231 1228  699  421  696  138
 224  505  778 1043 1300 1549 1790 2022 2249 1786 2021 2019 2018 1782 2017 2016 2014 2013 2012 2011 2010 2009 2008 2007 2006 2005 2004 2003 2002 2001 2000 1999 1997 1996 1995 1760 1994 1993 1991 1756 1990 1989 1988 1986 1985 2213 1984 1983 1982 1745 2205 1980 1979 2203 2422 1975 2200 1737 2418 1972 1490 1968 1964 1967 1732 2191 2194 1728 1229 1482  971  423  700
 223  504  777 1042 1299 1789 1547 1544 1788 1787 2020 1784 1540 1783 1781 1780 1779 1778 1777 1776 1775 1774 1773 1772 1771 1770 1769 1768 1767 1766 1765 1764 1763 1762 1761 1759 1758 1757 1992 1513 1755 1754 1753 1752 1751 1750 1749 1503 1505 1981 1746 1250 1742 1744 1743 1497 1245 1740 2199 1738 1735 1239 1736 1733 1969 1962  970 1484  969 1232  701  425  139
 222  503  776 1041 1298 1546 1294 2023 1293 1543 1542 1541 1288 1785 1539 1537 1536 1535 1534 1533 1532 1531 1530 1529 1528 1527 1526 1525 1524 1523 1522 1521 1520 1519 1518 1517 1265 1516 1514 1262 1512 1511 1510 1509 1257 1507 1508 1506 1747 2207 1252  992 1502 1499 1976 1496 1973 1244 1493 1971 1492 1734 1966 1489 1730 1488 1487 1965  972  424  141  426  140
 221  502  775 1040 1297 1548 1296 1545 1292 1291 1031 1032 1289 1287 1538 1286 1284 1283 1024 1282 1281 1280 1279 1278 1277 1276 1275 1274 1273 1272 1271 1270 1269 1268 1267 1006 1266 1515 1264 1263 1261 1260 1259 1258  996 1254 1256 1504 1748  991 1251 1249 1500  988  721 1741 1498 1495  986 1242 1241 1491  979  982 1486  977  976 1485 1233  703  974  702  142
 220  501  774 1039 1038 1037 1036 1295 1035 1034 1033 1290 1030 1029 1028 1285 1027 1026 1025 1023 1022 1021 1020 1019 1018 1017 1016 1015 1014 1013 1012 1011 1010 1009  741 1008  738 1004 1003  736 1002 1001 1000  998  731 1255  995 1253  452  994  449  724 1247  163  166 1246 1494 1739  716 1243  983 1238  978  713 1237  709 1234 1235  975  706  973  427  143
 219  500  773  772  771  770  769  768  767  766  765  764  763  762  761  760  759  758  757  756  755  754  753  752  751  750  749  748  747  746  745  744  743  742 1007  466  740 1005  463  735  734  733  732  999  456  997  729  728  993  726  167  990 1248  723  444  161  985  719  984  441 1240  981  438  980  714  712  711  710  433  431  428  705  144
 218  499  498  497  496  495  494  493  492  491  207  489  205  487  486  485  484  483  482  481  480  479  478  477  476  475  474  473  472  471  470  469  468  467  182  739  464  462  737  461  460  459  458  457  173  730  454  727  453  451  722  448  989  447  720  162  717  987  443  715  442  440  156  437  436  153  434  707  708  432  704  430  429
 217  216  215  214  213  212  211  210  209  490  208  488  206  204  203  202  201  200  199  198  197  196  195  194  193  192  191  190  189  188  187  186  185  184  181  183  465  180  179  178  177  176  175  174  172  455  171  170  165  725  169  450  168  446  164  445  718  160  159  158  157  155  439  154  152  435  151  150  149  148  147  146  145
