# This puzzle is unsolvable
64
   2    1  254    0  255    3    7    8    9   10   11   12   13   14   15   16   17   18   19   20   21   22   23   24   26  278  277   27   29   30   31   32   33   34   35   36   37   38   39   40   41   42   43   44   45   46   47   48   49   50   51   52   53   54   55   56   57   58   59   60   61   62   63   64
 252  253  498    4    5    6  258  259  260  261  262  263  264  265  266  267  268  269  270  271  272  273  274  275   25  276   28  280  522  281  282  283  284  285  286  287  288  289  290  291  292  293  294  295  296  297  298  299  300  301  302  303  304  305  306  307  308  309  310  311  312  313  314   65
 495  496  499  256  734  257  501  502  503  504  505  506  507  508  509  510  511  512  513  514  515  516  518  754  519  520  521  524  758  986  525  526  527  528  529  530  531  532  533  534  535  536  537  538  539  540  541  542  543  544  545  546  547  548  549  550  551  552  553  554  555  556  315   66
 251  250  497  960 1181  500  733  739  965 1185  740  741  742  743  744  746  747  748  976  975  750  751  517  980  753  755  756  757  279  523  759  761  762  763  764  765  766  767  768  769  770  771  772  773  774  775  776  777  778  779  780  781  782  783  784  785  786  787  788  789  790  557  316   67
 248  731  732 1180  735  966  736  738  737 1186  967  968  969  970  971  745  972 1194  974  749 1195  977  752  979 1200  981  982  983  984  985  760  988  989  990  991  992  993  994  995  996  997  998  999 1000 1001 1002 1003 1004 1005 1006 1007 1008 1009 1010 1011 1012 1013 1014 1015 1016  791  558  317   68
 494  730  729  959  961 1394 1178 1182 1183  964 1397 1187 1188 1189 1190 1191 1193 1802  973 1196  978 1407 1198 1199 1411 1201 1202 1203 1204 1206  987 1207 1208 1209 1210 1211 1212 1213 1214 1215 1216 1217 1218 1219 1220 1221 1222 1223 1224 1225 1226 1227 1228 1229 1230 1231 1232 1233 1234 1017  792  559  318   69
 249  246  956  962  963 1392 1179 1597 1184 1598 1398 1601 1399 1400 1401 1402 1404 1405 1609 1406 1197 1409 1804 2172 1410 1412 1414 1415 1618 1205 1417 1418 1419 1420 1421 1422 1423 1424 1425 1426 1427 1428 1429 1430 1431 1432 1433 1434 1435 1436 1437 1438 1439 1440 1441 1442 1443 1444 1235 1018  793  560  319   70
 493  245 1792  726  728 1390 1391 1395 1980 1396 1599 1983 1602 1603 1604 1403 1192 1607 1805 1408 1610 1613 2173 1808 1614 1615 1413 1616 1619 1416 1620 1621 1622 1623 1624 1625 1626 1627 1628 1629 1630 1631 1632 1633 1634 1635 1636 1637 1638 1639 1640 1641 1642 1643 1644 1645 1646 1445 1236 1019  794  561  320   71
 247  492  491  727  490 1596  958 1593 1177 2159 1600 1795 1796 1797 1799 1605 1606 1989 1803 1608 1991 1611 1612 1809 2176 1810 1811 1617 1812 1813 1815 1816 1817 1818 1819 1820 1821 1822 1823 1824 1825 1826 1827 1828 1829 1830 1831 1832 1833 1834 1835 1836 1837 1838 1839 1840 1647 1446 1237 1020  795  562  321   72
 489  244  953  957 1388 1176 1389 1393 1793 1984 1794 1981 2332 1798 2163 1988 2338 1800 1992 2506 2344 1807 1995 2345 2347 1997 1998 2000 2001 1814 2002 2003 2004 2005 2006 2007 2008 2009 2010 2011 2012 2013 2014 2015 2016 2017 2018 2019 2020 2021 2022 2023 2024 2025 2026 1841 1648 1447 1238 1021  796  563  322   73
 954 1171  488  242 1386  955 1595 1594 1982 1978 2160 2162 2333 2166 1985 1801 1987 2342 1990 2167 1993 2507 1994 1996 2346 2179 2350 1999 2180 2351 2181 2182 2183 2184 2185 2186 2187 2188 2189 2190 2191 2192 2193 2194 2195 2196 2197 2198 2199 2200 2201 2202 2203 2204 2027 1842 1649 1448 1239 1022  797  564  323   74
 243  241 1174  240  723 1789 1175 1591 1790 1979 1976 1788 2496 2500 2336 2498 1986 2168 2337 2340 2341 2171 2508 2807 2175 2509 2177 2348 2178 2514 2352 2353 2354 2355 2356 2357 2358 2359 2360 2361 2362 2363 2364 2365 2366 2367 2368 2369 2370 2371 2372 2373 2374 2205 2028 1843 1650 1449 1240 1023  798  565  324   75
 487  486  725 1384  952  724 1791 1590 2161 2494 2652 2164 2334 2165 2335 2804 2659 2503 2170 2660 2174 2505 2943 2809 1806 2663 2512 2665 2513 2669 2516 2517 2672 2518 2519 2520 2521 2522 2523 2524 2525 2526 2527 2528 2529 2530 2531 2532 2533 2534 2535 2536 2375 2206 2029 1844 1651 1450 1241 1024  799  566  325   76
 239  485 1173 1170 1786 1589 1387 1385 1977 2158 2495 2499 2653 2655 2502 2656 2803 2805 2339 2657 2661 2169 2808 2343 2664 2510 2814 2666 3207 2670 2515 2671 2819 2673 2674 2675 2676 2677 2678 2679 2680 2681 2682 2683 2684 2685 2686 2687 2688 2689 2690 2537 2376 2207 2030 1845 1652 1451 1242 1025  800  567  326   77
 238  719  722 1172 1382  951 1383 2157 1592 2331 2497 2328 2800 2654 2801 2501 2658 2945 2504 2947 3314 2662 2810 3081 2811 2511 2953 2668 2667 2954 2817 2818 2958 2820 2821 2822 2823 2824 2825 2826 2827 2828 2829 2830 2831 2832 2833 2834 2835 2836 2691 2538 2377 2208 2031 1846 1653 1452 1243 1026  801  568  327   78
 481  721  950  947 1168 1587 1784 2155 1975 2330 2329 2493 2651 2650 2940 2941 2802 3074 2944 2806 3315 3079 3078 2950 2349 2812 2813 2952 2816 2955 2815 2956 2957 2959 2960 2961 2962 2963 2964 2965 2966 2967 2968 2969 2970 2971 2972 2973 2974 2837 2692 2539 2378 2209 2032 1847 1654 1453 1244 1027  802  569  328   79
 483  237  949  484  716 1783 1588 1973 2156 2325 2327 2492 2649 2799 2798 3073 2939 3072 3196 3076 2946 3201 2948 3082 2949 2951 3085 3206 3084 3086 3087 3088 3089 3090 3091 3092 3093 3094 3095 3096 3097 3098 3099 3100 3101 3102 3103 3104 2975 2838 2693 2540 2379 2210 2033 1848 1655 1454 1245 1028  803  570  329   80
 236  480  720  718 1169  948 1586 1782 1787 1974 2154 2491 2647 2648 2937 2938 3312 2942 3200 3313 3197 3077 3199 3204 3083 3427 3321 3429 3208 3324 3209 3212 3533 3213 3214 3215 3216 3217 3218 3219 3220 3221 3222 3223 3224 3225 3226 3105 2976 2839 2694 2541 2380 2211 2034 1849 1656 1455 1246 1029  804  571  330   81
 235  715  482  946  945 1585 1379 1971 1785 1972 2326 2153 2490 2797 2796 3195 3070 3198 3420 3075 3421 3422 3319 3080 3320 3525 3205 3322 3323 3431 3529 3210 3326 3327 3328 3330 3331 3332 3333 3334 3335 3336 3337 3338 3339 3340 3227 3106 2977 2840 2695 2542 2381 2212 2035 1850 1657 1456 1247 1030  805  572  331   82
 234  717  233  479 1381 1380 1378 1781 1970 2152 2151 2489 2646 2795 2936 3071 3068 3310 3311 3424 3316 3423 3202 3317 3318 3425 3428 3527 3432 3325 3211 3433 3434 3436 3329 3437 3438 3439 3440 3441 3442 3443 3444 3445 3446 3341 3228 3107 2978 2841 2696 2543 2382 2213 2036 1851 1658 1457 1248 1031  806  573  332   83
 476  944  477 1584 1167 1377 1583 1779 2150 1968 2324 2323 2488 2794 2935 3194 3069 3193 3419 3520 3521 3522 3203 3426 3523 3617 3618 3619 3430 3847 3531 3532 3624 3435 3535 3536 3537 3538 3539 3540 3541 3542 3543 3544 3447 3342 3229 3108 2979 2842 2697 2544 2383 2214 2037 1852 1659 1458 1249 1032  807  574  333   84
 714  478  713  943 1166 1164 1165 1969 1780 2149 2487 2644 2645 2793 2934 3067 3192 3309 3418 3519 3612 3613 3615 3697 3614 3700 3701 3703 3528 3530 3621 3623 3625 3534 3626 3627 3628 3629 3630 3631 3632 3633 3634 3545 3448 3343 3230 3109 2980 2843 2698 2545 2384 2215 2038 1853 1660 1459 1250 1033  808  575  334   85
 232  231  942 1376 1163 1581 1582 1778 1967 2148 2322 2321 2643 2792 2933 3066 3191 3308 3417 3518 3611 3695 3696 3698 3524 3699 3702 3620 3526 3781 3622 3705 3707 3708 3709 3710 3711 3712 3713 3714 3715 3716 3635 3546 3449 3344 3231 3110 2981 2844 2699 2546 2385 2216 2039 1854 1661 1460 1251 1034  809  576  335   86
 229  475  941  712  940 1375 1580 1777 1966 2320 2319 2486 2642 2791 2932 3065 3190 3307 3416 3517 3609 3610 3694 3773 3616 3774 3776 3777 3704 3778 3779 3706 3782 3783 3784 3785 3786 3787 3788 3789 3790 3717 3636 3547 3450 3345 3232 3111 2982 2845 2700 2547 2386 2217 2040 1855 1662 1461 1252 1035  810  577  336   87
 474  230  711 1162 1374 1775 1159 1776 1579 2147 2482 2485 2641 2790 2931 3064 3189 3306 3415 3516 3771 3693 3772 3840 3841 3775 3842 3843 3844 3845 3780 3848 3849 3850 3851 3852 3853 3854 3855 3856 3791 3718 3637 3548 3451 3346 3233 3112 2983 2846 2701 2548 2387 2218 2041 1856 1663 1462 1253 1036  811  578  337   88
 473  227  939 1373 1575 1372 1161 2146 2144 2145 2316 2484 2640 2789 2930 3063 3188 3305 3414 3515 3608 3692 3770 3839 3900 3901 3902 3903 3904 3846 3906 3907 3908 3909 3910 3911 3912 3913 3914 3857 3792 3719 3638 3549 3452 3347 3234 3113 2984 2847 2702 2549 2388 2219 2042 1857 1664 1463 1254 1037  812  579  338   89
 228  708  710 1158 1371 1965 1160 1774 2318 1964 2483 2317 2639 2788 2929 3062 3187 3304 3413 3514 3606 3607 3769 3838 3899 3952 3953 3954 3955 3905 3957 4000 3959 3960 3961 3962 3963 3964 3915 3858 3793 3720 3639 3550 3453 3348 3235 3114 2985 2848 2703 2550 2389 2220 2043 1858 1665 1464 1255 1038  813  580  339   90
 226  709  707  472 1370 1578 1157 1577 1576 2143 2315 2481 2638 2787 2928 3061 3185 3186 3303 3412 3691 3690 3768 3837 3898 3951 3996 3997 4033 3958 3956 4001 4037 4002 4004 4005 4006 3965 3916 3859 3794 3721 3640 3551 3454 3349 3236 3115 2986 2849 2704 2551 2390 2221 2044 1859 1666 1465 1256 1039  814  581  340   91
 470  935  937  936  938 1773 1772 1960 1963 2141 2142 2480 2637 2786 2927 3060 3184 3302 3411 3513 3512 3605 3767 3836 3897 3950 4031 4032 3999 3998 4034 4035 4036 4038 4066 4039 4007 3966 3917 3860 3795 3722 3641 3552 3455 3350 3237 3116 2987 2850 2705 2552 2391 2222 1860 1667 1466 1257 1258 1040  815  342  584   92
 225  469  223  471  934 1369 1961 1574 1962 1770 2314 2479 2636 2785 2926 3058 3059 3301 3410 3511 3604 3689 3766 3835 3896 3994 3995 4030 4060 4061 4062 4093 4003 4064 4084 4040 4008 3967 3918 3861 3796 3723 3642 3553 3456 3351 3238 3117 2988 2851 2706 2553 2392 2223 2045 1861 1668 1467 1259  582  817 1041  341   93
 224  705  706 1155 1156 1959 2138 1771 1572 2140 2313 2478 2635 2784 2924 2925 3183 3300 3409 3510 3603 3688 3765 3834 3895 3949 3947 4029 4059 4092 4079 4081 4063 4082 4065 4041 4042 3968 3919 3862 3797 3724 3643 3554 3457 3352 3239 3118 2989 2708 2852 2707 2554 2393 2047 1862 1670 1669 1468 1043 1042  816  343   94
 222  468  704  933 1154 1368 1367 1956 1958 1769 2139 2312 2477 2634 2783 3057 3182 3299 3408 3509 3602 3687 3764 3833 3894 3993 3948 3992 4058 4080 4073 4086 4085 4083 4067 4043 4009 4010 3969 3863 3798 3725 3644 3555 3458 3353 3240 3119 2854 2990 2709 2555 2225 2226 2224 2046 2048 1471 1045 1261 1260  585  583   95
 221  220  703  932 1153 1366 1573 1571 1957 1569 2311 2476 2633 2782 2923 3056 3181 3298 3407 3508 3601 3686 3763 3832 3893 3946 3991 4028 4057 4078 4094 4095 4068 4072 4087 4044 4045 3920 3921 3864 3799 3726 3645 3556 3459 3354 2991 2992 2853 2855 2556 2395 2396 2394 2049 1865 1863 1671 1044 1262  818  586   96  587
 466  467  465  702 1152 1365 1768 2135 1766 2137 2136 2475 2632 2781 2922 3055 3180 3297 3406 3507 3600 3685 3762 3831 3892 3945 3990 4027 4056 4077 4089 4088 4050 4071 4014 3971 4011 3970 3973 3923 3800 3727 3646 3557 3460 3355 3241 3242 3120 2710 2711 2557 2397 2227 2050 1673 1866 1469 1864  821  346  345  588  344
 464  701  930  931 1151 1364 1570 1767 1954 2134 2310 2474 2631 2780 2921 3054 3179 3296 3405 3506 3599 3684 3761 3830 3891 3944 3989 4026 4055 4076 4091 4090 4074 4051 4017 4069 3922 3972 3866 3865 3801 3728 3647 3558 3461 3356 3122 3121 2993 2856 2712 2558 2398 2228 2229 2051 1472 1470 1263  819  820   98  347   97
 219  218  463  929 1150 1363 1764 1567 1765 1955 2308 2473 2630 2779 2920 3053 3178 3295 3404 3505 3598 3683 3760 3829 3890 3943 3988 4025 4054 4053 4075 4052 4018 4019 4013 4046 4070 4012 3924 3867 3802 3729 3648 3559 3462 3357 3243 3244 2994 2857 2713 2559 2399 2230 2052 1672 1674 1473 1264 1048 1046  589  822  349
 217  461  700  928 1149 1362 1566 1568 1953 2309 2472 2471 2629 2778 2919 3052 3177 3294 3403 3504 3597 3682 3759 3828 3889 3942 3987 4024 4023 3983 4022 4020 3980 3979 4047 4048 4015 3974 3926 3868 3803 3730 3649 3560 3463 3358 3245 3123 2995 2714 2560 2400 2561 2401 1868 1867 1675 1266  823 1265 1047  348  100   99
 216  699  462  698 1148 1361 1763 1762 1952 2133 2132 2307 2628 2777 2917 2918 3176 3293 3402 3503 3596 3681 3758 3827 3888 3941 3986 3985 3984 4021 3982 4049 3978 3932 3977 4016 3976 3925 3975 3869 3804 3731 3650 3561 3464 3359 3246 3124 2996 2858 2859 2562 1869 2231 2054 2053 1676 1474 1476 1475 1049  824  590  101
 215  460  697  927 1147 1360 1565 1761 1951 2130 2305 2306 2470 2775 2627 3051 3175 3292 3401 3502 3595 3680 3757 3826 3887 3940 3939 3938 3937 3936 3935 3981 3933 3877 3931 3930 3929 3928 3927 3806 3732 3651 3653 3562 3465 3360 3247 3125 3126 2997 2715 2402 2232 2055 2056 1872 1870 1677 1267  592  591  826  350  351
 458  696  695  926 1146 1359 1564 1950 2131 2303 2304 2469 2626 2916 3049 3050 3174 3291 3400 3501 3594 3679 3756 3825 3886 3885 3884 3883 3882 3881 3880 3934 3878 3814 3812 3876 3872 3809 3808 3805 3870 3733 3734 3563 3466 3361 3248 3127 2860 2999 2717 2716 2234 1871 1679 1678 1680 1478 1477 1051 1050  825  104  102
 214  459  924  925  923 1358 1562 1563 1949 2129 2468 2467 2625 2776 2915 3048 3173 3290 3399 3500 3593 3678 3755 3824 3823 3822 3821 3820 3819 3818 3817 3879 3816 3813 3811 3742 3873 3740 3739 3737 3807 3652 3564 3565 3654 3467 3249 3128 2998 2861 2563 2565 2403 2233 2057 2235 1268 1874 1269 1052  827  352  353  105
 213  456  457  694 1145 1144 1561 1760 1759 1948 2302 2466 2624 2774 2914 3047 3172 3289 3398 3499 3592 3677 3754 3753 3752 3751 3750 3749 3748 3747 3746 3745 3815 3744 3875 3576 3741 3874 3871 3738 3736 3735 3655 3469 3363 3362 3250 3130 2863 2718 2862 2405 2564 2236 1873 2058 1681 1481 1270 1053  596  593  594  354
 211  212  693  922 1143 1356 1357 1758 2128 2127 2623 2465 2772 2773 2913 3046 3171 3288 3397 3498 3591 3676 3675 3674 3673 3672 3671 3670 3669 3668 3667 3666 3665 3743 3664 3663 3661 3660 3810 3659 3657 3656 3468 3567 3566 3251 3252 3000 3129 2865 2406 2567 2238 2404 2407 1480 1479 1271 1482  830  828  597  829  103
 209  210  455  920 1142 1355 1560 1947 1946 2126 2301 2622 2770 2912 3045 3044 3170 3287 3396 3497 3590 3589 3588 3587 3586 3585 3584 3583 3582 3581 3580 3579 3578 3378 3482 3662 3575 3573 3572 3658 3570 3569 3470 3365 3368 3364 3001 3254 3132 2864 2566 2719 2722 2239 2059 2060 1682 1877 1055  355  598 1054  595  106
 208  453  454  921  691 1354 1559 1757 1945 2299 2300 2464 2771 2621 2911 3043 3169 3286 3395 3496 3495 3494 3493 3492 3491 3490 3489 3488 3487 3486 3485 3484 3483 3481 3577 3377 3574 3478 3477 3571 3476 3474 3568 3370 3472 3133 3134 2866 3131 2720 2408 2568 2409 2237 2569 1875 1683 1272 1483 1056  109  831  357  107
 690  452  689 1141  692 1352 1353 1756 1558 2125 2298 2463 2620 2769 2910 3042 3168 3285 3394 3393 3392 3391 3390 3389 3388 3387 3386 3385 3384 3383 3382 3381 3380 3379 3267 3479 3480 3376 3374 3373 3475 3371 3369 3366 3471 3367 3257 3253 2868 3006 2723 2721 1878 2062 2572 1876 1485 1686 1273 1057  601  599  111  358
 451  918  919 1139 1140 1557 1556 1754 1755 1944 2297 2462 2619 2768 2908 2909 3167 3284 3283 3282 3281 3280 3279 3278 3277 3276 3275 3274 3273 3272 3271 3270 3269 3268 3266 3265 3146 3375 3016 3144 3372 3260 3473 3259 3139 3137 3256 3255 3002 3003 2570 2411 2065 2241 2061 2064 2063 1684 1058  356  108  113  359  112
 207  206  688  917 1138 1351 1752 1555 1942 1943 2123 2461 2618 2767 2907 3041 3166 3165 3164 3163 3162 3161 3160 3159 3158 3157 3156 3155 3154 3153 3152 3151 3150 3149 3148 3147 3019 3264 3015 3262 3263 3014 3140 3138 3258 2874 2875 3008 3004 2869 2724 2571 2410 2573 1880 1879 1687 1484 1274  832  835  360  110  600
 205  450  687  916 1137 1350 1753 1751 1941 2124 2296 2295 2460 2617 2766 3040 3039 3038 3037 3036 3035 3034 3033 3032 3031 3030 3029 3028 3027 3026 3025 3024 3023 3022 3021 3020 2881 3017 3145 3142 3261 2878 3013 3141 2732 3011 3010 3135 2867 3005 2871 2725 2240 2242 1685 1487  838 1276 1059 1275 1060  833  361  114
 204  449  686  915 1135 1553 1348 1940 1939 2122 2294 2459 2616 2765 2906 2905 2904 2903 2902 2901 2900 2899 2898 2897 2896 2895 2894 2893 2892 2891 2890 2889 2888 2887 2886 2885 2880 2882 2587 3143 2879 2740 2737 3012 3136 3009 3007 2873 2729 2870 2726 2412 2066 2067 1881 2243 1488 1490 1278 1486  834  602  839  836
 203  448  685  914 1349 1136 1750 1554 2120 2121 2293 2458 2615 2764 2763 2762 2761 2760 2759 2758 2757 2756 2755 2754 2753 2752 2751 2750 2749 2748 2747 2746 2745 2744 2743 2742 2884 3018 2739 2429 2735 2736 2734 2877 2424 2733 2730 2872 2580 2577 2728 2727 2413 2244 1882 1279 1688 1064  605 1277 1062 1061  115  363
 202  447  684  913 1134 1347 1552 1749 1938 2119 2292 2457 2614 2613 2612 2611 2610 2609 2608 2607 2606 2605 2604 2603 2602 2601 2600 2599 2598 2597 2596 2595 2594 2593 2433 2592 2430 2883 2741 2738 2428 2426 2583 2425 2582 2731 2876 2581 2578 2418 2417 2574 2414 2245 2068 1689 1690 1491 1280 1281  837  362  365  364
 201  446  683  912 1133 1346 1551 1748 1937 2118 2291 2456 2455 2454 2453 2452 2451 2450 2449 2448 2447 2446 2445 2444 2443 2442 2441 2440 2439 2438 2437 2436 2435 2434 1715 2432 2591 2091 2589 2588 2586 2585 2427 2584 2423 2422 2579 2077 2575 2576 2416 2415 2246 2069 1884 1883 1691 1063 1489 1282  607  606  603  116
 200  445  682  911 1132 1345 1550 1747 1936 2117 2290 2289 2288 2287 2286 2285 2284 2283 2282 2281 2280 2279 2278 2277 2276 2275 2274 2273 2272 2271 2270 2269 2268 2266 2265 2264 1716 2590 2431 2261 2260 2259 2257 2256 2081 2421 2255 2254 2419 2252 2251 2250 2247 2071 2070 1885 1692 1492 1283  840 1065  604  119  366
 199  444  681  910 1131 1344 1549 1746 1935 2116 2115 2114 2113 2112 2111 2110 2109 2108 2107 2106 2105 2104 2103 2102 2101 2100 2099 2098 2097 2096 2095 2094 2093 2267 1908 1905 1717 1906 2263 2089 2084 2258 2083 2082 1898 2080 2420 2078 2253 2076 2075 2249 2248 2072 1889 1886 1693 1493 1694 1066  842  609  118  367
 198  443  680  909 1130 1343 1548 1745 1934 1933 1932 1931 1930 1929 1928 1927 1926 1925 1924 1923 1922 1921 1920 1919 1918 1917 1916 1915 1914 1912 1720 1721 1910 2092 2090 1311 2088 2262 2086 2085 1902 1903 1901 1900 1899 1707 2079 1896 1894 1893 1892 1891 2074 2073 1890 1887 1496 1696  608 1284  841  610  117  368
 197  442  679  908 1129 1342 1547 1744 1743 1742 1741 1740 1739 1738 1737 1736 1735 1734 1733 1732 1731 1730 1729 1728 1727 1526 1723 1722 1523 1913 1911 1719 1718 1907 1517 1713 1909 1904 2087 1711 1710 1091 1709 1708 1508 1704 1897 1895 1703 1702 1701 1700 1699 1698 1888 1697 1289 1695 1285 1067  843  611  369  120
 196  441  678  907 1128 1341 1546 1545 1544 1543 1542 1541 1540 1539 1538 1537 1536 1535 1534 1533 1532 1531 1530 1529 1528 1726 1725 1319 1724 1525 1522 1520 1098 1518 1519 1714 1516 1094 1515 1513 1712 1512 1510 1509 1507 1706 1705 1298 1505 1504 1503 1502 1501 1499 1498 1497 1494 1286 1069 1068  844  612  370  121
 195  440  677  906 1127 1340 1339 1338 1337 1336 1335 1334 1333 1332 1331 1330 1329 1328 1327 1326 1325 1324 1323 1322 1321 1527 1320 1318 1524  878 1316 1521 1099 1313 1312 1310 1308 1309 1514 1305 1304 1511 1303 1302 1301 1300 1506 1299 1297 1296 1295 1079 1500 1293 1292 1291 1290 1495 1288 1287 1070  371  372  122
 194  439  676  905 1126 1125 1124 1123 1122 1121 1120 1119 1118 1117 1116 1115 1114 1113 1112 1111 1110 1109 1108 1107 1106 1105 1104 1103 1317  647  877 1315 1314 1097 1096 1095 1093  869 1307 1306 1090 1089 1088 1087 1086 1085 1084 1083 1082 1081 1080 1078 1294 1077 1076 1075 1074 1073 1072 1071  845  614  613  123
 193  438  675  904  903  902  901  900  899  898  897  896  895  894  893  892  891  890  889  888  887  886  885  884  883  882  881  880 1102  879 1101 1100  875  874  873  641  872 1092  870  399  637  866  865  864  863  862  861  860  859  858  857  856  855  854  853  852  851  850  849  848  846  847  373  124
 192  437  674  673  672  671  670  669  668  667  666  665  664  663  662  661  660  659  658  657  656  655  654  653  652  651  650  649  648  408  645  876  644  643  642  871  639  398  868  638  635  867  634  633  632  631  630  629  628  627  626  625  624  623  622  621  620  619  618  617  616  615  374  125
 191  436  435  434  433  432  431  430  429  428  427  426  425  424  423  422  421  420  419  418  417  416  415  414  413  412  411  410  409  407  646  406  405  404  403  401  640  153  400  396  397  149  395  394  393  392  391  390  389  388  387  386  385  384  383  382  381  380  379  378  377  376  375  126
 190  189  188  187  186  185  184  183  182  181  180  179  178  177  176  175  174  173  172  171  170  169  168  167  166  165  164  163  162  161  160  159  158  157  156  402  155  154  152  151  636  150  148  147  146  145  144  143  142  141  140  139  138  137  136  135  134  133  132  131  130  129  128  127
