# This puzzle is unsolvable
8
10 63 34 53 11 52 28 15
62 25 49 14  0 46  9 60
54 55 30 23 27 33 51 13
61  1 24  7 37 18 50  5
 4 58 12 16 59  6 32 48
22 38 21 31 35  8 20 56
44 36 19 26 42 57 40 43
39 29  3 17 47 41  2 45
