# This puzzle is unsolvable
50
   2    1    3    4    5    6    7    8    9   10   11   12   13   14   15   16   17   18   19   20   21   22   23   24   25   26   27   28   29   30   31   32   33   34   35   36   37   38   39   40   41   42   43   44   45   46   47   48   49   50
 196  197  198  199  200  201  202  203  204  205  206  207  208  209  210  211  212  213  214  215  216  217  218  219  220  221  222  223  224  225  226  227  228  229  230  231  232  233  234  235  236  237  238  239  240  241  242  243  244   51
 195  384  385  386  387  388  389  390  391  392  393  394  395  396  397  398  399  400  401  402  403  404  405  406  407  408  409  410  411  412  413  414  415  416  417  418  419  420  421  422  423  424  425  426  427  428  429  430  245   52
 194  383  564  565  566  567  568  569  570  571  572  573  574  575  576  577  578  579  580  581  582  583  584  585  586  587  588  589  590  591  592  593  594  595  596  597  598  599  600  601  602  603  604  605  606  607  608  431  246   53
 193  382  563  736  737  738  739  740  741  742  743  744  745  746 1066  747  748  750  751  752  753  754  755  756  757  758  759  760  761  762  763  764  765  766  767  768  769  770  771  772  773  774  775  776  777  778  609  432  247   54
 192  381  562  735  900  901  902  903  904  905 1062  906  908  909  910  912  749  913  914  915  916  917  918  919  920  921  922  923  924  925  926  927  928  929  930  931  932  933  934  935  936  937  938  939  940  779  610  433  248   55
 191  380  561  734  899 1056 1057 1058 1060 1061 1208  907 1209 1064 1351 1067  911 1068 1069 1070 1071 1072 1073 1074 1075 1076 1077 1078 1079 1080 1081 1082 1083 1084 1085 1086 1087 1088 1089 1090 1091 1092 1093 1094  941  780  611  434  249   56
 190  379  560  733  898 1055 1204 1206 1059 1207    0 1210 1063 1065 1211 1213 1214 1215 1216 1217 1218 1219 1220 1221 1222 1223 1224 1225 1226 1227 1228 1229 1230 1231 1232 1233 1234 1235 1236 1237 1238 1239 1240 1095  942  781  612  435  250   57
 189  378  559  732  897 1054 1203 1205 1345 1346 1347 1348 1349 1212 1350 1352 1353 1354 1355 1356 1357 1358 1359 1360 1361 1362 1363 1364 1365 1366 1367 1368 1369 1370 1371 1372 1373 1374 1375 1376 1377 1378 1241 1096  943  782  613  436  251   58
 188  377  558  731  896 1053 1202 1344 1476 1477 1478 1479 1480 1481 1482 1483 1484 1485 1486 1487 1488 1489 1490 1491 1492 1493 1494 1495 1496 1497 1498 1499 1500 1501 1502 1503 1504 1505 1506 1507 1508 1379 1242 1097  944  783  614  437  252   59
 187  376  557  730  895 1052 1201 1343 1342 1600 1601 1602 1603 1604 1605 1606 1607 1608 1609 1610 1611 1612 1613 1614 1615 1616 1617 1618 1619 1620 1621 1622 1623 1624 1625 1626 1627 1628 1629 1630 1509 1380 1243 1098  945  784  615  438  253   60
 186  374  556  894 1051 1200 1341 1474 1475 1599 1716 1717 1718 1719 1720 1721 1722 1723 1724 1725 1726 1727 1728 1729 1730 1731 1732 1733 1734 1735 1736 1737 1738 1739 1740 1741 1742 1743 1744 1631 1510 1381 1244 1099  946  785  616  439  254   61
 185  555  375  729  893 1050 1199 1340 1598 1597 1715 1824 1825 1826 1827 1828 1829 1830 1831 1832 1833 1834 1835 1836 1837 1838 1839 1840 1841 1842 1843 1844 1845 1846 1847 1848 1849 1850 1745 1632 1511 1382 1245 1100  947  786  617  440  255   62
 184  373  554  728  727 1049 1198 1473 1471 1472 1714 1823 1924 1925 1926 1927 1928 1929 1930 1931 1932 1933 1934 1935 1936 1937 1938 1939 1940 1941 1942 1943 1944 1945 1946 1947 1948 1851 1746 1633 1512 1383 1246 1101  948  787  618  441  256   63
 183  372  553  726  892 1048 1197 1339 1338 1596 1713 1822 1923 2016 2017 2018 2019 2020 2021 2022 2023 2024 2025 2026 2027 2028 2029 2030 2031 2032 2033 2034 2035 2036 2037 2038 1949 1852 1747 1634 1513 1384 1247 1102  949  788  619  442  257   64
 182  371  552  725  891  890 1047 1337 1469 1470 1595 1821 1922 2015 2100 2101 2102 2103 2104 2105 2106 2107 2108 2109 2110 2111 2112 2113 2114 2115 2116 2117 2118 2119 2120 2039 1950 1853 1748 1635 1514 1385 1248 1103  950  789  620  443  258   65
 181  370  551  724  889 1046 1196 1195 1468 1594 1712 1820 1921 2014 2099 2176 2177 2178 2179 2180 2181 2182 2183 2184 2185 2186 2187 2188 2189 2190 2191 2192 2193 2194 2121 2040 1951 1854 1749 1636 1515 1386 1249 1104  951  790  621  444  259   66
 180  369  550  723  888 1194 1335 1336 1592 1593 1711 1819 1920 2013 2098 2175 2244 2245 2246 2247 2248 2249 2250 2251 2252 2253 2254 2255 2256 2257 2258 2259 2260 2195 2122 2041 1952 1855 1750 1637 1516 1387 1250 1105  952  791  622  445  260   67
 179  368  549  722 1044 1045 1193 1334 1707 1709 1710 1818 1919 2012 2097 2174 2243 2304 2305 2358 2306 2308 2309 2310 2311 2312 2313 2314 2315 2316 2317 2318 2261 2196 2123 2042 1953 1856 1751 1638 1517 1388 1251 1106  953  792  623  446  261   68
 178  548  547  721  885  887 1466 1467 1333 1590 1332 1817 1918 2011 2173 2242 2303 2357 2355 2401 2359 2402 2362 2403 2405 2363 2364 2365 2366 2367 2368 2319 2262 2197 2124 2043 1954 1857 1752 1639 1518 1389 1252 1107  954  793  624  447  262   69
 176  367  546  884 1043  886 1042 1465 1708 1192 1591 1816 1917 2010 2096 2172 2302 2241 2240 2307 2436 2361 2360 2404 2440 2406 2407 2408 2409 2410 2369 2320 2263 2198 2125 2044 1955 1858 1753 1640 1519 1390 1253 1108  955  794  625  448  263   70
 364  177  545  720  719 1041 1191 1330 1706 1588 1589 1815 1916 2009 2095 2094 2171 2301 2356 2352 2400 2399 2437 2466 2439 2441 2442 2443 2444 2411 2370 2321 2264 2199 2126 2045 1956 1859 1754 1641 1520 1391 1254 1109  956  795  626  449  264   71
 365  366  172  883  881 1037 1331 1189 1190 1705 1461 1813 1915 2008 2093 2239 2238 2398 2300 2396 2353 2464 2438 2485 2465 2468 2469 2470 2445 2412 2371 2322 2265 2200 2127 2046 1957 1860 1755 1642 1521 1392 1255 1110  957  796  627  450  265   72
 543  174  542  882 1040 1039  717 1188 1463 1814 1704 1812 1914 2007 2005 2092 2169 2298 2351 2434 2435 2354 2484 2499 2467 2487 2488 2471 2446 2413 2372 2323 2266 2201 2128 2047 1958 1861 1756 1643 1522 1393 1256 1111  958  797  628  451  266   73
 173  175  718  363  880 1035 1186 1187 1459 1460 1703 1464 1702 1913 2088 2091 2237 2170 2297 2431 2494 2463 2461 2462 2486 2498 2489 2472 2447 2414 2373 2324 2267 2202 2129 2048 1959 1862 1757 1644 1523 1394 1257 1112  959  798  629  452  267   74
 544  171  713  539  541 1327 1329 1462 1700 1586 1584 1587 1811 1911 2006 1912 2089 2299 2167 2236 2433 2397 2460 2483 2497 2496 2476 2490 2473 2416 2415 2325 2268 2203 2130 2049 1960 1863 1758 1645 1524 1395 1258 1113  960  799  630  453  268   75
 360  361  362  170  879  712 1184 1328 1038 1585 1458 1583 1810 2090 2166 2168 2393 2350 2395 2349 2459 2458 2430 2493 2491 2492 2454 2474 2448 2449 2374 2326 2269 2204 2131 2050 1961 1864 1759 1646 1525 1396 1259 1114  961  800  631  454  269   76
 168  355  715  710 1034  716 1036 1325 1185 1582 1699 2004 1909 1910 2234 2235 2233 2394 2292 2345 2432 2457 2482 2479 2495 2478 2475 2422 2450 2376 2375 2327 2270 2205 2132 2051 1962 1865 1760 1647 1526 1397 1260 1115  962  801  632  455  270   77
 169  537  540  714  878 1183 1326 1324 1581 1456 1809 1701 2002 2003 2164 2086 2165 2348 2392 2391 2428 2481 2480 2456 2455 2477 2383 2420 2451 2417 2377 2328 2271 2206 2133 2052 1963 1866 1761 1648 1527 1398 1261 1116  963  802  633  456  271   78
 357  359  709  875 1033 1182 1323 1580 1698 1457 1808 1807 2001 2000 1908 2087 2347 2295 2344 2346 2429 2285 2388 2426 2453 2425 2452 2421 2419 2418 2378 2329 2272 2207 2134 2053 1964 1867 1762 1649 1528 1399 1262 1117  964  803  634  457  272   79
 358  167  876  873  877 1032 1181 1454 1322 1579 1697 1806 2085 1907 1906 2163 2294 2231 2296 2390 2293 2389 2427 2387 2423 2384 2382 2335 2334 2381 2332 2330 2273 2208 2135 2054 1965 1868 1763 1650 1529 1400 1263 1118  965  804  635  458  273   80
 165  538  356  711 1030 1031 1319 1455 1453 1321 1578 1804 1998 2160 2084 2230 2162 2232 2343 2342 2287 2286 2340 2339 2424 2337 2336 2279 2280 2379 2380 2331 2274 2209 2136 2055 1966 1869 1764 1651 1530 1401 1264 1119  966  805  636  459  274   81
 352  166  536  354  872 1029 1178 1318 1180 1803 1805 1905 1904 1996 2083 2161 2159 2291 2290 2289 2288 2284 2341 2385 2386 2219 2282 2218 2216 2333 2277 2276 2275 2210 2137 2056 1967 1870 1765 1652 1531 1402 1265 1120  967  806  637  460  275   82
 164  874  705  707 1179  871 1177 1176 1320 1696 1576 1801 1999 1997 2082 2158 2229 2227 2228 2225 2223 2283 2220 2221 2338 2148 2217 2281 2215 2278 2214 2213 2212 2211 2138 2057 1968 1871 1766 1653 1532 1403 1266 1121  968  807  638  461  276   83
 162  870  535  533  529 1028 1027 1317 1316 1452 1695 1694 1903 1800 2081 2157 2078 2155 2226 2154 2073 2222 2151 2071 2150 2149 2147 2146 2145 2144 2143 2142 2141 2140 2139 2058 1969 1872 1767 1654 1533 1404 1267 1122  969  808  639  462  277   84
 706  534  708  528 1175  704 1172 1572 1575 1450 1802 1902 1577 1994 2080 2079 1795 1896 2156 2075 2153 2224 2152 2069 1982 1887 2068 2067 2066 2065 2064 2063 2062 2061 2060 2059 1970 1873 1768 1655 1534 1405 1268 1123  970  809  640  463  278   85
 351  163  866  531  532  869 1449 1173  867 1693 1690 1692 1798 1993 1995 1684 1898 2076 1891 1560 1989 1988 2072 1984 2070 1983 1981 1980 1979 1978 1977 1976 1975 1974 1973 1972 1971 1874 1769 1656 1535 1406 1269 1124  971  810  641  464  279   86
 159  353 1026  347  701  695  868  344 1799 1451 1446 1900 1901 1685 1899 1895 1683 2077 1990 1790 1789 1787 1985 1890 1888 1674 1672 1886 1884 1883 1882 1881 1880 1879 1878 1877 1876 1875 1770 1657 1536 1407 1270 1125  972  811  642  465  280   87
 703  160  157  349  863  156 1025 1688 1171 1573 1691 1796 1686 1992 1794 1897 1991 1893 1894 1561 2074 1987 1986 1889 1785 1784 1885 1670 1782 1780 1779 1778 1777 1776 1775 1774 1773 1772 1771 1658 1537 1408 1271 1126  973  812  643  466  281   88
 158 1021  350 1311  348 1315 1019  699 1314 1448 1313 1689 1447 1681 1793 1791 1792 1680 1559 1558 1296 1678 1431 1676 1675 1783 1554 1673 1781 1669 1668 1667 1666 1665 1664 1663 1662 1661 1660 1659 1538 1409 1272 1127  974  813  644  467  282   89
 154 1022  524 1020  527  525 1024 1023  858 1571 1574 1569 1570 1797 1304 1566 1682 1562 1300 1788 1294 1429 1433 1892 1428 1553 1427 1671 1551 1550 1549 1548 1547 1546 1545 1544 1543 1542 1541 1540 1539 1410 1273 1128  975  814  645  468  283   90
 521  702  526  700  696 1312  530  161 1307 1445 1165 1567 1439 1687 1303 1564 1679 1563 1297 1432 1001 1002 1153 1555 1786 1426 1552 1425 1424 1423 1422 1421 1420 1419 1418 1417 1416 1415 1414 1413 1412 1411 1274 1129  976  815  646  469  284   91
 153  151  522 1018  155 1309 1308  865 1013 1166 1306 1305 1568 1160 1438 1008 1436 1157 1158 1295  676  677 1556 1430 1151 1292 1291 1290 1289 1288 1287 1286 1285 1284 1283 1282 1281 1280 1279 1278 1277 1276 1275 1130  977  816  647  470  285   92
 343  861  345 1164 1169  152 1174 1441 1167 1443  512 1162 1440 1437 1565  850 1302 1005  847 1434 1557  845 1677 1152 1293  999 1149  996 1146 1145 1144 1143 1142 1141 1140 1139 1138 1137 1136 1135 1134 1133 1132 1131  978  817  648  471  286   93
 342  860  523  339  857 1168 1444 1170  862  688 1015 1442 1163 1010 1301 1011 1435 1159  680 1156 1299  502  675  841 1006  998 1147 1148  995  994  993  992  991  990  989  988  987  986  985  984  983  982  981  980  979  818  649  472  287   94
 150  520  346  340  519  694  693  698  690  856  855  684 1161  849  683  851 1004 1007 1003  679  673  844 1155  840  839 1150  997  838  836  835  834  833  832  831  830  829  828  827  826  825  824  823  822  821  820  819  650  473  288   95
 338  864  341  148 1017 1016  515 1310  859  853 1012 1014 1009  852  133  505  131  504  128  843  503  319 1298  314 1000  498  670  837  494  669  668  666  665  664  663  662  661  660  659  658  657  656  655  654  653  652  651  474  289   96
 336  334  145  143  518  330  689  692  141  332  510  686  685  509  508  848  320  130  678  501  125 1154  671  842  497  318  495  121  312  493  667  491  490  489  488  487  486  485  484  483  482  481  480  479  478  477  476  475  290   97
 337  149  517  138  146  142  333  327  329  513  687  511  135  136  507  324  506  321  682  322  316  674  123  124  126  496  313  120  311  309  492  308  307  306  305  304  303  302  301  300  299  298  297  296  295  294  293  292  291   98
 147  697  335  516  691  144  328  140  331  139  137  854  514  326  134  325  681  132  323  129  499  500  127  317  846  315  672  122  119  310  118  117  116  115  114  113  112  111  110  109  108  107  106  105  104  103  102  101  100   99
