# This puzzle is unsolvable
31
  2   1   3   4   5   6 127   7  10 130 129 131 134 132 245  14  17 248 136  21  20  22  24 143  25  27  28 147  30  32 149
120 121 122 123 124 125 239   9 128 243 345  11  13 135  16 349 137 252 140  19  18 138 144 451 360 255  26 257  29  31  33
119 232 337 233 234 433 237   8 238 240 439 244  12 347 133  15 446 351 141 449 753 249 142  23 254 454 361 259 260 258 150
118 231 336 235 236 434 126 338 340 242 344 241 346 348 350 246 247 533 251 139 352 354 253 536 145 357 256 455 146 148  34
117 230 334 519 432 521 339 436 523 343 341 438 440 442 443 444 612 611 447 448 534 353 355 358 452 542 456 362 261 151  35
116 229 333 430 335 520 522 524 342 437 526 527 441 528 608 532 445 682 685 614 535 453 618 539 538 359 543 363 263 152 262
115 227 228 431 600 601 435 602 603 525 604 606 607 679 609 530 610 613 800 749 250 450 537 617 751 356 619 540 266  37 153
114 113 332 518 516 599 672 673 674 675 605 677 678 680 529 683 743 744 615 684 804 686 545 541 690 365 155 364 154  39  36
112 428 426 429 598 597 671 736 737 739 676 741 742 796 797 531 681 799 803 748 806 616 457 750 625 621 458  38 265 156 157
224 225 517 515 596 791 792 793 738 838 740 840 794 845 798 846 919 847 747 746 754 687 688 755 544 264 623 460 159  40 368
223 111 329 331 226 735 670 789 731 732 795 912 843 937 885 916 942 849 745 889 851 752 805 891 692 624 689 369 267 366  44
110 427 222 514 512 595 734 666 879 790 842 841 939 844 914 886 958 854 801 918 852 691 622 694 546 626 462 164 620  41 459
109 330 326 668 594 425 881 592 788 839 882 915 883 884 954 887 951 888 952 850 920 693 890 808 547 627 463 370 466 269 461
108 328 424 221 423 421 669 665 880 936 876 909 913 934 960 848 802 921 927 696 759   0 853 695 549 273 551 268 367  42 464
219 107 324 589 511 327 662 593 836 667 910 875 878 955 938 940 896 922 756 855 924 809 552 553 548 162  43 375  45 371 158
509 220 105 728 419 513 420 663 786 837 948 730 950 908 947 949 917 941 894 946 892 628 807 467 629 165 465 376 160 161 272
106 321 325 422 322 590 785 784 782 787 935 727 933 959 929 953 893 956 943 863 810 758 698 757 631 373 554 372 270 550  46
217 216 102 587 835 833 591 907 729 733 832 911 834 932 906 858 957 901 856 926 700 813 811 555 697 271 468 276 274 277 163
214 320 510 218 418 586 659 877 588 831 664 873 825 931 905 930 857 944 760 860 945 812 699 630 701 633 471 167 377  48  47
101 104 319 103 416 507 783 660 874 828 780 871 870 826 872 923 900 711 862 817 898 815 632 761 469 556 473 374 378 166  49
 98 318 323 505 506 724 661 725 726 830 823 775 868 904 869 772 928 821 820 814 897 763 762 702 634 472 379 470 282 275  50
212 414 215  99 658 585 657 723 779 781 778 776 867 714 903 866 859 864 899 818 819 766 765 635 558 764 170 278 168  52  51
417 213 415 502 508 584 722 653 777 827 651 719 824 774 773 572 771 770 925 644 865 708 704 710 560 557 381 380 384 169 171
500 100 504 582  96 656 721 720 404 718 829 645 649 574 716 902 712 822 895 768 568 861 642 559 705 478 703 279 174  53 281
 94 211 317 316 583 503 501 654 494 580 650 717 573 715 713 570 569 643 769 709 767 640 816 564 636 474 280 475 637 382  54
208  97 310 210 499 406 413 497 579 652 577 575 491 571 648 647 486 396 567 485 482 391 706 707 639 386 388 283 479 173 172
315  93 209 408 314 409 655 411 578 495 493 576 492 490 489 488 646 487 566 641 483 565 393 638 562 387 476 383 385  55  57
207  91  90 498 412 307 496 405 305 402 303 401 400 399 398 397 395 189 296 392 390 481 289 563 480 288 561 286 285  58  56
 95  88 410 312  85 407  86 304 403 197 195 302 301 300 299 298 297 295 394 293 292 484 291 389 290 179 287 284 178 175 176
205 206 581 313 203 202 199 200  83  82  81  80 194 193 192 191  75 187  72 294 186 185 184 183 182 181 477 180  61  62  59
 92  89 311  87 204 201 309 308  84 306 198 196  79  78  77  76  74 188 190  73  71  70  69  68  67  66  65  64 177  63  60
