# This puzzle is unsolvable
38
   2    1    3  152    4    7    8  156    9  157   10   11   13   14   15   16   17   18   19   20   21   22   23   24   25   26   27   28   29   30   31   32   33   34   35   36   37   38
 148  149  150    5  153    6  292  155  295  296  158   12  159  161  162  163  164  166  305  167  168  169  170  171  172  173  174  175  176  177  178  179  180  181  182  183  184   39
 147  288  289  290  424  423  154  293  426  297  299  429  431  300  302  432  303  165  436  306  307  309  563  310  311  312  313  315  316  446  317  318  319  320  321  322  185   40
 146  287  421  291  151  546  768  294  425  428  551  553  160  430  555  301  434  304  437  438  439  308  562  441  442  443  683  314  444  447  448  449  450  451  452  323  186   41
 145  286  420  544  422  545  661  548  549  427  666  668  298  554  556  672  433  435  559  560  561  440  564  679  565  680  681  445  792  568  571  572  573  574  453  324  187   42
 144  285  419  660  769  547  662  663  664  550  552  872  667  669  670  557  779  558  675  782  676  678  786  977  785  566  790  684  570  569  686  687  688  575  454  326  325   43
 143  284  418  543  416  542  770  771  870  772  665  773  775  776  777  671  778  880  674  783  883  677  784  787  788  886  682  567  889  793  892  794  689  576  455  327  188  189
 142  283  417  659  541  658  868  867  869  871  963  774  874  875  876  877  878  879  673  781  973  882  884  885  976  888  890  789  978  685  891  795  577  578  458  456  190   44
 141  282  415  540  656  657  766  767  960  962  964  873  965  966  967  968  969 1053  780  881 1056  974 1058 1059  980  979  791 1138  887 1064  893  691  690  457  329  328   46   45
 139  140  280  414  539  866  961 1043  959 1045 1046 1047 1048 1049 1050 1126 1051  970  972  971 1131  975 1057 1133 1134 1061 1062 1137  894  982  985  692  693  579  580  192  191   47
 138  413  281  655  654  765 1044  865  958 1120 1121 1122 1123 1124 1125 1193 1194 1127 1054 1256 1132 1199 1200 1060 1136 1203  981 1063  796  895 1139  797  984  459  582   49  193  331
 279  412  537  538  763  764  864  957 1042 1119 1188 1249 1189 1191 1192 1252 1254 1052 1055 1195 1130 1129 1202 1258 1261 1135 1204 1066 1065 1141  983  694  460  332  581  330   50   48
 137  278  411  536  653  762  863  956 1118 1117 1187 1248 1190 1250 1251 1253 1302 1255 1128 1350 1198 1197 1310 1260 1201 1262 1140 1263  986  798  800  695  799  696  462 1067  461  196
 136  277  410  535  761  862  955  861 1186 1040 1247 1185 1299 1300 1304 1301 1305 1384 1196 1309 1308 1257 1353 1355 1312 1264 1205 1206 1144  987  896  899  898  801  583  333  195  194
 134  135  409  534  652  760  651  860  954 1041 1039 1246 1298 1344 1345 1303 1348 1383 1307 1349 1314 1412 1354 1311 1313 1207 1142 1068 1266  988  803  584  989  697  335  334   51   52
 274  276  408  650  532  533  759 1038 1037 1114 1116 1342 1343 1380 1347 1429 1409 1382 1410 1306 1388 1414 1259 1413 1208 1210 1209  897 1071 1143  900  698  902  586  198  463   54   53
 530  133  531  405  757  758  953  859 1036  952 1183 1245 1244 1408 1297 1381 1428 1442 1411 1386 1352 1431 1351 1415 1387 1145 1265 1315 1146 1070  806  990  587  464  465  336  197  199
 275  132  273  407  647  854 1035  528  951 1113 1115 1182 1243 1379 1341 1378 1427 1407 1440 1430 1416 1434 1418 1392 1390  995 1147 1212 1072  700  802  702  805  467  585  466  337   55
 272  406  527  649  755  648  948  855  950 1112 1181 1296 1184 1295 1405 1346 1425 1426 1423 1436 1432 1385 1389 1391 1319 1357 1267 1069 1073 1074  991  699  468  589  701  340  338  200
 131  130  529  129  403  756    0  858  949 1034 1241 1242 1339 1340 1293 1406 1376 1399 1443 1433 1317 1270 1417 1358 1356 1211 1318  992  905  901  703  804  808  591  469  201  588   56
 128  644  271  646  404 1031  943  857 1110 1111 1180 1240 1292 1294 1377 1375 1439 1400 1369 1438 1394 1441 1393 1359 1395 1316 1268 1269 1148  997  904  807  903  590  341  202  339   57
 269  852  126  645  399 1030  526  642  946 1033 1179 1109 1178 1239 1374 1404 1403 1402 1366 1421 1437 1420 1435 1360 1271 1215  994 1320 1075 1078  810  993  705  203  704  471   59  204
 402  127  268  401  751  853  947  856  945 1177 1176 1238 1291 1338 1337 1373 1371 1424 1367 1327 1419 1363 1396 1361 1323 1272  908 1151 1149 1077  906  809  706  342  592   61  206   58
 267  266  270  754  400  753  525 1108 1107 1175 1174 1237 1290 1335 1336 1332 1370 1368 1401 1422 1365 1152 1321 1275 1274 1322 1214 1213  996  811  999  812  593  207  470  344  343  205
 265  124  523  749  750  640  944 1029 1106 1105 1235 1236 1334 1285 1372 1333 1330 1228 1325 1282 1397 1398 1223 1278 1273 1218 1216 1150 1153  909 1081  907  472  473  707   63  209   62
 125  396  524  522  641  643  942  752 1032 1288 1173 1289 1170 1287 1286 1167 1229 1284 1280 1329 1326 1362 1279 1364 1277 1324 1217 1080 1076 1079  912  813  708  594  345 1001  475   60
 123  398  397  639  849  850  851 1028 1103 1102 1104 1171 1234 1233 1331 1232 1283 1230 1328 1281 1227 1163 1221 1156 1085 1276 1220 1155  913  910  814  816  998  709  346  210   64  208
 122  395  264  393  748  747  847 1026 1027 1100 1022 1099 1169 1231 1168 1165 1093 1226 1014 1164 1225 1224 1161 1159 1222 1088 1083 1002 1000  911  595 1219  600  598  597  476   66  596
 262  263  521  636  940  637  745  938  941 1025 1021 1020 1172 1098 1097 1166 1096 1094 1091  925 1162 1090 1089 1160 1008 1006 1157  918 1154  720  711  599  713  710  474  347   67   65
 121  120  258  394  520  939  937  744 1024 1023  935 1101  840 1019 1018  834 1095  930 1012 1011 1087 1010 1009 1158  921 1003 1086  609  712  815  817  916  818  478  477  348  213  211
 260  638  259  518  519  746  634  743  739  740  936  625  933 1017  734 1016  833 1015  929  830 1013  922  924  827  920  613  610  721  917 1084 1082  488  914  915  352  350  349   68
 119  261  390  517  515  635  844  845  741  841  934  838  737  932  931  733  835  732  731  926  498  828  923  724 1007  611  823  821 1005  608 1004  715  820  480  479  212   69  215
 632  117  118  392  387  630  843  627  633  842  626  839  738  735  836  927  730  928 1092  727  729  369  726  723  493  826  919  722  717  606  486  607  359  601  351  353  214   70
 257  256  115  846  513  511  629  848  509  381  508  736  623  624  504  621  619  618  371  728  616  725  615  368  718  491  824  363  489  224  605  223  356  819  483  481  603  216
 114  516  514  391  388  631  384  628  246  382  837  505  506  377  622  503  373  829  832  499  496  234  831  494  617  495  492  612  822  226  714  716  357  604  482   73  217   76
 254  116  109  389  251  512  105  248  102  742  380  507  378  242  376  239  375  502  501  233   93  365  497  825  230  231  364  490  362  719  220  358   81  485  218   78   75  484
 255  113  253  107  108  249  250  106  510  247  243  379   98  241  374   95  500  372  236  240  235   89  370   90  614  366  229  228  227  487  361   82  602   79  355   74   72   71
 112  111  252  386  110  385  383  103  104  244  245  101  100   99   97   96   94  620  238  237   91   88   92  367  232   87   86   85   84   83  225  221  360   80  354  222   77  219
