# This puzzle is unsolvable
55
   2    1    3    4    5    6    7    8    9   10   11   12   13   14   15   16   17   18   19   20   21   22   23   24   25   26   27   28   29   30   31   32   33   34   35   36   37   38   39   40   41   42   43   44   45   46   47   48   49   50   51   52   53   54   55
 216  217  218  219  220  221  222  223  224  225  226  227  228  229  230  231  232  233  234  235  236  237  238  239  240  241  242  243  244  245  246  247  248  249  250  251  252  253  254  255  256  257  258  259  260  261  262  263  264  265  266  267  268  269   56
 215  424  425  426  427  428  429  430  431  432  433  434  435  436  437  438  439  440  441  442  443  444  445  446  447  448  449  450  451  452  453  454  455  456  457  458  459  460  461  462  463  464  465  466  467  468  469  470  471  472  473  474  475  270   57
 214  423  624  625  626  627  628  629  630  631  632  633  634  635  636  637  638  639  640  641  642  643  644  645  646  647  648  649  650  651  652  653  654  655  656  657  658  659  660  661  662  663  664  665  666  667  668  669  670  671  672  673  476  271   58
 213  422  623  816  817  818  819  820  821  822  823  824  825  826  827  828  829  830  831  832  833  834  835  836  837  838  839  840  841  842  843  844  845  846  847  848  849  850  851  852  853  854  855  856  857  858  859  860  861  862  863  674  477  272   59
 212  421  622  815 1000 1001 1002 1003 1004 1005 1006 1007 1008 1009 1010 1011 1012 1013 1014 1015 1016 1017 1018 1019 1020 1021 1022 1023 1024 1025 1026 1027 1028 1029 1030 1031 1032 1033 1034 1035 1036 1037 1038 1039 1040 1041 1042 1043 1044 1045  864  675  478  273   60
 211  420  621  814  999 1176 1177 1178 1179 1180 1181 1182 1183 1184 1185 1186 1187 1188 1189 1190 1191 1192 1193 1194 1195 1196 1197 1198 1199 1200 1201 1202 1203 1204 1205 1206 1207 1208 1209 1210 1211 1212 1213 1214 1215 1216 1217 1218 1219 1046  865  676  479  274   61
 210  419  620  813  998 1175 1344 1345 1346 1347 1348 1349 1350 1351 1352 1353 1354 1355 1356 1357 1358 1359 1360 1361 1362 1363 1364 1365 1366 1367 1368 1369 1370 1371 1372 1373 1374 1375 1376 1377 1378 1379 1380 1381 1382 1383 1384 1385 1220 1047  866  677  480  275   62
 209  418  619  812  997 1174 1343 1504 1505 1506 1507 1508 1509 1510 1511 1512 1513 1514 1515 1516 1517 1518 1519 1520 1521 1522 1523 1524 1525 1526 1527 1528 1529 1530 1531 1532 1533 1534 1535 1536 1537 1538 1539 1540 1541 1542 1543 1386 1221 1048  867  678  481  276   63
 208  417  618  811  996 1173 1342 1503 1656 1657 1658 1659 1660 1661 1662 1663 1664 1665 1666 1667 1668 1669 1670 1671 1672 1673 1674 1675 1676 1677 1678 1679 1680 1681 1682 1683 1684 1685 1686 1687 1688 1689 1690 1691 1692 1693 1544 1387 1222 1049  868  679  482  277   64
 207  416  617  810  995 1172 1341 1502 1655 1800 1801 1802 1803 1804 1805 1806 1807 1808 1809 1810 1811 1812 1813 1814 1815 1816 1817 1818 1819 1820 1821 1822 1823 1824 1825 1826 1827 1828 1829 1830 1831 1832 1833 1834 1835 1694 1545 1388 1223 1050  869  680  483  278   65
 206  415  616  809  994 1171 1340 1501 1654 1799 1936 1937 1938 1939 1940 1941 1942 1943 1944 1945 1946 1947 1948 1949 1950 1951 1952 1953 1954 1955 1956 1957 1958 1959 1960 1961 1962 1963 1964 1965 1966 1967 1968 1969 1836 1695 1546 1389 1224 1051  870  681  484  279   66
 205  414  615  808  993 1170 1339 1500 1653 1798 1935 2064 2065 2066 2067 2068 2069 2070 2071 2072 2073 2074 2075 2076 2077 2078 2079 2080 2081 2082 2083 2084 2085 2086 2087 2088 2089 2090 2091 2092 2093 2094 2095 1970 1837 1696 1547 1390 1225 1052  871  682  485  280   67
 204  413  614  807  992 1169 1338 1499 1652 1797 1934 2063 2184 2185 2186 2187 2188 2189 2190 2191 2192 2193 2194 2195 2196 2197 2198 2199 2200 2201 2202 2203 2204 2205 2206 2207 2208 2209 2210 2211 2212 2213 2096 1971 1838 1697 1548 1391 1226 1053  872  683  486  281   68
 203  412  613  806  991 1168 1337 1498 1651 1795 1796 1933 2183 2296 2297 2298 2299 2300 2301 2302 2303 2304 2305 2306 2307 2308 2309 2310 2311 2312 2313 2314 2315 2316 2317 2318 2319 2320 2321 2322 2323 2214 2097 1972 1839 1698 1549 1392 1227 1054  873  684  487  282   69
 202  411  612  805  990 1167 1336 1497 1650 1794 2061 2062 2182 2295 2400 2401 2402 2403 2404 2405 2406 2407 2408 2409 2410 2411 2412 2413 2414 2415 2416 2417 2418 2419 2420 2421 2422 2423 2424 2425 2324 2215 2098 1973 1840 1699 1550 1393 1228 1055  874  685  488  283   70
 201  410  611  804  989 1166 1335 1496 1649 1930 1932 2060 2181 2294 2399 2496 2497 2498 2499 2500 2501 2502 2503 2504 2505 2506 2507 2508 2509 2510 2511 2512 2513 2514 2515 2516 2517 2518 2519 2426 2325 2216 2099 1974 1841 1700 1551 1394 1229 1056  875  686  489  284   71
 200  409  610  803  988 1165 1333 1334 1648 1793 1931 2059 2180 2293 2398 2495 2584 2585 2586 2587 2588 2589 2590 2591 2592 2593 2594 2595 2596 2597 2598 2599 2600 2601 2602 2603 2604 2605 2520 2427 2326 2217 2100 1975 1842 1701 1552 1395 1230 1057  876  687  490  285   72
 199  608  407  609  987 1332 1163 1495 1647 1792 1929 2058 2179 2292 2397 2494 2583 2664 2665 2666 2667 2668 2669 2670 2671 2672 2673 2674 2675 2676 2677 2678 2679 2680 2681 2682 2683 2606 2521 2428 2327 2218 2101 1976 1843 1702 1553 1396 1231 1058  877  688  491  286   73
 197  198  408  802 1164  800 1493 1494 1646 1791 1928 2056 2057 2291 2396 2493 2582 2663 2736 2737 2738 2739 2740 2741 2742 2743 2744 2745 2746 2747 2748 2749 2750 2751 2752 2753 2684 2607 2522 2429 2328 2219 2102 1977 1844 1703 1554 1397 1232 1059  878  689  492  287   74
 406  405  607  801 1162  986 1331 1491 1492 1644 1645 1790 2178 2290 2395 2492 2581 2662 2735 2800 2801 2802 2803 2804 2805 2806 2807 2808 2809 2810 2811 2812 2813 2814 2815 2754 2685 2608 2523 2430 2329 2220 2103 1978 1845 1704 1555 1398 1233 1060  879  690  493  288   75
 195  196  606  984  985 1161 1330 1490 1789 1926 2055 1927 2177 2176 2289 2394 2580 2661 2734 2799 2856 2857 2858 2859 2860 2861 2862 2863 2864 2865 2866 2867 2868 2869 2816 2755 2686 2609 2524 2431 2330 2221 2104 1979 1846 1705 1556 1399 1234 1061  880  691  494  289   76
 194  404  799  797  983 1160 1329 1643 1788 1787 1925 2054 2175 2288 2393 2491 2490 2579 2733 2798 2855 2904 2905 2906 2907 2908 2909 2910 2911 2912 2913 2914 2915 2870 2817 2756 2687 2610 2525 2432 2331 2222 2105 1980 1847 1706 1557 1400 1235 1062  881  692  495  290   77
 193  403  605  982  981 1159 1488 1328 1642 1786 1924 2053 2174 2287 2488 2392 2578 2660 2659 2797 2854 2903 2944 2945 2946 2947 2948 2949 2950 2951 2952 2953 2916 2871 2818 2757 2688 2611 2526 2433 2332 2223 2106 1981 1848 1707 1558 1401 1236 1063  882  693  496  291   78
 402  796  798  980 1157 1327 1489 1485 1640 1641 1923 2172 2173 2286 2391 2489 2658 2731 2732 2796 2853 2902 2943 2976 2977 2978 2979 2980 2981 2982 2983 2954 2917 2872 2819 2758 2689 2612 2527 2334 2434 2333 2107 1982 1849 1708 1559 1402 1237 1064  883  694  497  292   79
 192  604  601  603 1158  978 1487 1639 1486 1785 1922 2052 2171 2285 2390 2487 2576 2577 2730 2795 2852 2901 2942 2975 3000 3001 3002 3003 3004 3005 2984 2955 2918 2873 2820 2760 2759 2690 2435 2225 2224 2226 2108 1983 1850 1709 1560 1403 1238 1065  884  695  498  293   80
 400  794  401 1156  791  979 1484 1326 1322 2048 1921 2050 2170 1920 2389 2283 2486 2657 2729 2794 2851 2900 2941 2974 2999 3016 3017 3018 3019 3006 2985 2956 2919 2874 2821 2691 2613 2530 2528 2436 2335 2109 1985 1984 1851 1710 1561 1404 1239 1066  885  696  499  294   81
 396  602  599  795  190 1155  793  976 1638 1784 1636 2051 2284 2485 2387 2573 2388 2656 2728 2793 2850 2899 2940 2973 2998 3015 3024 3020 3021 3007 2986 2957 2920 2875 2822 2761 2615 2529 2614 2437 2336 2227 2110 2111 1852 1711 1562 1405 1240 1067  886  697  500  295   82
 399  973  398  600  598  597  792 1325 1154 1782 1783 1919 1781 2282 2386 2571 2574 2575 2655 2792 2849 2898 2972 2970 2997 3014 3023 3022 3008 2987 2958 2921 2876 2823 2762 2825 2692 2693 2531 2438 2337 2229 2228 1987 1986 1853 1712 1406 1241 1068  887  698  501  296   83
 188  191 1483 1634 1323 1481 1320 1324 1633 1482 1918 2047 2281 2385 2280 2572 2654 2726 2727 2790 2848 2938 2939 2937 2971 3013 3012 3011 3010 3009 2988 2959 2922 2877 2824 2764 2619 2616 2617 2439 2338 2230 2112 1854 1855 1713 1563 1564 1407 1242 1069  888  502  297   84
 397  975  790 1149 1148 1779 1478 1480 1153 1637 2169 2168 2049 2166 2483 2481 2484 2652 2791 2897 2847 2896 2935 2936 2995 2994 2993 2992 2991 2990 2989 2960 2924 2878 2826 2694 2696 2763 2535 2532 2441 2440 2113 1988 1856 1714 1565 1408 1243 1070  700  699  503  298   85
 185 1151  977  186  974 1321 1477 1635 1916 1319 1632 1917 2162 2044 2278 2384 2570 2653 2725 2789 2846 2895 2892 2996 2968 2967 2966 2965 2964 2963 2961 2883 2880 2927 2923 2534 2765 2533 2341 2340 2339 2231 1989 2115 1857 1715 1409 1410 1244  890  889  701  504  299   86
 189  183  787  789  393 1150 1479 1777 1631 1780 1915 2167 2046 2383 2279 2482 2569 2724 2720 2479 2845 2894 2969 2891 2934 2933 2931 2930 2928 2884 2962 2882 2831 2879 2827 2828 2620 2695 2443 2536 2442 2233 2232 2114 1990 1716 1566 1568 1247 1245 1072  702  505  300   87
 596 1152  394  395  788 1147  970 1317 2276 2042 1776 2043 2045 2165 2480 2567 2382 2722 2651 2568 2788 2787 2844 2840 2839 2890 2932 2887 2929 2886 2885 2833 2926 2925 2698 2766 2699 2697 2234 2344 2625 2342 2116 1991 1859 1858 1718 1567 1073 1071  891  892  506  301   88
 184  187  968  595 1316  785 1630 1778 2041 2038 1774 1913 2164 2381 2380 2275 2719 2646 2723 2650 2842 2782 2841 2893 2713 2889 2888 2836 2834 2774 2773 2830 2832 2767 2881 2829 2768 2622 2343 2537 2444 2235 1993 2117 1719 1717 1411 1249 1412 1246 1074  893  703  507   89
 594  392  972  390  969  784 1318 1475 1914 1775 1629 1911 2163 2277 2478 2566 2717 2565 2649 2721 2780 2843 2714 2838 2781 2777 2837 2637 2709 2835 2707 2706 2772 2769 2703 2700 2624 2618 2621 2538 2345 2236 1992 1994 1860 1573 1570 1414 1571 1248 1075  509  705  303  302
 182  389  590  967  780 1146  783 1315 1773 1627 2040 1912 2273 2161 2379 2477 2648 2644 2647 2786 2784 2785 2558 2464 2716 2555 2711 2710 2632 2360 2775 2548 2704 2629 2770 2627 2623 2701 2539 2346 2445 2119 2118 1862 1861 1569 1413 1415 1076  704  894  896  508   90  304
 391  592  388  971 1313  589 1312 1314 1476 2039 2160 2159 1910 2274 2378 2475 2476 2645 2561 2642 2641 2715 2783 2639 2638 2778 2779 2462 2552 2634 2635 2458 2708 2771 2702 2453 2626 2542 2540 2447 2446 2237 2120 1720 1721 1572 1251 1416 1250 1077  898  895  305   91   94
 386  181  179  786 1141  781  964 1772 1769 1628 1908 1909 2158 2272 2376 2474 2564 2471 2643 2718 2560 2559 2640 2466 2556 2712 2554 2461 2359 2459 2631 2551 2455 2705 2545 2628 2544 2451 2541 2448 2347 1996 2121 1995 1863 1722 1574 1078 1252  897  899  706  306   92  511
 180  177 1145 1139  963  385 1474  965 1625 1472 2037 2036 2377 2271 2375 2563 2562 2472 2370 2469 2467 2024 2367 2557 2465 2364 2463 2636 2633 2776 2357 2630 2547 2454 2355 2543 2450 2130 2353 2351 2449 2348 2238 1997 1864 1724 1723 1417 1253 1080 1079  707  708   93   95
 178  588  591 1144    0  966 1143 1770 1623 1907 1768 2157 2156 2270 2268 2473 2373 2372 2371 2262 2468 2259 2260 2365 2553 2363 2362 2460 2550 2549 2254 2253 2250 2356 2546 2247 2352 2128 2132 2350 2243 2239 2122 1998 1866 1865 1725 1418 1081  900  710  512  510  709  310
 383  387  384  593  779  176  782 1311 1310 1624 2034 2035 1900 1905 2155 2152 2267 2265 2149 2369 2147 2263 2368 2366 2143 2258 2141 2256 2255 1883 2457 2358 2456 2251 2248 2249 2452 2354 2129 2349 2127 2240 2241 1999 1726 1575 1419 1254 1082 1420  901  513  308  307  309
 778  175 1142 1473 1626  961 1771 1471 1309 1622 2033 1904 2154 2153 2374 2266 2150 2027 2470 2148 2025 2261 2144 2145 2021 2257 1885 2142 2137 2138 2361 2252 2135 2134 2133 2246 1877 2244 2245 2004 1873 2242 2123 2000 1867 1727 1576 1577  712  713  711  514  515   96   97
 173  174  172  959  776 1619 1133 1906 1140 1618 1767 2032 2030 1899 1761 2028 1898 2029 1895 2026 2264 2146 2020 2019 1888 1889 2018 2140 1884 2016 2013 2139 2014 2011 2010 2009 2131 2008 1874 1737 1734 1872 2124 2001 1730 1868 1255 1423 1083 1256  902  516  311   98   99
 584 1135  585  171  587 1470  774 1308  775 1766 1615 1458 1764 2151 2269 1758 1897 1611 1756 1894 2023 1893 2022 1752 1751 1890 1887 1747 1745 2017 1746 2136 2012 1881 1879 1591 2007 2005 2006 1733 1735 2126 2125 2002 1870 1728 1257 1421 1422 1084  903  714  517  313  312
 582  777  586  583 1137 1468 1302 1469 1306 1902 1903 1765 1466 2031 1901 1455 1610 1896 1757 1755 1754 1891 1892 1750 1603 1749 1601 1748 1599 2015 1596 1882 1440 1880 1740 1875 1436 1739 1738 1736 1585 1871 2003 1731 1579 1869 1580 1578 1424  905 1258  715  314  519  100
 382  581 1136  380  169  962 1138 1131 1299 1467 1614 1459 1763 1762 1760 1759 1456 1454 1291 1609 1607 1753 1451 1604 1602 1447 1600 1886 1598 1441 1744 1597 1595 1741 1592 1878 1437 1589 1876 1588 1587 1732 1430 1584 1583 1729 1581 1425 1259 1085  904  716  520  518  101
 379  580  381  957  956  958 1134 1620 1307  953 1300 1464 1613 1612  944 1124 1293 1294 1290 1608 1452 1605 1287 1450 1448 1446 1445 1444 1280 1443 1277 1743 1442 1594 1593 1434 1103 1271 1590 1433 1432 1586 1431 1429 1582 1427 1426 1087 1086 1260  906  717  315  316  102
 378  578  579 1305 1303 1304  960  952 1621 1465 1462 1616 1296 1460  759 1295 1457 1122 1292 1453 1116 1606 1117 1449 1285 1284 1283 1282 1281 1109 1278 1742  927 1276 1438 1274 1273 1272 1435 1270 1269 1267 1096 1266 1428 1265 1264 1262 1088 1090  907  719  317  718  103
 170  167  377  771  773  772  767  951 1301 1617 1129 1125 1461 1123 1298  758 1121  943 1119 1289 1118  938 1288  937 1115 1113  932 1112 1110  930 1106 1439 1275 1105  925 1104 1102 1101  921 1099  920 1097  917 1095 1094 1093 1263  911 1089  910  908  721  720  521  104
 168  375  376  576  954  571 1132 1130  762  950 1463 1297  947  565  946 1126 1120  757  753  941  940  939 1114 1286  935  936 1111  745  931  742 1279 1107  741  739  926  924  923 1100  922  918 1098 1268  731  916  915  913  725 1092 1091 1261  723  527  522  526  318
 165  166  575  955  577  768  765  569  366 1128  949  760 1127  763  948  359  563  756  755  555  557  750  352  749  747  746  748  550  744  929 1108  928  740  544  738  737  736  735  538  919  733  536  729  535  727  914  724  532  912  525  323  722  110  523  107
 164  372  373  770  574  766  572  368  365  764  567  761  564  150  945  562  560  942  355  754  559  752  554  553  552  933  934  551  549  548  547  743  546  545  543  542  541  540  734  539  732  333  730  331  728  531  726  530  909  529  113  324  319  105  111
 374  161  160  371  769  573  367  156  153  154  566  363  362  148  361  357  561  146  356  558  353  751  142  351  350  349  348  347  346  345  344  343  342  341  340  339  338  337  336  335  537  334  332  533  534  119  329  328  327  528  114  112  322  320  109
 163  162  159  158  370  369  157  568  570  155  364  152  151  149  147  360  358  145  144  143  141  556  354  140  139  138  137  136  135  134  133  132  131  130  129  128  127  126  125  124  123  122  121  120  118  330  117  116  115  326  325  524  108  106  321
