# This puzzle is unsolvable
71
   2    1    3    4    5    6    7    8    9   10   11   12   13   14   15   16   17   18   19   20   21   22   23   24   25   26   27   28   29   30   31   32   33   34   35   36   37   38   39   40   41   42   43   44   45   47  327  595   50  328   51   52   53  333   55  336  607  335   59   61   62  342   65  343   66  345   67   68   69   70   71
 280  281  282  283  284  285  286  287  288  289  290  291  292  293  294  295  296  297  298  299  300  301  302  303  304  305  306  307  308  309  310  311  312  313  314  315  316  317  318  319  320  321  322  323  325   46   48  598  599   49  329  331   54  334  604   56  337  606   58  608   63  612  341  344   64  346  879  348  618  619   72
 279  552  553  554  555  556  557  558  559  560  561  562  563  564  565  566  567  568  569  570  571  572  573  574  575  576  577  578  579  580  581  582  583  584  585  586  587  589  851  590  591  592  593  594  324  860  326  863  864  330 1117  601  603  332  867 1123   57  871   60 2066  609  611  877 1132  614  617  616  880  881  349   73
 278  551  816  817  818  819  820  821  822  823  824  825  826  827  828  829  830  831  832  833  834  835  836  837  838  839  840  841  842  843  844  845  846  847  848  849  850  588  853  854  855 1110  856  857 1113  597  596 1115  862 1119  865  866  602 1369  869  873  605 1127  338  339 1374  874  876  613 1130 1134 1135  621  620  350   74
 277  550  815 1072 1073 1074 1075 1076 1077 1078 1079 1080 1081 1082 1083 1084 1085 1086 1087 1088 1089 1090 1091 1092 1093 1094 1095 1096 1097 1098 1099 1100 1101 1102 1103 1104 1105 1106  852 1108 1356 1109 1111 1112 1114  858 1361  859 1365  861  600 1120 1121 1122 1371  868  610 1370 1615 1616 1128  340 1129  615 1379  347  882  352  884   75   76
 276  549  814 1071 1320 1321 1322 1323 1324 1325 1326 1327 1328 1329 1330 1331 1332 1333 1334 1335 1336 1337 1338 1339 1340 1341 1342 1343 1344 1345 1346 1347 1349 1350 1351 1589 1353 1593 1107 1355 1357 1596 1358 1359 1360 1362 1601 1116 1363 1118 1366 1367 1368 1124 2277 1609  870 1611 1126 1376 1843  875 1618 1378 1382  878 1619  623  883  353  351
 275  548  813 1070 1319 1560 1561 1562 1563 1564 1565 1566 1567 1568 1569 1570 1571 1572 1573 1574 1575 1576 1577 1578 1579 1580 1581 1582 1583 1584 1585 1586 1348 1818 1588 1823 1590 1354 1592 1825 1595 1827 1597 1598 1599 1600 1832 1602 1364 1603 1837 1605 1607 1608 1840 1838  872 1373 1846 1125 1375 2070 1377 1617 1380 1131 1133  885  622  354   77
 274  547  812 1069 1318 1559 1792 1793 1794 1795 1796 1797 1798 1799 1800 1801 1802 1803 1804 1805 1806 1807 1808 1809 1810 1811 1812 1813 1814 1815 1816 1817 1587 1819 1820 1821 1352 1591 1594 1824 1826 2050 1828 2054 1830 2055 2270 1833 1834 1604 2058 1836 1839 2060 1606 1610 1372 1613 1612 1614 2286 2072 1847 1620 1383 1139 1136  624  355   78   81
 273  546  811 1068 1317 1558 1791 2016 2017 2018 2019 2020 2021 2022 2023 2024 2025 2026 2027 2028 2029 2030 2031 2032 2033 2034 2035 2036 2037 2038 2039 2040 2041 2257 2044 2046 1822 2260 2047 2048 2049 2266 2053 1829 2265 2056 2478 1835 2057 2273 2059 2274 2063 2062 2065 2486 1841 1842 1845 2069 2067 2284 1622 1849 1850 1138 1381 1137  886  356  357
 272  545  810 1067 1316 1557 1790 2015 2232 2233 2234 2235 2236 2237 2238 2239 2240 2241 2242 2243 2244 2245 2246 2247 2248 2249 2250 2251 2252 2253 2254 2255 2256 2464 2042 2258 2667 2045 2262 2263 2264 2473 2051 2052 1831 2269 2675 2479 2677 2272 2482 2061 2276 2275 2484 2686 2064 2283 1844 2068 2282 2287 2071 1848 1621 1385 1384  888  625  626  628
 271  544  809 1066 1315 1556 1789 2014 2231 2440 2441 2442 2443 2444 2445 2446 2447 2448 2449 2450 2451 2452 2453 2454 2455 2456 2457 2458 2459 2460 2461 2462 2463 2664 2043 2259 2467 2261 2468 2470 2471 2472 2267 2474 2268 2475 2476 2271 2678 2481 2680 2279 2681 2278 2876 2485 2487 2280 2488 2491 2285 2492 2073 1851 1623 1140 1141 1386  358  887   79
 270  543  808 1065 1314 1555 1788 2013 2230 2439 2640 2641 2642 2643 2644 2645 2646 2647 2648 2649 2650 2651 2652 2653 2654 2655 2656 2657 2658 2659 2660 2852 2661 2662 2466 2465 2665 2666 2469 2669 2670 2862 2671 2673 2865 2866 2674 2477 2679 2870 3054 2480 2874 2685 2684 3060 2877 2688 2281 2489 2490 2076 2074 1624 1854 1387 1142  630  889   82   80
 269  542  807 1064 1313 1554 1787 2012 2229 2438 2639 2832 2833 2834 2835 2836 2837 2838 2839 2840 2841 2842 2843 2844 2845 2846 2847 2848 2849 2850 2851 2853 2663 2854 2855 2856 2857 2858 2668 2859 2861 2672 3046 2863 2864 2676 2867 2868 2869 2871 3402 2682 3400 2875 2483 2683 2879 2687 2691 2289 2689 2496 1625 1852 1388 1626 1143  359 1145  629   83
 268  541  806 1063 1312 1553 1786 2011 2228 2437 2638 2831 3016 3017 3018 3019 3020 3021 3022 3023 3024 3025 3026 3027 3028 3029 3030 3031 3032 3033 3034 3035 3036 3037 3038 3039 3040 3041 3042 2860 3044 3220 3045 3047 3048 3049 3050 3051 3052 3053 3229 2872 3057 3231 2873 3235 3061 2878 2495 2690 2288 2493 2291 1853 1855 1144  891  890  360  627   85
 267  540  805 1062 1311 1552 1785 2010 2227 2436 2637 2830 3015 3192 3193 3194 3195 3196 3197 3198 3199 3200 3201 3202 3203 3204 3205 3206 3207 3208 3209 3210 3211 3212 3213 3214 3215 3216 3217 3043 3218 3219 3221 3222 3223 3225 3391 3226 3395 3230 3702 3055 3232 3056 3058 3062 3059 2880 3063 2494 2692 2075 1856 2077 1627 1389 1390  892  631  364  361
 266  539  804 1061 1310 1551 1784 2009 2226 2435 2636 2829 3014 3191 3360 3361 3362 3363 3364 3365 3366 3367 3368 3369 3370 3371 3372 3373 3374 3375 3376 3377 3378 3379 3380 3381 3382 3383 3384 3385 3386 3387 3388 3389 3390 3224 3392 3227 3228 3396 3554 3555 3552 3559 3236 3234 2881 3233 2693 2882 2290 2079 1857 1629 1628 1147  363  893 1149  362   86
 265  538  803 1060 1309 1550 1783 2008 2225 2434 2635 2828 3013 3190 3359 3520 3521 3522 3523 3524 3525 3526 3527 3528 3529 3530 3531 3532 3533 3534 3535 3536 3537 3538 3539 3540 3541 3542 3543 3544 3545 3546 3547 3548 3549 3550 3393 3703 3394 3705 3399 3398 3397 3851 3403 3401 3065 3066 2883 2292 2497 1391 2499 2498 1858 1146  634 1148   84  632   87
 264  537  802 1059 1308 1549 1782 2007 2224 2433 2634 2827 3012 3189 3358 3519 3672 3673 3674 3675 3676 3677 3678 3679 3680 3681 3682 3683 3684 3685 3686 3687 3688 3689 3690 3691 3692 3693 3694 3695 3696 3697 3698 3699 3700 3701 3551 3846 3704 3984 3849 3706 3556 3558 3708 3237 3238 3064 2885 2293 2695 2078 1859 1394 1393  898  895  894  366  365   88
 263  536  801 1058 1307 1548 1781 2006 2223 2432 2633 2826 3011 3188 3357 3518 3671 3816 3817 3818 3819 3820 3821 3822 3823 3824 3825 3826 3827 3828 3829 3830 3831 3832 3833 3834 3835 3836 3837 3838 3839 3840 3841 3842 3843 3844 3845 3847 3848 3983 3553 3707 3853 3557 3560 3710 3404 3240 2886 2694 2696 2294 1392 2080 1630 1631  635  367  633  636   89
 262  535  800 1057 1306 1547 1780 2005 2222 2431 2632 2825 3010 3187 3356 3517 3670 3815 3952 3953 3954 3955 3956 3957 3958 3959 3960 3961 3962 3963 3964 3965 3966 3967 3968 3969 3970 3971 3972 3973 3974 3975 3976 3977 3978 3979 3980 3981 3982 4110 3709 3850 3852 3406 3561 3564 3239 3068 3067 2884 2295 2501 2082 1860 1861 1632 1395 1152  896  637   90
 261  534  799 1056 1305 1546 1779 2004 2221 2430 2631 2824 3009 3186 3355 3516 3669 3814 3951 4080 4081 4082 4083 4084 4085 4086 4087 4088 4089 4090 4091 4092 4093 4094 4095 4096 4097 4098 4099 4100 4101 4102 4103 4104 4105 4106 4108 4109 4229 4230 4111 3985 3712 3562 3407 3711 3563 3241 2887 2500 2699 2296 2081 1862 1633 1634 1396 1151  368  369   91
 260  533  798 1055 1304 1545 1778 2003 2220 2429 2630 2823 3008 3185 3354 3515 3668 3813 3950 4079 4200 4201 4202 4203 4204 4205 4206 4207 4208 4209 4210 4211 4212 4213 4214 4215 4216 4217 4218 4219 4220 4221 4222 4223 4224 4225 4107 4227 4228 4231 4112 3986 3987 3713 3565 3242 3069 3405 2700 2697 2502 2084 2083 1863 1864 1635 1150 1398  897   93  370
 259  532  797 1054 1303 1544 1777 2002 2219 2428 2629 2822 3007 3184 3353 3514 3667 3812 3949 4078 4199 4312 4313 4314 4315 4316 4317 4318 4319 4320 4321 4322 4323 4324 4325 4326 4327 4328 4329 4330 4331 4332 4333 4334 4335 4336 4226 4440 4338 4339 4113 3988 3854 3715 3714 3408 3243 3070 2888 2889 2698 2503 2298 2085 1636 1153 1397  899  638  900   92
 258  531  796 1053 1302 1543 1776 2001 2218 2427 2628 2821 3006 3183 3352 3513 3666 3811 3948 4077 4198 4311 4416 4417 4418 4419 4420 4421 4422 4423 4424 4425 4426 4427 4428 4429 4430 4431 4432 4433 4529 4434 4435 4436 4438 4439 4337 4442 4441 4340 4114 3989 3855 3716 3566 3409 3244 3071 2890 2505 2299 2504 2297 1865 2086 1399 1154  902  639   95  640
 257  530  795 1052 1301 1542 1775 2000 2217 2426 2627 2820 3005 3182 3351 3512 3665 3810 3947 4076 4197 4310 4415 4512 4513 4514 4515 4516 4517 4518 4519 4520 4521 4522 4523 4524 4525 4527 4614 4528 4530 4618 4619 4437 4533 4534 4536 4342 4232 4341 4115 3991 3990 3857 3567 3410 3245 2891 2703 2701 2506 2300 2088 1866 1637 1400 1155  903  901  641   94
 256  529  794 1051 1300 1541 1774 1999 2216 2425 2626 2819 3004 3181 3350 3511 3664 3809 3946 4075 4196 4309 4414 4511 4600 4601 4602 4603 4604 4605 4606 4607 4608 4610 4689 4611 4612 4526 4693 4615 4616 4532 4697 4531 4699 4621 4443 4344 4535 4233 4444 4116 3856 3717 3568 3411 3246 3072 2893 2702 2507 2087 2301 1867 1638 1401 1156  642  374  371  373
 255  528  793 1050 1299 1540 1773 1998 2215 2424 2625 2818 3003 3180 3349 3510 3663 3808 3945 4074 4195 4308 4413 4510 4599 4680 4681 4682 4683 4684 4685 4686 4687 4609 4690 4761 4692 4613 4694 4695 4696 4767 4617 4620 4700 4622 4537 4446 4343 4345 4234 3992 3858 3718 3569 3412 3247 2892 3073 3074 2704 2302 2089 1868 1639 1402 1157  904  372  643   96
 254  527  792 1049 1298 1539 1772 1997 2214 2423 2624 2817 3002 3179 3348 3509 3662 3807 3944 4073 4194 4307 4412 4509 4598 4679 4752 4753 4754 4756 4818 4757 4759 4688 4760 4762 4691 4763 4764 4765 4766 4830 4768 4698 4769 4623 4624 4445 4235 4118 3993 3860 3859 3719 3570 3413 3248 3075 2894 2705 2508 2303 2090 1869 1640 1403 1158  905  375   98   97
 253  526  791 1048 1297 1538 1771 1996 2213 2422 2623 2816 3001 3178 3347 3508 3661 3806 3943 4072 4193 4306 4411 4508 4597 4678 4751 4816 4817 4755 4820 4821 4758 4822 4823 4824 4825 4826 4827 4828 4829 4885 4831 4770 4701 4538 4447 4237 4346 4236 4117 3994 3861 3720 3571 3414 3249 3076 2895 2706 2509 2304 2091 1870 1641 1404 1159  906  644  376  377
 252  525  790 1047 1296 1537 1770 1995 2212 2421 2622 2815 3000 3177 3346 3507 3660 3805 3942 4071 4192 4305 4410 4507 4596 4677 4750 4815 4872 4873 4819 4875 4876 4877 4878 4879 4880 4881 4883 4929 4884 4832 4834 4771 4702 4539 4541 4347 4121 4120 4119 3995 3862 3721 3572 3415 3250 3077 2896 2707 2510 2305 2092 1871 1642 1160  646  908  645  100   99
 251  524  789 1046 1295 1536 1769 1994 2211 2420 2621 2814 2999 3176 3345 3506 3659 3804 3941 4070 4191 4304 4409 4506 4595 4676 4749 4814 4919 4920 4874 4960 4923 4924 4925 4965 4926 4927 4928 4882 4930 4931 4772 4703 4626 4625 4448 4540 4239 4240 4238 3996 3863 3722 3573 3416 3251 3078 2897 2708 2511 2093 1872 1406 2512 1405 1161  907  647  378  101
 250  523  788 1045 1294 1535 1768 1993 2210 2419 2620 2813 2998 3175 3344 3505 3658 3803 3940 4069 4190 4303 4408 4505 4594 4675 4748 4813 4870 4871 4922 4921 4962 4963 4964 4966 4997 4967 4968 4969 4932 4833 4886 4773 4704 4627 4542 4449 4348 4122 3997 3998 3864 3723 3417 3575 3252 3079 2898 2899 2709 2306 2308 1643 1873 1644 1162  909  648  379  102
 249  522  787 1044 1293 1534 1767 1992 2209 2418 2619 2812 2997 3174 3343 3504 3657 3802 3939 4068 4189 4302 4407 4504 4593 4674 4747 4812 4959 4918 4992 4961 4993 4994 4995 4996 5035 5020 4999 4970 4888 4887 4835 4774 4628 4543 4544 4450 4350 4349 4123 3999 3865 3725 3418 3420 3253 3080 2900 2513 2710 2307 2094 1874 1645 1407  910  649  651  380  103
 248  521  786 1043 1292 1533 1766 1991 2208 2417 2618 2811 2996 3173 3342 3503 3656 3801 3938 4067 4188 4301 4406 4503 4592 4673 4746 4868 4869 4917 4958 4991 5016 5017 5018 5019 4998 5000 5022 4971 4933 4934 4836 4775 4707 4705 4629 4451 4351 4241 4124 3724 3867 3866 3255 3574 3254 2514 2712 2902 2310 2096 2095 1875 1646 1408 1409  911  912  650  381
 247  520  785 1042 1291 1532 1765 1990 2207 2416 2617 2810 2995 3172 3341 3502 3655 3800 3937 4066 4187 4300 4405 4502 4591 4672 4745 4811 4867 4916 4957 4990 5015 5032 5040 5033 5036 5021 4891 5001 4889 4890 4837 4777 4776 4630 4545 4243 4352 4452 4242 4000 3726 3579 3576 3082 2518 3081 2901 2516 2309 2515 2097 1649 1876 1164 1163  913  105  104  107
 246  519  784 1041 1290 1531 1764 1989 2206 2415 2616 2809 2994 3171 3340 3501 3654 3799 3936 4065 4186 4299 4404 4501 4590 4671 4744 4810 4866 4915 4956 4989 5014 5030 5031 5039 5024 5002 4972 4974 4973 4892 4838 4778 4708 4631 4546 4706 4548 4125 4001 4244 3868 3577 3728 3419 3578 2713 3084 2716 2711 2311 1648 1647 1413 1410 1165  914 1166  382  383
 245  518  783 1040 1289 1530 1763 1988 2205 2414 2615 2808 2993 3170 3339 3500 3653 3798 3935 4064 4185 4298 4403 4500 4589 4670 4743 4809 4808 4914 4955 4988 5013 5029 5038 5034 5023 5037 4975 4936 4935 4893 4839 4779 4632 4551 4454 4353 4455 4127 4547 4126 3869 3729 3727 3083 3257 3256 2904 2903 2312 2100 2098 1877 1414 1167 1411  384  385  386  106
 244  517  782 1039 1288 1529 1762 1987 2204 2413 2614 2807 2992 3169 3338 3499 3652 3797 3934 4063 4184 4297 4402 4499 4588 4669 4742 4807 4865 4864 4913 4987 5012 5028 5027 5008 5026 5004 5003 5005 4937 4939 4840 4710 4709 4633 4453 4355 4456 4128 4129 4003 3870 3424 3260 3259 3421 3258 3085 2715 2517 2314 1651 1650 1412 2099 1168  652  653  109  387
 243  516  781 1038 1287 1528 1761 1986 2203 2412 2613 2806 2991 3168 3337 3498 3651 3796 3933 4062 4183 4296 4401 4498 4587 4668 4741 4806 4863 4912 4954 4986 4984 5011 5010 5009 5025 5007 4979 4976 4938 4894 4782 4711 4841 4780 4549 4245 4246 4354 4004 4002 3872 3730 3580 2907 3262 2714 3422 2906 2313 2519 1878 1416 1415 1879  654  917  915  916  108
 242  515  780 1037 1286 1527 1760 1985 2202 2411 2612 2805 2990 3167 3336 3497 3650 3795 3932 4061 4182 4295 4400 4497 4586 4667 4740 4805 4862 4911 4953 4952 4985 4983 4982 4981 4980 4978 5006 4977 4940 4842 4896 4637 4781 4844 4634 4248 4358 4133 4130 4005 3582 3583 3584 3731 3735 2717 2718 2905 2521 2316 2315 1880 1652 1170 1171 1169  655  656  110
 241  514  779 1036 1285 1526 1759 1984 2201 2410 2611 2804 2989 3166 3335 3496 3649 3794 3931 4060 4181 4294 4399 4496 4585 4666 4739 4804 4861 4910 4951 4950 4949 4948 4947 4946 4945 4944 4943 4942 4941 4895 4712 4247 4460 4635 4636 4550 4553 4250 4356 4006 3873 3427 3581 3425 3423 3261 3087 2522 2520 1882 2101 1881 2102 1653 1172  918  657  388  111
 240  513  778 1035 1284 1525 1758 1983 2200 2409 2610 2803 2988 3165 3334 3495 3648 3793 3930 4059 4180 4293 4398 4495 4584 4665 4738 4803 4860 4909 4908 4907 4906 4905 4904 4903 4902 4901 4900 4899 4898 4897 4843 4458 4552 4457 4555 4459 4554 4357 4131 4132 3736 3426 3086 3734 3428 3733 2719 2720 2317 2103 2104 2105 1883 1417 1173  919  658  389  112
 239  512  777 1034 1283 1524 1757 1982 2199 2408 2609 2802 2987 3164 3333 3494 3647 3792 3929 4058 4179 4292 4397 4494 4583 4664 4737 4802 4859 4858 4857 4856 4855 4854 4853 4852 4851 4850 4849 4848 4847 4845 4784 4783 4714 4640 4785 4464 4638 4253 4008 4360 3871 4249 3874 3732 3586 3263 3089 2524 2908 2318 2106 1885 1418 1657  920  921  659  390  113
 238  511  776 1033 1282 1523 1756 1981 2198 2407 2608 2801 2986 3163 3332 3493 3646 3791 3928 4057 4178 4291 4396 4493 4582 4663 4736 4801 4800 4799 4798 4797 4796 4795 4794 4793 4792 4791 4790 4789 4788 4720 4846 4787 4713 4558 4463 4715 4556 4639 3875 4010 3737 4007 3585 3429 3091 3088 2909 2525 2721 2523 2321 1884 1654 1656 1174 1175  660  391  114
 237  510  775 1032 1281 1522 1755 1980 2197 2406 2607 2800 2985 3162 3331 3492 3645 3790 3927 4056 4177 4290 4395 4492 4581 4662 4735 4734 4733 4732 4731 4730 4729 4728 4727 4726 4725 4724 4723 4722 4721 4786 4645 4718 4717 4559 4641 4467 4462 4361 4359 4009 4135 3588 3876 3431 3430 3092 2910 2722 2108 2320 2319 2107 1886 1419 1420  922  393  115  116
 236  509  774 1031 1280 1521 1754 1979 2196 2405 2606 2799 2984 3161 3330 3491 3644 3789 3926 4055 4176 4289 4394 4491 4580 4661 4660 4659 4658 4657 4656 4655 4654 4653 4652 4651 4650 4649 4648 4647 4646 4719 4644 4468 4560 4642 4716 4461 4255 4134 4252 3879 3877 3587 3590 3265 2913 3268 3264 2723 2912 2109 1888 2110 1421 1655 1176  663  392  923  117
 235  508  773 1030 1279 1520 1753 1978 2195 2404 2605 2798 2983 3160 3329 3490 3643 3788 3925 4054 4175 4288 4393 4490 4579 4578 4577 4576 4575 4574 4573 4572 4571 4570 4569 4568 4567 4566 4565 4564 4563 4561 4562 4266 4469 4557 4363 4136    0 4251 4013 4012 4254 3738 3589 3432 3878 3266 3090 2528 2322 2323 1659 1658 1887 1423  924  662  395  118  661
 234  507  772 1029 1278 1519 1752 1977 2194 2403 2604 2797 2982 3159 3328 3489 3642 3787 3924 4053 4174 4287 4392 4489 4488 4487 4486 4485 4484 4483 4482 4481 4480 4479 4478 4477 4476 4475 4474 4374 4473 4471 4472 4368 4643 4370 4466 4365 4465 4139 4137 4140 4138 4011 3591 3267 3094 3093 2724 2529 2915 2526 2527 1889 1422 1177 1179  925  396  397  394
 233  506  771 1028 1277 1518 1751 1976 2193 2402 2603 2796 2981 3158 3327 3488 3641 3786 3923 4052 4173 4286 4391 4390 4389 4388 4387 4386 4385 4384 4383 4382 4381 4380 4379 4378 4377 4376 4375 4267 4372 4371 4263 4259 4262 4367 4258 4145 4143 4364 4142 4015 3740 3739 3744 3269 3436 2916 2725 3095 2911 2325 2111 1663 1660 1661 1178  926  664  398  119
 232  505  770 1027 1276 1517 1750 1975 2192 2401 2602 2795 2980 3157 3326 3487 3640 3785 3922 4051 4172 4285 4284 4283 4282 4281 4280 4279 4278 4277 4276 4275 4274 4273 4272 4271 4270 4154 4269 4268 4150 4149 4265 4148 4470 4366 4369 4362 4022 4256 4141 3880 4014 3434 3433 3270 3097 3096 2914 2113 2728 2727 1890 2324 1891 2112  928 1180  927  120  666
 231  504  769 1026 1275 1516 1749 1974 2191 2400 2601 2794 2979 3156 3325 3486 3639 3784 3921 4050 4171 4170 4169 4168 4167 4166 4165 4164 4163 4162 4161 4160 4159 4158 4157 4156 4155 4153 4030 4152 4373 4264 4147 4025 4023 4146 4021 3890 4257 4260 4018 3881 3884 3592 3741 3594 3100 3435 2726 2115 2729 2531 2326 2114 1427 1425 1662  665  667  399  668
 230  503  768 1025 1274 1515 1748 1973 2190 2399 2600 2793 2978 3155 3324 3485 3638 3783 3920 4049 4048 4047 4046 4045 4044 4043 4042 4041 4040 4039 4038 4037 4036 4035 4034 4033 4032 4031 4029 4028 4151 4027 3895 4024 3893 4144 3889 3888 4020 4016 3743 3882 4017 3748 3593 3742 3437 3271 2530 2532 2918 2534 2327 1892 1424 1664  121 1182  400  123  669
 229  502  767 1024 1273 1514 1747 1972 2189 2398 2599 2792 2977 3154 3323 3484 3637 3782 3919 3918 3917 3916 3915 3914 3913 3912 3911 3910 3909 3908 3907 3906 3905 3904 3903 3902 3901 3900 3899 3898 3758 3897 3896 3894 4026 4261 3892 3750 3887 3751 4019 3603 3883 3745 3885 3598 3273 3098 2917 2920 2328 2730 1894 1893 1183 1426 1181 1185  929  930  122
 228  501  766 1023 1272 1513 1746 1971 2188 2397 2598 2791 2976 3153 3322 3483 3636 3781 3780 3779 3778 3777 3776 3775 3774 3773 3772 3771 3770 3769 3768 3767 3766 3765 3764 3763 3762 3761 3760 3759 3757 3756 3755 3608 3754 3753 3891 3448 3450 3886 3284 3747 3599 3441 3274 3595 3102 3099 2921 2329 2116 2533 1895 1667 1428 1666 1430 1184  670  401  125
 227  500  765 1022 1271 1512 1745 1970 2187 2396 2597 2790 2975 3152 3321 3482 3635 3634 3633 3632 3631 3630 3629 3628 3627 3626 3625 3624 3623 3622 3621 3620 3619 3618 3617 3616 3615 3614 3613 3612 3611 3610 3609 3453 3606 3605 3749 3602 3600 3446 3746 3445 3443 3439 3275 3442 3103 3101 2919 2732 2330 3272 2117 1665 1896 1432 1429  931  672  124  402
 226  499  764 1021 1270 1511 1744 1969 2186 2395 2596 2789 2974 3151 3320 3481 3480 3479 3478 3477 3476 3475 3474 3473 3472 3471 3470 3469 3468 3467 3466 3465 3464 3463 3462 3461 3460 3459 3458 3457 3456 3455 3454 3452 3607 3451 3752 3449 3447 3285 3444 3281 3601 3440 3276 3438 3596 2733 2922 2731 2331 2332 2118 1897 1186 1668 1431  932  403  671  126
 225  498  763 1020 1269 1510 1743 1968 2185 2394 2595 2788 2973 3150 3319 3318 3317 3316 3315 3314 3313 3312 3311 3310 3309 3308 3307 3306 3305 3304 3303 3302 3301 3300 3299 3298 3297 3296 3295 3294 3293 3292 3291 3290 3289 3288 3287 3604 3286 3283 3282 3597 2931 3280 3278 3107 2924 2926 2535 2536 2333 2119 2120 1898 1669 1433 1187  933  673  404  127
 224  497  762 1019 1268 1509 1742 1967 2184 2393 2594 2787 2972 3149 3148 3147 3146 3145 3144 3143 3142 3141 3140 3139 3138 3137 3136 3135 3134 3133 3132 3131 3130 3129 3128 3127 3126 3125 3124 3123 3122 3121 3120 3119 3118 3117 3116 3115 3113 2935 2745 3112 2547 3108 3277 2928 3106 2734 3104 3105 2923 2538 2121 1899 1670 1188  935  934  674  405  128
 223  496  761 1018 1267 1508 1741 1966 2183 2392 2593 2786 2971 2970 2969 2968 2967 2966 2965 2964 2963 2962 2961 2960 2959 2958 2957 2956 2955 2954 2953 2952 2951 2950 2949 2948 2947 2946 2945 2944 2943 2942 2941 2940 2939 2938 2937 2936 3114 2934 2933 2932 3111 3109 3279 2546 2929 2739 2927 2539 2537 2334 2122 1900 1671 1434 1189  936  675  406  129
 222  495  760 1017 1266 1507 1740 1965 2182 2391 2592 2785 2784 2783 2782 2781 2780 2779 2778 2777 2776 2775 2774 2773 2772 2771 2770 2769 2768 2767 2766 2765 2764 2763 2762 2761 2760 2759 2758 2757 2756 2755 2754 2753 2752 2751 2750 2749 2748 2747 2746 2930 2744 3110 2743 2545 2740 2543 2925 2737 2736 2540 2335 1901 1672 1435 1190  937  676  407  130
 221  494  759 1016 1265 1506 1739 1964 2181 2390 2591 2590 2589 2588 2587 2586 2585 2584 2583 2582 2581 2580 2579 2578 2577 2576 2575 2574 2573 2572 2571 2570 2569 2568 2567 2566 2565 2564 2563 2562 2561 2560 2559 2558 2557 2556 2555 2554 2553 2552 2348 2550 2549 2346 2742 2544 2741 2542 2735 2738 2541 2337 2123 1902 1673 1436 1191  938  677  408  131
 220  493  758 1015 1264 1505 1738 1963 2180 2389 2388 2387 2386 2385 2384 2383 2382 2381 2380 2379 2378 2377 2376 2375 2374 2373 2372 2371 2370 2369 2368 2367 2366 2365 2364 2363 2362 2361 2360 2359 2358 2357 2356 2355 2354 2353 2352 2351 2350 2349 2347 2551 2345 2548 2344 2343 2342 2341 2340 2339 2336 2127 2124 1675 1903 1437 1192  939  678  409  132
 219  492  757 1014 1263 1504 1737 1962 2179 2178 2177 2176 2175 2174 2173 2172 2171 2170 2169 2168 2167 2166 2165 2164 2163 2162 2161 2160 2159 2158 2157 2156 2155 2154 2153 2152 2151 2150 2149 2148 2147 2146 2145 2144 2143 2142 2141 2140 2139 2138 2137 2136 2135 2134 2133 2132 1912 2130 2129 1909 2125 2338 2126 1904 1674 1438 1193  940  679  410  133
 218  491  756 1013 1262 1503 1736 1961 1960 1959 1958 1957 1956 1955 1954 1953 1952 1951 1950 1949 1948 1947 1946 1945 1944 1943 1942 1941 1940 1939 1938 1937 1936 1935 1934 1933 1932 1931 1930 1929 1928 1927 1926 1925 1924 1923 1922 1921 1920 1919 1918 1917 1916 1915 1914 2131 1913 1911 1682 1908 1907 1681 1444 1905 1676 1439 1194  941  680  411  134
 217  490  755 1012 1261 1502 1735 1734 1733 1732 1731 1730 1729 1728 1727 1726 1725 1724 1723 1722 1721 1720 1719 1718 1717 1716 1715 1714 1713 1712 1711 1710 1709 1708 1707 1706 1705 1704 1703 1702 1701 1700 1699 1698 1697 1696 1695 1694 1693 1692 1691 1690 1454 1689 1687 1686 1685 1684 1910 1447 1906 2128 1680 1678 1677 1440 1195  942  681  412  135
 216  489  754 1011 1260 1501 1500 1499 1498 1497 1496 1495 1494 1493 1492 1491 1490 1489 1488 1487 1486 1485 1484 1483 1482 1481 1480 1479 1478 1477 1476 1475 1474 1473 1472 1471 1470 1469 1468 1467 1466 1465 1464 1463 1462 1461 1460 1459 1458 1457 1456 1455 1211 1688 1452 1208 1451 1449 1205 1448 1683 1679 1445 1443 1442 1441 1196  943  682  413  136
 215  488  753 1010 1259 1258 1257 1256 1255 1254 1253 1252 1251 1250 1249 1248 1247 1246 1245 1244 1243 1242 1241 1240 1239 1238 1237 1236 1235 1234 1233 1232 1231 1230 1229 1228 1227 1226 1225 1224 1223 1222 1221 1220 1219 1218 1217 1216 1215 1214 1213 1212  960 1453 1210 1209 1450  955 1206 1203 1446 1202 1201 1200 1199 1198 1197  944  683  414  137
 214  487  752 1009 1008 1007 1006 1005 1004 1003 1002 1001 1000  999  998  997  996  995  994  993  992  991  990  989  988  987  986  985  984  983  982  981  980  979  978  977  976  975  974  973  972  971  970  969  968  967  966  965  964  963  962  961  701  959  958  957 1207  956  953 1204  952  951  950  949  948  947  946  945  684  415  138
 213  486  751  750  749  748  747  746  745  744  743  742  741  740  739  738  737  736  735  734  733  732  731  730  729  728  727  726  725  724  723  722  721  720  719  718  717  716  715  714  713  712  711  710  709  708  707  706  705  704  703  702  700  699  432  698  431  696  954  694  693  692  691  690  689  688  687  686  685  416  139
 212  485  484  483  482  481  480  479  478  477  476  475  474  473  472  471  470  469  468  467  466  465  464  463  462  461  460  459  458  457  456  455  454  453  452  451  450  449  448  447  446  445  444  443  442  441  440  439  438  437  436  159  434  433  157  156  697  427  695  152  426  425  424  423  422  421  420  419  418  417  140
 211  210  209  208  207  206  205  204  203  202  201  200  199  198  197  196  195  194  193  192  191  190  189  188  187  186  185  184  183  182  181  180  179  178  177  176  175  174  173  172  171  170  169  168  167  166  165  164  163  162  161  435  160  158  155  429  154  430  428  153  151  150  149  148  147  146  145  144  143  142  141
