# This puzzle is unsolvable
23
  2   1   3   4   5   6   7   8   9  98  10  12 102 100  14  15 105 255 186 184  21  25 188
 88  89  90  91  92  93  94  95  96  11  99 179  13  16 185 256  22 182 181  19 189  28  26
 87 168 169 170 171 172 173 174 175  97 177 313 249 101 104  17 318 319 254 106 320 112 257
166  85 167 240 241 243 244 245 246 176 248 247 178 180 183 317 107  27  18  20 108 109 111
 86 165 239 304 242 306 307 308 309 311 251 312 370 103 367 252 316 253 187 258  23  30 110
 84  80 238 303 305 360 362 363 412 411 365 310 415 250 371 489 417 456 322 418  24 191 260
234 163  83 302 361 358 409 410 364 366 413 453 315 314 369 373 419 487 376 259 113  33 190
 82 237 162 357 359 301 408 449 481 451 452 454 414 368 421 422 423 420 262 457 115  29 372
 81 164 356 299 300 405 407 450 479 484 521 522 485 509 458 416 463 374 263 321 192 118 196
160  79 406 235 480 447 448 478 446 483 486 514 507 508 455 377 324 264 375 424  32   0  34
 78  77 298 297 233 441 403 475 504 505 506 518 494 524 488 459 378 510 461 197 323 116 325
236 159 290 229 355 404 444 528 477 482 503 520 526 512 511 491 327 198 261 119 122 117 193
157 295 231 292 353 401 352 155 519 498 527 437 525 523 490 380 120 462 460 195 426 267 425
354 161 230  75 158 402 445 232 443 502 500 495 464 427 513 379 328 329  35 114 123 121 194
156 294 350 351 501 436 344 398 472 516 515 469 468 467 492 466 430 201 381 332  40  31  36
 76  74 152 400 399 226 341 392 284 497 496 434 326 493 431 465  47  45  39 382  37 204 271
296  72 349 154 228 440 345 285 473 442 476 280 337 433 389 387 200 272 266 339 199 127  38
151  73 153 293 346 286 474 438 517 470 394 435 336 428 429 388 390 385  49 333 206 265 270
222 220 227 289 395 342 224 283 393 216  58 391 340 331 432 338 125 207  53 383 274 124 268
149  71 397 291 287  68  69 143 499 219 217 343 212 276 277 384  50  52 203 128 126  43 202
146 225 396 145 223 221 347  70 471 142 140 282 139 211 136 209 275 134 334 269  48 273 132
 65 148  67  63 348 144  59  55  62 141 218  56 213 137 210 330 386 335  46  51 131 208  42
 66  64 150 147  61 439 288 281 214 215 138  60  57 135 279  54 133 278  41  44 205 129 130
