# This puzzle is unsolvable
44
   2    1    3    4    5    6    7    8    9   10   11   12   13   14   15   16   17   18   19   20   21   22   23  196  197   24  359  200   30   31   36  202  365   32   37  206  208  372   38   39   40   42   43   44
 172  173  174  175  176  177  178  179  180  181  182  183  185  348  187  350  188  189  190  191  192  193  194  358  360   26   27   25  199  201  367  366   33   34  203  207  671  527  210  211   41  215  213   45
 171  336  338  339  494  340  341  342  343  344  346  347  184  503  186  505  351  352  353  354  355  356  357  195  514   29   28  363  663  518  519  521  204  205   35  370  526  371  209  373  374  375  214   46
 170  337  640  780  493  495  496  497  498  500  345  501  502  504  651  349  506  507  508  509  657  511  660  512  661  198  361  800  805  664  806  364  368  670  674  369  811  816  528  529  212  376  216   47
 169  335  492  491  641  642  643  644  646  499  647  648  788  650  790  653  654  793  655  656  658  795  510  513  799  362  516  662  517  936  666  937  522  520  673  672  524  675  677  218  530  377  378  217
 168  334  333  639  779  782  913  783  645  785  917  786  789  649  791  652  792  924  794  926  796  659  798  930  801  515  802  803  665  935  807  809  669  808  940  943  532  525  814  679  676  379   49   48
 167  332  490  778  912  781  914 1038  784  915  916  787  919  920  921  922  923  925 1048 1050 1166  928 1053  929  931  932  933  934  804 1059 1060 1177 1062  668 1063  523 1065  678  812  531  533  534  219   50
 166  331  489  488  636  911 1035 1036 1037 1039 1041  918 1042 1043 1044 1045 1162 1047 1165  927 1164  797 1052 1168 1055 1056 1057 1058 1172  938 1280 1061  667  941 1064 1066  944  947  813  381  380  535  220   51
 165  330  487  638  637  776  909 1151 1152 1153 1154 1263 1156 1157 1159 1160 1458 1046 1049 1271 1051 1273 1054 1167 1169 1170 1171 1174 1281 1175 1176 1384  810 1178  939  942  815  818  946  817  945  680  221   52
 164  329  486  635  777  908  910 1034 1260 1155 1040 1262 1264 1158 1266 1267 1161 1269 1163 1270 1272 1372 1274 1275 1276 1277 1278 1279 1380 1555 1471 1282 1283 1285 1070 1182 1179 1069  536  383  382  222  223   53
 163  328  485  634  775  774 1033 1150 1259 1261 1361 1362 1364 1265 1365 1366 1268 1367 1368 1370 1371 1463 1373 1374 1375 1376 1468 1627 1377 1469 1379 1383 1284 1180 1181  948 1067 1289  682  681  537  224  384   55
 162  327  484  773  632  907 1032 1149 1360 1256 1452 1453 1363 1455 1456 1541 1459 1460 1369 1462 1545 1464 1547 1465 1466 1467 1694 1173 1470 1631 1381 1382 1474 1183 1286 1071 1072 1068  823  683  819  820   54   56
 161  326  483  906  905 1147 1257 1359 1258 1358 1612 1536 1454 1538 1539 1457 1540 1542 1617 1543 1461 1546 1622 1548 1549 1550 1628 1552 1378 1556 1630 1554 1472 1385 1387 1287 1288  950  821  684  539  538  225   57
 160  325  482  633  904 1148  631 1357 1255 1535 1253 1356 1680 1610 1537 1615 1616 1684 1620 1544 1621 1745 1688 1623 1625 1626 1693 1551 1695 1553 1557 1473 1386 1476 1184 1073  949  951  952  685  386  385  387  226
 158  628  481  480  629  630 1031  772 1143 1450 1145 1534 1451 1611 1614 1682 1683 1685 1619 1618 1748 1690 1799 1691 1750 1624 1755 1692 1753 1629 1477 1559 1475 1291 1290 1185 1186  953  822  541  388  390  227   58
 157  159  323  324  768 1026  903 1029 1146 1254 1030 1533 1530 1613 1609 1741 1742 1794 1744 1743 1747 1686 1800 1844 1749 1801 1752 1697 1754 1699 1632 1558 1478 1388 1390 1292 1074  954  687  542  540  543  228   59
 322  479  627  766  771  770 1028 1144 1354 1446 1607 1448 1740 1681 1679 1792 1793 1796 1687 1746 1840 1797 1842 1798 1879 1751 1802 1803 1698 1696 1633 1560 1389 1479 1188 1187 1075  825  824  686  389  391  229   60
 156  625  478  769  624  901 1142 1025 1252 1447 1532 1608 1678 1739 1738 1737 1836 1837 1795 1839 1875 1689 1877 1843 1845 1846 1847 1804 1634 1756 1561 1480 1391 1294 1293 1189 1076  955  826  688  544  689  230   61
 155  476  321  320  900  899  626 1355 1139 1251 1351 1352 1531 1677 1675 1791 1790 1872 1838 1874 1841 1876 1903 1907 1878 1905 1880 1807 1805 1700 1635 1562 1481 1392 1295 1190 1077  828  690  545  392  393  231   62
 154  153  764  318  475  767  765  902 1141 1449 1353 1445 1606 1676 1736 1789 1788 1870 1873 1920 1901 1933 1902 1906 1881 1882 1848 1806 1758 1636 1565 1563 1482 1393 1296 1191 1078  827  956  691  692  232   63   64
 152  319  477  623  898 1140 1348 1248 1250 1027 1247 1528 1605 1731 1674 1787 1834 1869 1871 1899 1922 1931 1934 1925 1924 1904 1808 1760 1757 1701 1702 1483 1484 1394 1297 1192 1079  958  957  829  546  394  233   65
 473  894  317  474 1022 1023 1024 1350 1244 1245 1444 1442 1529 1527 1734 1735 1835 1832 1898 1900 1921 1929 1923 1910 1926 1849 1850 1809 1703 1637 1641 1564 1396 1485 1194 1080  959 1081  830  547  548  694  235  234
 150  316  622  472  897  763  896 1138 1137 1441 1249 1443 1673 1604 1868 1785 1867 1833 1916 1897 1918 1915 1884 1908 1851 1811 1885 1812 1759 1761 1639 1638 1566 1395 1302 1299 1082  960  831  693  396  395  236   66
 617  315  892  621 1019  893 1021 1349 1440 1347 1439 1732 1670 1786 1603 1831 1866 1784 1896 1917 1919 1935 1930 1913 1928 1911 1883 1762 1704 1569 1640 1397 1705 1196 1193 1298 1197 1083  961  832  549  550  397  238
 151  471  147  760  619  620  758 1017 1523 1346 1525 1671 1601 1733 1729 1672 1830 1895 1829 1914 1932 1860 1886 1927 1888 1887 1810 1852 1763 1707 1706 1486 1398 1567 1195 1303  962  834  695  696  551   69   67  237
 149  146  470  895 1020 1136 1246  761 1135 1345 1526 1598 1524 1602 1730 1828 1864 1865 1862 1894 1861 1859 1892 1890 1854 1909 1853 1813 1764 1709 1568 1643 1570 1487 1300 1399 1084  963  833  697  552  239  398  399
 314  469  145  762  467 1016  759 1018 1344 1669 1599 1436 1518 1782 1668 1783 1778 1827 1824 1863 1893 1858 1891 1912 1857 1856 1855 1814 1766 1765 1642 1708 1304 1198 1086 1301 1085  964  835  698  400  240   68   70
 311  756  148  618  889 1243  891 1343 1241 1438 1342 1520 1522 1600 1595 1781 1724 1822 1722 1823 1720 1776 1821 1889 1818 1817 1816 1815 1767 1710 1644 1571 1490 1572 1400 1201 1087  965  836  699  553  401  556   71
 313  310  312  616  468  755 1242 1134 1132 1435 1597 1517 1667 1666 1727 1826 1779 1825 1660 1773 1657 1774 1820 1819 1772 1770 1769 1768 1645 1711 1646 1305 1402 1199 1488 1489  966  837  700  555  402   74   72  241
 309  308  466  757  890 1013  887 1133 1015 1433 1014 1437 1131 1519 1780 1723 1661 1777 1775 1656 1718 1721 1719 1716 1653 1771 1715 1714 1712 1577 1647 1493 1573 1401 1492 1306 1088  967  838  701  554  403   75   73
 144  465  463  464  614 1130 1240 1010 1339 1128 1596 1521 1726 1340 1728 1663 1659 1590 1655 1658 1587 1584 1717 1502 1654 1582 1650 1713 1649 1491 1648 1495 1574 1494 1203 1200 1089  968  839  703  702  557  243  242
 143  307  754  613 1012 1129 1127 1236 1341 1239 1432 1431 1664 1430 1592 1665 1589 1422 1591 1508 1420 1506 1585 1652 1581 1651 1579 1578 1499 1498 1576 1575 1496 1404 1307 1202 1090  969  840  560  405  244  246   76
 141  612  306  753  611  615 1011 1237 1238 1336 1434 1333 1516 1426 1594 1593 1662 1509 1513 1421 1324 1325 1507 1323 1416 1583 1501 1500 1317 1411 1409 1405 1308 1406 1403 1204 1091  970  971  841  404  559  558  245
 142  305  886  888  752 1008  883 1009 1338 1235 1119 1429 1427 1515 1725 1514 1510 1511 1329 1423 1586 1419 1218 1504 1505 1503 1580 1320 1318 1412 1497 1410 1407 1312 1309 1206 1205 1092  704  842  408  561   77   78
 140  304  459  610  750  885 1125  884 1234 1232 1334 1121 1337 1428 1512 1331 1425 1224 1588 1327 1111 1418 1322 1219 1221 1107 1105 1414 1215 1316 1315 1313 1408 1311 1310 1207 1093  972  707  705  406  562  407  247
 138  460  609  608  461  882  751 1126 1003 1122 1120 1335 1231 1332 1424 1228 1114 1225 1328 1223 1326 1222 1220 1415 1321 1108 1319 1413 1103 1214 1213 1211 1314 1209 1208 1094  973  974  843  844  706   79   81  248
 139  462  301  302  749  748 1233 1124 1123  741 1002  999  872 1230 1226 1227 1113 1112  993  991  992 1110 1109 1417 1106  987 1217 1104  984 1102 1101 1100 1099 1210  852 1097 1096 1095  708  563  847  975  709   80
 137  136  458  607  747  881  602 1005  878  876  875  873  998 1116  870 1330  995  996  868  994  728  864  990  989  860  988 1216  859  983  856 1212  981  980  978 1098  979  977  845  846  411  410  409   82  249
 457  303  606  746  879  880  603  877 1001  596  874 1229  738 1115  734 1117  869  731  736  867  866  729  863  862  861  985  724  986  858  855  982  854  853  573  850  851  976  713  564  712  415  251  250   83
 135  300  298  605  299 1007  743 1006 1004  597  740 1000  739  593    0  997  591  440  732  437  865  730  585  727  725  857  582  723  722  721  720  719  717  715  716  572  848  849  569  258  412  710  565   84
 134  297  455  293  453  601  745  450  742  600  599  445  737  595 1118  594  735  590  589  278  588  587  434  726  584  431  432  580  579  578  577  576  718  575  421  571  714  570  417  711  414  566  252  253
 133  456  604  294  451  452  448  449  744  447  286  287  282  118  871  441  439  281  733  279  436  586  435  433  273  430  581  429  428  427  426  425  424  423  574  422  420  419  568  256  257  413   86   87
 296  129  131  295  454  292  291  290  289  288  446  444  285  443  284  442  115  280  592  277  110  276  275  274  272  583  271  270  269  268  267  266  265  264  263  262   94  260  418  567  255  416   90   88
 132  130  128  127  126  125  124  123  122  121  120  598  283  119  116  117  114  113  112  111  438  109  108  107  106  105  104  103  102  101  100   99   98   97   96  261   95   93  259   92   91   89  254   85
