# This puzzle is unsolvable
66
 261    2    4    5  266    6    8    9   10   12  522  764   13   14   15   17   18  529   20  281   22  283   25  284   26  285   27   28   29   30  291   33  292   34   35   36   37   38   39  298   41   42   44   45   46   47  306  558   48   51  310   52   54  313   55  314   57   58   59   60   61   62   63   64   65   66
   1    3  260  262  263  264  517  267  268   11  271  272  273  524  275   16  527 1007   19  280   23   21  533  534   24  286  537  288  289  290   32  543  293  544  294  295  296  551  299  550  300  301   43  303  556  555  559  305  309   50  311  312   53  565  564  315  566  316  570  569  320  321  322  323  324   67
 259  512  513  514  515    7  265  518  519  269  521  270  523  274  525  276  528 1232  771  531  282  532  777  776  535  536  538  287  539  540  541   31  786  545  788  546  548  297  549   40  794  552  553  554  304  557   49  307  308  560  804  562  563  807  567   56  810  318  317  319  571  572  573  574  325   68
 258  511  756  757  758  516  760  994  762  520  763 1000  765  767  768  526  278 1233  530  279  277  772 1011  774  778  779  780  781  782  783  784  542  785 1022  787 1025  547  791  792  793 1029  302  795  797  798  799  800  801  802  561  805  806 1041  808 1042  809 1045  568  812  813  814  815  816  575  326   69
 257  510  755  992  993  759  995  761 1223  997  998  999  766 1001 1002  769  770 1006 1453 1009 1235  773  775 1012 1013 1014 1015 1016 1017 1018 1019 1020 1021 1023 1250  790  789 1026 1027 1028 1030 1031  796 1032 1033 1034 1262 1035 1036  803 1266 1039 1040 1270 1043 1044 1272  811 1049 1275 1047 1050  817  576  327   70
 256  509  754  991 1220 1221 1222 1442  996 1224 1225 1227 1228 1229 1003 1230 1231 1004 1005 1008 1237 1010 1238 1239 1240 1241 1242 1243 1245 1464 1246 1247 1248 1249 1251 1024 1471 1253 1254 1255 1256 1257 1258 1259 1260 1261 1263 1483 1037 1264 1265 1488 1485 1267 1490 1271 1273 1046 1274 1048 1276 1051  818  577  328   71
 255  508  753  990 1219 1440 1441 1443 1444 1445 1226 1446 1447 1448 1449 1450 1662 1451 1234 1455 1236 1456 1457 1458 1460 1461 1462 1463 1674 1244 1465 1466 1467 1468 1469 1252 1470 1472 1473 1474 1475 1476 1477 1478 1479 1691 1480 1038 1695 1694 1486 1484 1489 1268 1269 1491 1702 1492 1493 1494 1277 1052  819  578  329   72
 254  507  752  989 1218 1439 1652 1653 1654 1655 1656 1657 1658 1659 1660 1661 1865 1452 1666 1454 1667 1870 1668 1669 1459 1671 1670 1672 1673 1675 1676 1677 1678 1679 1680 1681 1682 1683 1684 1685 1686 1687 1688 1689 1690 2089 1894 1692 1482 1898 1696 1698 1697 1699 1903 1700 1701 1703 1704 1495 1278 1053  820  579  330   73
 253  506  751  988 1217 1438 1651 1856 1857 1858 1859 1860 1861 1862 1863 1864 1663 1866 1664 1867 1869 1868 1872 1873 1874 2256 1875 1876 1877 2075 2260 1879 1881 1882 1883 1884 1885 1886 1887 1888 1889 1890 1891 1892 1893 1481 1895 1693 1897 2092 1899 1487 1901 1902 1904 2099 1905 1906 1705 1496 1279 1054  821  580  331   74
 252  505  750  987 1216 1437 1650 1855 2052 2053 2054 2055 2056 2057 2058 2059 2060 2061 2062 2063 2250 2066 2065 2067 2068 2768 2258 2069 2070 2072 1878 1880 2076 2077 2078 2079 2080 2081 2082 2083 2084 2085 2086 2087 2088 2090 2278 2277 2091 2093 2094 1900 2095 2096 2098 2286 2100 1907 1706 1497 1280 1055  822  581  332   75
 251  504  749  986 1215 1436 1649 1854 2051 2240 2241 2242 2243 2244 2245 2246 2247 2248 2249 2600 1665 2429 2254 2433 2607 2437 2434 2071 2259 2074 2073 2262 2263 2264 2265 2266 2267 2268 2269 2270 2271 2272 2273 2274 2275 2276 1896 2457 2279 2280 2281 2282 2463 2097 2284 2285 2102 1908 1707 1498 1281 1056  823  582  333   76
 250  503  748  985 1214 1435 1648 1853 2050 2239 2420 2421 2422 2423 2424 2425 2426 2427 2428 2253 2064 2252 2432 1871 2431 2255 2257 2438 2439 2440 2261 2441 2442 2443 2444 2445 2446 2447 2448 2449 2450 2451 2452 2453 2454 2455 2627 2456 2458 2459 2460 2461 2283 2462 2464 2101 2287 1909 1708 1499 1282 1057  824  583  334   77
 249  502  747  984 1213 1434 1647 1852 2049 2238 2419 2592 2593 2594 2595 2596 2597 2598 2599 2919 2430 2251 2602 2604 2435 2606 2436 2608 2609 2610 2611 2612 2613 2614 2615 2616 2617 2618 2619 2620 2621 2622 2623 2624 2625 2626 2628 2629 2630 2631 2632 2795 2633 2634 2288 2103 2104 1910 1709 1500 1283 1058  825  584  335   78
 248  501  746  983 1212 1433 1646 1851 2048 2237 2418 2591 2756 2757 2758 2759 2760 2761 2762 2763 2921 2920 2601 2766 2924 2923 2771 2926 2928 2927 2773 2774 2776 2777 2778 2779 2935 2780 2781 2783 2784 2785 2786 2787 2788 2789 2790 2791 2792 2793 2794 2466 2635 2468 2465 2289 1911 1912 1710 1501 1284  827 1059  585  336   79
 247  500  745  982 1211 1432 1645 1850 2047 2236 2417 2590 2755 2912 2913 2914 2915 2916 2917 2918 2605 2765 2603 3068 3071 2925 2770 3073 3213 2772 2929 2775 2930 2932 3080 2933 2934 2936 2782 2937 2939 2940 2941 2942 2943 2944 2945 2946 2947 2948 2949 2796 2797 2798 2636 2290 2105 1711 1712 1285 1060 1061  826  586  337   80
 246  499  744  981 1210 1431 1644 1849 2046 2235 2416 2589 2754 2911 3060 3061 3062 3063 3065 3066 3207 2767 2764 2922 3069 2769 3070 3074 3075 3214 3076 3077 2931 3078 3079 3081 3082 3083 3084 2938 3086 3087 3088 3089 3090 3091 3092 3093 3094 3095 2953 2950 2638 2637 2467 2291 2106 1913 1503 1502 1062  828  587  338   81   82
 245  498  743  980 1209 1430 1643 1848 2045 2234 2415 2588 2753 2910 3059 3200 3201 3064 3202 3204 3336 3067 3338 3206 3208 3341 3072 3210 3211 3345 3215 3216 3217 3218 3219 3351 3220 3222 3223 3085 3224 3226 3227 3228 3229 3230 3231 3232 3233 3234 2951 3096 2639 2799 2470 2292 2107 1914 1713 1504 1286 1287  829  588  339   83
 244  497  742  979 1208 1429 1642 1847 2044 2233 2414 2587 2752 2909 3058 3199 3332 3457 3335 3203 3205 3459 3337 3340 3339 3464 3342 3212 3344 3343 3346 3347 3348 3349 3350 3474 3221 3353 3354 3355 3225 3356 3358 3359 3360 3361 3362 3363 3235 3098 3097 2800 2801 2469 2641 2293 2108 1915 1714 1506 1288 1063  830  589  341  340
 243  496  741  978 1207 1428 1641 1846 2043 2232 2413 2586 2751 2908 3057 3198 3331 3456 3333 3573 3460 3461 3462 3463 3577 3580 3579 3466 3467 3468 3469 3470 3587 3586 3472 3589 3352 3476 3478 3479 3480 3357 3481 3482 3483 3484 3485 3486 3364 3236 3099 2954 2802 2640 2952 2471 2109 1916 1505 1715 1289 1064  831  590  342   84
 242  495  740  977 1206 1427 1640 1845 2042 2231 2412 2585 2750 2907 3056 3197 3330 3454 3334 3571 3458 3575 3683 3576 3209 3578 3465 3581 3582 3583 3584 3585 3693 3471 3473 3696 3475 3591 3590 3593 3594 3595 3596 3597 3598 3599 3600 3366 3365 3237 3100 2955 2803 2296 2642 2294 2110 1917 1716 1507 1290 1065  832  591   85   86
 241  494  739  976 1205 1426 1639 1844 2041 2230 2411 2584 2749 2906 3055 3196 3329 3572 3455 3681 3574 3781 3682 3684 3685 3686 3687 3688 3689 3690 3790 3691 3692 3588 3695 3795 3697 3592 3477 3699 3700 3701 3702 3704 3705 3706 3601 3487 3367 3238 3102 2956 2473 2643 2472 2295 2111 1919 1918 1717 1291 1066  833  593  592  343
 240  493  738  975 1204 1425 1638 1843 2040 2229 2410 2583 2748 2905 3054 3195 3328 3453 3570 3680 3780 3872 3782 3783 3784 3785 3786 3787 3962 3788 3789 3792 3883 3694 3793 3968 3797 3698 3798 3799 3801 3802 3703 3803 3804 3707 3602 3368 3239 3101 3104 3103 2957 2644 2474 2297 2112 1920 1718 1508 1509 1067  834  344  345   87
 239  492  737  974 1203 1424 1637 1842 2039 2228 2409 2582 2747 2904 3053 3194 3327 3452 3569 3679 3678 3779 3873 3874 3875 3876 3877 3879 3963 3880 3881 3791 3884 3794 3970 3886 3796 3888 3889 3890 3800 3892 3893 3894 3805 3708 3489 3488 3369 3240 2959 2958 2804 2645 2475 2298 2113 1921 1719 1510 1292 1068  835  596   89  595
 238  491  736  973 1202 1423 1636 1841 2038 2227 2408 2581 2746 2903 3052 3193 3326 3451 3676 3778 3871 3870 3956 3957 3958 3959 3960 4036 3964 4037 3965 3882 3885 4042 3969 4045 3887 4046 3973 3974 3891 3975 3976 3895 3806 3709 3490 3491 3370 3241 2962 3105 2805 2646 2476 2299 2114 1720 1511 1295 1293 1069  836   88   90  594
 237  490  735  972 1201 1422 1635 1840 2037 2226 2407 2580 2745 2902 3051 3192 3450 3567 3677 3568 3777 3955 3953 4032 4033 4034 4035 3878 3961 4039 4107 4040 3967 3966 4106 4043 4112 3972 3971 4048 4049 4050 3977 3896 3807 3710 3603 3493 3492 3242 3243 2807 2961 2806 2477 2300 2115 1922 1721 1294 1296 1070  837  597  347  346
 236  489  734  971 1200 1421 1634 1839 2036 2225 2406 2579 2744 2901 3050 3191 3323 3324 3449 3566 3675 3954 4031 4030 4100 4101 4102 4103 4104 4038 4165 4110 4041 4109 4111 4044 4171 4114 4047 4115 4116 4051 3978 3897 3808 3711 3604 3605 3371 3372 3106 2960 2808 2647 2478 2301 2116 1923 1513 1514 1512 1071  838  839  348   91
 235  488  733  970 1199 1420 1633 1838 2035 2224 2405 2578 2743 2900 3049 3447 3565 3325 3674 3673 3776 3952 3869 4099 4160 4161 4162 4163 4164 4105 4166 4108 4167 4168 4169 4170 4172 4113 4174 4117 4118 4052 3979 3898 3809 3712 3606 3607 3374 3373 2963 3108 2809 2648 2479 2117 2118 1924 1723    0 1722 1072  599  841  349   92
 234  487  732  969 1198 1419 1632 1837 2034 2223 2404 2577 2742 2899 3048 3190 3322 3448 3564 3672 3775 3950 3868 4029 4098 4159 4212 4213 4214 4215 4216 4217 4260 4219 4220 4221 4222 4265 4173 4175 4119 4053 3980 3899 3713 3608 3495 3494 3375 3244 3107 2812 2810 2649 2480 2302 2119 1925 1515 1298 1297  840  350  600  353   94
 233  486  731  968 1197 1418 1631 1836 2033 2222 2403 2576 2898 3046 3188 3189 3321 3563 3562 3773 3774 3866 3949 4028 4097 4158 4211 4256 4257 4258 4294 4259 4218 4262 4263 4264 4300 4224 4225 4176 4120 4054 3900 3811 3810 3714 3376 3496 3377 3245 3246 3112 2811 2650 2481 2303 1926 1725 1724 1300 1073 1074  601  598  354  351
 232  485  730  967 1196 1417 1630 1835 2032 2221 2402 2740 2741 3047 3187 3186 3320 3319 3446 3671 3772 3867 3951 4027 4096 4157 4210 4255 4291 4292 4293 4296 4261 4297 4298 4299 4266 4223 4226 4178 4177 3982 3981 3901 3812 3716 3498 3609 2966 2967 3111 3109 2965 2651 2482 2306 2305 2304 1927 1517 1516 1075  842   93   95  352
 231  484  729  966 1195 1416 1629 1834 2031 2220 2401 2575 2738 3045 2739 2896 3444 3445 3561 3670 3771 3865 3864 4026 4095 4156 4209 4253 4254 4320 4321 4295 4341 4325 4324 4327 4267 4268 4227 4121 4056 4055 3984 3902 3813 3718 3497 3715 2964 3379 3247 3110 2813 2652 2483 2121 2120 1518 1726 1301 1299 1076  602  844   96   97
 230  483  728  965 1194 1415 1628 1833 2219 2400 2573 2574 2895 3185 2897 3184 3318 3443 3560 3669 3770 3863 3948 4025 4094 4155 4208 4252 4290 4319 4340 4322 4353 4326 4328 4302 4301 4269 4228 4179 4123 4122 4057 3983 3613 3611 3610 3378 3248 3249 3114 2968 2814 2485 2484 2308 1928 1729 1930 1519 1302 1303  845  603  355   98
 229  482  727  964 1193 1414 1627 1832 2030 2029 2218 2399 2737 2894 3044 3042 3317 3441 3442 3559 3862 3861 3947 4024 4093 4154 4207 4251 4289 4318 4339 4323 4342 4354 4343 4344 4303 4270 4229 4180 4124 4058 3903 3717 3814 3815 3499 3500 3380 3113 3250 2815 2654 2307 2653 1929 2125 1727 2124 1728 1082 1077 1078  843  356  604
 228  481  726  963 1192 1413 1626 1831 2217 2398 2397 2572 2736 2893 3043 3316 3558 3440 3557 3668 3667 3769 3946 4023 4092 4153 4206 4250 4288 4317 4338 4352 4351 4348 4333 4329 4304 4271 4230 4181 4059 4060 3985 3986 3816 3904 3612 3381 3382 3502 3251 2969 2817 2656 2486 2655 2122 2123 1730 1731 1307 1304  606  846 1305   99
 227  480  725  962 1191 1412 1625 1830 2028 2216 2214 2571 2570 2892 3041 3183 3182 3314 3767 3666 3768 3860 3945 4022 4091 4152 4205 4249 4287 4316 4337 4350 4355 4347 4331 4345 4330 4305 4231 4182 4125 3988 3817 3905 3721 3719 3720 3501 3503 3252 3115 2816 2970 2311 2487 2310 1933 2309 2127 1521 1081 1520 1080  605  357  100
 226  479  724  961 1190 1411 1624 1829 2027 2396 2569 2734 2735 2891 3040 3181 3315 3438 3439 3556 3765 3766 3859 4021 4090 4151 4204 4286 4315 4314 4336 4312 4335 4334 4309 4346 4273 4272 4232 4183 4126 3987 3906 4061 3616 3818 3614 3615 3254 3255 3253 2971 2818 2657 2488 2313 2312 1932 1732 1524 1306  847  848  358  359  101
 225  478  723  960 1189 1410 1623 1828 2026 2025 2215 2568 2733 2890 3039 3180 3313 3437 3555 3665 3664 3858 3944 4020 4089 4150 4203 4248 4284 4285 4313 4349 4310 4279 4240 4307 4308 4274 4233 4184 4127 4062 3989 3908 3907 3722 3504 3383 3384 3116 2972 2819 2658 2489 2490 1935 2128 1522 1931 1525 1083 1079  849  608  607  360
 224  477  722  959 1188 1409 1622 2024 2213 2394 2395 2567 2732 2889 3038 3178 3179 3312 3554 3663 3764 3857 3943 4019 4088 4149 4202 4247 4245 4283 4282 4280 4311 4332 4278 4306 4237 4276 4234 4185 4128 4063 3990 3909 3819 3724 3723 3617 3505 3117 3118 2973 2821 2659 2820 2126 1309 1934 1733 1084 1085  850  851 1529  102  362
 223  476  721  958 1187 1408 1621 1827 1826 2212 2393 2566 2731 2888 3037 3311 3436 3435 3661 3553 3856 3941 3942 4018 4087 4148 4201 4246 4198 4197 4244 4243 4281 4242 4192 4277 4238 4275 4236 4186 4129 4064 3991 3910 3820 3821 3620 3619 3385 3256 3119 2974 2660 2975 2491 2314 1936 1938 1526 1737 1308 1523  610  854  361  609
 222  475  720  957 1186 1407 1620 1825 2023 2211 2392 2565 2730 2887 3036 3177 3310 3551 3763 3662 3552 3855 3940 4017 4086 4147 4010 4200 4199 4143 4196 4194 4241 4193 4239 4191 4190 4189 4235 4187 4130 4065 3992 3911 3822 3618 3725 3506 3507 3386 3121 3120 2976 2822 2661 2492 2129 1734 1735 1312 1939  852  105  363  104  103
 221  474  719  956 1185 1406 1619 1824 2022 2210 2391 2564 2729 2886 3035 3176 3308 3309 3762 3853 3761 3659 3852 4016 4084 4085 4146 4145 4142 4075 4140 4195 4139 4138 4136 4135 4071 4134 4188 4133 4131 4066 3993 3912 3823 3726 3621 3622 3387 3257 3258 2978 2825 2664 2823 1937 2315 1736 2494 1086 1313 1087 1089  856  106  855
 220  473  955 1184 1405 1403 1618 1823 2021 2209 2390 2563 2728 2885 3034 3307 3174 3431 3434 3433 3938 3937 3854 4014 4013 4083 4011 3931 4007 4141 4009 4076 4074 4005 3925 4137 4001 4000 3999 4132 4068 4067 3994 3913 3824 3727 3509 3508 3388 3259 2495 2979 2826 2977 2316 1940 2824 2317 1739 2130 1310 1528  612  611  365  107
 219  472  718  717  954 1404 1822 2019 2020 2208 2389 2562 2727 2884 3033 3173 3175 3432 3550 3660 3759 3758 3936 4015 3939 4012 4144 4080 4081 4079 4078 4006 3926 4004 3924 4003 4073 4072 4069 4070 3997 3996 3995 3914 3825 3728 3623 3510 3389 3260 3122 2980 2662 2665 2663 2133 2131 1944 1527 2319 1530  615  614  364 1311 1315
 218  471  716  953 1183 1182 1617 1616 2017 2018 2388 2561 2726 2883 3032 3172 3306 3305 3548 3549 3658 3760 3849 3935 3934 3933 4082 3932 3747 3929 3930 3843 3839 4077 4002 3922 3919 3920 3833 3831 3998 3917 3916 3915 3826 3729 3624 3511 3390 3261 3124 3123 2827 2493 2318 2496 2132 1738 1740 1741 1088  616 1532  367  366  109
 217  470  715  952 1181 1402 1615 1821 1820 2207 2387 2560 2725 2882 3031 3171 3304 3547 3656 3757 3851 3850 3848 3847 3752 3846 3845 3844 3748 4008 3643 3642 3837 3744 3836 3923 3741 3921 3739 3738 3918 3736 3829 3828 3827 3730 3625 3512 3391 3262 3126 3125 2666 2667 2497 2135 2320 1533 1941 1531 1317 1314 1090 1091  613  108
 216  469  714  951 1180 1401 1614 1819 2016 2206 2386 2559 2724 2881 3030 3303 3430 3655 3429 3657 3756 3755 3754 3650 3753 3751 3750 3646 3842 3840 3927 3928 3742 3838 3639 3527 3740 3834 3737 3832 3633 3830 3734 3733 3732 3626 3628 3513 3392 3263 3127 2981 2828 2668 2321 2322 1942 2134 1943 1743 1534 1742  618  112  368  110
 215  468  713  950 1179 1613 1399 1816 1818 2205 2385 2558 2723 2880 3028 3029 3169 3168 3170 3654 3653 3652 3540 3651 3649 3538 3535 3645 3749 3746 3532 3745 3841 3529 3640 3743 3835 3636 3523 3635 3634 3735 3631 3630 3629 3731 3627 3515 3514 3393 3264 2982 2829 2499 2498 2138 2136 2137 1744 1535 1316 1092  617  857  853  111
 214  467  712  949 1178 1400 1817 2014 2204 2015 2384 2557 2722 2879 3027 3301 3425 3427 3428 3544 3542 3541 3421 3539 3647 3648 3534 3415 3416 3644 3414 3641 3530 3412 3638 3526 3637 3525 3524 3522 3402 3632 3520 3400 3519 3399 3397 3516 3394 3265 3128 2983 2830 2669 2500 2323 2139 1945 1745 1320 1094 1093  858  369  113  860
 213  466  711  948 1177 1611 1612 2012 2202 2203 2383 2556 2721 2878 3026 3167 3302 3545 3546 3543 3422 3295 3294 3420 3419 3537 3155 3289 3417 3287 3533 3413 3411 3409 3408 3528 3280 3406 3404 3278 3521 3403 3401 3273 3517 3518 3398 3396 3395 3266 3129 2984 2831 2670 2501 2324 1947 1948 1319 1539 1746 1318  861  859  373  114
 211  212  465  947 1397 1398 1610 2013 1815 2011 2381 2555 2720 2718 2877 3300 3426 3298 3297 3423 3296 3017 3160 3293 3292 3154 3151 3153 3152 3288 3286 3531 3285 3410 3147 3282 3407 3405 3143 3277 3276 3275 3274 3138 3272 3271 3270 3269 3268 3267 3130 2985 2832 2671 2502 2140 1946 1537 1536 1538 1321  372  862  619  117  118
 464  463  710  946 1176 1175 1609 1814 2382 1813 2200 2554 2876 3025 3023 3165 3021 3299 3163 3424 2867 3161 3158 3157 2861 3291 3536 3418 2701 3009 3010 3008 3284 3148 3281 3146 3279 3145 3001 3142 3141 3140 3139 3137 2994 3136 3135 3134 3133 3132 3131 2986 2833 2672 2503 2325 2326 2141 1747 1323 1322  371  621  620  370  622
 210  462  709  945 1174 1396 1608 2010 2201 2199 2380 2553 2719 2875 2546 3022 3164 2870 3020 3162 3019 3018 3159 3015 2863 3014 3156 2860 3012 2858 3007 3150 3149 3006 3005 3283 3003 3002 3000 3144 2999 2998 2996 2995 2843 2993 2992 2991 2990 2989 2988 2987 2834 2673 2504 2327 2142 1949 1749 1098 1095 1097  120  116  115  864
 209  708  707  944 1394 1395 1607 1809 2009 2198 2379 2552 2717 2874 3166 2713 2714 2872 2869 2868 2708 2866 3016 2865 2864 3011 3013 3290 2859 2699 2857 2856 2854 2695 2852 3004 2851 2850 2849 2848 2847 2997 2846 2845 2844 2842 2841 2840 2839 2838 2837 2836 2835 2674 2505 2328 2143 1951 1950 1540 1748 1099 1096  863  376  626
 208  461  706 1392 1173 1811 1393 1606 1605 2197 2378 2551 2715 2873 3024 2371 2871 2712 2543 2710 2709 2539 2706 2705 2362 2862 2702 2534 2700 2697 2529 2855 2696 2694 2853 2693 2692 2691 2690 2689 2688 2687 2686 2685 2684 2683 2682 2681 2680 2679 2678 2677 2676 2675 2506 2329 1952 1750 1541 1324 1100  865  624  374  625  375
 206  704  703  943  705 1172 1810 2007 2008 2196 2376 2377 2716 2549 2373 2548 2545 2711 2544 2542 2366 2707 2540 2538 2704 2537 2360 2357 2535 2533 2698 2531 2530 2528 2527 2526 2525 2524 2523 2522 2521 2520 2519 2518 2517 2516 2515 2514 2513 2512 2511 2510 2509 2508 2507 2330 2144 2145 1751 1542 1325  866  867  623  119  121
 460  207  459 1170  940 1168 1812 1391 2005 2194 2195 2375 2374 2372 1800 2188 2547 2369 2368 2367 2365 2541 2364 2363 2361 2536 2703 2175 2532 2359 2356 2355 2354 2353 2352 2351 2350 2349 2348 2347 2346 2345 2344 2343 2342 2341 2340 2339 2338 2337 2336 2335 2334 2333 2332 2331 2146 1953 1752 1543 1326 1101  868  377  122  123
 458  941 1171  942 1389 1390 1604 2006 1807 2003 2192 2550 2191 1997 2187 1996 2370 2186 2185 2184 2183 2182 2181 2179 2177 2178 1986 2176 2358 2174 2173 2172 2171 2170 2169 2168 2167 2166 2165 2164 2163 2162 2161 2160 2159 2158 2157 2156 2155 2154 2153 2152 2151 2150 2149 2148 2147 1954 1753 1544 1327 1102  628  627  379  378
 205  457 1167  938  939 1388 1603 1808 1803 2004 1381 1802 2001 2000 1998 2190 2189 1995 1994 1993 1992 1991 1990 2180 1989 1788 1987 1787 1984 1983 1982 1981 1980 1979 1978 1977 1976 1975 1974 1973 1972 1971 1970 1969 1968 1967 1966 1965 1964 1963 1962 1961 1960 1959 1958 1957 1956 1955 1754 1545 1328 1103  871  870  629  380
 204  202  454  702 1169 1600 1602 1805 1384 1598 2193 1594 1596 1799 1999 1798 1797 1796 1795 1794 1793 1792 1791 1789 1988 1581 1580 1985 1785 1784 1783 1782 1781 1780 1779 1778 1777 1776 1775 1774 1773 1772 1771 1770 1769 1768 1767 1766 1765 1764 1763 1762 1761 1760 1759 1758 1757 1756 1755 1546 1329  872  381  869  382  124
 701  700  456  937 1166 1161 1162 1385 1806 1383 2002 1597 1157 1595 1593 1591 1590 1589 1588 1587 1586 1368 1584 1790 1582 1366 1579 1786 1578 1577 1576 1575 1574 1573 1572 1571 1570 1569 1568 1567 1566 1565 1564 1563 1562 1561 1560 1559 1558 1557 1556 1555 1554 1553 1552 1551 1550 1549 1548 1547 1331 1330 1105  630  383  125
 203  201  699  936 1165 1599 1163 1387 1382 1804 1380 1379 1801 1378 1592 1377 1375 1374 1373 1372 1371 1585 1370 1583 1367 1365  911 1142 1363 1362 1361 1360 1359 1358 1357 1356 1355 1354 1353 1352 1351 1350 1349 1348 1347 1346 1345 1344 1343 1342 1341 1340 1339 1338 1337 1336 1335 1334 1110 1333 1332  874 1104  873  633  384
 453  455  698  935 1601 1164 1386  932 1160 1159 1158 1156 1155 1154  923 1376 1152 1151 1150 1149 1148 1146 1369 1145 1144  912 1143 1364 1141 1139 1138 1137 1136 1135 1134 1133 1132 1131 1130 1129 1128 1127 1126 1125 1124 1123 1122 1121 1120 1119 1118 1117 1116 1115 1114 1113 1112 1111  879 1109 1108 1106  631  632  127  126
 200  198  697  696  934  446  929  930  928  689  927  926  925  924  684 1153  921  920  919  918  917 1147  916  915  674  913  910  671 1140  908  907  906  905  904  903  902  901  900  899  898  897  896  895  894  893  892  891  890  889  888  887  886  885  884  883  396  880  878  637  640  639 1107  390  634  385  128
 451  452  197  694  695  931  933  692  690  444  440  688  686  685  683  922  435  681  680  679  678  677  676  914  675  673  672  670  909  669  668  667  666  665  664  663  662  661  660  659  658  657  656  655  654  653  652  651  650  649  648  647  646  645  644  881  882  643  641  638  391  636  876  388  386  129
 196  199  194  448  693  447  445  691  188  442  443  687  439  438  437  682  436  434  433  432  431  430  429  428  427  426  425  424  423  422  421  420  419  418  417  416  415  414  413  412  411  410  409  408  407  406  405  404  403  402  401  400  399  398  397  395  394  642  392  136  875  635  389  877  130  131
 195  449  450  193  192  191  190  189  187  186  441  185  184  183  182  181  180  179  178  177  176  175  174  173  172  171  170  169  168  167  166  165  164  163  162  161  160  159  158  157  156  155  154  153  152  151  150  149  148  147  146  145  144  143  142  141  140  139  393  138  137  135  134  387  133  132
