# This puzzle is unsolvable
22
  1  84 160  86  89   8 289  93 231 237   7   5  99 169  16 103  18  20 100  22 178  21
 83 161  85   2  88 340 233 166 291 164  10  95  15 170 173  12  14 174 175 104  24  26
227 159   3 228 288 419 163 234  92 235   9 238  11 425 298 240 181 239 352  17  23 177
  4 157 162 341  87   6  90  91 167 388  94  96 242 349 172  19  97 302 243 245 179 180
158 286 229 165 290 338 230 294 156 297 296 348 391 350 456  13 101 176 105 107 102  27
 81 152  80 285 225 385 343 345 232 387 346 168 299 354 430 241 304 246  25  28 182 108
 79 224  78 287 337 342 292 448 422 452 347 236  98 455 171 392 305 244 247 110 106 109
 77 223 155  82 154 283 386 446 295 467 344 426 424 353 300 431 427 351 395 184  29 111
219  75  76 420 339 293 384 382 423 449 433 393 390 394 429 251 301 249 309 389 303  30
226 335 221 336 153 149 468 418 416 469 437 438 483 357 359 250 306 186 185 355 248  32
282  73 284  71 380 378 281 421 444 383 406 445 450 434 471 308 307 480 398 428 113 112
220 147 381 374 222 334 465  74 451 474 462 460 482 459 358 473 396 356  34 116 189  31
148 143 151 217 278 379 377 417 414 477 458 470 453 454 476 183 402 252 253  35 187 114
150 144 375 333 146 372 267 447 463 479 368 464 318 401 435 397 472 254 432  33 188 119
332  72 413 331 415 319 373 443 475 276 439 408 409 457 364 360 311 255 115 310  36 117
212  70 280 330 218 466 325 481 440 367 478 461 404 322 361 366 399 313 197 190 118  37
 68 273  66 277  67 279 205 410 266 442 264 436 207 365 317 258 403 259 191 256 120  38
274 275 271 216 441 376 412 134 326 324 270 405 204  49 130 400 257 194 362 312 193  39
145 213 215  63 329 272  56 135 268 202 132 200 320 369 263 261 316 125 192 127 121  40
328  69 140 141 208 327 411  61 371 323 203 407  51 321   0 363 315  47 314 195  45 122
 65 139 138 137 370  62 209 210 136  54 133  50 201 131 199 262 260  44  46 126 196  41
 64 142 211  59 214  60  58 206  57 269 265  53  55  52 129 128 198  48  42 123 124  43
