# This puzzle is unsolvable
44
   2    1    3    4    5    6    7    8    9   10   12  347  184   13   14   16   17   18   19   20   21   22   23   24   25   26   27   28   29   30   31   32   33   34   35   36   37   38   39   40   41   42   43   44
 172  173  174  175  176  177  178  179  180  181   11  346  183  185   15  187  188  189  190  191  192  193  194  195  196  197  198  199  200  201  202  203  204  205  206  207  208  209  210  211  212  213  214   45
 171  336  337  338  339  340  341  342  343  345  182  500  348  501  186  349  351  352  353  354  355  356  357  358  359  360  361  362  363  364  365  366  367  368  369  370  371  372  373  374  375  376  215   46
 170  335  492  493  494  495  496  497  498  499  646  789  650  651  503  350  653  506  509  655  510  512  659  513  514  515  516  517  518  519  520  521  522  523  524  525  526  527  528  529  530  377  216   47
 169  334  491  640  641  642  643  644  645  344  787  649  920  504  505  652  793  507  508  795  656  658  511  660  661  662  663  664  665  666  667  668  669  670  671  672  673  674  675  676  531  378  217   48
 168  333  490  639  780  781  913  782  783  648  788  502 1158  919  791  792  922  654  924  925  657  796  799  930  800  801  802  803  804  805  806  807  808  809  810  811  812  813  814  677  532  379  218   49
 167  332  489  638  779  912  914  915 1039  784  647  918  786 1043  790 1160 1045  794 1161  926  927  798  797 1053  932  933 1056  934  935  936  937  938  939  940  941  942  943  944  815  678  533  380  219   50
 166  331  488  637  778  911 1036 1037  785 1154 1259 1153  917 1157  921 1366 1048  923 1162 1049 1050 1051  928  929  931 1055 1054 1057 1058 1059 1060 1061 1062 1063 1064 1065 1066  945  816  679  534  381  220   51
 165  330  487  636  777  910 1035 1152 1260 1262 1360 1156 1040 1159 1363 1044 1047 1368 1164 1270 1165 1167 1052 1169 1277 1170 1467 1172 1173 1174 1176 1281 1177 1178 1179 1180 1067  946  817  680  535  382  221   52
 164  329  486  635  776  909 1034 1038 1155  916 1535 1261 1452 1042 1455 1265 1046 1268 1163 1370 1271 1166 1274 1275 1168 1171 1377 1279 1280 1380 1175 1283 1284 1285 1286 1181 1068  947  818  681  536  383  222   53
 163  328  485  634  775  908 1033 1258 1149 1151 1612 1264 1041 1538 1365 1266 1367 1369 1269 1371 1273 1272 1373 1374 1276 1375 1278 1378 1379 1282 1472 1381 1382 1383 1384 1182 1069  948  819  682  537  384  223   54
 162  327  483  774  632  907 1031 1032 1359 1358 1361 1537 1454 1267 1362 1457 1458 1459 1460 1461 1462 1372 1547 1465 1548 1376 1468 1469 1470 1471 1473 1475 1630 1385 1287 1183 1070  684  950  949  538  385  224   55
 161  326  633  484  772 1148  771 1256 1150 1257 1364 1613 1453 1611 1614 1540 1456 1542 1543 1544 1546 1463 1549 1464 1624 1550 1551 1552 1553 1554 1556 1555 1474 1386 1288 1289 1184  952  683  820  685  386  225   56
 160  325  481  482 1029  773 1254 1357 1533 1450 1354 1263 1539 1740 1681 1615 1541 1617 1618 1619 1545 1621 1622 1466 1691 1625 1626 1627 1628 1696 1629 1557 1476 1387 1290 1185 1071  823  821  540  539  387  226   57
 159  324  629  480  770 1027 1146  905 1536 1355 1253 1534 1680 1683 1742 1682 1616 1684 1685 1686 1620 1688 1689 1623 1690 1692 1693 1694 1697 1695 1558 1559 1477 1388 1291 1186  951 1072  822  686  541  388  227   58
 158  323  479  630  769  628 1030 1145 1255 1529 1356 1449 1679 1678 1791 1741 1793 1743 1744 1745 1687 1747 1748 1749 1750 1751 1752 1754 1804 1632 1755 1631 1478 1389 1292 1187 1073  953  824  687  542  389  228   59
 157  478  904  631 1147 1353  903  906 1446 1531 1447 1451 1532 1738 1836 1790 1794 1795 1796 1797 1746 1798 1799 1800 1801 1802 1753 1846 1756 1698 1633 1479 1390 1293 1188 1075 1074  954  825  688  543  390  229   60
 322  477  625  321  627  768 1026 1028 1143 1607 1352 1609 1677 1610 1608 1792 1835 1837 1838 1839 1840 1841 1842 1843 1844 1803 1805 1699 1757 1700 1635 1560 1561 1480 1189 1190 1076  955  826  689  544  391  230   61
 156  320  319  475  767  902  901 1249 1250 1252 1444 1739 1448 1736 1737 1789 1872 1873 1900 1875 1902 1876 1877 1878 1879 1845 1847 1806 1701 1636 1563 1634 1562 1294 1391 1295 1077  956  827  690  545  392  231   62
 155  154  766  765 1141  900 1025 1024 1144 1351 1445 1606 1605 1530 1676 1788 1834 1871 1901 1920 1874 1903 1904 1905 1906 1880 1848 1807 1758 1702 1637 1481 1482 1393 1296 1191 1078  957  828  691  546  393  232   63
 153  476  626  898  899  897 1142 1350 1251 1248 1442 1443 1675 1674 1735 1832 1787 1833 1870 1919 1921 1923 1924 1934 1907 1881 1849 1760 1808 1638 1564 1566 1392 1483 1297 1192 1079  958  829  692  547  394  233   64
 152  318  317  474  764  895 1140 1139 1023 1348 1527 1528 1604 1673 1734 1786 1869 1899 1898 1930 1931 1922 1925 1913 1908 1882 1883 1809 1759 1703 1565 1484 1394 1298 1301 1193 1080  959  830  693  548  395  234   65
 151  316  622  624  763  762 1138 1136 1247 1440 1441 1526 1603 1671 1672 1733 1831 1868 1897 1915 1933 1932 1935 1910 1926 1884 1850 1851 1811 1810 1704 1485 1395 1397 1299 1194 1081  960  831  694  549  396  235   66
 150  315  473  623  761 1137 1022 1020  896 1347 1349 1436 1525 1601 1732 1785 1830 1867 1896 1918 1916 1929 1928 1914 1909 1885 1761 1812 1705 1640 1567 1707 1486 1398 1396 1195 1082  961  832  695  550  397  236   67
 149  314  472  621  620  618 1021  760 1246 1345 1346 1439 1602 1669 1731 1784 1828 1829 1866 1892 1893 1891 1912 1927 1889 1886 1852 1762 1763 1641 1639 1568 1569 1487 1083 1302 1084  962  833  696  551  398  237   68
 148  313  471  469  892  893 1135 1244 1019 1243 1245 1522 1524 1517 1730 1827 1782 1865 1895 1917 1861 1890 1820 1859 1911 1857 1853 1854 1764 1642 1706 1571 1488 1399 1300 1197 1085  963  834  697  552  399  238   69
 146  147  467  619  894  891 1133 1017 1018 1596 1521 1600 1670 1598 1599 1729 1783 1864 1894 1822 1862 1860 1819 1888 1858 1887 1856 1855 1814 1643 1765 1489 1400 1196 1303 1199 1198  964  835  698  553  400  239   70
 310  144  312  470  466  311  759  890 1134 1437 1432 1240 1523 1666 1727 1728 1781 1826 1825 1863 1823 1818 1774 1772 1771 1817 1816 1813 1766 1708 1570 1709 1645 1401 1305 1304 1086  965  836  554  401  402  240   71
 468  616  756  758 1015  617 1013 1342 1343 1518 1520 1433 1438 1662 1726 1780 1779 1777 1658 1824 1657 1821 1655 1770 1715 1768 1714 1815 1767 1712 1644 1491 1490 1402 1306 1089  967  839  837  699  555  241  242   72
 143  145  463  615 1014 1012 1132 1434 1344 1429 1594 1241 1668 1130 1665 1724 1660 1778 1510 1723 1721 1720 1717 1773 1716 1652 1769 1713 1711 1710 1646 1572 1573 1403 1307 1087  700  840  701  556  557  404  403   73
 141  309  757  754  464 1435 1016 1341 1242 1131 1515 1597 1330 1340 1725 1664 1661 1588 1586 1776 1585 1722 1718 1719 1654 1653 1651 1650 1649 1648 1647 1575 1492 1404 1088 1202 1200  966  969  838  559  405  243   74
 613  885  465  753 1238  886  889 1127 1128 1236 1431 1427 1667 1592 1426 1663 1589 1590 1587 1656 1508 1506 1584 1583 1582 1581 1580 1579 1578 1577 1576 1574 1496 1405 1308 1495 1201 1091  703  841  706  406  244   75
 882  142  308  307  611  887 1338  751 1129 1516 1239 1595 1591 1519 1428 1331 1509 1329 1423 1775 1507 1419 1505 1504 1503 1502 1501 1500 1499 1498 1497 1493 1406 1409 1203 1204 1092 1090  702  968  245  562  246   76
 139 1009  306  755 1010  888  614 1011 1235  884 1336 1337 1332 1513 1117 1511 1327 1424 1421 1422 1659 1324 1418 1417 1416 1415 1414 1413 1412 1411 1410 1314 1494 1309 1206 1310  971  972  842  707  558  843  248   77
 610  608  140  305  301  749  461 1430 1126 1231 1233 1333 1237 1334 1335 1512 1227 1326 1226 1420 1222 1109 1323 1321 1219 1320 1319 1318 1317 1316 1315 1408 1407 1210 1311 1205 1207 1093  970  704  561  407  408  247
 138  135  462  742  612  750  137 1232 1339 1121 1119 1593 1230 1514 1228 1118 1225 1425 1325 1113 1223 1221 1220 1322  988 1217 1216 1215 1213 1212 1101 1211 1313 1097 1312 1209    0  716  705  844  560  563  409   78
 298  458  459  881  303 1123 1003 1234  875 1125  876 1120 1122  999 1229 1115 1116  996 1328 1224 1112 1111 1110 1108 1106 1105  986 1103  984 1214 1102 1100 1099 1098 1208  976  973  848  974  845  708  564   80   79
 132  746 1007  460 1008  878  609 1006  877  596 1004  743  594  998  873  997  869 1114  995  993  992  990  863  989 1218 1107  985 1104  983  982  855  854  981  850  714  977 1094  975  709  410  411  249  250   81
 453  607  879  752  136 1005  741  744  289  600 1002  739  871  737  870  736  734  868  994  866  864  991  728  862  860  987  859  858  857  721  719  852  851  717  573 1096  571  849  847  710  565  412  251   82
 302  299  304  455 1124  883  606  448  601  595 1000  445  593 1001  738  592  733  732  867  589  586  729  727  726  861  725  724  723  856  720  578  980  715  978 1095  979  853  712  846  711  566  413  252   83
 748  133  604  296  456  880  128  290  124  874  446  287  284  872  591  283  735  437  588  587  865  730  585  584  583  582  581  580  722  579  577  576  575  574  572  421  570  713  569  568  567  414  253   84
 300  129  125  457  747  449  126  602  127  597  292  740  442  285  443  116  590  438  436  731  277  435  434  433  432  431  430  429  428  427  426  425  718  423  422  262  420  419  418  417  416  415  254   85
 131  295  297  134  293  452  745  294  598  120  121  599  118  444  282  114  441  280  281  111  110  276  275  274  273  272  271  270  269  268  267  266  424  265  264  263  261  260  259  258  257  256  255   86
 130  454  603  605  450  451  123  122  291  286  447  119  288  117  115  279  439  113  440  278  112  109  108  107  106  105  104  103  102  101  100   99   98   97   96   95   94   93   92   91   90   89   88   87
