# This puzzle is unsolvable
33
   2    1    4  132  133    5    7    6  137    9  139   13  258   17  142   18  145  147   20   22   24  149   23   25  151   26   27   28  156   29   30   31   33
 128  248    3  250  464  561  255    8  136   12  256  371  372   15  141  140   14   16   19  146  264  269  270  150  153  154  155  276  277  275  158   32  159
 127  131  129  560  360  249  135  366  470  657  367   11  368  567  261  477  260  143  376  267  265  268  579  381  152  272  273  274  157  278  160  161   34
 126  247  130  462  361  362  138  468  565    0  254  568   10  569  476  263  262  144  480  266   21  379  380  486  378  271  385  583  386  388  279  387   35
 125  246  358  359  251  134  365  363  653  257  467  469  652  472  573  572  374  373  377  661  148  577  483  484  384  383  488  489  491  389  162   36   37
 124  245  465  466  649  471  364  252  801  564  803  369  473  654  259  574  375  479  478  576  481  482  578  382  580  487  746  669  584  281  282  163  164
 123  461  242  357  648  463  562  728  253  802  868  805  474  475  658  659  571  660  662  741  575  663  665  666  582  747  670  280  671  394  166   39   38
 559  244  356  557  235  558  727  563  731  732  800  734  370  570  656  737  738  810  740  742  875  814  664  743  668  586  493  581  490  485  391  283   40
 355  119  644  459  122  798  650  797  651  726  796  733  655  804  807  806  928  739  873  812  876  813  744  667  745  817  748  587  494  585  492  165   41
 354  353  554  241  458  647  729  795  865  566  864  736  924  866  867  872  809  874  811  930  877  933  815  816  879  749  672  674  392  167  168   42   43
 725  243  456  556  646  863  553  730  920  921  861  919  968 1064  971  869  870  808  974  979 1015  932  880  819  818  821  673  495  496  588  390  396  169
 121  120  455  239  721  457  240  862  724  916  794  970  922  972  871  973 1046  976 1045  978  931  936  881  882  590  750  751  395  286  591  285  170   44
 118  352  645  555  454  718  460  551  641  917  967  735  969  925  923 1082  927 1013  975 1016 1017  935  878  676  752  753  675  589  284  288  393  171   45
 238  114  350  642  351  117  349  723 1008  966 1005 1010 1011 1009 1041 1012 1067 1070 1014  977  981  982  934  884  883  822  820  592  497  499  287  173   46
 116  234  347  237  722  918  793  643  860  965  915  964 1004 1039 1080 1081 1088 1068  929 1044 1047  983  980  937  823  754  593  500  498  172  289  290   47
 719  112  348  115  639  453  717  452  799  858 1006 1040 1038  926 1062 1066 1086 1079 1043 1018 1019 1069  938  885  755  677  595  398  397  400  291  399   48
 548  233  113  550  638  552  720  640  857 1007  712  913 1033  963 1076 1061 1083 1071 1020 1048 1049 1022  984  826  940  824  680  503  594  401  501  174   49
 111  636  545  344  346  715  547  450  792  962 1001 1065 1063 1078 1060 1035 1056 1051 1084 1023  939 1050  886  887  678  681  825  758  596  502  292  176  175
 543  230  342  448  447  787  635  791  961  859 1003 1037 1042 1036 1031 1075 1030 1085 1073 1021 1024  985  986  941  756  757  827  504  597  402  293   50   51
 549  232  546  109  236  637  790  911  914  856  855 1002 1059 1057 1087 1072  993 1055 1052 1027 1054 1053  942  889  888  683  759  679  403  406  294  178  177
 341  108  713  449  345  789  339  451  910  909  912 1000 1032 1077 1034  997 1074  996  995 1025  988  987  943  890  828  760  682  598  506  295  404  296   52
 340  343  227  229  444  716  711  960  854  957  959  999  998 1058  953 1028 1029  994  992  991  990  989  944  829  891  761  684  505  507  297  405   54   53
 106  634  632  542  631  633  710  788  908  847  958  956  955  954  902  952  951  950  949  896 1026  947  945  892  830  831  685  600  599  509  180  179   55
 105  110  630  231  709  443  629  541  446  906  780  905  904  903  843  901  900  899  898  948  897  946  894  893  832  762  763  687  407  508  298  181   56
 104  337  628  544  226  540  228  782  907  783  852  706  846  779  842  775  841  840  839  838  770  895  835  834  833  764  601  686  602  510  299  182   57
 539  225  332  714  627  537  853  785  850  848  708  325  620  844  778  777  698  774  697  772  836  837  768  767  766  765  688  603  409  408  300  183   58
 223  334  107  445  784  222  851  625  781  705  623  704  702  701  700  525  526  773  695  771  696  769  693  692  691  690  689  604  511  410  301  184   59
 221  101  333  626  438  329  786  532  849  432  703  326  621  321  776  427  699  615  424  614  611  694  610  609  608  607  606  605  512  411  302  185   60
 103   96  338  441  224  436  534  624  434  622  430  619  845  428  618  206  617  426  523  522  612  423  520  519  517  516  515  514  513  412  303  186   61
 102  336  217  440  216  538  435  533  531  212  707  323  530  322  528  429  524  616  613  422  421  420  419  518  418  417  416  415  414  413  304  187   62
 100   99  439  437   91  442  330  535  214  536  529  431  209  207  527  319  318  317  202  316  521  315  314  312  311  310  309  308  307  306  305  188   63
 219   98   97  331   93  215  213  327   89   88  324  210  208   84  320  204   80   81  425  201  200  198  313  197  196  195  194  193  192  191  190  189   64
  94  220   95  218  335   92  328  433  211   90   87   86   85   83  205  203   82   79   78   77   76  199   75   74   73   72   71   70   69   68   67   66   65
