# This puzzle is unsolvable
48
   1  188    4  371    5  193  373    7    9   11  198   12   13  201   15   16   17   18   19   20   21   22   23   24   25   26   28  215   29   30   31   32   33  399  401   36   37   38   39   40   41   42   43   44   45   46   47   48
 187  190  191    2    6  194    8  196   10  377  199   14  379  200  203  204  205  384  206  207  208  209  210  211  212  213   27  394  217  218  569  221  219   35  402  223  224  225  226  227  228  229  230  231  232  233  234   49
 365  189  367    3  368  543  545  195  375  376  197  378  550  714  202  380  382  385  386  387  388  390  560  391  392  214  564  216  567  397  568  398  220   34  222  573  403  404  405  406  578  407  409  410  411  412  235   50
 185  366  370  186  541  372  192  374  710  547  548  549  551  552  715  381  717  555  556  558  389  561  878  724  563  393  881  395  728  396  732  570  400  734  571  736  737  574  577  895  740  408  580  581  582  413  236   51
 183  538  704  184  703  706  860  546  709  865  711  712  713  870  871  869  553  383  718  719  559  876 1022  723  562  565  725 1030  566  886  887  731  733  735  891  572  575  738  576  897  739  579  743  744  583  414  237   52
 364  537  859  535  862  707  544  708  863 1011  866  867 1155  868 1017  716  872  554  873  557  720 1163  721  879 1026  880  727 1028  882  729  730  884 1175 1036  888  892 1309 1039 1043 1042  896  741  898  745  584  415  238   53
 539  369  698  542  701  861  702  705 1012 1151 1013 1014 1015 1016 1158 1019 1018 1021 1162 1160  875 1025  722 1165  726 1167 1029 1031  883 1033  885 1303 1035  889 1310  894 1176  893 1307 1046 1045  899  900  746  585  416  239   54
 182  540  536 1006 1007 1148 1008  864 1010 1149 1152 1153 1156 1286 1154 1526 1288 1290 1159 1293 1291 1161 1416 1166 1296 1027 1168 1169 1170 1425 1172 1034 1173 1430 1306 1038  890 1179 1180 1040 1182 1044  742  747  586  417  240   55
 362  363  700  858  857 1009 1147 1280 1150 1283 1284 1407 1408 1285 1289 1525 1734 1020  874 1417 1292 1023 1164 1297 1299 1298 1422 1301 1302 1171 1032 1304 1305 1177 1431 1178 1432 1433 1311 1181 1041 1184  901  748  587  418  241   56
 181  361  534  533  856 1005 1146 1405 1282 1281 1523 1406 1630 1409 1157 1633 1528 1413 1412 1530 1024 1532 1294  877 1642 1420 1538 1645 1423 1539 1426 1542 1174 1037 1653 1652 1547 1435 1548 1183 1434 1047  902  749  588  419  242   57
 180  360  532  855  699 1145 1404 1279 1402 1521 1628    0 1626 1524 1287 1410 1414 1733 1415 1736 1295 1829 1533 1419 1641 1535 1536 1300 1540 1424 1427 1650 1545 1651 1429 1308 1654 1549 1313 1186 1185 1048  903  750  589  420  243   58
 179  178  359  697  854 1004 1278 1403 1519 1520 1627 1629 1522 1527 1411 1906 1824 1826 1637 1737 1638 1639 1418 1738 1643 1644 1537 1421 1646 1541 1747 1648 1428 1649 1751 1546 1544 1550 1315 1316 1439 1049  904  751  590  421  244   59
 177  358  531  696  853 1003 1144 1277 1142 1518 1729 1632 1728 1731 1727 1730 1635 1908 1529 1531 1636 1739 1640 1534 1741 1743 1744 1919 1835 1647 1543 1748 1840 1749 1750 1752 1314 1551 1436 1188 1187 1050  905  752  591  422  245   60
 176  357  530  695  851 1002 1143  852 1401 1276 1726 1820 1904 1819 1631 1822 1823 1735 1909 1634 1830 1913 1740 1988 1833 1742 1917 1745 1746 1836 1839 1922 1841 1924 1754 1842 1655 1552 1438 1312 1189 1051  906  753  592  423  246   61
 175  356  174  529  850 1141 1275 1400 1516 1517 1818 1625 1725 1905 1821 1825 2049 1982 2050 1827 1910 1828 1912 1990 1915 1831 1993 1834 1918 1921 1838 1837 1843 1998 1844 1656 1753 1440 1317 1437 1190 1052  907  754  593  424  247   62
 353  692  355  694 1000 1273 1001 1274 1398 1515 1623 1624 1723 1903 1980 1732 1979 1907 2052 1985 1987 1989 1914 2056 1991 2059 1994 2060 1920 1996 1997 2065 1923 1926 1925 1755 1658 1318 1553 1319 1053  908  909  755  594  425  248   63
 173  528  526  848  849  999 1140 1139 1399 1271 1622 1513 1724 1817 1978 1981 2108 1983 1986 2109 1911 2113 2054 2165 1832 1916 2058 2061 1995 2120 2062 2063 2064 1927 1845 1659 1657 1554 1441 1320 1191 1054  910  756  595  426  249   64
 525  352  354  847  998  997 1138 1514 1396 1397 1621 1816 1815 1900 1902 2048 2162 2045 2112 2051 2053 2163 2114 2055 2057 1992 2117 2118 2119 2121 2122 2066 1928 1999 1757 1756 1660 1555 1442 1192 1322 1055  911  757  596  427  250   65
 172  691  690  693  527  995 1272 1137 1512 1721 1720 1976 1977 1898 2046 2204 1975 2107 2047 1984 2164 2243 2208 2168 2116 2212 2171 2214 2124 2173 2002 2123 2000 1847 1846 1758 1661 1556 1443 1321 1193 1056  759  912  428  251   66   67
 171  350  524  689  846 1136  996 1393 1394 1510 1620 1722 1897 1813 2104 2106 2110 2161 2111 2160 2206 2207 2209 2166 2167 2245 2170 2211 2126 2215 2003 1930 2001 1929 1848 1759 1662 1557 1444 1195 1323 1194  913  758  598  429  252   68
 170  169  351  688  845  993 1395 1270 1392 1619 1508 1901 1812 1811 1814 2105 2103 2158 2241 2203 2205 2268 2242 2292 2115 2210 2213 2247 2169 2217 2067 2069 2068 1931 1849 1760 1664 1663 1558 1324 1058 1057  760  761  597  430  254  253
 167  523  522  687  992 1268  994 1269 1267 1617 1718 1899 1974 1973 1810 2044 2159 2200 2157 2238 2202 2269 2271 2246 2276 2249 2274 2290 2125 2172 2174 2129 2004 2007 1932 1851 1761 1559 1445 1325 1196 1059  914  762  599  600  255   69
 348  168  844  349  842 1265 1135 1132 1391 1509 1618 1511 1715 1809 1970 2156 2043 2201 2272 2287 2300 2244 2288 2270 2264 2293 2273 2275 2216 2127 2175 1933 2070 1850 2005 1762 1560 1446 1328 1326 1197 1060 1061  915  431  432  433   70
 166  347  521  684  685  991 1134  843 1133 1264 1390 1616 1719 1716 1972 2042 2237 2197 2233 2265 2298 2289 2297 2301 2280 2291 2254 2248 2250 2253 2178 2128 2071 1935 1852 1666 1665 1561 1447 1449 1448 1327  764 1198  916  601  434   71
 165  518  686  683  841  990 1131 1130 1266 1507 1806 1808 1894 1615 2154 2041 2198 2155 2240 2299 2236 2239 2235 2277 2303 2251 2295 2220 2176 2218 2074 2072 1936 2006 1763 1765 1764 1562 1450 1199 1062  917  765  918  602  256   72  257
 164  519  520  346  839 1263  989 1261 1506 1614 1389 1612 1896 1969 1893 1895 2040 2101 2099 2266 2153 2230 2283 2281 2296 2294 2279 2219 2179 2177 2073 2008 2131 1855 1853 1934 1767 1667 1563 1329 1063 1064  919  763  604  435   73  258
 163  345  517  840  682 1129  838  988 1388 1504 1505 1501 1717 2036 1892 2102 1971 2098 2100 2151 2284 2302 2229 2190 2285 2255 2258 2252 2221 2180 2130 2075 2009 1854 1766 1768 1565 1669 1564 1200 1330 1201  767  603  605  606  259   74
 162  344  516  515  681  987 1262 1384 1387 1714 1713 1611 1807 1890 2149 2039 2199 2038 2196 2152 2232 2234 2259 2086 2260 2282 2257 2278 2222 2181 2182 2132 1938 1857 2010 1856 1672 1668 1453 1331 1202  768  766  921  436  438  260   75
 161  343  342  514  986 1126 1128 1127 1260 1502 1386 1613 1711 1887 1891 2096 1968 1967 2231 2262 2263 2267 2286 2228 2261 2143 2185 2186 2256 2133 2076 2134 2011 1937 1566 1671 1769 1567 1451 1452 1066  923  920 1065  439  607  437  262
 340  341  159  985  837 1125 1258 1259 1500 1385 1503 1610 1712 1805 1889 1965 2097 2037 2147 2195 2093 2191 2087 2227 2141 2226 2137 2022 2184 2183 2136 2224 2012 1939 1858 1770 1670 1455 1454 1203 1204 1068 1067  922  608  440   76  261
 158  160  513  836  678  835  983 1124 1499 1382 1609 1803 1708 1886 2033 1888 2035 2192 2193 2090 2091 2144 2145 2084 2225 2188 2189 2138 2223 2140 2077 2080 2013 1941 1859 1332 1568 1673 1334 1333 1206 1205  769  771  609  264  263   77
 339  338  832  680  679  834  984 1256 1709 1707 1605 1710 1804 1964 1963 1966 2094 2092 2146 2029 2150 2025 2088 2024 2194 2139 2083 2082 2019 2135 2079 1940 2078 1942 1860 1771 1674 1569 1456 1335 1207  924  770  610  441  442   78   79
 157  510  512  676  675  981 1381 1607 1383 1257 1380 1800 1802 2032 2034 2095 1958 2148 1957 1880 2027 2028 2085 2142 1954 2187 2021 1950 2018 1947 2017 2014 2016 1944 1772 1675 1676 1570 1457 1336 1070 1069  925  772  611  443  265   80
 155  677  156  511  336  833 1123 1254 1255 1608 1498 1606 1801 1885 1962 1961 2031 1960 1959 1956 1695 2089 1877 1953 2023 1952 1949 2020 1948 1868 2081 2015 1945 1861 1862 1773 1677 1571 1458 1337 1208 1209  926  773  613  612  266   81
 152  509  830  507  831  982  337 1252 1379 1497 1496 1706 1799 1884 1883 1882 1881 1879 1878 1790 1789 1875 2026 1788 1874 1951 1784 1870 1869 1781 1946 1866 1865 1943 1864 1774 1678 1572 1459 1338 1072 1071  927  774  614  444  267   82
 153  508  672  149  979  978 1121 1120 1376 1378 1604 1705 1798 1797 1796 1795 1794 1793 2030 1696 1697 1955 1787 1871 1786 1873 1785 1689 1782 1686 1867 1779 1778 1777 1863 1776 1775 1573 1460 1339 1210 1073  928  775  615  445  268   83
 825  333  335  154  980  674 1119 1251 1122 1495 1377 1704 1703 1702 1701 1700 1699 1698 1792 1791 1694 1876 1693 1692 1691 1872 1587 1783 1688 1685 1780 1684 1683 1682 1681 1680 1679 1574 1461 1340 1211 1074  929  776  616  446  269   84
 673  829  332  828  827  976 1118 1491 1253 1603 1494 1601 1600 1599 1598 1597 1596 1595 1594 1593 1592 1591 1590 1589 1588 1586 1690 1584 1687 1583 1582 1581 1580 1579 1578 1577 1576 1575 1462 1341 1212 1075  930  778  777  447  270   85
 334  151  506  505  671 1117 1250 1374 1375 1493 1602 1490 1489 1488 1487 1486 1485 1484 1483 1482 1481 1480 1479 1478 1477 1476 1585 1474 1473 1472 1471 1470 1469 1468 1467 1466 1465 1464 1463 1342 1213 1076  931  779  617  448  271   86
 331  669  148  974  668 1116 1115 1249 1246 1492 1372 1371 1370 1369 1368 1367 1366 1365 1364 1363 1362 1361 1360 1359 1358 1357 1475 1356 1354 1353 1352 1351 1350 1349 1347 1220 1346 1345 1344 1343 1214 1078 1077  932  618  449  272   87
 147  502  670  826  975  973  977 1248 1373 1247 1245 1244 1243 1242 1241 1240 1239 1238 1237 1236 1235 1234 1233 1232 1231 1230 1229 1355 1228 1226 1225 1224 1223 1222 1348 1086 1219 1218 1217 1081 1216 1079  933  780  619  450  273   88
 326  150  666  329  821  667  972 1114 1112 1111 1110 1109 1108 1107 1106 1105 1104 1103 1102 1101 1100 1099 1098 1097 1096 1095 1094 1092 1227 1091 1090 1089 1088 1087 1221 1085  941 1084 1083  938 1215  937  934  781  620  451  274   89
 146  503  504  330  823  824  970 1113  969  968  967  966  965  964  963  962  961  960  959  958  957  956  955  954  953  952  951 1093  949  948  947  946  945  944  943  942  790  940 1082  939  788 1080  935  782  621  452  275   90
 325  498  501  328  497  820  971  819  818  817  816  815  814  813  812  811  810  809  808  807  806  805  804  803  802  801  800  950  639  798  637  795  794  793  792  632  791  630  789  786  787  936  784  625  622  453  276   91
 145  500  664  327  495  665  661  660  659  658  657  656  655  654  653  652  651  650  649  648  647  646  645  644  643  642  641  799  640  796  797  470  469  466  465  635  288  631  629  628  785  626  458  783  623  454  277   92
 143  323  139  662  321  494  319  493  492  491  490  489  488  487  486  485  484  483  482  481  480  479  478  477  476  475  474  473  472  638  636  468  109  467  292  634  633  463  286  462  627  459  283  624  456  455  278   93
 142  141  663  499  322  137  136  318  317  316  315  314  313  312  311  310  309  308  307  306  305  304  303  302  301  300  299  298  297  471  296  295  293  291  290  289  464  287  461  103  460  284  100  457  281  280  279   94
 140  822  324  144  496  138  320  135  134  133  132  131  130  129  128  127  126  125  124  123  122  121  120  119  118  117  116  115  114  113  112  294  111  110  108  107  106  105  104  102  285  101   99  282   98   97   96   95
