# This puzzle is unsolvable
33
   2    1    3    4    6    9  134   10  138  368  135  257   12  139   14  262  144   17   18  146   21  150   23  270  272   25  157  152   35   31  276   33   32
 128  129  132  130    5  253  136  370  367    8  140  256   11  141  143   15  145  374   19  573  147  269  148   24  273  381   26   27  275  491   29  280   34
 127  248  249  250  362  133  251    7  561  652  471  255  371   13   16  475  264  263  265   20  482   22  583  481  153  389  490   28  278  156  159  277   30
 126  247  360  361  131  466  469  468  137  731  259  369  473  260  261  574  142  480  575  663  266  578  155  484  384  271  382  489  488  386  388  161  158
 125  359  464  364  562  648  363  465  366  470  254  258  567  656  372  661  376  375  479  660  267  665  149  746  380  379  485  274  582  385  390  163  387
 245  246  358  559  649  557  650  729  800  563  565  736  732  734  373  571  572  378  873  813  741  268  579  580  492  745  151  581  587  283  160  164   38
 124  122  243  560  467  804  558  564  799  569  653  365  474  566  657  570  576  478  662  666  812  483  740  377  154  748  486  668  747  281  162  279   37
 244  123  242  357  864  463  646  726  801  472  568  735  655  807  659  477  871  476  664  876  928  816  744  667  577  383  749  493  670  282   43   36  669
 120  356  353  462  728  647  920  863  803  922  866  252  868  870  808  658  738  737  875  930  742  878  743  879  817  672  585  671  495  165  487   41  586
 355  354  352  460  121  865  727  645  725  805  651  802  733  654  926  974  811  809  932  975  931  933  881  880  815  818  584  496  494  395  393   40   39
 119  457  554  556  644  555  461  862  798  921  967  730  867  924  927  973 1012  872  739  977  976  877  820  821  819  674  750  675  284  673  392  391  167
 241  351  552  722  459  551  236  724  919  923  918  806  925  968  972 1013 1068  874 1044  978  810  814  934  935  882  751  676  588  590  285  171   45   42
 117  118  238  553  643  642  641  454  860  917 1007 1040 1008 1043  869 1042 1010 1014  929 1015  979  981  936  980  752  753  677  498  396  286  168  166   44
 116  240  723  234  235  458  796  718  859  965 1006  969  970 1009  971 1065 1078 1045 1046 1047 1016 1017  937  883  822  591  497  499  394  289  290  287  170
 456  350  858  237  640  721  794  639  795  793  861  916 1011 1080 1064 1066 1067 1069 1048 1049 1018 1019  884  823  754  678  593  500  288  589  173  169  172
 348  231  455  452  638  720  797  964  857  915  966 1038 1037 1039 1029 1062 1055 1082 1083 1070 1021  982  938  885  824  755  592  397  398  400   48   47   46
 345  239  453  349  232  548  550  542  855  914 1005 1004 1002 1063 1041 1088 1087 1084 1071 1020  984  983  939  886  825  756  679  594  399  291   49  292  175
 115  114  112  549  547  719  962  792  791  854 1061 1036 1081 1003 1077 1076 1079 1073 1052 1050 1051 1022  940  887  826  757  680  595  501  503  401  174   50
 110  346  344  717  716  450  634  789  913  959 1001  963 1035 1060 1030 1075 1085 1074 1086 1072 1023  985  941  888  827  758  681  596  402  293  502  176   52
 447  108  233  787  113  714  635  546  637  856  633  905 1000 1059 1058  996  993 1054 1053 1024  987  986  942  889  828  759  682  597  504  403  294   51  177
 631  230  347  451  954  713  229  908  715  111  956  961  845  958  997  953 1056  994 1027 1026 1025  988  943  890  829  760  683  598  505  404  295  178   53
 343  228  109  107  545  449  910  786  636  779  848  911  999 1032  902 1031  950  951  992  991  990  989  944  891  830  761  684  599  506  405  296  179   54
 227  342  543  629  448  544  632  710  850  960  852  780  957  998 1033 1057  995  901  949  947  896  946  945  892  831  762  685  600  507  406  297  180   55
 340  446  444  790  442  788  541  853  909  706 1034  842  846  955  903  841  900 1028  948  898  897  895  894  893  832  763  686  601  508  407  298  181   56
 106  226  225  712  630  784  907  625  785  781  851  703  844  904  775  952  840  899  772  839  837  836  835  834  833  764  687  602  509  408  299  182   57
 341  540  338  337  339  537  626  782  708  849  912  906  776  843  774  618  773  699  697  838  770  769  768  767  766  765  688  603  510  409  300  183   58
 104  441  102  336  709  445  443  711  623  534  847  778  620  702  619  617  428  615  698  771  695  694  693  692  691  690  689  604  511  410  301  184   59
 101  105  224   99  538  783  539  628  433  705  704  777  531  701  527  526  700  616  696  614  612  611  610  609  608  607  606  605  512  411  302  185   60
 220  222  218  103  223  627  624  707  435  536  621  532  622  530  528  321  525  524  523  613  521  520  519  518  517  516  515  514  513  412  303  186   61
  97  100  438  221  437  535  436  214  434  326  432  431  529  430  320  426  427  425  424  522  422  421  420  419  418  417  416  415  414  413  304  187   62
  95  334  332  333  439   98  330  215  211  327  325  324  323  429  322   83  204  317  316  423  315  314  313  312  311  310  309  308  307  306  305  188   63
  94  219  335  217  331  440   91  213   89  533   88  209  208  207  319  206  205  318  202  201  200  199  198  197  196  195  194  193  192  191  190  189   64
  96  216   92  212  328   93    0  329   90   87  210   86   85   84   82   81   80  203   79   78   77   76   75   74   73   72   71   70   69   68   67   66   65
