# This puzzle is unsolvable
33
 129    1    2  131    5    6    7    8  136    9   11   12   13  141   14  262   16   18   19  148  268  482   24  153  379   26   27   28   29   30   31   32   33
 127  128    4  250    3  132  133  134  255   10  137  259  139   15  142   17  146  266   21  265   20  151   22  270   25  274  154  155  156  157  158  159   34
 248  246  130  361  251  253  364  254  366  256  138  257  140  260  261  143  375  145  147  267  149  378  269  483  150  582  385  273  275  276  277  160   35
 247  249  360  252  359  467  648  135  367  471  369  258  370  371  572  144  373  264  377  575  480  577  271  383  486  152  272  489  386  387  161   37   36
 126  245  124  362  466  363  464  365  468  470  368  567  475  474  476  571  659  372  374  481   23  578  485  380  382  579  487  484  388  162  278  163   38
 123  122  561  358  560  462  562  563  469  564  566  568  473  569  735  263  376  478  574  576  662  663  744  667  384  381  488  490  491  389  279  280   39
 121  357  125  244  465  726  463  650  865  729  565  654  655  570  736  738  479  573  660  661  742  665  664  580  746  669  583  671  584  493  390  282  165
 243  356  355  461  649  647  727  728  472  653  730  651  807  657  737  809  477  928  812  811  814  741  815  745  747  585  672  668  494  670  164  281  166
 120  242  353  460  558  645  725  644  800  864  732  868  656  731  805  810  739  872 1044  740  813  743  816  879  666  492  749  588  393  391  284   42   41
 119  241  459  557  556  559  555  797  801  652  919  970  806  734  658  871  930  874  875  977  978  876  877  817  748  581  675  392  495  394  167   40   44
 354  239  240  457  798  643  646  722  733  921  802  923  804  972  808  925 1013  975 1014  979 1015 1016  878  880  818  750  586  753  587  283  168  169  286
 117  352  351  554  458  796  799  863  724  861  969  922  867 1043  924  873  869  929  927 1018  932  934  933  881  819  673  589  497  496  285   43  170   45
 238  118  455  553  721  456  642  862  967  918  968  803  917 1010 1066  974  870 1012 1083  931 1017  980  935  882  823  820  822  751  396  395   46  171   47
 115  237  116  350  349  723  794  795  860 1008  920 1006 1063 1011  926  866 1040 1064 1045 1047  981  936  883  938  884  752  821  590  498  287  172  398   49
 114  235  236  454  641  552  720  793  859  916 1009 1007  965 1005  973  976 1081 1042 1019  982 1067  983  937  756  755  676  591  674  397  288  400  290  173
 348  346  347  453  551  640  639  858  857  915  966  964 1039  971 1061 1041 1080 1074 1068 1048 1021  984  941  939  754  824  678  499  399  500  289   50   48
 113  234  345  452  549  550  548  792  914  790  963  961 1046 1062 1086 1069 1084 1070 1020 1071 1049  825  828  758  885  826  887  677  679  291  292   51  174
 112  233  344  232  451  719  638  718  911  855 1038 1002 1037  962 1088 1065 1075  895 1073 1050  985  831 1022  757  886  297  592  680  504  293  503  501  402
 111  231  229  547  546  637  636  791  856  913 1035 1003 1060  996 1082  997 1087 1072 1028  987 1027 1051  943 1023  294  295  596  593  598  298  175  178  401
 230  449  545  448  450  635  715  851  717  910  789 1077 1036 1078 1055 1076 1079 1085 1031 1053  990  986  829  595  759  681  508  594  502  406  509  179   53
 110  106  343  341  713  853  714  852  854  912  958 1004 1032 1000 1059 1057  899 1029 1026  837  897  890  940  894  889  942  506  405  888  687  181   52  176
 108  541  340  716  543  342  634  788  956  908  960 1001  907 1058  953 1030 1052 1056  950  991  948  835 1024 1025  988  760  600  403  507  683  180   54  404
 109  228  540  711  544  630  632  786  999  957  959  906  703  998  904  993  995  774  992 1054  989  892  836  684  682  827  505  597  762  510  299  177   57
 105  542  107  633  446  447  787  626  780  849  955  782 1033  844  954  994  903  900  775  946  945  947  891  896  832  686  830  601  408  763  410   55  296
 227  103  445  443  631  629  712  781  846  845  909 1034  777  902  843  842  952  901  840  838  769  949  767  944  893  603  513  688  308  300  764   59   56
 223  104  442  226  339  444  783  707  848  850  779  905  778  776  701  700  951  773  841  898  614  768  604  834  606  685  761  599  407  301  514  184   58
 221   94  539  338  224  710  628  785  623  706  537  705  702  619  616  618  772  612  694  422  522  693  766  518  765  608  602  512  411  605  302   62  182
 101  222  336  441  709  627  532  784  533  434  847  529  429  620  528  617  699  525  698  771  839  521  610  691  312  689  305  833  183  303  511  186   60
 225  216   97  334  337  438  538  624  535  622  704  621  531  206  526  320  426  615  613  770  611  314  692  609  519  418  515  409  690  412  187  185  189
 100  335  215  331  708  439  440  327  534  432   86  431  530  527  428  425  203  524  523  695  424  520   77  420  311  607  517  417  306    0   61  304   64
 333   95   99   98   93  437  213  326   88  625  435  430  324  323  322  427  319  423  318  697  421   78  199  313  516  196  415  419  193   72  309   63   65
 102  219  218  330   92   91  436  328  325  433  209  211  208  207  205  321  204  316  696  315   76  200   74   75  197  194  192   71   68   69  188   67   70
 220  536   96  217  332  329  212   90  214   89  210   87   85   84   83   82   81   80  202   79  201  317  198  195   73  416  413  310  191  414  307   66  190
