# This puzzle is unsolvable
70
   3    2    4    5  280    6    7    8    9   10   11   12   13   14   15   16   17   18   19   20   21  298  297   23   24   26   27   28   29   30   33  307  308   34   35   36   37   38   39   40   41   42   43   44   45   46   47   48   49   51  325   52   53  330   54   56   58   60  336  599   61   62   63  865  339  341  342   66   70   71
   1  276  277  279  281  807  282  283  284  285  286  287  288  289  290  291  292  560  293  295  296   22  299   25  300  301  303  570  304  573  305   31   32  575  309  311  312  313  314  315  316  317  318  319  320  321  322  323  324  592   50  327  328   55  331 1585   57   59 1111  334  335  606  605   65   67   69   64   68  610   72
 275  545  802  278  547  548  550  809  552  811  553  554  555  556  557  558  559  294  562  821  563  564  565  825  827  569  302  829  571  572  831  574  576  835  578  577  579  580  581  582  583  584  585  586  587  588  589  590  591  851  326  594  595  329  597  333  332  600  860  604  603 1116  338  867 1117  607  608  345  344   73
 272  544  546  806  805 1301  549 1060  810  551  812  813  814  815  816  818  819  820  561 1072  822  823  824 1076  567  568  828 1082  830  832  306  833 1085 1087 1086  310  838  839  840  841  842  843 1095  844  846 1342  847  849  850 1103  593  853  854  596  857 1106  859 1110  602  862  601  337  864  340 1360  870 1120  343  346   74
 274  804 1300  803 1536  808 1058 1061 1062 1063 1064 1065 1066 1067 1068  817 1069 1070 1071 1073 1074 1317 1075 1319  566 1078 1079 1080 1081 1083 1084 1327 1328  834  837 1088 1089 1090 1091 1092 1336 1093 1094  845 1097 1099  848 1098 1101  852 1345 1346 1104  856  855 1109  858  598 1112  861 1113 1114 1358  866  869  868 1118  611  347  348
1055  273  542 1057 1056 1299 1059 1303 1304 1305 1306 1307 1308 1309 1310 1311 1312 1313 1314 1315 1316 1552 1318 1077  826 1321 1322 1323 1324 1325 1326 1329 1563  836 1330 1567 1331 1333 1335 1570 1337 1338 1096 1340 1341 1576 1343 1344 1579 1102 1581 1105 1583 1349 1108 1813 1587 1352 1353 1355 1356  863 1820 1119 1363  612  350 1362   77 1361
 543  540  269 1054 1298 1537 1302 1538 1539 1540 1541 1542 1543 1544 1545 1546 1547 1775 1548 1549 1551 1553 1554 1555 1320 1556 1557 1558 1559 1560 1561 1562 1790 1564 1566 1332 1568 1569 1796 1334 1571 1572 1573 1339 1575 1577 1578 1100 1806 1580 1582 1347 1350 1586 1351 1812 1815 1588 1354 1589 1818 1592  609 1115 1594 1359  872 1595   76  614
 270  800  799 1053 1535 1534 1764 1765 1766 1767 1768 1769 1770 1771 1772 1773 1993 1774 1777 1550 1778 1779 1780 1781 1782 1783 1784 1785 1786 1787 1788 1789 1791 2011 1792 1793 1794 2015 1797 1798 2017 1799 1801 1574 2230 1803 2022 1804 2027 2239 2026 1348 2028 1811 1107 1584 1814 2034 1816 1591 1590 1819 1596 1593 1364  616  615  613   75  349
 801  541  271  537 1052 1051 1763 1984 1985 1986 1987 1988 1989 2201 1990 1991 2204 1776 1995 1996 1997 1998 1999 2000 2001 2002 2003 2004 2005 2006 2007 2008 2009 1565 2012 2222 2225 1795 2014 2016 2018 2019 2228 1802 2233 2232 2023 1805 1807 2024 2237 1809 2029 1810 2031 2032 2033 2035 2036 1817 2248 2038 1822 1821 1597 1123 1122  617  351   78
 268  539  538  798 1295 1297 1532 1762 2196 2197 2198 2199 2200 2404 2202 1992 2407 1994 2408 2206 2209 2412 2210 2211 2212 2213 2214 2215 2216 2217 2218 2219 2220 2423 2425 2427 2013 2223 2226 2430 2432 1800 2229 2020 2021 2234 2235 2025 2236 2238 1808 2442 2241 2030 2242 2243 2244 2245 2246 2247 2039 2040 2037 1121 1357  871  873  875  352   79
 266  267  536  797 1294 1531 1296 1533 1982 2400 2401 2402 2403 2599 2405 2406 2205 2203 2409 2207 2605 2208 2413 2414 2415 2416 2417 2418 2419 2420 2421 2422 2618 2010 2221 2424 2426 2224 2429 2431 2227 2433 2434 2231 2435 2436 2437 2438 2439 2440 2441 2443 2240 2444 2445 2446 2447 2448 2449 2450 2249 1823 1598 1365 1366 1124  618  874  353   80
 796  795 1050 1293 1292 1760 1761 1983 1980 2195 2596 2597 2598 2600 2601 2602 2603 2790 2604 2792 2410 2607 2796 2608 2610 2611 2612 2613 2614 2615 2616 2617 2619 2806 2620 2622 2623 2428 2624 2625 2626 2627 2628 2815 2630 2631 2632 2633 2634 2635 2636 2637 2638 2639 2640 2641 2642 2643 2644 2451 2250 2042 2041 1824 1599 1125  876  619  354   81
 265  535 1048 1049 1759 1047 1979 2193 2399 2194 2595 2784 2785 2786 2787 2788 2789 2969 2791 2793 2411 2606 2794 2797 2976 2798 2799 2800 2801 2802 2803 2804 2805 2807 2808 2621 2988 2810 2811 2812 2813 2993 2814 2629 2817 2818 2819 2820 2821 2822 2823 2824 2825 2826 2828 2829 3009 2830 2645 2453 2452 2251 1825 1600 1367 1126  877  620  355   82
 264  534  533 1046 1291 1530 1981 2192 2398 2397 2593 2594 2964 2965 2966 2967 2968 3140 2970 2971 2972 3144 2609 2975 3148 2977 2978 2979 2980 2981 2982 2983 2984 2985 2986 2809 2987 2989 2990 2991 2992 3164 2994 2816 2996 2997 2998 2999 3000 3001 3002 3003 3004 3005 2827 3008 3007 3178 2648 2252 2253 2043 1826 1601 1368 1127  878  621  356   83
 263  262  794  793 1529 1757 1758 1976 1978 2592 2396 2783 2963 3136 3137 3138 3139 3141 3142 3143 3308 2795 3310 2974 3146 3311 3149 3150 3151 3152 3153 3154 3155 3156 3319 3158 3159 3160 3161 3162 3165 3482 3167 2995 3168 3331 3169 3170 3171 3172 3173 3174 3175 3176 3006 2833 3011 2646 2831 2647 2044 1827 1603 1828 1369 1128  879  622  357   84
 531  532  792 1045 1527 1290 1756 2190 2191 2781 2782 2780 2962 3135 3300 3301 3302 3304 3305 3306 2973 3307 3145 3147 3611 3466 3312 3313 3314 3315 3316 3317 3318 3320 3157 3321 3322 3323 3324 3325 3327 3328 3166 3329 3330 3486 3332 3333 3334 3335 3336 3337 3338 3339 3177 3341 3179 2832 2649 2454 2455 2254 2045 1602 1370 1129  880  623  358   85
 261  530  791 1044 1289 1528 1975 1755 1977 2394 2591 2779 2961 3134 3299 3456 3457 3303 3458 3459 3460 3462 3750 3463 3309 3613 3467 3468 3469 3470 3471 3472 3473 3474 3475 3476 3477 3478 3479 3480 3163 3326 3629 3483 3485 3632 3633 3488 3489 3490 3491 3492 3493 3494 3340 3180 3012 3010 2834 2456 2255 2046 1829 1604 1371 1130  881  624  359   86
 260  529  790 1043 1288 1526 1525 2188 2189 2395 2589 2590 2960 3133 3298 3455 3604 3606 3607 3746 3608 3461 3609 3465 3464 3752 3614 3754 3616 3617 3618 3619 3620 3621 3622 3623 3624 3625 3626 3627 3630 3481 3484 3771 4025 3772 3487 3634 3636 3637 3638 3639 3640 3495 3343 3342 3181 2835 2650 2457 2256 2047 1830 1605 1372 1131  882  625  360   87
 259  528  789 1042 1287 1524 1754 1753 2187 2393 2392 2778 2959 3132 3297 3454 3603 3605 3745 3877 3747 3748 3610 3881 3612 3615 3885 3753 3755 3756 3757 3758 3759 3760 3761 3762 3763 3764 3765 3766 3628 3768 3631 3900 3902 3904 3773 3774 3635 3906 3777 3908 3778 3496 3344 3182 3013 2836 2651 2458 2257 2048 1831 1606 1373 1132  883  626  361   88
 258  527  788 1041 1286 1523 1752 1974 2186 2391 2588 2777 2958 3131 3296 3453 3602 3744 3876 3999 3878 3880 3749 4004 4005 3882 4121 4008 3886 3887 3888 3889 3890 3891 3892 3893 3894 3895 3896 3897 3767 3898 3899 3769 3901 3905 4249 4027 3775 3776 3779 3780 3641 3497 3345 3183 3014 2837 2652 2459 2258 2049 1832 1607 1374 1133  884  627  362   89
 257  526 1040 1285 1521 1751 1972 1973 1971 2390 2587 2776 2957 3130 3295 3452 3601 3743 3742 3874 4000 3879 4002 4003 3883 4119 3751 3884 4009 4010 4011 4012 4013 4014 4015 4016 4017 4018 4019 4020 4021 4022 4023 4024 3770 4026 4143 4028 4031 3909 4030 3781 3642 3498 3184 3185 3015 2838 2653 2460 2259 2050 1833 1608 1375 1134  885  628  363   90
 256  525  787  786 1522 1750 1749 2184 2185 2389 2586 2775 2956 3129 3294 3451 3600 3741 3875 3998 4001 4117 4225 4006 4226 4007 4229 4123 4124 4125 4126 4127 4128 4129 4130 4131 4132 4133 4134 4135 4136 4137 4246 4139 3903 4142 4140 4251 4252 3907 3911 3910 3643 3499 3347 3346 3016 2839 2654 2461 2260 2051 1834 1609 1376 1135  886  629  364   91
 253  254  523 1037 1284 1038 1283 1520 2183 2388 2585 2774 3128 3127 3450 3449 3599 3740 3873 3997 4116 4224 4324 4122 4416 4118 4227 4230 4231 4232 4233 4234 4235 4236 4237 4238 4239 4240 4241 4242 4243 4244 4138 4344 4247 4248 4347 4348 4144 4029 4032 3782 3644 3500 3186 3187 3017 2840 2655 2462 2261 2052 1835 1610 1377 1136  887  630  365   92
 252  785  255 1036 1519 1039 1748 1970 1969 2182 2584 2773 2953 3292 3293 3291 3598 3739 3872 4113 4115 4223 4325 4326 4228 4120 4328 4329 4330 4331 4332 4333 4334 4335 4336 4337 4338 4339 4340 4341 4342 4343 4345 4245 4346 4141 4250 4145 4148 4034 4147 3783 3645 3501 3348 3188 3018 2841 2656 2463 2262 2053 1836 1611 1378 1137  888  631  366   93
 521  524  784 1035 1282 1281 1747 1967 1968 2387 2386 2772 2952 2954 3126 3597 3447 3448 3738 3871 4114 4222 4323 4417 4500 4327 4419 4420 4421 4422 4423 4424 4425 4426 4427 4428 4429 4430 4431 4432 4433 4434 4435 4436 4437 4438 4349 4033 4253 3913 3912 3784 3646 3502 3189 3350 3349 2842 2657 2464 2263 2054 1837 1612 1379 1138  889  632  367   94
 251  522  783 1280 1279 1518 1746 1966 2181 2180 2583 2582 2771 2951 3289 3290 3596 3737 3870 3996 4221 4220 4322 4415 4499 4418 4502 4503 4504 4505 4506 4507 4508 4509 4510 4511 4512 4513 4514 4515 4516 4517 4518 4519 4520 4439 4350 4146 4036 3914 3915 3648 3647 3503 3351 3020 3019 2843 2658 2465 2264 2055 1838 1613 1380 1139  890  633  368   95
 250  520  782 1034 1516 1517 1515 2179 2177 2385 2581 2770 3124 2955 3125 3446 3595 3735 3736 3995 3994 4112 4110 4414 4576 4501 4577 4578 4579 4580 4581 4582 4583 4584 4585 4586 4587 4588 4589 4590 4591 4592 4593 4594 4521 4440 4254 4150 4035 4149 3916 3785 3787 3504 3190 3191 3021 2844 2659 2466 2265 2056 1839 1614 1381 1140  891  634  369   96
 519  779  781 1033 1278 1745 1965 1744 1963 2384 2580 2769 2950 3123 3287 3288 3445 3594 3868 3869 3993 4111 4219 4412 4320 4575 4644 4645 4646 4647 4648 4649 4650 4651 4652 4653 4654 4655 4656 4657 4658 4659 4660 4595 4522 4441 4351 4256 4255 4038 4037 3786 3505 3649 3352 3022 2845 2846 2660 2467 2266 2057 1840 1615 1382 1141  892  635  370   97
 249  518  780 1032 1031 1743 1964 2382 2381 2383 2579 2768 2949 3443 3122 3444 3593 3734 3867 3992 4109 4218 4217 4321 4413 4572 4642 4643 4705 4706 4707 4708 4709 4710 4711 4712 4713 4714 4715 4716 4717 4718 4661 4596 4523 4442 4352 4353 4151 3917 3788 3651 3650 3506 3353 3192 3023 2847 2661 2469 2468 2267 1841 1616 1383 1142  893  636  371   98
 517  247  778 1030 1514 1277 1276 1742 2178 2578 2767 2948 3121 3120 3286 3592 3733 4107 3991 3988 4216 4319 4318 4411 4498 4573 4574 4704 4756 4757 4758 4759 4760 4761 4762 4763 4764 4765 4766 4767 4768 4719 4662 4597 4524 4443 4354 4257 4152 4039 3918 3789 3652 3507 3354 3193 3024 2848 2662 2470 2268 2058 1842 1617 1384 1143  894  637  372   99
 248  776  515  777 1275 1513 1741 1962 2176 2380 2576 2766 2947 3284 3285 3731 3591 3989 3442 3866 4108 4106 4314 4317 4496 4497 4702 4703 4755 4800 4801 4838 4802 4803 4805 4806 4807 4808 4809 4810 4769 4720 4663 4598 4525 4445 4444 4355 4258 4153 4040 3919 3790 3653 3508 3355 3025 2849 2663 2472 2060 2059 2061 1618 1385 1144  895  638  373  100
 246  516  775 1029 1274 1512 1740 1738 2174 2577 2575 2765 2946 3119 3440 3282 3729 3865 4215 3987 4213 4214 4409 4410 4569 4641 4640 4700 4701 4754 4799 4836 4839 4804 4840 4841 4842 4843 4844 4812 4811 4770 4721 4600 4599 4526 4356 4259 4154 4041 3920 3791 3654 3509 3356 3194 3026 2664 2471 2665 2270 1844 1843 1619 1386 1145  896  639  374  101
 245  514 1028  774 1273 1511 1961 2173 2175 2172 2379 2764 2945 3118 3441 3438 3588 3439 3732 4316 3864 4315 4407 4495 4494 4571 4570 4699 4753 4798 4835 4837 4864 4865 4867 4868 4869 4870 4846 4845 4771 4722 4664 4665 4527 4446 4357 4260 4155 4042 3921 3792 3655 3510 3357 3195 3196 2666 2852 2667 2271 2269 1846 1845 1387 1146  897  640  375  102
 244  512  773 1272 1508 1958 1509 1960 2377 2378 2574 2763 2944 2761 3281 3589 3590 3586 3861 3730 4104 4312 4493 4406 4408 4492 4639 4638 4752 4797 4834 4863 4885 4866 4886 4887 4888 4871 4847 4813 4772 4723 4666 4601 4528 4447 4358 4261 4156 4043 3922 3793 3656 3511 3358 3197 3027 2850 2273 2668 2272 2062 1620 1621 1147 1148  898  641  376  103
 513  243 1027 1271 1737 1510 1736 1957 1739 2171 2762 2943 2942 3117 3112 3283 3863 3728 3860 3985 4105 3986 4313 4103 4491 4568 4698 4636 4751 4796 4833 4883 4884 4896 4897 4898 4890 4889 4872 4814 4773 4724 4667 4602 4529 4448 4359 4262 4157 4044 3923 3794 3657 3512 3359 3198 3028 3029 2476 2274 2065 2063 2064 1847 1390 1149  899  642  377  104
 242  511  772 1026 1507 1269 1735 2170 2376 2375 2573 2572 2941 3115 3116 3587 3727 3725 4208 3858 3862 4210 4211 4405 4567 4637 4750 4697 4795 4794 4832 4862 4861 4895 4893 4899 4891 4873 4848 4815 4774 4725 4668 4603 4530 4449 4360 4263 4158 4045 3924 3795 3658 3513 3360 3199 3030 2669 2473 2475 2474 1848 1623 1389 1388 1150  900  643  378  105
 241  510  771 1024 1270 1505 1506 2169 1959 2759 2570 2758 2760 3113 3437 3280 3726 3585 3859 3990 4101 4311 4404 4489 4565 4490 4635 4696 4749 4793 4831 4881 4882 4859 4894 4892 4876 4874 4875 4816 4775 4726 4669 4604 4531 4450 4361 4264 4159 4046 3925 3796 3659 3514 3361 3200 3031 2853 2851 2855 2275 1849 1622 1624 1392 1391  901  644  379  106
 238  509  769  770 1025 1734 1955 2373 2167 2374 2940 3114 3279 3110 3436 3584 3583 3723 4212 3982 4209 4403 4402 4487 4488 4566 4634 4695 4747 4748 4830 4860 4857 4880 4878 4877 4853 4852 4849 4817 4776 4727 4670 4605 4532 4451 4362 4265 4160 4047 3926 3797 3660 3515 3362 3201 3032 2670 2854 2477 2276 2066 2067 1626 1625 1151  902  645  380  107
 240  239 1023 1267 1504 1733 2168 1956 2372 2568 2571 2939 2755 3111 3276 3434 3581 3856 4100 4098 4102 4309 4308 4310 4307 4564 4633 4694 4746 4792 4829 4827 4858 4879 4856 4855 4854 4851 4850 4818 4777 4728 4671 4606 4533 4452 4363 4266 4161 4048 3927 3798 3661 3516 3363 3202 3033 2856 2671 2478 2277 2068 1850 1627 1393 1152  903  646  381  108
 237  508  768 1022 1268 1021 1503 1953 1954 2937 2757 2569 2756 3277 3433 3278 3857 3582 3983 3981 3984 4099 4486 4401 4485 4563 4632 4692 4693 4791 4828 4788 4826 4825 4824 4823 4822 4821 4820 4819 4778 4729 4672 4607 4534 4453 4364 4267 4162 4049 3928 3799 3662 3517 3364 3203 3034 2857 2672 2479 2278 2069 1851 1852 1394 1153  904  647  382  109
 236  507  767 1020 1266 1729 1732 1952 2371 2166 2565 2368 3272 2936 2938 3435 3275 3724 3854 4207 4097 4206 4400 4399 4562 4630 4631 4690 4745 4790 4789 4741 4787 4786 4785 4784 4783 4782 4781 4780 4779 4730 4673 4608 4535 4454 4365 4268 4163 4050 3929 3800 3663 3518 3365 3204 3035 2858 2673 2480 2279 2070 1853 1854 1395 1154  905  648  383  110
 235  506  766 1019 1264 1502 1731 2162 1730 2370 3108 2369 2567 2934 2754 3580 3432 3431 3855 3980 3978 4094 4095 4096 4398 4561 4629 4691 4744 4743 4742 4686 4740 4739 4738 4737 4736 4735 4734 4733 4732 4731 4674 4609 4536 4455 4366 4269 4164 4051 3930 3801 3664 3519 3366 3205 3036 2859 2674 2481 2280 2071 1629 1628 1396 1155  906  649  384  111
 234  505  762 1500 1501 1265 1728 2160 1950 2563 2566 1951 2933 3107 3721 3109 3274 3722 3852 3719 3979 4205 4305 4484 4397 4560 4558 4559 4627 4626 4687 4623 4685 4684 4683 4682 4681 4680 4679 4678 4677 4676 4675 4610 4537 4456 4367 4270 4165 4052 3931 3802 3665 3520 3367 3206 3037 2860 2675 2482 2281 2072 1855 1630 1397 1156  907  650  385  112
 502  233  764  765 1499 1727 1017 2161 2163 2562 2366 2935 3106 3104 3718 3579 3428 3430 3720 4093 3977 4203 4306 4204 4483 4482 4478 4557 4688 4689 4625 4624 4622 4621 4620 4619 4618 4617 4616 4615 4614 4613 4612 4611 4538 4457 4368 4271 4166 4053 3932 3803 3666 3521 3368 3207 3038 2861 2676 2483 2282 2073 1856 1631 1398 1157  908  651  386  113
1259  501  760 1018 1263 1498 2159 2165 2164 1949 2367 2364 3270 2564 3273 2752 3575 3577 3976 4202 3974 4200 4303 4304 4302 4479 4480 4556 4628 4555 4554 4553 4552 4550 4549 4548 4547 4546 4545 4544 4543 4542 4541 4540 4539 4458 4369 4272 4167 4054 3933 3804 3667 3522 3369 3208 3039 2862 2677 2484 2283 2074 1857 1632 1399 1158  909  652  387  114
 499  500 1260 1262 1015  503 1947 1014 2365 2932 2931 2750 3105 2747 2753 3429 3850 3853 3578 3851 3716 4091 4201 4395 4393 4391 4481 4477 4476 4475 4473 4472 4551 4471 4470 4469 4468 4467 4466 4465 4464 4463 4462 4461 4460 4459 4370 4273 4168 4055 3934 3805 3668 3523 3370 3209 3040 2863 2678 2485 2284 2075 1858 1633 1400 1159  910  653  388  115
 504  232  230  231 1016 1497 1495 1948 2157 2158 2751 2558 3102 3268 3271 3427 3574 3717 3849 3975 4092 4199 4394 4396 4392 4297 4390 4389 4388 4387 4292 4386 4385 4384 4383 4382 4381 4380 4379 4378 4377 4376 4375 4374 4373 4372 4371 4274 4169 4056 3935 3806 3669 3524 3371 3210 3041 2864 2679 2486 2285 2076 1859 1634 1401 1160  911  654  389  116
 229  496  761  763 1261 1945 1723 2746 2560 1943 1944 2745 2748 3266 3269 3426 3576 3847 3715 3973 4090 4198 4301 4300 4299 4298 4194 4296 4294 4293 4291 4474 4290 4289 4288 4287 4286 4285 4284 4283 4282 4281 4280 4279 4278 4277 4276 4275 4170 4057 3936 3807 3670 3525 3372 3211 3042 2865 2680 2487 2286 2077 1860 1635 1402 1161  912  655  390  117
 228  759 1496  498 1257 1009 1258 1725 2360 2156 1946 2561 2749 3100 3103 3424 3572 3573 3972 4088 4089 4087 4197 4196 4195 4083 3962 4295 4191 4190 4189 4188 4187 4186 4185 4184 4183 4182 4181 4180 4179 4178 4177 4176 4175 4174 4173 4172 4171 4058 3937 3808 3671 3526 3373 3212 3043 2866 2681 2488 2287 2078 1861 1636 1403 1162  913  656  391  118
 494  495  757 1256 1013 1722 1494 1724 2361 2554 1940 2155 3267 1726 2930 3425 3423 3714 3848 3971 3968 3969 4086 4085 4084 4082 4192 4193 4080 4079 4078 4077 4076 4075 4074 4073 4072 4071 4070 4069 4068 4067 4066 4065 4064 4063 4062 4061 4060 4059 3938 3809 3672 3527 3374 3213 3044 2867 2682 2489 2288 2079 1862 1637 1404 1163  914  657  392  119
 226  756  227 1011 1010 1490 1721 2557 1012 2358 2363 2555 2559 2927 2928 3265 3713 3846 3711 3712 3842 3841 3967 3966 3965 3964 4081 3963 3961 3960 3959 3958 3957 3956 3955 3954 3953 3952 3951 3950 3949 3948 3947 3946 3945 3944 3943 3942 3941 3940 3939 3810 3673 3528 3375 3214 3045 2868 2683 2490 2289 2080 1863 1638 1405 1164  915  658  393  120
 224  225  497  755 1720 1255 1492 2362 2154 2356 2357 2925 2926 2929 3101 3264 3422 3570 3844 3970 3843 3706 3840 3839 3838 3837 3836 3835 3834 3833 3832 3831 3830 3829 3828 3827 3826 3825 3824 3823 3822 3821 3820 3819 3818 3817 3816 3815 3814 3813 3812 3811 3674 3529 3376 3215 3046 2869 2684 2491 2290 2081 1864 1639 1406 1165  916  659  394  121
 493  754  758 1254 1493 1491 1719 1942 2359 2744 2742 2556 3098 3263 3099 3420 3421 3845 3565 3709 3707 3563 3705 3561 3704 3702 3701 3700 3699 3698 3697 3696 3695 3694 3693 3692 3691 3690 3689 3688 3687 3686 3685 3684 3683 3682 3681 3680 3679 3678 3677 3676 3675 3530 3377 3216 3047 2870 2685 2492 2291 2082 1865 1640 1407 1166  917  660  395  122
 223  492 1253 1007 1252 1489 1941 2153 1717 2150 2743 2741 2924 3097 3262 3419 3571 3710 3568 3708 3564 3562 3411 3409 3703 3559 3558 3557 3556 3555 3554 3553 3552 3551 3550 3549 3548 3547 3546 3545 3544 3543 3542 3541 3540 3539 3538 3537 3536 3535 3534 3533 3532 3531 3378 3217 3048 2871 2686 2493 2292 2083 1866 1641 1408 1167  918  661  396  123
 753  752 1005 1006 1251 1249 1488 1718 1939 2553 2740 2922 2923 3261 3260 3567 3569 3416 3566 3255 3413 3412 3410 3251 3560 3408 3407 3406 3405 3404 3403 3402 3401 3400 3399 3398 3397 3396 3395 3394 3393 3392 3391 3390 3389 3388 3387 3386 3385 3384 3383 3382 3381 3380 3379 3218 3049 2872 2687 2494 2293 2084 1867 1642 1409 1168  919  662  397  124
 222  490  491 1008 1250 1716 1937 2151 1938 2152 2921 3095 2920 3096 3258 3418 3417 3090 3414 3415 3254 3253 3252 3250 3083 3249 3248 3247 3246 3245 3244 3243 3242 3241 3240 3239 3238 3237 3236 3235 3234 3233 3232 3231 3230 3229 3228 3227 3226 3225 3224 3223 3222 3221 3220 3219 3050 2873 2688 2495 2294 2085 1868 1643 1410 1169  920  663  398  125
 221  489  751 1004 1248 1487 1715 1936 2149 2551 2353 2552 2354 3094 3093 3259 3091 3256 3257 3088 3086 2912 3085 3084 2908 3082 3081 3080 3079 3078 3077 3076 3075 3074 3073 3072 3071 3070 3069 3068 3067 3066 3065 3064 3063 3062 3061 3060 3059 3058 3057 3056 3055 3054 3053 3052 3051 2874 2689 2496 2295 2086 1869 1644 1411 1170  921  664  399  126
 220  750 1002 1246  749 1003 1486 1714 2148 2355 2738 2739 2736 2919 3092 2917 2916 2915 3089 2730 2913 3087 2911 2909 2534 2907 2906 2905 2904 2903 2902 2901 2900 2899 2898 2897 2896 2895 2894 2893 2892 2891 2890 2889 2888 2887 2886 2885 2884 2883 2882 2881 2880 2879 2878 2877 2876 2875 2690 2497 2296 2087 1870 1645 1412 1171  922  665  400  127
 219  488 1001  747 1484 1485 1934 1935 2352 2548 2550 2347 2549 2735 2918 2734 2733 2732 2914 2731 2729 2728 2910 2727 2726 2724 2725 2722 2721 2720 2719 2718 2717 2716 2715 2714 2713 2712 2711 2710 2709 2708 2707 2706 2705 2704 2703 2702 2701 2700 2699 2698 2697 2696 2695 2694 2693 2692 2691 2498 2297 2088 1871 1646 1413 1172  923  666  401  128
 748  218 1000 1245 1247 1483 1713 1933 2147 2146 2349 2346 2546 2547 2545 2543 2542 2541 2540 2539 2538 2338 2536 2535 2533 2532 2723 2531 2530 2529 2528 2527 2526 2525 2524 2523 2522 2521 2520 2519 2518 2517 2516 2515 2514 2513 2512 2511 2510 2509 2508 2507 2506 2505 2504 2503 2502 2501 2500 2499 2298 2089 1872 1647 1414 1173  924  667  402  129
 217  485  487 1482 1244 1712 1711 1932 2145 2351 2348 2737 2140 2139 2544 2344 2343 2342 2341 2340 2339 2337 2537 2336 2335 2334 2333 2332 2331 2330 2329 2328 2327 2326 2325 2324 2323 2322 2321 2320 2319 2318 2317 2316 2315 2314 2313 2312 2311 2310 2309 2308 2307 2306 2305 2304 2303 2302 2301 2300 2299 2090 1873 1648 1415 1174  925  668  403  130
 486  216  484  999 1481 1710 1709 1931 2144 2350 1929 2141 1925 2138 2345 2137 2136 2135 2134 2133 2132 2131 2130 2129 2128 2127 2126 2125 2124 2123 2122 2121 2120 2119 2118 2117 2116 2115 2114 2113 2112 2111 2110 2109 2108 2107 2106 2105 2104 2103 2102 2101 2100 2099 2098 2097 2096 2095 2094 2093 2092 2091 1874 1649 1416 1175  926  669  404  131
 215  745  746  998 1243 1479 1480 1930 2143 2142 1926 1702 1471 1924 1923 1922 1921 1920 1919 1918 1917 1916 1915    0 1914 1912 1911 1910 1909 1908 1907 1906 1905 1904 1903 1902 1901 1900 1899 1898 1897 1896 1895 1894 1893 1892 1891 1890 1889 1888 1887 1886 1885 1884 1883 1882 1881 1880 1879 1878 1877 1876 1875 1650 1417 1176  927  670  405  132
 214  483  744  997 1242 1478 1708 1706 1927 1928 1704 1701 1470 1472 1700 1699 1698 1697 1696 1695 1694 1693 1692 1690 1913 1689 1688 1687 1686 1685 1684 1683 1682 1681 1680 1679 1678 1677 1676 1675 1674 1673 1672 1671 1670 1669 1668 1667 1666 1665 1664 1663 1662 1661 1660 1659 1658 1657 1656 1655 1654 1653 1652 1651 1418 1177  928  671  406  133
 213  482  743  996 1241 1477 1476 1707 1475 1705 1474 1703 1233 1469 1468 1229 1467 1466 1465 1464 1463 1462 1460 1691 1459 1458 1457 1456 1455 1454 1453 1452 1451 1450 1449 1448 1447 1446 1445 1444 1443 1442 1441 1440 1439 1438 1437 1436 1435 1434 1433 1432 1431 1430 1429 1428 1427 1426 1425 1424 1423 1422 1421 1420 1419 1178  929  672  407  134
 212  481  742  995 1240 1239 1238 1237 1236 1235 1473  986 1232 1231  983 1230 1227 1226  979 1225 1224 1223 1461 1222 1221 1219 1218 1217 1216 1215 1214 1213 1212 1211 1210 1209 1208 1207 1206 1205 1204 1203 1202 1201 1200 1199 1198 1197 1196 1195 1194 1193 1192 1191 1190 1189 1188 1187 1186 1185 1184 1183 1182 1181 1180 1179  930  673  408  135
 211  480  741  994  993  992  991  990  989  988 1234  731  985  984  982  981 1228  980  724  978  977  976  974  973 1220  972  971  970  969  968  967  966  965  964  963  962  961  960  959  958  957  956  955  954  953  952  951  950  949  948  947  946  945  944  943  942  941  940  939  938  937  936  935  934  933  932  931  674  409  136
 210  479  740  739  738  737  736  735  734  733  987  732  730  729  728  727  726  725  723  460  722  721  975  719  718  717  716  715  714  713  712  711  710  709  708  707  706  705  704  703  702  701  700  699  698  697  696  695  694  693  692  691  690  689  688  687  686  685  684  683  682  681  680  679  678  677  676  675  410  137
 209  478  477  476  475  474  473  472  471  470  469  468  467  466  465  464  463  462  461  189  459  458  720  456  455  454  453  452  451  450  449  448  447  446  445  444  443  442  441  440  439  438  437  436  435  434  433  432  431  430  429  428  427  426  425  424  423  422  421  420  419  418  417  416  415  414  413  412  411  138
 208  207  206  205  204  203  202  201  200  199  198  197  196  195  194  193  192  191  190  188  187  186  457  185  184  183  182  181  180  179  178  177  176  175  174  173  172  171  170  169  168  167  166  165  164  163  162  161  160  159  158  157  156  155  154  153  152  151  150  149  148  147  146  145  144  143  142  141  140  139
