# This puzzle is unsolvable
11
 41  72  97  73  99  15  10  74 111  81  90
 44   3  19  45  34  78 114  65  49 101  82
110 115   4   1  48  12  50   7   9  92  11
 76  70  36  51  26  77  37  14  88 109  95
 38  39  93  42  20 105  43 106  18  24  17
 68  23  71  30  64  59  32  46  47  85   5
  2 113 119  60  84  89  40   8  28  16   6
112  91  98  35  58 117  52  83  13 108  57
 61  33  87 104  22 118  62  55  27  25  53
 66  96 100  69  94  80  56  29 102  86  54
 75  31 107  63  67  21 103 120   0  79 116
