# This puzzle is unsolvable
46
   2    1  182    3    4    5  187    7    9   10   11   12   13   14   15  195   16   17   18  200   23  372  202   24   25   26   27   28   29   30   31   32   33   34   35   36   37   38   39   40   41   42   43   44   45   46
 180  352  181  183  185    6  186    8  188  189  190  191  192  193  194  366  196  199  198   20   22  373   19  203  204  205  206  207  208  209  210  211  212  213  214  215  216  217  218  219  220  221  222  223  224   47
 179  353  516  354  184  355  519  358  359  360  361  362  363  364  365  367  686  369  370  533  201  535   21  374  375  376  377  378  379  380  381  382  383  384  385  386  387  388  389  390  391  392  393  394  225   48
 178  351  515  517  518  357  356  676  521  523  524  525  526  969  527  529  530  197  368  532  371  687  536  537  538  539  540  541  542  543  544  545  546  547  548  549  550  551  552  553  554  555  556  395  226   49
 350  175  514  672  673  674  520  675  522  824  679  680  681  830 1225  682  831  832  688  835  534  837  691  692  693  694  695  696  697  698  699  700  701  702  703  704  705  706  707  708  709  710  557  396  227   50
 177  176  349  671  820  821  962  823  678  677  827 1097  683  971  684  528 1223  531 1101 1105  834  976 1106  839  840  841  842  843  844  845  846  847  848  849  850  851  852  853  854  855  856  711  558  397  228   51
 348  513  512  670  819  960  822  961  963  825  826 1334 1096 1099  685  833 1226  972  973  836  690  974  978 1108 1233  979  981  983 1114  984  985  986  987  988  989  990  991  992  993  994  857  712  559  398  229   52
 174  347  669  818  959  958 1092 1093 1094  965  966  967 1098  828  829  968  970 1104 1230  689  838 1553  975 1347 1456  980 1112  982 1113 1115 1116 1117 1118 1119 1120 1121 1122 1123 1124  995  858  713  560  399  230   53
 173  346  511  668  817 1091 1216 1217 1219 1218 1540 1336 1220 1339 1338 1102 1340 1343 1227 1229 1550 1109 1231 1110  977 1348 1111 1352 1236 1237 1238 1240 1241 1242 1243 1244 1245 1246 1125  996  859  714  561  400  231   54
 172  345  510  667  816  957 1090 1215 1332 1333  964 1100 1095 1221 1222 1448 1449 1103 1342 1345 1344 1228 1349 1457 1235 1234 1350 1459 1460 1353 1239 1355 1356 1357 1358 1359 1360 1247 1126  997  860  715  562  401  232   55
 171  344  509  666  814  815 1089 1214 1331 1440 1441 1443 1335 1337 1224 1447 1341 1546 1722 1554 1453 1232 1552 1555 1803 1556 1458 1351 1558 1461 1354 1462 1463 1464 1465 1466 1361 1248 1127  998  861  716  563  402  233   56
 170  508  342  665 1087  956 1088 1330 1632 1439 1539 1633 1444 1446 1445 1719 1545 1549 1450 1107 1725 1551 1455 1637 1724 1730 1646 1557 1732 1559 1560 1561 1562 1563 1564 1467 1362 1249 1128  999  862  717  564  403  234   57
 169  340  343  341  664  955 1086 1213 1538 1437 1438 1442 1543 1792 1547 1638 1863 1548 1640 1452 1802 1867 1346 1641 1727 1645 1805 1649 1807 1650 1651 1652 1653 1654 1565 1468 1363 1250 1129 1000  863  718  565  404  235   58
 660  168  812  507  954  952 1211 1212 1436 1435 1537 1542 1541 1634 1794 1635 1796 1720 1636 1723 1865 1927 1454 1642 1976 1729 1982 1647 1648 1733 1734 1735 1736 1655 1469 1470 1364 1251 1130 1001  864  719  566  405  236   59
 166  809  661  810  953  813 1085 1210 1716 1327 1631 1790 1630 1715 1862 1544 1795 1799 1798 1924 1639 1801 1979 1869 1728 1643 1871 1731 1873 1876 1809 1737 1656 1657 1567 1566 1365 1252 1131 1002  865  720  567  406  237   60
 505  506  504  663  164  659  811 1209 1329 1208 1434 1432 1328 1714 1717 1721 1864 1922 1797 1926 1977 1925 1868 1644 1928 1726 1874 1806 1875 1936 1808 1810 1738 1739 1568 1471 1366 1253 1132 1003  866  721  568  407  238   61
 337  167  658  503  951 1207  804  948 1206 1083 1535 1536 1711 1793 1791 1858 1919 2017 1859 1451 1923 1975 1804 1872 1931 1870 1932 1930 1933 1877 1935 1811 1813 1812 1569 1472 1367 1254 1133 1004  867  722  569  408  239   62
 162  165  339  502  662  950 1082 1084 1323 1529 1627 1789 1626 1628 1860 1861 1921 1918 1974 1972 1800 1866 2022 2021 2057 1929 1980 1984 1934 1937 1878 1880 1659 1570 1571 1473 1368 1255 1134 1005  868  723  570  409  240   63
 161  338  163  336 1205  949  806 1081 1325 1629 1326 1713 1788 1917 1857 1920 1915 1718 2052 2054 2019 1978 2020 2023 1981 2056 2025 1983 2026 1815 1814 1740 1658 1741 1474 1475 1369 1256 1135 1006  869  724  571  410  241   64
 656  805  500  808  947  946  807 1204 1324 1533 1431 1532 1712 1534 1787 1916 2016 1971 1973 2018 2053 2102 2082 2103 2024 2084 2058 1987 1985 1986 1816 1879 1742 1660 1661 1476 1370 1257 1136 1007  870  725  572  411  242   65
 333  159  160  501  657 1202 1080 1531 1321 1625 1624 1710 1785 1786 1968 1969 1855 1970 2013 2051 2055 2104 2083 2107 2085 2086 2059 2062 2028 1938 1881 1743 1662 1663 1573 1572 1371 1258 1137 1008  871  726  573  412  243   66
 496  332  334  499  655 1079 1203 1200 1320 1322 1429 1709 1706 1854 1856 1853 1967 2015 2014 2081 2079 2100 2088 2114 2063 2115 2027 2060 2061 1939 1882 1817 1746 1745 1664 1372 1373 1259 1138 1009  872  727  574  413  244   67
 335  331  498  497  654 1319  942  944 1318 1526 1433 1621 1708 1784 1914 1852 1966 2050 2080 2078 2077 2099 2101 2111 2089 2087 2064 2029 1988 2030 1818 1820 1744 1884 1574 1478 1260 1261 1139 1010  873  728  575  414  245   68
 158  495  653  652  651  803 1078 1072    0 1430 1528 1427 1783 1707 1913 1965 2009 2012 2047 2075 2098 2113 2112 2068 2090 2106 2031 1990 1989 1941 1883 1665 1819 1576 1575 1477 1577 1374 1140 1011  874  729  576  415  246   69
 157  329  494  801 1076 1077  940  945 1428 1623 1781 1425 1622 1620 1704 1848 1851 2011 2076 2046 2097 2109 2110 2000 2105 2093 2066 2032 1940 1942 1885 1747 1748 1667 1480 1479 1375 1262 1141 1012  875  730  577  416  247   70
 156  330  800  943  799  802 1074 1201 1317 1075 1530 1316 1618 1850 1703 1964 1912 2049 1782 2048 2096 2095 2094 2070 2092 2065 2034 2036 1991 1943 1887 1821 1749 1578 1481 1482 1376 1263 1142 1013  876  731  578  417  248   71
 155  328  493  650  941 1199 1315 1073 1197 1426 1525 1617 1705 1702 1909 1963 2045 2007 2043 2069 2008 2042 2071 2037 2039 2091 2035 1944 1992 1994 1822 1886 1750 1668 1666 1483 1377 1264 1143 1014  877  732  579  418  249   72
 154  327  492  648  796 1314  939 1527 1198 1423 1424 1779 1849 1616 1780 1908 2010 1846 2006 2073 2044 2041 1898 2072 2108 2038 2067 2033 1993 1946 1945 1823 1669 1580 1579 1484 1378 1265 1144 1015  878  733  580  419  250   73
 152  153  326  937  649 1071 1313  936  938 1196 1524 1421 1619 1962 1700 1778 1910 1847 1911 2074 1956 1902 2001 1900 1999 1896 1998 1996 1948 1888 1892 1824 1751 1670 1581 1485 1379 1266 1145 1016  879  734  581  420  251   74
 325  491  647  797  798 1069  795 1312 1420 1195 1522 1614 1907 1615 1844 1845 1961 1959 1904 2004 1838 2003 2002 2040 1952 1894 1995 1951 1947 1890 1829 1826 1752 1582 1486 1583 1380 1267 1146 1017  880  735  421  422  252   75
 151  324  489  645 1070  646 1194  935 1310 1521 1422 1419 1701 1906 1775 1960 1773 1839 2005 1840 1955 1901 1899 1897 1895 1997 1949 1893 1680 1891 1825 1889 1753 1671 1672 1487 1381 1268 1147 1018  881  583  582  584  253   76
 150  323  486  490 1191  793  934 1520 1418 1523 1697 1699 1612 1611 1774 1843 1905 1837 1958 1604 1957 1835 1954 1953 1764 1833 1831 1761 1832 1830 1828 1827 1677 1674 1754 1584 1383 1382 1148 1019  882  736  737  254  255   77
 149  322  321  644  933  792 1068 1067 1311 1309 1192 1519 1613 1694 1606 1772 1842 1767 1768 1836 1687 1603 1688 1765 1834 1684 1762 1683 1595 1759 1757 1756 1755 1673 1585 1384 1489 1269 1270 1020  883  585  739  740   80   78
 147  488  643  487  794 1417 1193 1065 1308 1517 1415 1776 1696 1698 1605 1407 1693 1406 1510 1903 1766 1602 1600 1598 1686 1500 1498 1950 1593 1681 1679 1676 1590 1588 1589 1488 1385 1022 1149 1272 1021  425  427  423   81   79
 320  148  485  642  791  932 1066 1189 1190 1416 1610 1607 1609 1695 1509 1512 1777 1770 1690 1507 1601 1689 1763 1504 1685 1597 1682 1396 1760 1758 1496 1678 1591 1675 1586 1490 1491 1271 1151  884  738  741  587  588  426  256
 146  319  484  640  641  790  931 1064 1306 1518 1307 1513 1412 1608 1409 1691 1769 1692 1841 1404 1506 1505 1599 1169 1596 1288 1594 1501 1394 1592 1392 1497 1494 1587 1389 1388 1492 1273 1386 1153  885  257  586  424  259   82
 318  483  789  482  788  930 1063 1187 1188 1515 1516 1411 1514 1511 1297 1298 1178 1771 1508 1296 1403 1402 1401 1170 1502 1399 1397 1285 1284 1503 1281 1395 1493 1279 1280 1158 1391 1274  886 1024 1023  887  742  431  258  260
 145  144  317  929 1061 1060 1062 1186 1185 1413 1301 1302 1182 1180 1410 1408 1295 1405 1294 1293 1292 1291 1400 1290 1398 1165 1286 1039 1283 1499 1161 1162 1035 1159 1277 1387 1275 1154 1152 1150  888 1025  430  589  428   86
 143  142  481  639  638  787  927 1414 1305 1057 1303 1183 1300 1052 1051 1177 1048 1049  913 1174 1173 1172 1171 1289 1043 1041 1167 1168 1164 1282 1393 1034  901 1160 1390 1157 1276 1156 1155  889  746  434  744  590  263  591
 141  316  480  637  786 1059  928 1058 1304 1184  921 1056 1053  917 1299 1179 1175 1176 1047  912 1046 1045 1044  908  905  906 1166  904 1495 1037  903 1036  898 1278 1032 1033 1031 1029 1027 1026  892  743  890  432   85  261
 314  315  479  636  785  926  925  924  923  922  778 1055 1181  920  918  773  916  914  770  769  767  911  909 1042  764 1040  610 1287 1038  902 1163  900  756  896  895  894 1030  751 1028  749  891  592  593   83   84  745
 140  313  478  635  784  783  782  781  780  779  627  777  775 1054  774  463 1050  915  772  771  768  910  766  907  765  762  761  451  760  758  607  899  755  897  754  753  893  752  750  598  597  262  747  429  435  268
 139  312  477  634  633  632  631  630  629  628  626  776  919  625  624  623  621  620  619  618  617  616  615  454  613  612  763  609  759  608  606  757  605  604  603  602  601  600  599  596  748  594   87  433   88  265
 138  311  476  475  474  473  472  471  470  469  468  467  466  465  622  464  462  461  460  459  458  457  456  614  455  611  452  284  450  449  448  447  446  445  444  443  442  441  440  439  438  270  266  269  264   90
 137  310  309  308  307  306  305  304  303  302  301  300  299  298  297  296  295  294  293  292  291  290  289  288  112  453  110  285  283  282  281  280  279  278  277  276  275  274  273  272  271  436  595  267   89   91
 136  135  134  133  132  131  130  129  128  127  126  125  124  123  122  121  120  119  118  117  116  115  114  113  286  287  111  109  108  107  106  105  104  103  102  101  100   99   98   97   96   95  437   94   93   92
