# This puzzle is unsolvable
11
 40  96  41  73  67   7  91 119  83  33  11
 35  43  90  46  39  81   4  12  78 101  14
 71  97   1  92  76  50  52  59  74  10  84
  3 111  65  45  77  75  48 110  61  54  68
 25  57  87  38  72  44  88 113  26  16 115
108  93  98   0  47  17  22   8 116   9  18
 63  56 117  27  51  89 118  58  79   6  42
 95  32  60 120 105   2 104  99 102 103  55
 49 114  64  28  36  94 112  66  15  80  82
 31 107  29  13  34  69  20   5 106 100  23
 85  30  70  21 109  19  53  86  62  37  24
