# This puzzle is unsolvable
9
69 72  8 68 54 38 59  7 32
58 57 45 39 50 19 13 10  4
 1 21 61 29 28 20 76 15 47
48 41 12 37 33 73 65  0 60
80 22 66  9 36 44 14 34 49
31 55 23 35 79  3 70 51 78
 5 56 64 30  6 67 53 71 16
43 42 52 63 24 11 74 18 17
26 77  2 75 27 46 62 25 40
