# This puzzle is unsolvable
10
 66  20   7  77  53  56  42   4   8  90
 62  73  92  37   3  83  14   6  51  36
 16  38  80  10  97  84  47  48  91  21
 98  64  79  59   2  74  76  71  60  43
 31  72  81  68  45   1  40  39  11  94
 57  27  28  82   5  75  35  88  52  23
 95   0  25  86  12  78  69  70  15   9
 46  99  29  32  44  58  61  18  50  34
 22  30  26  87  55  19  33  67  89  13
 85  63  96  65  93  41  54  49  24  17
