# This puzzle is unsolvable
35
   2    1    3    4    5    6    7    8    9   10   11   12   13   14   15   16   17   18   19   20  156   21   23   24   25   26   27   28   29   30   31   32   33   34   35
 136  137  138  139  140  141  142  143  144  145  146  147  148  149  150  151  279  152  153  154   22  157  158  159  160  161  162  163  164  165  166  167  168  169   36
 135  264  265  266  267  268  269  270  271  272  273  274  275  276  277  278  398  280  282  155  402  284  285  286  287  288  289  290  291  292  293  294  295  170   37
 134  263  384  385  386  387  388  389  390  391  392  393  394  395  396  397  509  399  281  513  401  283  514  404  406  407  408  409  410  411  412  413  296  171   38
 133  262  383  496  497  498  499  500  501  502  503  504  505  506  507  508  510  613  511  400  403  619  516  405  517  621  518  519  520  521  414  524  297  172   39
 132  261  382  495  600  601  602  603  604  605  606  607  608  609  610  611  612  614  709  616  512  618  515  620  713  806  717  718  624  623  522  523  298  173   40
 131  260  381  494  599  696  697  698  699  700  701  702  703  704  705  706  707  708  710  615  711  617  800  714  802  622  716  721  626  625  525  415  300  299  174
 130  259  380  493  598  695  784  785  786  787  788  789  790  791  792  793  794  795  796  797  799  712  715  801  881  883  803  719  627  526  417  176  175   43   41
 129  258  379  492  597  694  783  864  865  866  867  868  869  870  871  872  873  875  876  798  877  878  879  951  880  720  885  804  722  629  419  416  301  178   42
 128  257  378  491  596  693  782  863  936  937  938  939  940  941  942  943  944  874  945  948 1011  949 1013  950  952  882  808  805  724  807  420  418  302  530   44
 127  256  377  490  595  781  862  935 1000 1001 1056 1002 1003 1059 1004 1005 1007 1008 1150 1010  947 1012 1068 1014 1015  953  887  628  529  421  527  177  304  303   45
 126  254  255  489  594  692  779  780  860  861  999 1058 1104 1145 1060 1006 1063 1108  946 1066 1153 1184 1067 1069 1017 1016  884  723  886  811  633  531  305  179   47
 125  253  376  375  488  593  691  690  933  934 1055 1057 1146 1106 1061 1107 1149 1064 1148 1009 1065 1154 1152 1115 1018  954  809  528  532  630  631  423  181   46  180
 124  252  487  592  486  689  778  859  932  998  997 1103 1105 1143 1176 1201 1147 1110 1113 1204 1111 1114 1116 1070 1071  955  957  956  725  632  533  422  306  182   48
 251  371  591  373  483  687  688  858  931 1053 1054  995 1098 1144 1174 1177 1216 1178 1112 1109 1183 1182 1072 1155 1074  812  810  813  888  634  534  307   49   50   51
 123  119  590  485  374  777  776  686  857  996  930 1142 1102 1175 1224 1062 1203 1180 1205 1181 1151 1187 1117 1073 1019  958  890  726  727  728  425  424  308  310  183
 122  250  484  482  683  685  585  775  927  928  994 1051 1052 1141 1200 1202 1179 1217 1219 1119 1186 1118 1022 1075  894  818  960  891  814  635  535  426  184   52  185
 247  368  682  249  588  369  856  854 1048  929  993 1100 1139 1140 1199 1213 1223 1220 1207 1185 1221 1023 1158  961 1020  965  889  815  729  730  637  536  309  311  427
 372  367  246  479  120  587  992  684 1099 1050 1046 1101 1173 1215 1198 1218 1197 1192 1212 1210 1206 1157 1021 1120  819 1078  733  731  817  636  639  537  312  187   54
 121  244  117  681  924  589  774  925  926 1138 1171 1049 1195 1214 1166 1165 1170 1222 1190 1208 1079 1156 1209  541 1024  893  892  816  732  540  638  538  430   55   56
 477  116  481  248  370  991  988  773  771  584 1045 1097 1193 1137 1136 1132 1167 1191 1189 1129 1121 1128 1124  963  964  962  959  897  824  734  189  429  316  318  186
 114  853  586  852  581  582  770  768  990  986 1094 1169 1096 1168 1196 1163 1211 1130 1164 1188 1161  974  973 1083 1026  737 1076  736  641  539  313   57  822   53  188
 113  769  118  855  245  849  851  984  923 1047 1043 1092 1091 1039 1172 1131 1133 1088 1086 1122 1077 1033 1159  904  970 1126 1025  898  642  821  544  314   60  315   58
 365  679  242  850  772  366  919  921 1093  846  920 1041 1040 1090 1134 1038 1089 1194 1087 1162  831 1127  896 1029  900  966  820  735  739  645  640  428  431  317  193
 115  583  478  848  847  480  766  922 1042  989  678 1095  982  987  981  980  979  909 1036 1084 1123  908 1125 1160 1080  895  823 1028  545  432  543  435  542  643  191
 110  472  237  680  676  767  577 1135  476  917 1044  840  916  913  914  977 1037  910 1035  975  967 1031 1085  969 1081    0  903  902  901  434  644  190  192   59   61
 364  112  358  360  578  677  362  845  764  843  842  983  760  841  838  912  978  560  907  976  906 1034 1032 1030  899  744 1027  825  738  741  319  436  194  321  433
 243  109  240  363  361  475  580  918  572  348  985  568  915  836  755  753  911  835  562  837  748  749  829  971  743  826  546  552  647  649  437  196  198  442  195
 241  239  111  474  357  675  576  670  765  761  844  758  757  839  754  756  752  834  657  558  833  832  828  827  968 1082  742  650  651  740  439  438  322  320   63
 473  106  107  763  672  238  762  674  579  759  669  565  665  459  217  662  456  457  336  750  830  751  555  905  654  745  648  208  550  551  440  325  323   65   62
 236  471  574  108  673  351  359  571  464  350  664  569  566  460  567  663  458  340  455  563  450  659  972  747  746  653  445  205  646  328  547  548  200   66   64
 235  470  356  354  467  230  573  671  349  463  667  570  668  666  564  561  219  658  339  337  452  660   82  655  554  444  209  447  331  329  441   71  197  201   67
 105  234  355  468  575  469  353  466  226  465  462  346  221  342  343  453   88  454  214  451  661  557  656  556  332  333  448  652  206  446  443   75  204  326   69
 104  233  232  231   99   98  228  227  225  347  222  220   93  345   90  218   87  341  216  338  559   83  213  335  449  553   78  210  330  199   76   73  549  324   68
 103  102  101  352  100   97  229   96   95   94  224  223  461  344   92   91   89   86   85  215   84  212   81   80  334   79   77  207  211   74  327  203  202   72   70
