# This puzzle is unsolvable
8
53 47 10 34 48 20  8 38
13 18 24 42  6 46 35 32
23 15 36 16 50 43 52 49
 2 21 40 60 51 28 61 59
29 19 25  7 45 17 41 63
 3  9 62 30  0 26 22  4
 5  1 27 54 14 56 33 55
44 39 31 58 57 11 12 37
