# This puzzle is unsolvable
15
103   1 106  61 104 218   7 180 148  10  11  69  13  67  14
  2  57  56  55   4  62 146 111  18  12 112 109   9  15  19
141  98 144   3  60 102 179 154 224  65  66 153 117 152  73
 58  63 181 145   6 223 150 200 182 209 155  72 178  68 151
175  59 105 176 177 107 194 147 159  16  71 184 114 183 156
 54 173  52 142 202   8 108 219 116  23  70  17 205 199  20
138 139 171 143 207 100  99 110   5 120 222  79 125 113  75
 53 133  51 101 198 221 165 210 185 158  90  64 118 163 208
174 137  50 195 140 172  88 168 131 204 186 115  21 166 187
217 206  86 201 214 220 215 213 157 134  81 216  27 149  78
170 197 136  87  37  97 196 121 212 129 203  77 189  32 161
 49  36  95  47 132 128  42  91  24 190 122  31 160  25 127
 92  41  93  94 193 191  40 188  26  30 126 164  84  74 119
135  44  48  45  89  96  39 192  38   0  28  29  80  35 124
 43 169 130  46 211 162  34 167  33  76  82  83  85 123  22
