# This puzzle is unsolvable
64
   4    1  254  253    5    9    8  257   12   11   14  266   16  745 1396  268  265   20  270   17  271   19   21  752  277  276  278   28   29   30   31   32   33   34   35   36   37   38   39   40   41   42   43   44   45   46   47   48   49   50   51   52   53   54   55   56   57   58   59   60   61   62   63   64
 252    2  255  256  960    7 1394  261  258  260  262  263  508   15  507  513  974 1403  274  976  514  980  273  517   23   27  522  280  524  282  281  283  284  285  286  287  288  289  290  291  292  293  294  295  296  297  298  299  300  301  302  303  304  305  306  307  308  309  310  311  312  313  314   65
 495  251  498    3  501 1183  259  965    6  503  502  506  264  743  971  511  510 1407 1191 1197   24  747 1408   25  520  755  518  523  526  760  525  527  528  763  529  530  531  532  533  534  535  536  537  538  539  540  541  542  543  544  545  546  547  548  549  550  551  552  553  554  555  556  315   66
 250  497 1178  499  735  734  504  739   10  966  968 1187   13  969 1194  267  269  973   18  749  751  519  515  983   26  754  279  757  982  756  758  761  762  990  764  765  766  767  768  769  770  771  772  773  774  775  776  777  778  779  780  781  782  783  784  785  786  787  788  789  790  557  316   67
 493  248  732  959  962  961  500 1186 1182 1188 1797 1395  744  970  972 1798  742 1604  748  512  272 1410   22  979  275  521  981 1413  985  759  987  988 1208  989  991  992  993  994  995  996  997  998  999 1000 1001 1002 1003 1004 1005 1006 1007 1008 1009 1010 1011 1012 1013 1014 1015 1016  791  558  317   68
 729  731 1791  958 1180  956  736 1184 1597 1401 1181  505 1185  509 1603 1190  746 1989 1609 1404  516  975 1195 1198 1199 1201  984 1415 1202 1617 1414 1418 1207 1209 1210 1211 1212 1213 1214 1215 1216 1217 1218 1219 1220 1221 1222 1223 1224 1225 1226 1227 1228 1229 1230 1231 1232 1233 1234 1017  792  559  318   69
 733  490 1391  496  730 1393  740 1981  741  728  737 1982 1397 1189 1400 1402 1606 1192 1607 1405  977 1992  750 1412 1409 1810 1203 1815 1206  986 1621 1816 1419 1420 1421 1422 1423 1424 1425 1426 1427 1428 1429 1430 1431 1432 1433 1434 1435 1436 1437 1438 1439 1440 1441 1442 1443 1444 1235 1018  793  560  319   70
 247  489  494  491  963 1174 1179 1177 1792 1398 1790  967 1399 1799 1605 1800 1988 2165 1193 1614 1610 2173 1411 1611 1200  753 1616 1998 1205 1416 1619 1417 1622 1623 1624 1625 1626 1627 1628 1629 1630 1631 1632 1633 1634 1635 1636 1637 1638 1639 1640 1641 1642 1643 1644 1645 1646 1445 1236 1019  794  561  320   71
 249  721  246  725 1390 1600  964 2332 1596  738 1601 1985 2164 1980 1987 1802 1608 2170 1806 1990 1993 1803  978 1613 1994 1996 1204 1813 1615 1618 2001 1620 2003 2005 1819 1820 1821 1822 1823 1824 1825 1826 1827 1828 1829 1830 1831 1832 1833 1834 1835 1836 1837 1838 1839 1840 1647 1446 1237 1020  795  562  321   72
 727  243  957 1595 1392 1979 1599 1593 1598 2496 1793 1794 2161 2162 1602 1796 2340 1406 1801 2506 1196 1805 1809 1612 2176 1811 1812 2178 1814 2515 2000 2002 1817 1818 2006 2007 2008 2009 2010 2011 2012 2013 2014 2015 2016 2017 2018 2019 2020 2021 2022 2023 2024 2025 2026 1841 1648 1447 1238 1021  796  563  322   73
 726  245 1388  492  954  724 1591 1594 1977 1978 1983 2334 1984 2336 1804 2339 2167 2169 2502 2341 1991 2175 1808 2348 1997 1999 2349 2346 2179 2668 2513 2184 2355 2004 2185 2186 2187 2188 2189 2190 2191 2192 2193 2194 2195 2196 2197 2198 2199 2200 2201 2202 2203 2204 2027 1842 1649 1448 1239 1022  797  564  323   74
 486  244  488  953 2497 1592 1789 1384 1787 1974 1788 2498 1976 2168 2654 2500 2166 2499 2656 2505 2171 2172 2345 1807 2174 2347 2177 2511 2350 2353 2182 2181 2183 2354 2519 2357 2358 2359 2360 2361 2362 2363 2364 2365 2366 2367 2368 2369 2370 2371 2372 2373 2374 2205 2028 1843 1650 1449 1240 1023  798  565  324   75
 485  955  483  950 1175 1176 1387 1975 2157 2159 1389 2330 2495 2800 2653 2338 2337 2657 1986 2659 2344 2507 2343 2510 2514 2665 2669 2512 2667 2352 2670 2516 2672 2356 2518 2520 2521 2522 2523 2524 2525 2526 2527 2528 2529 2530 2531 2532 2533 2534 2535 2536 2375 2206 2029 1844 1651 1450 1241 1024  799  566  325   76
 241  487 1173  237  952  951 1588 1386 1590 2331 2160 2652 2493 2494 2335 2501 1795 2945 2342 2806 2658 2660 2508 1995 2663 2509 2666 2180 2814 2351 2816 2671 2673 2819 2674 2675 2822 2677 2678 2679 2680 2681 2682 2683 2684 2685 2686 2687 2688 2689 2690 2537 2376 2207 2030 1845 1652 1451 1242 1025  800  567  326   77
1172  482  723 1166  239 1382 1170 1785 2158 1784 2651 2649 2650 2333 2163 2940 2655 2803 2503 2504 2946 2661 2662 2810 2664 2951 2812 2813 2815 2954 2817 2818 2958 2517 2820 2961 2676 2824 2825 2826 2827 2828 2829 2830 2831 2832 2833 2834 2835 2836 2691 2538 2377 2208 2031 1846 1653 1452 1243 1026  801  568  327   78
 718  720  481  240 1171 1385 1589 1786 2329 2156 1973 2327 2328 2802 2801 3194 2804 3075 2805 3077 3078 2808 2809 2949 2811 2950 2952 2953 2955 3086 2956 2957 2960 3089 2959 2821 2962 2963 2964 2965 2966 2967 2968 2969 2970 2971 2972 2973 2974 2837 2692 2539 2378 2209 2032 1847 1654 1453 1244 1027  802  569  328   79
 722  242 1583 1585  719 1167  948 1169 1587 2154 1782 2152 2798 2799 2942 3072 3418 3195 3198 2807 3200 2947 2948 3080 3081 3082 3083 3084 3085 3209 3087 3211 3088 3090 2823 3092 3093 3217 3094 3096 3097 3098 3099 3100 3101 3102 3103 3104 2975 2838 2693 2540 2379 2210 2033 1848 1655 1454 1245 1028  803  570  329   80
 484  949  479  944 1163 1379 1383 1584 1970 2155 2151 2648 1380 2326 2941 2943 2944 3073 3196 3076 3197 3201 3079 3203 3204 3205 3206 3322 3207 3208 3210 3326 3212 3213 3091 3329 3215 3332 3095 3219 3220 3221 3222 3223 3224 3225 3226 3105 2976 2839 2694 2541 2380 2211 2034 1849 1656 1455 1246 1029  804  571  330   81
 234  238  236 1168  947 1162 1165 1968 1586 2488 2153 2647 2492 2796 3071 2797 3070 3193 3312 3074 3199 3314 3316 3318 3319 3320 3321 3429 3323 3324 3325 3433 3327 3328 3330 3214 3216 3331 3218 3333 3335 3336 3337 3338 3339 3340 3227 3106 2977 2840 2695 2542 2381 2212 2035 1850 1657 1456 1247 1030  805  572  331   82
 480  233  478  477  714 1381 1781 1783 1972 2324 2325 2489 2491 2939 3066 2938 2795 3420 3313 3421 3315 3317 3202 3423 3426 3427 3618 3428 3430 3530 3431 3432 3434 3435 3436 3437 3438 3439 3440 3334 3442 3443 3444 3445 3446 3341 3228 3107 2978 2841 2696 2543 2382 2213 2036 1851 1658 1457 1248 1031  806  573  332   83
 716  945  946 1377  943 1378 1778 1969 2149 1779 2644 1971 2645 2937 3310 2936 3417 3309 3419 3520 3521 3422 3424 3425 3523 3526 3701 3527 3529 3620 3531 3532 3533 3534 3535 3537 3538 3629 3540 3441 3541 3542 3543 3544 3447 3342 3229 3108 2979 2842 2697 2544 2383 2214 2037 1852 1659 1458 1249 1032  807  574  333   84
 235  717  232  715 1161 1164 1966 1967 2323 2150 2794 2490 2646 2934 3069 3067 3068 3311 3308 3519 3613 3522 3614 3524 3525 3615 3616 3528 3621 3704 3622 3623 3624 3625 3626 3536 3628 3630 3539 3631 3632 3633 3634 3545 3448 3343 3230 3109 2980 2843 2698 2545 2384 2215 2038 1853 1660 1459 1250 1033  808  575  334   85
 231  476  942 1581 1776 1160 2147 2148 1965 2322 2487 2486 2935 2793 2643 3191 3307 3064 3518 3611 3610 3696 3772 3698 3699 3617 3700 3619 3703    0 3705 3706 3707 3708 3709 3627 3711 3712 3713 3714 3715 3716 3635 3546 3449 3344 3231 3110 2981 2844 2699 2546 2385 2216 2039 1854 1661 1460 1251 1034  809  576  335   86
 474  229  713  712 1580 1577 1777 1780 2320 2321 2792 2485 2642 2791 2933 3306 2930 3416 3415 3612 3516 3697 3695 3773 3774 3775 3845 3777 3778 3779 3780 3781 3782 3783 3784 3710 3786 3787 3788 3789 3790 3717 3636 3547 3450 3345 3232 3111 2982 2845 2700 2547 2386 2217 2040 1855 1662 1461 1252 1035  810  577  336   87
 230  473  475  941  940 1374 1578 1582 1579 2146 2319 2484 2641 2790 3063 3190 2931 3414 3517 3515 3609 3694 3771 3840 3842 3843 3702 3776 3846 3906 3848 3907 3849 3851 3852 3785 3853 3854 3855 3856 3791 3718 3637 3548 3451 3346 3233 3112 2983 2846 2701 2548 2387 2218 2041 1856 1663 1462 1253 1036  811  578  337   88
 227  709  711 1375  938 1376 1775 1964 1963 2145 2318 2483 2640 2929 2788 3187 3186 3192 3188 3514 3608 3693 3770 3901 3841 3952 3902 3844 3903 3904 3847 3908 3909 3850 3910 3911 3912 3913 3914 3857 3792 3719 3638 3549 3452 3347 3234 3113 2984 2847 2702 2549 2388 2219 2042 1857 1664 1463 1254 1037  812  579  338   89
 471  228  939  710 1373 1372 1576 1371 1772 2144 2317 2482 2639 2789 3189 2932 3185 3305 3304 3413 3607 3692 3769 3900 3839 3899 3953 3954 3955 3905 3957 3958 3959 3960 3961 3962 3963 3964 3915 3858 3793 3720 3639 3550 3453 3348 3235 3114 2985 2848 2703 2550 2389 2220 2043 1858 1665 1464 1255 1038  813  580  339   90
 472  226  707  708 1158 1370 1962 1773 1774 2316 2315 2481 2787 3060 3062 3065 3303 3412 3513 3512 3606 3691 3768 3838 3898 3951 3996 3997 3998 3956 4000 4001 4002 4003 4004 4005 4006 3965 3916 3859 3794 3721 3640 3551 3454 3349 3236 3115 2986 2849 2704 2551 2390 2221 2044 1859 1666 1465 1256 1039  814  581  340   91
 225  470 1159  937 1157 1771 1575 2142 2141 2143 2480 2637 2638 2786 3061 2928 3302 3301 3411 3605 3604 3689 3690 3837 3897 3950 3995 4032 4033 3999 4034 4036 4037 4038 4039 4040 4007 3966 3917 3860 3795 3722 3641 3552 3455 3350 3237 3116 2987 2850 2705 2552 2391 2222 2045 1860 1667 1466 1257 1040  815  582  341   92
 224  469  706  936 1156 1369 1574 1961 1770 2140 2314 2479 2636 2785 2926 2927 3058 3410 3409 3510 3511 3767 3766 3836 3896 3949 3994 4031 4060 4061 4035 4081 4064 4065 4066 4041 4008 3967 3918 3861 3796 3723 3642 3553 3456 3351 3238 3117 2988 2851 2706 2553 2392 2223 2046 1861 1668 1467 1258 1041  816  583  342   93
 223  468  705  935 1155 1368 1573 1959 2139 1960 2313 2478 2635 2784 2925 3184 3059 3300 3299 3408 3688 3765 3834 3835 3895 3948 3993 4030 4059 4080 4063 4062 4082 4094 4067 4042 4009 3968 3919 3862 3797 3724 3643 3554 3457 3352 3239 3118 2989 2852 2707 2554 2393 2224 2047 1862 1669 1468 1259 1042  817  584  343   94
 222  467  704  934 1154 1367 1572 1769 2138 2312 2311 2477 2634 2783 2924 3182 3183 3298 3509 3508 3603 3687 3764 3833 3894 3947 3992 4029 4058 4079 4092 4093 4084 4083 4068 4043 4010 3969 3920 3863 3798 3725 3644 3555 3458 3353 3240 3119 2990 2853 2708 2555 2394 2225 2048 1863 1670 1469 1260 1043  818  585  344   95
 221  466  703  933 1153 1366 1571 1768 1958 1957 2310 2476 2633 2782 2923 3057 3056 3181 3406 3407 3602 3686 3763 3832 3893 3946 3991 4028 4057 4078 4091 4095 4086 4085 4087 4044 4011 3970 3921 3864 3799 3726 3645 3556 3459 3354 3241 3120 2991 2854 2709 2556 2395 2226 2049 1864 1671 1470 1261 1044  819  586  345   96
 220  465  702  932 1152 1365 1570 1767 1955 1956 2137 2475 2632 2781 2922 3055 3180 3297 3507 3600 3601 3685 3762 3831 3892 3945 3990 4027 4056 4077 4090 4089 4088 4071 4069 4045 4012 3971 3922 3865 3800 3727 3646 3557 3460 3355 3242 3121 2992 2855 2710 2557 2396 2227 2050 1865 1672 1471 1262 1045  820  587  346   97
 219  464  701  931  930 1151 1364 1569 1766 2136 2309 2474 2631 2780 2921 3054 3179 3296 3405 3506 3599 3684 3761 3830 3891 3944 3989 4026 4055 4076 4075 4074 4073 4070 4048 4046 4013 3972 3923 3866 3801 3728 3647 3558 3461 3356 3243 3122 2993 2856 2711 2558 2397 2228 2051 1866 1673 1472 1263 1046  821  588  347   98
 218  463  700  929 1150 1363 1568 1765 1954 2135 2308 2473 2630 2779 2920 3053 3178 3295 3404 3505 3598 3683 3760 3829 3890 3943 3988 4025 4054 4053 4052 4050 4049 4072 4017 4047 4014 3973 3924 3867 3802 3729 3648 3559 3462 3357 3244 3123 2994 2857 2712 2559 2398 2229 2052 1867 1674 1473 1264 1047  822  589  348   99
 217  462  699  928 1149 1362 1567 1764 1953 2134 2307 2472 2629 2778 2919 3052 3177 3294 3403 3504 3597 3682 3759 3828 3889 3942 3987 4024 4023 4022 4021 4051 4020 4019 3978 4016 4015 3974 3925 3868 3803 3730 3649 3560 3463 3358 3245 3124 2995 2858 2713 2560 2399 2230 2053 1868 1675 1474 1265 1048  823  590  349  100
 216  461  698  927 1148 1361 1566 1763 1952 2133 2306 2471 2628 2777 2918 3051 3176 3293 3402 3503 3596 3681 3758 3827 3888 3941 3986 3985 3984 3983 3982 3981 3980 4018 3979 3977 3976 3975 3926 3869 3804 3731 3650 3561 3464 3359 3246 3125 2996 2859 2714 2561 2400 2231 2054 1869 1676 1475 1266 1049  824  591  350  101
 215  460  697  926 1147 1360 1565 1762 1951 2132 2305 2470 2627 2776 2917 3050 3175 3292 3401 3502 3595 3680 3757 3826 3887 3940 3939 3938 3937 3936 3935 3934 3933 3932 3931 3930 3929 3928 3927 3870 3805 3732 3651 3562 3465 3360 3247 3126 2997 2860 2715 2562 2401 2232 2055 1870 1677 1476 1267 1050  825  592  351  102
 214  459  696  925 1146 1359 1564 1761 1950 2131 2304 2469 2626 2775 2916 3049 3174 3291 3400 3501 3594 3679 3756 3825 3886 3885 3884 3883 3882 3881 3880 3879 3878 3877 3876 3875 3874 3873 3872 3871 3806 3733 3652 3563 3466 3361 3248 3127 2998 2861 2716 2563 2402 2233 2056 1871 1678 1477 1268 1051  826  593  352  103
 213  458  695  924 1145 1358 1563 1760 1949 2130 2303 2468 2625 2774 2915 3048 3173 3290 3399 3500 3593 3678 3755 3824 3823 3822 3821 3820 3819 3818 3817 3816 3815 3814 3813 3812 3811 3810 3809 3808 3807 3734 3653 3564 3467 3362 3249 3128 2999 2862 2717 2564 2403 2234 2057 1872 1679 1478 1269 1052  827  594  353  104
 212  457  694  923 1144 1357 1562 1759 1948 2129 2302 2467 2624 2773 2914 3047 3172 3289 3398 3499 3592 3677 3754 3753 3752 3751 3750 3749 3748 3747 3746 3745 3744 3743 3742 3741 3740 3739 3738 3737 3736 3735 3654 3565 3468 3363 3250 3129 3000 2863 2718 2565 2404 2235 2058 1873 1680 1479 1270 1053  828  595  354  105
 211  456  693  922 1143 1356 1561 1758 1947 2128 2301 2466 2623 2772 2913 3046 3171 3288 3397 3498 3591 3676 3675 3674 3673 3672 3671 3670 3669 3668 3667 3666 3665 3664 3663 3662 3661 3660 3659 3658 3657 3656 3655 3566 3469 3364 3251 3130 3001 2864 2719 2566 2405 2236 2059 1874 1681 1480 1271 1054  829  596  355  106
 210  455  692  921 1142 1355 1560 1757 1946 2127 2300 2465 2622 2771 2912 3045 3170 3287 3396 3497 3590 3589 3588 3587 3586 3585 3584 3583 3582 3581 3580 3579 3578 3577 3576 3575 3574 3573 3572 3571 3570 3569 3568 3567 3470 3365 3252 3131 3002 2865 2720 2567 2406 2237 2060 1875 1682 1481 1272 1055  830  597  356  107
 209  454  691  920 1141 1354 1559 1756 1945 2126 2299 2464 2621 2770 2911 3044 3169 3286 3395 3496 3495 3494 3493 3492 3491 3490 3489 3488 3487 3486 3485 3484 3483 3482 3481 3480 3479 3478 3477 3476 3475 3474 3473 3472 3471 3366 3253 3132 3003 2866 2721 2568 2407 2238 2061 1876 1683 1482 1273 1056  831  598  357  108
 208  453  690  919 1140 1353 1558 1755 1944 2125 2298 2463 2620 2769 2910 3043 3168 3285 3394 3393 3392 3391 3390 3389 3388 3387 3386 3385 3384 3383 3382 3381 3380 3379 3378 3377 3376 3375 3374 3373 3372 3371 3370 3369 3368 3367 3254 3133 3004 2867 2722 2569 2408 2239 2062 1877 1684 1483 1274 1057  832  599  358  109
 207  452  689  918 1139 1352 1557 1754 1943 2124 2297 2462 2619 2768 2909 3042 3167 3284 3283 3282 3281 3280 3279 3278 3277 3276 3275 3274 3273 3272 3271 3270 3269 3268 3267 3266 3265 3264 3263 3262 3261 3260 3259 3258 3257 3256 3255 3134 3005 2868 2723 2570 2409 2240 2063 1878 1685 1484 1275 1058  833  600  359  110
 206  451  688  917 1138 1351 1556 1753 1942 2123 2296 2461 2618 2767 2908 3041 3166 3165 3164 3163 3162 3161 3160 3159 3158 3157 3156 3155 3154 3153 3152 3151 3150 3149 3148 3147 3146 3145 3144 3143 3142 3141 3140 3139 3138 3137 3136 3135 3006 2869 2724 2571 2410 2241 2064 1879 1686 1485 1276 1059  834  601  360  111
 205  450  687  916 1137 1350 1555 1752 1941 2122 2295 2460 2617 2766 2907 3040 3039 3038 3037 3036 3035 3034 3033 3032 3031 3030 3029 3028 3027 3026 3025 3024 3023 3022 3021 3020 3019 3018 3017 3016 3015 3014 3013 3012 3011 3010 3009 3008 3007 2870 2725 2572 2411 2242 2065 1880 1687 1486 1277 1060  835  602  361  112
 204  449  686  915 1136 1349 1554 1751 1940 2121 2294 2459 2616 2765 2906 2905 2904 2903 2902 2901 2900 2899 2898 2897 2896 2895 2894 2893 2892 2891 2890 2889 2888 2887 2886 2885 2884 2883 2882 2881 2880 2879 2878 2877 2876 2875 2874 2873 2872 2871 2726 2573 2412 2243 2066 1881 1688 1487 1278 1061  836  603  362  113
 203  448  685  914 1135 1348 1553 1750 1939 2120 2293 2458 2615 2764 2763 2762 2761 2760 2759 2758 2757 2756 2755 2754 2753 2752 2751 2750 2749 2748 2747 2746 2745 2744 2743 2742 2741 2740 2739 2738 2737 2736 2735 2734 2733 2732 2731 2730 2729 2728 2727 2574 2413 2244 2067 1882 1689 1488 1279 1062  837  604  363  114
 202  447  684  913 1134 1347 1552 1749 1938 2119 2292 2457 2614 2613 2612 2611 2610 2609 2608 2607 2606 2605 2604 2603 2602 2601 2600 2599 2598 2597 2596 2595 2594 2593 2592 2591 2590 2589 2588 2587 2586 2585 2584 2583 2582 2581 2580 2579 2578 2577 2576 2575 2414 2245 2068 1883 1690 1489 1280 1063  838  605  364  115
 201  446  683  912 1133 1346 1551 1748 1937 2118 2291 2456 2455 2454 2453 2452 2451 2450 2449 2448 2447 2446 2445 2444 2443 2442 2441 2440 2439 2438 2437 2436 2435 2434 2433 2432 2431 2430 2429 2428 2427 2426 2425 2424 2423 2422 2421 2420 2419 2418 2417 2416 2415 2246 2069 1884 1691 1490 1281 1064  839  606  365  116
 200  445  682  911 1132 1345 1550 1747 1936 2117 2290 2289 2288 2287 2286 2285 2284 2283 2282 2281 2280 2279 2278 2277 2276 2275 2274 2273 2272 2271 2270 2269 2268 2267 2266 2265 2264 2263 2262 2261 2260 2259 2258 2257 2256 2255 2254 2253 2252 2251 2250 2249 2248 2247 2070 1885 1692 1491 1282 1065  840  607  366  117
 199  444  681  910 1131 1344 1549 1746 1935 2116 2115 2114 2113 2112 2111 2110 2109 2108 2107 2106 2105 2104 2103 2102 2101 2100 2099 2098 2097 2096 2095 2094 2093 2092 2091 2090 2089 2088 2087 2086 2085 2084 2083 2082 2081 2080 2079 2078 2077 2076 2075 2074 2073 2072 2071 1886 1693 1492 1283 1066  841  608  367  118
 198  443  680  909 1130 1343 1548 1745 1934 1933 1932 1931 1930 1929 1928 1927 1926 1925 1924 1923 1922 1921 1920 1919 1918 1917 1916 1915 1914 1913 1912 1911 1910 1909 1908 1907 1906 1905 1904 1903 1902 1901 1900 1899 1898 1897 1896 1895 1894 1893 1892 1891 1890 1889 1888 1887 1694 1493 1284 1067  842  609  368  119
 197  442  679  908 1129 1342 1547 1744 1743 1742 1741 1740 1739 1738 1737 1736 1735 1734 1733 1732 1731 1730 1729 1728 1727 1726 1725 1724 1723 1722 1721 1720 1719 1718 1717 1716 1715 1714 1713 1712 1711 1710 1709 1708 1707 1706 1705 1704 1703 1702 1701 1700 1699 1698 1697 1696 1695 1494 1285 1068  843  610  369  120
 196  441  678  907 1128 1341 1546 1545 1544 1543 1542 1541 1540 1539 1538 1537 1536 1535 1534 1533 1532 1531 1530 1529 1528 1527 1526 1525 1524 1523 1522 1521 1520 1519 1518 1517 1516 1515 1514 1513 1512 1511 1510 1509 1508 1507 1506 1505 1504 1503 1502 1501 1500 1499 1498 1497 1496 1495 1286 1069  844  611  370  121
 195  440  677  906 1127 1340 1339 1338 1337 1336 1335 1334 1333 1332 1331 1330 1329 1328 1327 1326 1325 1324 1323 1322 1321 1320 1319 1318 1317 1316 1315 1314 1313 1312 1311 1310 1309 1308 1307 1306 1305 1304 1303 1302 1301 1300 1299 1298 1297 1296 1295 1294 1293 1292 1291 1290 1289 1288 1287 1070  845  612  371  122
 194  439  676  905 1126 1125 1124 1123 1122 1121 1120 1119 1118 1117 1116 1115 1114 1113 1112 1111 1110 1109 1108 1107 1106 1105 1104 1103 1102 1101 1100 1099 1098 1097 1096 1095 1094 1093 1092 1091 1090 1089 1088 1087 1086 1085 1084 1083 1082 1081 1080 1079 1078 1077 1076 1075 1074 1073 1072 1071  846  613  372  123
 193  438  675  904  903  902  901  900  899  898  897  896  895  894  893  892  891  890  889  888  887  886  885  884  883  882  881  880  879  878  877  876  875  874  873  872  871  870  869  868  867  866  865  864  863  862  861  860  859  858  857  856  855  854  853  852  851  850  849  848  847  614  373  124
 192  437  674  673  672  671  670  669  668  667  666  665  664  663  662  661  660  659  658  657  656  655  654  653  652  651  650  649  648  647  646  645  644  643  642  641  640  639  638  637  636  635  634  633  632  631  630  629  628  627  626  625  624  623  622  621  620  619  618  617  616  615  374  125
 191  436  435  434  433  432  431  430  429  428  427  426  425  424  423  422  421  420  419  418  417  416  415  414  413  412  411  410  409  408  407  406  405  404  403  402  401  400  399  398  397  396  395  394  393  392  391  390  389  388  387  386  385  384  383  382  381  380  379  378  377  376  375  126
 190  189  188  187  186  185  184  183  182  181  180  179  178  177  176  175  174  173  172  171  170  169  168  167  166  165  164  163  162  161  160  159  158  157  156  155  154  153  152  151  150  149  148  147  146  145  144  143  142  141  140  139  138  137  136  135  134  133  132  131  130  129  128  127
