# This puzzle is unsolvable
48
 368  188    4    1    5    6    7    8    9   10   11   12   13   14   15   16   18   19  207  206   21   22   23  211   25   26   27   28   29   30   31   32   33   34   35   36   37   38   39   41   43   42   44  581  231  232   46   45
 187    2    3  190  192  193  194  195  196  197  198  199  200  201  202  203   17  205   20  387  388  386  209  210  212  213  214  215  216  217  218  219  220  221  222  223  224  225  226   40  228  409  408  230  410  235   50   47
 367  189  191  370  371  372  373  374  546  375  380  550  379  551  382  553  204  383  385  557  208  389   24  390  391  563  392  393  395  396  397  398  399  400  401  402  403  404  576  405  227  229  412  584   49  233  582   48
 369  541  540  542  543  544  545  709  708  376  548  378  552  714  381  554  717  556  555  720  558  559  560  561  562  564  727  394  566  567  568  569  570  571  572  573  574  893  407  411  579  896  406  580  236  413  234   51
 186  366  539  704  705  706  862  707  710  547  377  711  713  869  715  871  716  718  384  875  721  722  723  724  725  726  882  565  728  729  731  887  732  734  735  736  890  575  738  739  578  741  744  743  415  583  414   52
 185  365  536  364  859  703  861  863  865  549 1011 1013  712  868  870 1018  872  873  719 1021  876  877  878  879  880  881  883  885  884  730  886  733 1035  888  889 1037  891  577  894 1043  899 1181  746  898  585  416  237  238
 184  182  183  860 1007 1008 1280 1009  864  866  867 1014 1016 1155 1156 1019 1158 1020 1022  874 1023 1024 1025 1026 1027 1028 1029 1030 1031 1032 1033 1034 1174 1036 1176 1039  737 1038  892 1041  897  740 1044  745  586  417   54   53
 181  363  538  702  700  858 1148 1149 1010 1151 1152 1154 1283 1017 1525 1286 1159 1290 1160 1292 1161 1162 1164 1165 1420 1166 1167 1168 1169 1170 1171 1172 1173 1429 1175 1431 1177 1042 1311 1180 1040  895  902  900  748  240  239   55
 362  361  535  537  701 1006 1005 1279 1150 1282 1012 1284 1153    0 1408 1157 1288 1289 1291 1415 1293 1163 1534 1295 1297 1299 1422 1300 1301 1302 1303 1304 1305 1430 1545 1307 1306 1179 1309 1183  747 1182  742  749  587  418   57  241
 180  534  698  856  857 1004 1147 1403 1281 1405 1406 1407 1015 1285 1409 1287 1412 1414 1636 1637 1417 1294 1532 1296 1418 1538 1645 1540 1424 1425 1426 1427 1428 1544 1653 1308 1178 1652 1315 1312 1045 1046  901  903  588   56  243  242
 179  360  699  532  855 1002 1146 1404 1520 1145 1628 1518 1631 1731 1523 1526 1411 1528 1413 1530 1416 1533 1419 1742 1298 1535 1421 1644 1423 1647 1541 1542 1432 1543 1549 1546 1310 1434 1547 1433 1047 1314  904 1048  589  244  419  421
 178  359  533  854  697 1144 1278 1402 1399 1521 1626 1519 1522 1730 1633 1524 1527 1634 1635 1737 1529 1639 1739 1640 1740 1833 1537 1536 1646 1838 1648 1649 1650 1651 1750 1753 1550 1435 1313 1184 1049 1051  905  750  751  590  420   58
 177  357  358  531 1003  853 1277 1401 1275 1400 1630 1627 1410 1632 1732 1904 1733 1734 1638 1735 1531 1830 1641 1831 1741 1642 1744 1539 1746 1745 1837 2064 1748 1840 1923 1752 1548 1186 1436 1316 1185 1189  753  752  591   60   59   61
 176  530  696  851  694  852 1143 1142 1276 1516 1726 1905 1517 1903 1725 1629 1824 1825 1826 1736 1738 1829 1913 1989 1643 1743 1834 1836 1918 1994 1920 1841 1997 1842 1754 1655 1654 1656 1187 1437 1188  592 1052  754  424  907  246   62
 175  356  529  695 1001 1140 1000 1274 1398 1624 1514 1515 1820 1980 1821 1822 1908 1983 1909 1910 1828 1987 2055 1914 1832 1917 2118 1835 1919 1921 1839 1747 1751 1925 1924 1843 1657 1551 1439 1317 1050 1318 1053  593  595  245  422  247
 174  355  998  693  848 1141 1273 1269 1625 1728 1623 1902 1901 1981 1979 1907 1729 1982 1984 2053 1827 1911 1988 1990 1915 1916 2059 1993 1992 1922 2062 1996 1749 1998 1927 1755 1658 1552 1438 1320 1319 1054  906  755  594  248  423   63
 173  354  850  691  692 1272  849 1622 1396 1271 1818 1816 1724 1819 1823 1727 1906 2052 1986 2162 1912 2113 2054 2056 2058 2167 1991 2060 2061 1995 2063 1999 1926 1844 1756 1757 1554 1659 1440 1441 1190 1191  908  756  426  425  249   64
 353  170  525  527  528 1270 1134 1397 1393 1513 1139 1511 1817 2047 1900 2106 2048 2109 2159 2161 2110 2164 2114 2115 2057 2117 2273 2119 2121 2065 2122 2066 2000 1928 1845 1758 1660 1553 1555 1442 1321 1192  909  757  596  427  250   65
 351  349  172  688 1138  996 1136  847 1512 1618 1395 1621 1975 1978 1977 2046 2049 1985 2051 2050 2108 2112 2165 2116 2211 2248 2170 2214 2120 2173 2172 2001 2002 1929 1846 1661 1556 1443 1444 1322 1193  911 1055  758  597  428  251   66
 523  526  171  997  690  846  999  992 1394 1721 1815 1723 1899 1813 1898 1976 2105 2044 2203 2206 2207 2205 2267 2243 2210 2169 2215 2171 2250 2125 2123 2068 2067 2003 1847 1759 1662 1557 1323 1324 1194  912  910  759  599  598  429   67
 348  350  524  687  993  845  995 1268 1619 1137 1814 1720 1719 1718 2104 2107 2103 2158 2268 2241 2269 2163 2166 2271 2246 2293 2168 2216 2212 2174 2213 2069 2004 1930 1848 1760 1663 1558 1445 1195 1057 1056 1058  913  760  430  252  253
 352  169  165  689  844 1135 1267 1507 1392 1508 1717 1509 1620 1722 1974 1897 2157 2204 2160 2111 2208 2240 2209 2242 2292 2247 2274 2249 2217 2128 1850 1853 1934 1931 1761 1762 1665 1559 1446 1325 1196 1059  914  761  600  431   69   68
 168  164  167  682  686  843 1510  994 1265 1266 1391 1896 1811 1971 1973 2043 2045 2042 2289 2239 2236 2264 2266 2156 2291 2272 2175 2127 2275 2070 2124 2006 2071 2072 1933 1664 1666 1560 1447 1326 1197 1060  915  762  601  255  254   70
 520  991  344  842  522  685 1132 1389 1133 1616 1894 1715 1810 2040 1972 2155 2102 2237 2202 2238 2298 2301 2245 2244 2303 2251 2219 2302 2277 2126 2005 2009 1849 1932 1852 1851 1763 1561 1448 1327 1198 1061  916  763  602  432  256   71
 163  166  986  518  345 1131 1264 1390 1614 1617 1615 1893 1895 1808 2154 1812 2039 2199 2197 2265 2288 2287 2270 2299 2295 2276 2278 2252 2178 2131 2130 2007 2129 2176 1765 1764 1667 1449 1450 1328 1199 1062  917  764  603  433  257   72
 519  159  521 1261  988 1128  990  517 1129 1506 1809 1713 1505 1716 2041 2097 2038 2200 2153 2201 2300 2285 2281 2297 2290 2253 2279 2179 2218 2220 2177 2181 2008 1936 1935 1668 1563 1562 1329 1200 1063 1064  918  765  435  434  258   73
 160  680  684  683  342  841 1125 1130 1388 1503 1714 2101 1970 1892 1968 2037 2194 2152 2151 2235 2230 2286 2261 2294 2284 2283 2225 2254 2257 2182 2073 2132 2221 1854 1855 1766 1669 1564 1451 1330 1201 1065  766  605  604  436  259   74
 347  346  162  989 1126  839 1386 1263 1387 1504 1613 1612 1807 1806 1969 2098 2196 2198 2232 2231 2234 2233 2258 2296 2282 2226 2223 2137 2224 2180 2183 2074 2133 1856 1938 1671 1767 1565 1452 1331 1202  920  919  767  606  437  260   75
 515  341  985  838  837  681  835 1262 1501 1385 1611 1805 1711 1889 1891 1967 2100 2099 2195 2192 2263 2191 2260 2228 2227 2280 2138 2185 2255 2081 2222 2256 1937 2010 2011 1857 1670 1566 1453 1332 1203 1066  921  768  607  438  261   76
 161  516  679  677 1124  840 1127 1384 1610 1712 1502 1710 1804 1887 2035 1890 2034 2150 2096 2193 2262 2145 2229 2142 2259 2141 2189 2186 2076 2134 2184 2075 2012 1939 1858 1768 1672 1567 1454 1333 1204 1067  922  769  608  439  262   77
 340  514  511  343  158  833  983 1259 1257 1260 1609 1803 1888 1966 2033 2149 2036 2148 2147 2146 2144 2190 2088 2087 2085 2187 2140 2019 2077 2136 2082 2078 2013 1940 1770 1859 1673 1568 1455 1334 1205 1068  923  770  609  440  263   78
 157  339  510  512  836 1258  987 1382 1383 1500 1499 1608 1709 1802 1964 2095 2094 2093 1958 2027 2090 2143 2089 2023 2022 2086 2188 1948 2083 2080 2018 2079 1941 1860 1674 1769 1675 1569 1456 1335 1206 1069  924  771  610  441  264   79
 156  513  834  982  832  678 1123 1256 1381 1498 1607 1708 1801 1965 1963 2032 2031 2030 2092 2029 2091 2026 2024 1953 1952 1951 2139 2021 1870 2135 2016 1942 2014 1861 1771 1773 1570 1457 1336 1207 1208 1070  925  772  611  442  265   80
 155  338  337  676  831  984 1122 1377 1255 1497 1606 1799 1707 1885 1886 1962 1882 1959 1879 1957 2028 1954 2025 1950 1872 1871 2084 2020 1869 1949 2017 1780 1945 1943 1862 1676 1772 1458 1572 1338 1337 1071  926  773  612  443  266   81
 335  154  509  675  980  981 1253 1380 1252 1378 1605 1800 1798 1884 1883 1960 1961 1880 1792 1878 1956 1877 1955 1874 1873 1786 1784 1783 1781 1867 1947 1865 1864 2015 1774 1775 1573 1677 1571 1459 1209 1072  927  774  613  444  267   82
 336  508  673  674  830 1121 1254 1379 1494 1496 1604 1705 1706 1797 1796 1795 1881 1793 1791 1695 1789 1876 1875 1787 1692 1476 1785 1782 1868 1686 1946 1778 1944 1683 1776 1863 1681 1574 1460 1339 1210 1073  928  775  614  445  268   83
 153  333  507  672  829  979 1118 1120 1376 1495 1603 1704 1703 1702 1701 1700 1794 1699 1697 1790 1696 1694 1788 1590 1691 1690 1689 1585 1688 1685 1684 1866 1777 1580 1578 1577 1679 1462 1575 1341 1211 1074  929  776  615  446  269   84
 334  152  506  671  828  978 1117 1119 1251 1375 1602 1601 1600 1599 1598 1597 1596 1698 1595 1594 1593 1592 1480 1693 1588 1587 1586 1473 1687 1583 1581 1779 1579 1682 1467 1465 1678 1464 1340 1461 1212 1075  930  777  616  447  270   85
 151  332  505  670  827  977  976 1250 1492 1493 1491 1490 1489 1488 1487 1486 1485 1484 1483 1482 1481 1591 1589 1478 1477 1357 1474 1355 1472 1584 1582 1471 1469 1468 1348 1680 1346 1576 1345 1342 1213 1076  931  778  617  448  271   86
 150  331  504  669  826  975 1116 1249 1374 1373 1372 1371 1370 1369 1368 1367 1366 1365 1364 1363 1362 1479 1361 1360 1359 1232 1230 1475 1354 1353 1352 1470 1350 1349 1221 1466 1219 1344 1463 1214 1215 1077  932  779  618  449  272   87
 149  330  503  668  825  974 1115 1248 1247 1246 1245 1244 1243 1242 1241 1240 1239 1238 1237 1236 1235 1234 1233 1097 1358 1095 1356 1228 1227 1226 1225 1351 1223 1087 1222 1220 1347 1343  939 1081 1216 1078  933  780  619  450  273   88
 148  329  502  667  824  973 1114 1113 1112 1111 1110 1109 1108 1107 1106 1105 1104 1103 1102 1101 1100 1099 1098 1096 1231 1094 1229 1093 1092 1091 1090 1224 1089 1088 1086 1085 1217 1084  940 1082  938 1079  934  781  620  451  274   89
 147  328  501  666  823  972  971  970  969  968  967  966  965  964  963  962  961  960  959  958  957  956  955  954  953  952  951  800  949  948  947  946  945  944  943  942  941 1218 1083  937 1080  936  935  782  621  452  275   90
 146  327  500  665  822  821  820  819  818  817  816  815  814  813  812  811  810  809  808  807  806  805  804  803  802  801  799  950  798  797  796  795  794  793  792  791  790  789  788  787  786  785  784  783  622  453  276   91
 145  326  499  664  663  662  661  660  659  658  657  656  655  654  653  652  651  650  649  648  647  646  645  644  643  642  641  640  639  638  637  636  635  634  633  632  631  630  629  628  627  626  625  624  623  454  277   92
 144  325  498  497  496  495  494  493  492  491  490  489  488  487  486  485  484  483  482  481  480  479  478  477  476  475  474  473  472  471  470  469  468  467  466  465  464  463  462  461  460  459  458  457  456  455  278   93
 143  324  323  322  321  320  319  318  317  316  315  314  313  312  311  310  309  308  307  306  305  304  303  302  301  300  299  298  297  296  295  294  293  292  291  290  289  288  287  286  285  284  283  282  281  280  279   94
 142  141  140  139  138  137  136  135  134  133  132  131  130  129  128  127  126  125  124  123  122  121  120  119  118  117  116  115  114  113  112  111  110  109  108  107  106  105  104  103  102  101  100   99   98   97   96   95
