# This puzzle is unsolvable
61
   2    1    3    4    6  245  246    8  247   10   12   13   14  253   15   16   18  257   19   20   21   22   24  263   25   26   27   28   29   30   31   32   33   34   35   36   37   38   39   40   41   42   43   44   45   46   47   48   49   50   51   52   53   54   55   56   57   58   59   60   61
 470  472  240  242    5  474    7  248    9  249   11  482  251  252  254  256   17  488  258  490  260  491  262  494  264  265  266  267  268  269  270  271  272  273  274  275  276  277  278  279  280  281  282  283  284  285  286  287  288  289  290  291  292  293  294  295  296  297  298  299   62
 473  238  699  476  244  477  478  479  250  480  704  481  483  484  485  255  487  259  489  492  714  261   23  493  495  496  497  498  499  500  501  502  503  504  505  506  507  508  509  510  511  512  513  514  515  516  517  518  519  520  521  522  523  524  525  526  527  528  529  300   63
 239  241  912  243  471  696  700  701  702  703  919  705  706  707  709  486  710  711  712  713  929  715  716  717  718  719  720  721  722  723  724  725  726  727  728  729  730  731  732  733  734  735  736  737  738  739  740  741  742  743  744  745  746  747  748  749  750  751  530  301   64
 236  237  698  694  475  913  914  916  918 1124 1126  920  921  922  708  924  925  926  927  928 1136  930  931  932  933  934  935  936  937  938  939  940  941  942  943  944  945  946  947  948  949  950  951  952  953  954  955  956  957  958  959  960  961  962  963  964  965  752  531  302   65
 469  911  695  693 1120 1121 1122  915 1325 1324 1125 1128 1129 1130  923 1131 1132 1133 1134 1135 1137 1336 1138 1139 1140 1141 1142 1143 1144 1145 1146 1147 1148 1149 1150 1151 1152 1153 1154 1155 1156 1157 1158 1159 1160 1161 1162 1163 1164 1165 1166 1167 1168 1169 1170 1171  966  753  532  303   66
 235  468  910  697 1320 1321 1123 1322  917 1514 1327 1127 1326 1328 1329 1330 1331 1332 1333 1334 1526 1335 1337 1338 1339 1340 1341 1342 1343 1344 1345 1346 1347 1348 1349 1350 1351 1352 1353 1354 1355 1356 1357 1358 1359 1360 1361 1362 1363 1364 1365 1366 1367 1368 1369 1172  967  754  533  304   67
 234  467  692  909 1119 1319 1512 1513 1323 1700 1697 1516 1517 1518 1519 1521 1705 1522 1523 1524 1525 1527 1528 1529 1530 1531 1532 1533 1534 1535 1536 1537 1538 1539 1540 1541 1542 1543 1544 1545 1546 1547 1548 1549 1550 1551 1552 1553 1554 1555 1556 1557 1558 1559 1370 1173  968  755  534  305   68
 233  466  691  908 1118 1511 1698 1872 1515 1873 2042 1876 1701 1702 1520 1703 1704 1706 1707 1708 1709 1710 1711 1712 1713 1714 1715 1716 1717 1718 1719 1720 1721 1722 1723 1724 1725 1726 1727 1728 1729 1730 1731 1732 1733 1734 1735 1736 1737 1738 1739 1740 1741 1560 1371 1174  969  756  535  306   69
 232  465  690 1117 1317 1318 1695 1696 2040 1694 1699 1875 2043 1877 1878 1879 1880 1881 1882 1883 1884 1885 1886 1887 1888 1889 1890 1891 1892 1893 1894 1895 1896 1897 1898 1899 1900 1901 1902 1903 1904 1905 1906 1907 1908 1909 1910 1911 1912 1913 1914 1915 1742 1561 1372 1175  970  757  536  307   70
 231  464  906  907 1116 1315 1507 1510 2041 1509 1869 2200 2044 2045 2204 2046 2047 2048 2049 2050 2051 2052 2053 2054 2055 2056 2057 2058 2059 2060 2061 2062 2063 2064 2065 2066 2067 2068 2069 2070 2071 2072 2073 2074 2075 2076 2077 2078 2079 2080 2081 1916 1743 1562 1373 1176  971  758  537  308   71
 230  463  689  688  904 1115 1316 1871 1870 1867 2199 2038 2201 1874 2355 2205 2206 2207 2208 2209 2210 2211 2212 2213 2214 2215 2216 2217 2218 2219 2220 2221 2222 2223 2224 2225 2226 2227 2228 2229 2230 2231 2232 2233 2234 2235 2236 2237 2238 2239 2082 1917 1744 1563 1374 1177  972  759  538  309   72
 229  462  687 1113 1114  905 1508 1693 1691 1868 2198 2353 2202 2203 2354 2356 2357 2358 2359 2360 2361 2362 2363 2364 2365 2366 2367 2368 2369 2370 2371 2372 2373 2374 2375 2376 2377 2378 2379 2380 2381 2382 2383 2384 2385 2386 2387 2388 2389 2240 2083 1918 1745 1564 1375 1178  973  760  539  310   73
 228  461  686  903 1112 1314 1692 1506 2039 2197 2037 2352 2496 2497 2498 2499 2500 2501 2502 2503 2504 2505 2506 2507 2508 2509 2510 2511 2512 2513 2514 2515 2516 2517 2518 2519 2520 2521 2522 2523 2524 2525 2526 2527 2528 2529 2530 2531 2390 2241 2084 1919 1746 1565 1376 1179  974  761  540  311   74
 227  460  685  902 1111 1313 1505 1690 2036 2196 2350 2351 2495 2632 2633 2634 2635 2636 2637 2638 2639 2640 2641 2642 2643 2644 2645 2646 2647 2648 2649 2650 2651 2652 2653 2654 2655 2656 2657 2658 2659 2660 2661 2662 2663 2664 2665 2532 2391 2242 2085 1920 1747 1566 1377 1180  975  762  541  312   75
 226  459  684  901 1110 1312 1311 1689 1866 1865 2034 2349 2494 2631 2760 2761 2762 2763 2764 2765 2766 2767 2768 2769 2770 2771 2772 2773 2774 2775 2776 2777 2778 2779 2780 2781 2782 2783 2784 2785 2786 2787 2788 2789 2790 2791 2666 2533 2392 2243 2086 1921 1748 1567 1378 1181  976  763  542  313   76
 225  458  683  900 1109 1503 1504 1501 1688 2035 2195 2348 2493 2630 2759 2880 2881 2882 2883 2884 2885 2886 2887 2888 2889 2890 2891 2892 2893 2894 2895 2896 2897 2898 2899 2900 2901 2902 2903 2904 2905 2906 2907 2908 2909 2792 2667 2534 2393 2244 2087 1922 1749 1568 1379 1182  977  764  543  314   77
 224  457  682  899 1108 1310 1686 1502 2033 2193 1863 2347 2492 2629 2758 2879 2992 2993 2994 2995 2996 2997 2998 2999 3000 3001 3002 3003 3004 3005 3006 3007 3008 3009 3010 3011 3012 3013 3014 3015 3016 3017 3018 3019 2910 2793 2668 2535 2394 2245 2088 1923 1750 1569 1380 1183  978  765  544  315   78
 223  456  681  898 1107 1309 1308 1687 1864 2032 2194 2346 2491 2628 2757 2878 2991 3096 3097 3098 3099 3100 3101 3102 3103 3104 3105 3106 3107 3108 3109 3110 3111 3112 3113 3114 3115 3116 3117 3118 3119 3120 3121 3020 2911 2794 2669 2536 2395 2246 2089 1924 1751 1570 1381 1184  979  766  545  316   79
 222  455  680  897 1106 1307 1500 1862 2031 2030 2192 2345 2490 2627 2756 2877 2990 3095 3192 3193 3194 3195 3196 3197 3198 3199 3200 3201 3202 3203 3204 3205 3206 3207 3208 3209 3210 3211 3212 3213 3214 3215 3122 3021 2912 2795 2670 2537 2396 2247 2090 1925 1752 1571 1382 1185  980  767  546  317   80
 221  679  678 1105 1305 1499 1684 1685 1861 2029 2191 2344 2489 2626 2755 2876 2989 3094 3191 3280 3281 3282 3283 3284 3285 3286 3287 3368 3438 3290 3292 3371 3293 3294 3295 3296 3297 3298 3299 3300 3301 3216 3123 3022 2913 2796 2671 2538 2397 2248 2091 1926 1753 1572 1383 1186  981  768  547  318   81
 220  454  895  896  894 1304 1306 1497 1683 1860 2190 2343 2488 2625 2754 2875 2988 3093 3190 3279 3360 3361 3362 3363 3364 3365 3367 3289 3291 3440 3503 3370 3372 3373 3374 3375 3376 3377 3378 3379 3302 3217 3124 3023 2914 2797 2672 2539 2398 2249 2092 1927 1754 1573 1384 1187  982  769  548  319   82
 219  452  677 1104  893 1303 1682 1498 1859 2028 2189 2342 2487 2624 2753 2874 2987 3092 3189 3278 3359 3432 3433 3434 3435 3366 3500 3369 3288 3439 3559 3442 3443 3444 3445 3446 3447 3448 3449 3380 3303 3218 3125 3024 2915 2798 2673 2540 2399 2250 1928 1929 1755 1574 1385 1188  983  770  549  320   83
 218  453  676  451  890 1496 1495 1681 1858 2027 2188 2341 2486 2623 2752 2873 2986 3091 3188 3277 3358 3431 3496 3497 3498 3436 3499 3437 3501 3441 3504 3560 3505 3506 3508 3509 3510 3511 3450 3381 3304 3219 3126 3025 2916 2799 2674 2541 2400 2094 2093 1756 1757 1575 1386 1189  984  771  550  321   84
 217  450  892  891 1103 1302 1494 1680 1857 2026 2187 2340 2485 2622 2751 2872 2985 3090 3187 3276 3357 3430 3495 3552 3553 3554 3556 3603 3557 3502 3558 3561 3507 3563 3610 3564 3565 3512 3451 3382 3305 3220 3127 3026 2917 2800 2675 2542 2401 2251 2095 1930 1758 1576 1387 1190  985  772  551  322   85
 449  675  674 1100 1102 1301 1493 1679 1856 2025 2186 2339 2484 2621 2750 2871 2984 3089 3186 3275 3356 3429 3494 3551 3600 3602 3555 3604 3605 3675 3606 3607 3648 3562 3649 3611 3566 3513 3452 3383 3306 3221 3128 2918 2801 2676 2543 2544 2253 2254 2252 2096 1931 1577 1388 1191  986  773  552  323   86
 216  672  671  889 1099 1101 1300 1678 1855 2024 2185 2338 2483 2620 2749 2870 2983 3088 3185 3274 3355 3428 3493 3550 3640 3601 3641 3642 3643 3645 3644 3647 3679 3678 3608 3612 3567 3514 3453 3384 3307 3222 3129 3027 2919 2802 2677 2403 2405 2402 2097 1932 1759 1578 1389 1192  987  774  553  324   87
 673  214  215  445 1298 1299 1492 1677 1854 2023 2184 2337 2482 2619 2748 2869 2982 3087 3184 3273 3354 3427 3492 3549 3599 3639 3672 3696 3673 3698 3676 3677 3646 3609 3650 3613 3568 3515 3454 3385 3308 3223 3130 3028 2920 2803 2678 2679 2545 2255 2098 1933 1760 1579 1390 1193  988  775  554  325   88
 448  670  213 1098 1097 1491 1297 1676 1853 2022 2183 2336 2481 2618 2746 2747 2868 3086 3183 3272 3353 3426 3491 3548 3598 3638 3671 3674 3713 3699 3720 3714 3700 3680 3651 3614 3569 3516 3455 3386 3309 3131 3030 3029 2921 2804 2546 2404 2256 2257 2099 1934 1761 1580 1391 1194  989  776  555  326   89
 212  447  669  885  446  888 1096 1674 1852 2021 2182 2335 2480 2617 2745 2867 2981 3085 3182 3271 3352 3425 3490 3547 3597 3637 3670 3695 3697 3712 3715 3716 3701 3681 3652 3615 3570 3517 3456 3387 3225 3224 3132 3031 2922 2805 2680 2548 2547 2406 2100 1935 1762 1581 1392 1195  990  777  556  327   90
 444  210  668 1094  887  886 1673 1489 1851 2020 2181 2334 2479 2616 2744 2866 2980 3084 3181 3270 3351 3488 3424 3546 3596 3636 3669 3694 3711 3719 3718 3702 3703 3682 3653 3616 3571 3518 3457 3388 3310 3311 3032 3033 2923 2806 2681 2407 2408 2258 2101 1936 1763 1582 1393 1196  991  778  557  328   91
 211  443  667 1095 1675 1490 1488 1847 1850 2180 2017 2333 2478 2614 2615 2865 2979 3083 3180 3269 3350 3423 3489 3545 3595 3594 3668 3693 3710 3708 3717 3706 3704 3683 3654 3617 3572 3519 3458 3389 3312 3226 3134 3133 2924 2925 2682 2549 2259 2260 2102 1937 1764 1583 1394 1197  992  779  558  329   92
 209  442  881  666 1092 1296 1295 1672 1848 1849 2019 2179 2477 2741 2743 2977 2978 2976 3082 3268 3349 3485 3422 3544 3593 3635 3634 3667 3690 3709 3707 3705 3684 3685 3655 3618 3573 3520 3459 3390 3313 3227 3135 3034 2808 2807 2551 2550 2409 2261 1938 1765 1584 1395 1198  993  994  780  559  330   93
 441  207  883  884 1292 1091 1668 1294 1846 2018 2016 2332 2613 2742 2864 2861 2862 3081 3179 3267 3421 3487 3542 3484 3543 3666 3633 3692 3664 3688 3687 3660 3686 3656 3619 3574 3576 3521 3460 3391 3314 3228 3137 3035 2926 2809 2683 2552 2410 2104 2103 2105 1939 1585 1396 1199  995  781  560  331   94
 208  439  880  882 1485 1093 1293 1486 1487 2176 2330 2331 2476 2611 2863 2740 2975 3266 3178 3176 3348 3347 3486 3541 3591 3592 3629 3663 3662 3689 3661 3659 3624 3658 3579 3620 3524 3523 3522 3315 3230 3136 3229 3036 2927 2810 2684 2553 2685 2411 1940 1941 1766 1586 1397 1201 1200  782  561  332   95
 206  440 1089  663 1291 1670 1671 1484 1483 2015 2329 2474 2178 2475 2739 2859 2974 3080 3177 3345 3346 3420 3419 3590 3632 3631 3665 3586 3628 3691 3627 3626 3625 3623 3575 3657 3621 3461 3393 3317 3316 3232 3138 3037 2928 2811 2686 2554 2263 2264 2262 1768 1769 1588 1398  996  783  785  562  333   96
 205  665 1289  878 1665 1482 1669 1842 2014 2328 2177 2327 2473 2612 2860 2973 3175 3262 3263 3417 3264 3418 3483 3480 3540 3539 3534 3536 3587 3584 3583 3582 3581 3580 3527 3622 3577 3463 3462 3392 3231 3394 3139 3038 2929 2812 2687 2413 2412 2265 2106 1942 1767 1587 1399 1202  997  998  784  334   97
 204  438  664  437  879 1088 1290 1667 1480 1844 1845 2172 2472 2610 2737 2738 2971 3173 3078 3171 3265 3416 3343 3482 3478 3589 3479 3630 3585 3533 3532 3531 3530 3469 3470 3528 3578 3525 3464 3395 3318 3233 3140 3039 2930 2813 2555 2556 2108 2414 2109 1945 1402 1591 1589 1401 1204 1400  563  564   98
 435  434  660  662  436 1090 1085 1843 2013 1481 2175 2174 2173 2608 2609 2972 2857 3075 3077 3079 3261 3538 3413 3412 3537 3477 3535 3476 3475 3474 3473 3472 3471 3529 3468 3467 3526 3466 3465 3396 3319 3234 3141 3040 2931 2814 2688 2691 2415 2110 1771 1770 1203 1772  787  999  786  337  335  336   99
 203  661  874  877  433 1086 1664 1288 1286 2012 2171 2470 2471 2325 2607 2736 2858 3076 3260 3342 3174 3344 3588 3415 3253 3338 3410 3334 3333 3407 3406 3405 3404 3403 3402 3401 3400 3399 3398 3397 3320 3235 3142 3041 2932 2815 2689 2558 2690 2266 1403 1943 2107 1590  566 1000 1002 1001  565  102  100
 875  658  655 1287 1666 1087 1479 1841 1663 2170 2326 2324 2606 2469 2734 2856 2969 3172 2970 3259 3167 3339 3481 3164 3337 3255 3336 3408 3409 3332 3331 3330 3329 3328 3327 3326 3325 3324 3323 3322 3321 3236 3143 3042 2933 2816 2692 2557 2269 2416 2267 1946 1773 1774 1205 1208 1003  338  567  569  339
1084  202  201  876 1661 1082 1478 1662 2169 1839 2320 2008 2605 2323 2733 2855 3072 3074 3340 3166 3341 3256 3414 3165 3411 3163 3335 3251 3250 3249 3248 3247 3246 3245 3244 3243 3242 3241 3240 3239 3238 3237 3144 3043 2934 2817 2559 2560 2417 2270 1775 1206 1948 1593 1594 1207 1592  788  570  789  568
 200  659  432 1083 1285 1476 1477 2010 1837 2011 2468 2604 2735 2732 2854 3073    0 2968 3168 3170 3068 2961 3065 2958 3254 3062 3162 3252 3159 3158 3157 3156 3155 3154 3153 3152 3151 3150 3149 3148 3147 3146 3145 3044 2935 2693 2561 2418 2562 2111 2273 1404 1944 1595 1947 1209 1004  792  790  340  101
 199  198  657  873 1283 1281 1284 1475 2322 1840 2007 2465 2602 2603 2731 2966 2967 2964 3169 3258 2845 3257 2959 3066 3064 3063 3161 3160 3061 3058 2951 3057 3056 3055 3054 3053 3052 3051 3050 3049 3048 3047 3046 3045 2936 2819 2818 2694 2419 2116 2113 2272 2112 2114 1405 1406 1005  791  793  103  341
 197  431  430  654 1080 1081 1838 1660 2009 2167 2168 2319 2321 2467 2598 2853 2963 3071 3070 2847 3069 2846 3067 2842 2957 2956 2955 2840 3060 2953 2836 2950 2949 2948 2947 2946 2945 2944 2943 2942 2941 2940 2939 2938 2937 2420 2424 2695 2421 2271 1776 1950 1597 1596 1598 1210 1407  572  571  342  104
 196  429  656 1079 1282 1277 1835 1474 2005 2006 2166 2318 2464 2600 2729 2852 2965 2962 2849 2848 2722 2723 2844 2843 2719 2841 2839 2954 3059 2952 2714 2835 2834 2833 2832 2831 2830 2829 2828 2827 2826 2825 2824 2823 2822 2820 2696 2564 1952 2563 1778 1949 1779 1599 1408 1008 1006  573  105  343  106
 195  428  653  871  872 1078 1659 1279 1834 2003 1472 2601 2466 2728 2851 2850 2727 2726 2725 2724 2960 2721 2591 2720 2588 2718 2716 2838 2583 2715 2712 2581 2711 2710 2709 2708 2707 2706 2705 2704 2703 2702 2701 2700 2699 2821 2275 2698 2268 2423 2115 2422 1951 2119 1212 1213 1211  794 1007  795  108
 194  427  652 1077 1280  869 1657 1833 1836 2002 2164 2165 2463 2730 2460 2597 2596 2595 2594 2593 2454 2592 2451 2589 2587 2586 2717 2585 2584 2837 2713 2296 2580 2579 2578 2577 2576 2575 2574 2573 2572 2571 2431 2568 2567 2280 2428 2425 2697 2118 2274 2117 1777 1780 1781 1009 1010  575  576  107  109
 426  651  866 1076  870 1656 1658 1469 2315 2461 2004 2316 2313 2462 2599 2458 2457 2153 2308 2456 2455 2453 2590 2450 2449 2448 2447 2446 2445 2443 2582 2442 2441 2440 2439 2438 2437 2436 2435 2434 2433 2432 2284 2570 2429 2566 2278 2565 2427 2276 2120 1954 1953 1600 1412  796  344 1216  574  345  346
 193  189  867  650 1471 1470 1473 1653 1655 2314 2001 2317 2160 2459 2311 2156 2157 2154 2152 2307 2306 2151 2304 2303 2302 2301 2299 2144 2444 2142 2297 2294 2293 2138 2292 2291 2135 2290 2288 2287 2286 2285 2430 2569 2282 2281 2279 2124 2426 2122 1955 1409 1411 1782 1413 1214 1410 1012  798  347  110
 425  192  648  424 1276 1074 1278 1467 1831 2000 2163 2161 2162 2159 2158 1994 2310 2309 1640 1988 1817 2452 2150 1984 2149 2145 2300 2143 2298 2141 2140 1976 2139 2137 1803 1973 2136 2289 2134 1970 2130 2129 2128 2283 1963 2127 2126 1790 2121 2277 1956 1783 1603 1602 1215  797 1013 1011  577  348  111
 191  649  190  868 1073 1275 1830 1654 1468 1998 1828 1997 1995 1824 1819 1992 1822 1991 2155 1990 1987 2305 1986 2147 1983 2146 1982 1981 1980 1979 1441 1978 2295 1977 1975 1974 1972 1971 1800 2132 1799 2131 1966 1965 1964 1792 1611 2123 1791 1788 1959 1960 1784 1785 1414 1217 1218  578  579  349  112
 423  647  863  865 1075  864 1274 1832 1829 1999 1652 1461 1826 1262 2312 1823 1057 1641 1453 1989 1639 1816 1985 2148 1813 1812 1811 1810 1630 1809 1442 1807 1805 1627 1626 1802 1801 1621 1968 2133 1795 1967 1430 1617 1794 2125 1962 1612 1961 1958 1787 1957 1415 1219 1605  799 1604  800  580  350  113
 187  421  645  422 1072 1273 1466 1651 1650 1649 1458 1827 1825 1996 1459 1644 1457 1259 1455 1637 1636 1818 1814 1634 1447 1633 1632 1631 1443 1628 1808 1806 1625 1804 1624 1623 1622 1237 1969 1620 1797 1235 1796 1233 1616 1614 1230 1613 1789 1610 1609 1786 1601 1606 1416 1417  803 1014  801  351  114
 186  420  188  646  644 1272 1465 1464 1463 1462 1647 1648 1460 1646 1645 1643 1820 1260 1456 1642 1452 1450  394 1251 1250 1049 1445 1048 1444 1629 1440 1439 1245 1438 1437 1436 1435 1239 1240 1798 1033 1234 1429 1232 1428 1427 1025 1424 1423 1422 1608 1421 1607 1419 1222 1015 1221  802  581  352  115
 419  418  862 1070 1071 1271 1270 1269 1267 1065 1266 1265 1060 1993 1264 1059  400 1257 1258 1454 1638 1256 1635 1448 1253 1815 1248 1249 1046 1045 1044  831 1246 1243 1242 1241 1037 1035  823 1434 1619 1431 1615 1426 1793 1231 1425 1229 1228 1227 1226 1420 1224 1418 1223 1018  806 1017  582  353  116
 184  185  861  643 1069 1068 1067 1066 1268 1064 1061  849  850 1263 1261 1821  627 1451  844  623 1053  841 1255  621 1449 1446  835  836  833  614 1247 1042 1043 1041 1039 1038  825 1433 1036 1618 1432 1236 1032 1031  597  598  814  596 1026  815 1022 1225 1021  809  591  808  805 1016  804  354  117
 183  642  859  860  858  857  856  855  854  853 1063 1062  851 1058  402 1056  847  625  845  398 1052  160 1252  840 1051 1050  391  837  616  834  832  830 1244  610  829  828  827  606  826 1238 1034  821  601  820  818 1029 1027 1028  813 1024 1023  810  589 1020 1220 1019  807  584  583  355  118
 416  417  413  182  639  638  410  637  635  634  852  633  632  404  630  628  629  161  843 1054  624  842 1254  619  618  838  617 1047  389  387  612 1040  611  383  609  608  607  378  824  602  822  603  373  372  135  599  817  816  368  595  594  811  812  592  590  588  587  586  585  356  119
 181  415  641  640  412  177  174  636  409  408  407  405  403  848  631  166  165  626 1055  846  396  158  622  395  839  392  615  390  152  386  613  150  385  148  382  381  380  605  377  604  376  140  374  371 1030  137  136  370  369  367  366  364  593  363  127  125  361  359  358  357  120
 180  414  179  178  176  411  175  173  172  171  406  170  169  168  401  167  399  164  397  163  162  159  393  157  620  156  155  154  388  153  151  384  149  147  146  145  144  379  143  142  375  141  139  600  819  138  134  133  132  131  130  365  129  362  128  126  360  124  123  122  121
