# This puzzle is unsolvable
58
 229    2    3  233    4  234    7  235    9  237   10   12   13   14   15   16   17   18   19   20   21   22   23   24   25   26   27  255   28   29   30  259   33   36   35  263   37   38   39   40   43  489  270   44   45   46   47   48   49   50   51   52   53   54   55   56   57   58
   1  659  660  662  232    5  455  236  457   11  238  239  241  242  461  243  244  245  246  247  467  248  249  251  252  253  684  473  475  257   31  258  690   32  260  264  483  265  266  269  267   42  488  271  272  273  274  275  276  277  278  279  280  281  282  283  284   59
 445  228  230  447  450  661  453    8  456  667  458  459  240  460  462  673  463  464  677  465  468  250  680  682  470  472  683  254  474  476  477  478  479   34  261  482  694  484  485  486  268   41  487  490  491  492  493  494  495  496  497  498  499  500  501  502  285   60
 227  446  226  231    6  664  452  665  454  666  668  872  669  670  672  876  674  676  466  879  678  679  681  884  885  888  256  685  686  687  688  689  480  481  262  693  692  695  696  697  698  699  700  701  702  703  704  705  706  707  708  709  710  711  712  503  286   61
 225  449  448  864  866  451  663  868  869 1065  870 1067  873  671  875 1071  877  675  878  880  882  469 1080 1082  883  886  887 1270  889  890  891  892  894  691  895  896 1094  898 1281  899  900  902  903  904  905  906  907  908  909  910  911  912  913  914  713  504  287   62
 224  444  863  861  865 1060  867 1063 1064 1252  871 1066 1068  874 1069 1070 1072 1073 1074 1075  881 1077 1079 1268  471 1445 1269 1447 1084 1085 1086 1087  893 1088 1089 1277  897 1092 1093 1095  901 1097 1098 1099 1100 1101 1102 1103 1104 1105 1106 1107 1108  915  714  505  288   63
 223  443  658  862 1248 1062 1249 1250 1251 1431 1253 1254 1255 1256 1257 1258 1259 1260 1261 1262 1263 1076 1265 1266 1081 1617 1083 1449 1271 1272 1273 1274 1275 1090 1091 1458 1278 1279 1280 1461 1096 1284 1285 1286 1287 1288 1289 1290 1291 1292 1293 1294 1109  916  715  506  289   64
 222  442  657  860 1059 1061 1247 1428 1429 1432 1603 1433 1434 1606 1435 1437 1438 1439 1611 1440 1441 1442 1443 1264 1446 1619 1782 1618 1450 1451 1452 1453 1454 1276 1626 1457 1459 1460 1462 1282 1283 1463 1464 1465 1466 1467 1468 1469 1470 1471 1472 1295 1110  917  716  507  290   65
 221  656  655 1058 1057 1246 1600 1601 1430 1765 1602 1768 1604 1605 1436 1607 1608 1610 2076 1774 1613 1614 1078 1615 1267 1936 1448 1621 1784 1622 1623 1624 1625 1456 1455 1791 1629 1630 1631 1794 1632 1634 1798 1636 1637 1638 1639 1640 1641 1642 1473 1296 1111  918  717  508  291   66
 220  441  654  859 1245 1426 1427 1425 1764 1920 1767 1924 1921 1770 1771 1927 1609 1773 1930 1612 1775 1777 1778 1444 1934 2223 1937 2084 1620 1785 1786 1787 1788 1789 1628 1627 1792 1793 1795 1796 1633 1635 1951 1799 1800 1801 1802 1803 1804 1643 1474 1297 1112  919  718  509  292   67
 440  653  858 1054 1056 1244 1598 1762 1918 1763 1766 2069 1922 1769 1925 1926 1929 1772 2215 1931 1776 2218 1616 2219 1779 2085 1781 1783 1939 1940 1941 1942 1943 1944 1790 1946 1947 1948 1949 1950 1952 1797 1953 1954 1955 1956 1957 1958 1805 1644 1475 1298 1113  920  719  510  293   68
 219  215  652  218 1055 1599 1597 1240 1761 1919 2068 2208 1923 2071 2072 2073 1928 2074 2214 2077 2079 2349 1933 1935 2082 2083 1780 2221 2086 2088 2089 2228 2091 2092 1945 2093 2094 2095 2096 2097 2098 2099 2100 2101 2102 2103 2104 1959 1806 1645 1476 1299 1114  921  720  511  294   69
 217  648  438  439  651 1243 1423 1424 1596 1917 2067 2070 2210 2211 2212 2345 2213 2075 2216 2217 2078 2081 1932 2352 2080 2475 2225 2354 2087 2226 2227 2229 2090 2230 2231 2232 2233 2234 2235 2236 2237 2238 2239 2240 2241 2242 2105 1960 1807 1646 1477 1300 1115  922  721  512  295   70
 216  650 1242  856  855 1422 1594 1593 1595 1760 2207 2204 2209 2341 2343 2466 2467 2342 2347 2346 2471 2348 2351 2220 2591 2222 2224 1938 2479 2356 2358 2359 2484 2360 2361 2362 2364 2365 2366 2367 2368 2369 2370 2371 2372 2243 2106 1961 1808 1647 1478 1301 1116  923  722  513  296   71
 435  437 1051 1241  857 1053 1421 1759 1916 2065 2066 2340 2206 2464 2580 2689 2465 2344 2470 2584 2586 2472 2350 2473 2592 2476 2353 2478 2355 2357 2481 2482 2485 2599 2600 2363 2487 2488 2489 2490 2491 2492 2493 2494 2373 2244 2107 1962 1809 1648 1479 1302 1117  924  723  514  297   72
 649  434  852  854 1050 1052 1239 1420 1758 1915 2063 2064 2339 2205 2338 2463 2468 2583 2469 2585 2791 2588 2696 2698 2795 2593 2971 2594 2702 2480 2596 2703 2598 2483 2601 2486 2602 2603 2604 2605 2606 2607 2608 2495 2374 2245 2108 1963 1810 1649 1480 1303 1118  925  724  515  298   73
 213  646  436  647 1049 1419 1592 1757 1591 1913 1914 2203 2337 2462 2579 2581 2582 2688 2691 2882 2692 2587 2589 2794 2477 2799 2797 2700 2801 2597 2704 2803 2705 2706 2707 2708 2709 2710 2711 2712 2713 2714 2609 2496 2375 2246 2109 1964 1811 1650 1481 1304 1119  926  725  516  299   74
 211  853  214  850  851 1238 1237 1046 1417 1756 2061 2062 2336 2461 2578 2788 2787 2789 2690 2790 2694 2884 2695 2697 2474 2798 2699 2701 2891 2802 2595 2894 2804 2805 2806 2807 2808 2809 2810 2811 2812 2715 2610 2497 2376 2247 2110 1965 1812 1651 1482 1305 1120  927  726  517  300   75
 432  849  644  848 1234 1045 1047 1590 1754 1755 1912 2202 2335 2577 2686 2687 2880 2879 2883 2965 2693 2796 2970 2888 2590 2968 2800 2889 2892 2976 2977 2893 2895 2896 2897 2898 2899 2900 2901 2902 2813 2716 2611 2498 2377 2248 2111 1966 1813 1652 1483 1306 1121  928  727  518  301   76
 431  430  212  643  645 1236 1048 1414 1589 1911 2060 2334 2333 2460 2576 2786 2785 2964 2962 2881 3040 2885 2793 2886 3045 2887 2972 3048 2890 2973 2975 3052 2978 2979 2980 2981 2982 2983 2984 2903 2814 2717 2612 2499 2378 2249 2112 1967 1814 1653 1484 1307 1122  929  728  519  302   77
 209  433  207 1044 1415 1235 1418 1416 1910 1752 2059 2201 2458 2459 2457 2575 2685 2878 3039 2963 2792 2967 2966 2969 3112 3046 3047 3175 3049 2974 3050 3119 3053 3054 3055 3056 3057 3058 2985 2904 2815 2718 2613 2500 2379 2250 2113 1968 1815 1654 1485 1308 1123  930  729  520  303   78
 206  208  429  210  846 1232 1233 1588 1586 1587 2199 2200 2332 2574 2683 2684 2784 2877 2961 3106 3168 3042 3044 3043 3171 3115 3114 3173 3176 3116 3051 3118 3120 3121 3122 3123 3124 3059 2986 2905 2816 2719 2614 2501 2380 2251 2114 1969 1816 1655 1486 1309 1124  931  730  521  304   79
 641  642  427    0  847 1413 1412 1585 1751 1753 2058 2057 2456 2455 2573 2682 2783 2876 3038 3107 3108 3041 3109 3111 3170 3113 3226 3174 3225 3177 3117 3178 3179 3180 3181 3182 3125 3060 2987 2906 2817 2720 2615 2502 2381 2252 2115 1970 1817 1656 1487 1310 1125  932  731  522  305   80
 205  426  640 1043  845 1042 1231 1410 1750 1909 2197 2330 2329 2331 2571 2681 2680 2875 2960 3105 3167 3220 3110 3169 3264 3223 3172 3304 3228 3303 3271 3229 3230 3231 3232 3183 3126 3061 2988 2907 2818 2721 2616 2503 2382 2253 2116 1971 1818 1657 1488 1311 1126  933  732  523  306   81
 428  639  844 1041 1040 1230 1584 1411 1906 2056 1908 2055 2195 2572 2454 2781 2782 2874 2959 3036 3166 3219 3221 3265 3222 3267 3224 3268 3302 3227 3270 3272 3273 3274 3233 3184 3127 3062 2989 2908 2819 2722 2617 2504 2383 2254 2117 1972 1819 1658 1489 1312 1127  934  733  524  307   82
 204  425  637  638  843 1229 1583 1748 1749 1907 2054 2198 2196 2328 2570 2679 2780 2873 2958 3104 3037 3165 3218 3263 3262 3266 3328 3329 3269 3305 3306 3307 3308 3275 3234 3185 3128 3063 2990 2909 2822 2820 2723 2505 2384 2255 2118 1973 1820 1659 1490 1313 1128  935  734  525  308   83
 203  424  636  842 1039 1228 1409 1582 1747 1905 2053 2194 2327 2453 2452 2678 2779 2957 3034 3035 3103 3164 3216 3217 3300 3301 3348 3331 3350 3332 3333 3334 3309 3276 3235 3186 3130 3129 2991 2911 2910 2727 2618 2619 2385 2256 2119 1974 1821 1660 1491 1314 1129  936  735  526  309   84
 202  423  635  841 1227 1408 1407 1581 1746 1904 2052 2193 2326 2451 2569 2568 2677 2872 2956 3033 3102 3163 3213 3261 3299 3327 3347 3349 3330 3351 3352 3335 3310 3277 3236 3187 3064 3066 3065 2992 2620 2725 2821 2506 2386 2257 2120 1975 1822 1661 1492 1315 1130  937  736  527  310   85
 201  421  422  840 1038 1226 1406 1580 1902 1903 2051 2192 2325 2450 2567 2777 2778 2871 2870 2955 3100 3161 3162 3297 3298 3325 3326 3360 3362 3363 3353 3336 3311 3278 3237 3188 3131 2912 3067 2913 2621 2622 2724 2507 2508 2259 2258 1976 1823 1662 1493 1316 1131  938  737  528  311   86
 200  420  634  839 1037 1225 1405 1579 1745 1901 2050 2191 2324 2449 2566 2676 2776 2869 2954 3030 3032 3101 3260 3258 3215 3296 3346 3359 3361 3356 3354 3337 3313 3312 3238 3189 3132 2993 2995 2914 2726 2823 2824 2509 2387 2388 2121 1977 1824 1663 1494 1317 1132  939  738  529  312   87
 199  419  633  838 1036 1224 1578 1743 1744 1742 1900 2049 2323 2448 2565 2675 2775 2953 2952 3029 3031 3159 3257 3160 3211 3259 3345 3358 3357 3341 3339 3355 3281 3316 3190 3133 3134 3068 2994 2915 2825 2624 2728 2389 2260 2261 2122 1978 1825 1664 1495 1318 1133  940  739  530  313   88
 198  632  631  837 1035 1223 1404 1577 1899 2048 2047 2190 2189 2322 2564 2674 2673 2867 2950 2951 3099 3098 3210 3293 3323 3324 3344 3343 3319 3317 3342 3338 3314 3279 3239 3240 3069 3135 2996 2729 2916 2826 2510 2511 2390 2124 2123 1979 1826 1665 1496 1319 1134  941  740  531  314   89
 197  418  834  836 1034 1222 1403 1576 1741 1898 2046 2188 2321 2447 2446 2774 2866 2868 3156 3157 3209 3294 3295 3206 3212 3322 3321 3320 3318 3340 3286 3285 3282 3280 3241 3191 3136 3070 2997 2829 2827 2625 2623 2626 2391 2262 2125 1980 1827 1666 1497 1320 1135  942  741  532  315   90
 196  417  630 1032  835 1221 1402 1575 1740 1896 1897 2187 2444 2319 2669 2562 2672 2773 2563 2949 3097 3155 3255 3214 3253 3290 3252 3289 3288 3248 3315 3242 3192 3284 3244 3193 3071 2998 2828 2919 2830 2730 2513 2512 2392 2263 2126 1981 1828 1667 1498 1321 1136  943  742  533  316   91
 195  416  629  833 1033 1031 1401 1574 1738 1739 2186 2445 2320 2561 2670 2771 2772 3027 3028 3026 3095 3094 3254 3158 3205 3291 3250 3202 3249 3246 3247 3245 3143 3078 3200 3142 3194 3137 3072 2917 2733 2731 2627 2514 2393 2264 2127 1982 1829 1668 1499 1322 1137  944  743  534  317   92
 194  415  628 1030 1400 1220 1399 1573 1737 1895 2045 2317 2185 2441 2770 2668 2863 2865 2864 3025 3256 3208 3154 3292 3207 3150 3251 3148 3203 3201 3145 3287 3197 3283 3196 3243 3138 3074 3073 2999 2918 2732 2734 2628 2394 2265 2128 1983 1830 1669 1500 1323 1138  945  744  535  318   93
 193  414  627  832 1029 1219 1571 1572 1894 2043 2044 2184 2318 2442 2671 2560 2769 2862 2948 2947 3096 3093 3091 3153 3088 3151 3204 3147 3084 3146 3082 3144 3198 3081 3077 3195 3076 3000 3006 2920 2831 2629 2516 2515 2395 2266 2129 1984 1831 1670 1501 1324 1139  946  745  536  319   94
 192  413  626  831 1217 1028 1218 1398 1736 1893 2042 2183 2443 2558 2557 2667 2559 2861 2946 3024 3021 2945 3090 3152 3087 3017 3015 3086 3085 3083 3010 3199 2929 3141 3139 3008 2926 3140 3001 3002 2832 2735 2630 2517 2396 2267 2130 1985 1832 1671 1502 1325 1140  947  746  537  320   95
 191  412  625  830 1027 1216 1397 1570 1735 2041 2182 2315 2316 2440 2666 2767 2768 2860 2857 3092 3023 3019 3089 2939 2937 3149 3016 3014 3013 3012 2932 2928 3007 3079 2841 2927 2925 3075 3003 2921 2738 2736 2631 2518 2397 2268 2131 1986 1833 1672 1503 1326 1141  948  747  538  321   96
 190  411  624  829 1026 1215 1396 1569 1891 1892 2040 2181 2314 2555 2438 2665 2766 2859 2943 2941 2762 2940 3022 3018 2852 2851 2849 2935 2934 2933 2931 3080 3011 3009 2840 2641 2745 3005 2922 2833 3004 2835 2737 2632 2398 2269 2132 1987 1834 1673 1504 1327 1142  949  748  539  322   97
 189  410  623  828 1025 1214 1395 1568 1734 1890 2039 2180 2313 2439 2312 2765 2663 2858 2856 2657 2760 3020 2854 2756 2853 2938 2850 2936 2847 2848 2845 2749 2930 2843 2746 2644 2838 2640 2924 2741 2923 2740 2633 2519 2399 2270 2133 1988 1835 1674 1505 1328 1143  950  749  540  323   98
 188  409  622  827 1024 1213 1394 1567 1733 1889 2179 2037 2178 2556 2664 2764 2761 2855 2942 2658 2656 2758 2757 2654 2755 2754 2651 2753 2751 2844 2846 2646 2842 2748 2642 2744 2743 2839 2638 2639 2834 2524 2521 2522 2400 2272 2134 1989 1836 1675 1506 1329 1144  951  750  541  324   99
 187  408  621  826 1023 1212 1393 1731 1732 1887 1888 2038 2311 2437 2436 2662 2661 2944 2763 2659 2547 2759 2545 2655 2653 2652 2650 2649 2752 2537 2750 2647 2534 2645 2747 2530 2643 2739 2837 2742 2636 2836 2634 2405 2271 2401 2135 1990 1837 1676 1507 1330 1145  952  751  542  325  100
 186  407  620  825 1022 1211 1392 1566 1565 1730 2034 2309 2552 2553 2554 2432 2551 2550 2660 2428 2426 2544 2425 2543 2542 2541 2540 2539 2538 2536 2648 2535 2415 2412 2411 2532 2529 2410 2528 2527 2525 2635 2523 2520 2404 2273 2136 1992 1991 1677 1332 1508 1146  953  752  543  326  101
 185  406  618 1021  823 1210 1391 1564 1729 2177 2174 2310 2036 2434 2435 2433 2431 2430 2549 2548 2301 2546 2298 2424 2423 2422 2421 2420 2419 2418 2417 2416 2288 2531 2533 2413 2284 2006 2409 2406 2407 2408 2526 2403 2402 2274 2137 1838 1678 1331 1509 1333 1147  954  753  545  544  102
 184  405  824  619 1209 1388 1390 1885 2035 1886 2032 2033 2308 2307 2306 2170 2305 2303 2427 2429 2300 2164 2299 2162 2297 2296 2294 2293 2292 2291 2290 2289 2153 2414 2286 2285 2283 2282 2145 1693 2637 2280 2277 2142 2276 2275 2138 1993 1839 1840 1510 1148  955  755 1150  754  327  328
 183  404  617  821 1020 1207 1208 1728 1884 1389 2173 2175 2176 2172 2171 2027 2304 2169 2166 2302 2167 2163 2021 2020 2161 2295 2159 2158 2157 2156 2155 2010 2152 2287 2151 2150 2149 2148 2281 2002 2279 2278 1851 1999 2141 2140 2139 1994 1841 1679  956 1149  957 1334  547  330  329  103
 182  403  616  820  822 1018 1561 1727 1563 1883 2031 1721 2030 1878 1877 2028 2029 2026 2168 2024 2165 1870 1871 2018 2017 2160 2016 2015 2014 2013 2012 2154 2011 2009 2008 2007 2005 2004 2146 2147 2001 2144 1688 1998 1997 1846 1996 1681 1511 1512 1683 1680 1682 1335 1154  546  331  104
 181  402 1017 1016 1019 1206 1387 1560 1562 1726 1882 1722 1880 1879 1718 1717 1875 1874 2025 1873 2023 1872 1868 2019 1867 1866 1865 1864 1863 1862 1861 1860 1859 1858 1857 1856 1855 1854 1853 2003 1850 1852 2143 2000 1848 1685 1687 1844 1514 1341 1336 1151  958  959  756  758  757  105
 180  401  615  819 1015 1204 1205 1557 1386 1559 1881 1724 1720 1719 1716 1550 1549 1715 1713 2022 1710 1711 1544 1709 1708 1707 1706 1705 1704 1703 1702 1701 1700 1699 1698 1697 1696 1695 1694 1692 1525 1691 1849 1523 1521 1689 1345 1995 1845 1842 1338  961  960  761  759  107  550  106
 179  400  614  818 1014 1203 1385 1558 1556 1723 1554 1552 1725 1192 1551 1876 1547 1372 1714  998 1545 1712 1869 1543 1541 1540 1539 1538 1537 1536 1535 1534 1533 1532 1531 1530 1529 1528 1527 1526 1524 1166 1349 1847 1690 1163 1161 1686 1843 1342 1152 1340  762 1153  551  548  108  332
 178  612  613  817  816 1013 1384 1383 1197  809 1377 1380 1555 1376  802 1000 1373 1189 1371 1546 1370 1369 1368 1542 1367 1366 1181 1363 1362 1361 1360 1359 1358 1357 1356 1355 1354 1353 1352 1168 1351 1350 1348 1162 1520 1519 1346 1684 1518 1517 1513  963  766 1155  764  549  333  109
 398  399  610  611 1202  812 1201 1200 1382 1378 1381 1375 1195 1193  804  595  594  593 1188  997 1187 1186 1185 1184 1183 1364 1365 1180 1179 1178 1177 1176 1175 1174 1173 1172 1171 1170 1169  977 1167 1165 1164 1522  972 1344 1159  969 1343 1515 1158  563 1156  341  552  760  334  110
 177  608  175  609 1012  813 1010 1009 1198 1008 1553 1003 1004  806  596 1191 1002 1190 1548 1374  995  796  994  992  991 1182  990  989  988  987  986  985  984  983  982  981  980  979  978  778  976  975  974 1347  774 1160  971  770  968  558  767 1157  763  962  553  337  335  336
 396  176  815  814 1011  605  811  810 1007 1199  600 1194  807 1196 1005  379  801  592  378  996  591  590  795  993  793  792  791  790  789  788  787  786  785  577  784  783  782  781  780  571  777  776  775  773  973  347  970  771  560 1337 1516  966  964  967  556  554  113  111
 174  395  393  606  392  604  389  603  601 1006  599 1379  162  798  803  157  800  377  158  797  799  376  589  794  371  584  370  583  582  366  581  580  578  362  576  575  574  573  779  572  570  569  568  567  566  772  348  349  768  765 1339  965  342  340  344  115  118  338
 173  170  397  394  607  390  166  388  808  602  386  384  160  159  805 1001  380  155  154  375  373  152  150  588  372  585  586  368  367  143  365  579  364  139  361  360  359  358  357  356  355  354  353  352  351  564  350  125  559  561  123  122  116  120  343  557  555  112
 172  169  171  168  391  167  165  164  387  163  385  161  382  598  383  381  597  156  153  999  374  151  149  587  148  147  369  146  145  144  142  141  363  140  138  137  136  135  134  133  132  131  130  129  128  565  127  126  562  769  124  121  119  345  346  117  339  114
