# This puzzle is unsolvable
64
   2    1    3    4    5    6    8    9  259   10   11   12   13  265   14   16   17   18   19   20   21   22   23   24   25   26   27   28   29   30   31   32   33   34   35   36   37   38   39   40   41   42   43   44   45   46   47   48   49   50   51   52   53   54   55   56   57   58   59   60   61   62   63   64
 252  253  254  255  256  501    7  258  261  505  504  263  507  264   15  267  268  269  270  271  272  273  274  275  276  277  278  279  280  281  282  283  284  285  286  287  288  289  290  291  292  293  294  295  296  297  298  299  300  301  302  303  304  305  306  307  308  309  310  311  312  313  314   65
 251  496  497  498  499  257  736  500  260  739  262  506  742  509  266  510  511  512  513  514  515  516  517  518  519  520  521  522  523  524  525  526  527  528  529  530  531  532  533  534  535  536  537  538  539  540  541  542  543  544  545  546  547  548  549  550  551  552  553  554  555  556  315   66
 250  495  732  733  734  735  963  738  964  502  740  968  741  508  743  972  745  746  748  749  750  751  752  753  754  755  756  757  758  759  760  761  762  763  764  765  766  767  768  769  770  771  772  773  774  775  776  777  778  779  780  781  782  783  784  785  786  787  788  789  790  557  316   67
 249  494  731  960  961 1181  503 1183  737  965  966  967 1188  970  744 1191  973  747  975  976  977  978  979  980  981  982  983  984  985  986  987  988  989  990  991  992  993  994  995  996  997  998  999 1000 1001 1002 1003 1004 1005 1006 1007 1008 1009 1010 1011 1012 1013 1014 1015 1016  791  558  317   68
 248  493  730  959 1180 1182  962 1184 1395 1185 1186  969 1399 1189  971 1190 1192  974 1193 1194 1195 1197 1198 1199 1411 1200 1202 1203 1204 1205 1206 1207 1208 1209 1210 1211 1212 1213 1214 1215 1216 1217 1218 1219 1220 1221 1222 1223 1224 1225 1226 1227 1228 1229 1230 1231 1232 1233 1234 1017  792  559  318   69
 247  492  729  958 1179 1392 1393 1394 1598 1396 1397 1187 1398 1400 1401 1402 1403 1404 1405 1406 1196 1407 1613 1612 1409 1201 1413 1414 1415 1416 1417 1418 1419 1420 1421 1422 1423 1424 1425 1426 1427 1428 1429 1430 1431 1432 1433 1434 1435 1436 1437 1438 1439 1440 1441 1442 1443 1444 1235 1018  793  560  319   70
 246  491  728  957 1178 1391 1596 1597 1793 1599 1600 1601 1602 1603 1604 1605 1606 1607 1608 1609 1805 1408 1410 1614 1809 1412 1615 1616 1618 1619 1620 1621 1622 1623 1624 1625 1626 1627 1628 1629 1630 1631 1632 1633 1634 1635 1636 1637 1638 1639 1640 1641 1642 1643 1644 1645 1646 1445 1236 1019  794  561  320   71
 245  490  727  956 1177 1390 1595 1792 1980 1794 1795 1796 1797 1798 1799 1800 1801 1802 1803 1804 1806 1610 1807 1808 1611 1810 1811 1617 1812 1814 2001 1816 1817 1818 1819 1820 1821 1822 1823 1824 1825 1826 1827 1828 1829 1830 1831 1832 1833 1834 1835 1836 1837 1838 1839 1840 1647 1446 1237 1020  795  562  321   72
 244  489  726  955 1176 1389 1594 1791 1981 2160 1982 1983 1984 1985 1986 1987 1988 1989 1990 1991 1992 2173 1993 1994 1997 2176 1998 1999 1813 2179 1815 2002 2004 2005 2006 2007 2008 2009 2010 2011 2012 2013 2014 2015 2016 2017 2018 2019 2020 2021 2022 2023 2024 2025 2026 1841 1648 1447 1238 1021  796  563  322   73
 243  488  725  954 1175 1388 1593 1790 1979 2161 2162 2334 2333 2164 2165 2166 2167 2168 2169 2170 2171 2174 2345 1996 2175 2347 2177 2178 2000 2180 2181 2003 2183 2184 2185 2186 2187 2188 2189 2190 2191 2192 2193 2194 2195 2196 2197 2198 2199 2200 2201 2202 2203 2204 2027 1842 1649 1448 1239 1022  797  564  323   74
 242  487  724  953 1174 1387 1592 1789 1978 2159 2332 2496 2163 2335 2336 2337 2338 2339 2340 2341 2342 2172 1995 2663 2509 2346 2348 2349 2351 2352 2353 2182 2354 2355 2356 2357 2358 2359 2360 2361 2362 2363 2364 2365 2366 2367 2368 2369 2370 2371 2372 2373 2374 2205 2028 1843 1650 1449 1240 1023  798  565  324   75
 241  486  723  952 1173 1386 1591 1788 1977 2158 2331 2495 2497 2498 2499 2500 2501 2502 2503 2504 2505 2506 2344 2343 2508 2510 2511 2512 2350 2514 2515 2516 2517 2518 2519 2520 2521 2522 2523 2524 2525 2526 2527 2528 2529 2530 2531 2532 2533 2534 2535 2536 2375 2206 2029 1844 1651 1450 1241 1024  799  566  325   76
 240  485  722  951 1172 1385 1590 1787 1976 2157 2330 2652 2653 2800 2655 2802 2656 2657 2658 2659 2660 2661 2507 2809 2664 2665 2666 2667 2513 2669 2670 2671 2672 2673 2674 2675 2676 2677 2678 2679 2680 2681 2682 2683 2684 2685 2686 2687 2688 2689 2690 2537 2376 2207 2030 1845 1652 1451 1242 1025  800  567  326   77
 239  484  721  950 1171 1384 1589 1786 1975 2156 2329 2494 2651 2801 2654 2941 2803 2804 2805 2806 2807 2808 2948 2662 2811 2812 2813 2815 2668 2816 2817 2818 2819 2820 2821 2822 2823 2824 2825 2826 2827 2828 2829 2830 2831 2832 2833 2834 2835 2836 2691 2538 2377 2208 2031 1846 1653 1452 1243 1026  801  568  327   78
 238  483  720  949 1170 1383 1588 1785 1974 2155 2328 2493 2650 2799 2940 3072 2942 2943 2944 2945 2946 2947 2810 2949 2950 2952 2953 2814 2954 2955 2956 2957 2958 2959 2960 2961 2962 2963 2964 2965 2966 2967 2968 2969 2970 2971 2972 2973 2974 2837 2692 2539 2378 2209 2032 1847 1654 1453 1244 1027  802  569  328   79
 237  482  719  948 1169 1382 1587 1784 1973 2154 2327 2492 2649 2798 2939 3071 3073 3074 3076 3199 3077 3201 3078 3081 3205 2951 3083 3084 3085 3086 3210 3087 3089 3090 3091 3092 3093 3094 3095 3096 3097 3098 3099 3100 3101 3102 3103 3104 2975 2838 2693 2540 2379 2210 2033 1848 1655 1454 1245 1028  803  570  329   80
 236  481  718  947 1168 1381 1586 1783 1972 2153 2326 2491 2648 2797 2938 3196 3197 3312 3075 3200 3315 3316 3202 3079 3082 3204 3206 3207 3208 3209 3325 3088 3212 3213 3214 3215 3216 3217 3218 3219 3220 3221 3222 3223 3224 3225 3226 3105 2976 2839 2694 2541 2380 2211 2034 1849 1656 1455 1246 1029  804  571  330   81
 235  480  717  946 1167 1380 1585 1782 1971 2152 2325 2490 2647 2796 2937 3070 3195 3313 3198 3314 3317 3423 3203 3080 3319 3320 3321 3429 3322 3323 3324 3211 3327 3328 3329 3330 3331 3332 3333 3334 3335 3336 3337 3338 3339 3340 3227 3106 2977 2840 2695 2542 2381 2212 2035 1850 1657 1456 1247 1030  805  572  331   82
 234  479  716  945 1166 1379 1584 1781 1970 2151 2324 2489 2646 2795 2936 3069 3194 3311 3420 3421 3422 3522 3424 3318 3425 3426 3427 3428 3430 3431 3432 3326 3434 3436 3534 3437 3438 3439 3440 3441 3442 3443 3444 3445 3446 3341 3228 3107 2978 2841 2696 2543 2382 2213 2036 1851 1658 1457 1248 1031  806  573  332   83
 233  478  715  944 1165 1378 1583 1780 1969 2150 2323 2488 2645 2794 2935 3068 3193 3310 3419 3520 3521 3613 3523 3524 3525 3526 3527 3528 3529 3530 3531 3433 3533 3626 3435 3536 3537 3538 3539 3540 3541 3542 3543 3544 3447 3342 3229 3108 2979 2842 2697 2544 2383 2214 2037 1852 1659 1458 1249 1032  807  574  333   84
 232  477  714  943 1164 1377 1582 1779 1968 2149 2322 2487 2644 2793 2934 3067 3192 3309 3418 3519 3612 3696 3614 3615 3616 3617 3618 3619 3620 3621 3622 3532 3624 3535 3709 3627 3628 3629 3630 3631 3632 3633 3634 3545 3448 3343 3230 3109 2980 2843 2698 2545 2384 2215 2038 1853 1660 1459 1250 1033  808  575  334   85
 231  476  713  942 1163 1376 1581 1778 1967 2148 2321 2486 2643 2792 2933 3066 3191 3308 3417 3518 3697 3773 3610 3695 3699 3700 3701 3702 3703 3705 3779 3623 3706 3708 3625 3710 3711 3712 3713 3714 3715 3716 3635 3546 3449 3344 3231 3110 2981 2844 2699 2546 2385 2216 2039 1854 1661 1460 1251 1034  809  576  335   86
 230  475  712  941 1162 1375 1580 1777 1966 2147 2320 2485 2642 2791 2932 3065 3190 3307 3416 3517 3609 3611 3772 3698 3774 3775 3776 3777 3778 3704 3781 3848 3707 3782 3784 3785 3786 3787 3788 3789 3790 3717 3636 3547 3450 3345 3232 3111 2982 2845 2700 2547 2386 2217 2040 1855 1662 1461 1252 1035  810  577  336   87
 229  474  711  940 1161 1374 1579 1776 1965 2146 2319 2484 2641 2790 2931 3064 3189 3306 3415 3515 3516 3694 3771 3840 3841 3842 3843 3844 3845 3847 3780 3783 3849 3909 3850 3852 3853 3854 3855 3856 3791 3718 3637 3548 3451 3346 3233 3112 2983 2846 2701 2548 2387 2218 2041 1856 1663 1462 1253 1036  811  578  337   88
 228  473  710  939 1160 1373 1578 1775 1964 2145 2318 2483 2640 2789 2930 3063 3188 3305 3413 3414 3608 3693 3770 3839 3900 3901 3902 3903 3904 3846 3906 3907 3908 3851 3911 3962 3912 3913 3914 3857 3792 3719 3638 3549 3452 3347 3234 3113 2984 2847 2702 2549 2388 2219 2042 1857 1664 1463 1254 1037  812  579  338   89
 227  472  709  938 1159 1372 1577 1774 1963 2144 2317 2482 2639 2788 2929 3062 3187 3412 3303 3514 3607 3692 3769 3838 3899 3952 3953 3955 3956 3905 3957 3958 3959 3961 4003 3910 3963 3964 3915 3858 3793 3720 3639 3550 3453 3348 3235 3114 2985 2848 2703 2550 2389 2220 2043 1858 1665 1464 1255 1038  813  580  339   90
 226  471  708  937 1158 1371 1576 1773 1962 2143 2316 2481 2638 2787 2928 3061 3186 3304 3513 3606 3605 3691 3837 3836 3898 3951 3996 3954 3998 3999 4000 4001 4002 3960 4004 4005 4006 3965 3916 3859 3794 3721 3640 3551 3454 3349 3236 3115 2986 2849 2704 2551 2390 2221 2044 1859 1666 1465 1256 1039  814  581  340   91
 225  470  707  936 1157 1370 1575 1772 1961 2142 2315 2480 2637 2786 2927 3060 3184 3411 3410 3512 3604 3689 3768 3834 3835 3995 4032 3997 4033 4030 4035 4036 4037 4038 4039 4040 4041 3966 3917 3860 3795 3722 3641 3552 3455 3350 3237 3116 2987 2850 2705 2552 2391 2222 2045 1860 1667 1466 1257 1040  815  582  341   92
 224  469  706  935 1156 1369 1574 1771 1960 2141 2314 2479 2636 2785 2926 3059 3183 3185 3409 3511 3766 3690 3767 3895 3950 3949 4059 4031 4060 4063 4082 4064 4084 4065 4066 4008 4007 3967 3918 3861 3796 3723 3642 3553 3456 3351 3238 3117 2988 2851 2706 2553 2392 2223 2046 1861 1668 1467 1258 1041  816  583  342   93
 223  468  705  934 1155 1368 1573 1770 1959 2140 2313 2476 2477 2784 2925 3058 3301 3302 3510 3687 3509 3602 3603 3762 3897 3948 3994 4029 4028 4034 4079 4061 4092 4085 4069 4042 4009 3968 3919 3862 3797 3724 3643 3554 3457 3352 3239 3118 2989 2852 2707 2554 2393 2224 2047 1862 1669 1468 1259 1042  817  584  343   94
 222  467  704  933 1154 1367 1572 1769 1958 2139 2312 2478 2635 2783 3182 2923 3181 3300 3407 3408 3601 3764 3688 3890 3765 3947 3992 3993 4058 4081 4093 4094 4062 4067 4083 4043 4010 3969 3920 3863 3798 3725 3644 3555 3458 3353 3240 3119 2990 2853 2708 2555 2394 2225 2048 1863 1670 1469 1260 1043  818  585  344   95
 221  466  703  932 1153 1366 1571 1768 1957 2138 2475 3057 2633 2634 2780 2924 3299 3054 3298 3507 3600 3686 3831 3896 3894 3832 3946 4056 4080 4078 4095 4074 4089 4068 4070 4044 4011 3970 3921 3864 3799 3726 3645 3556 3459 3354 3241 3120 2991 2854 2709 2556 2395 2226 2050 2049 1864 1671 1470 1044  819  586  345   96
 220  465  702  931 1151 1152 1570 1767 1956 2137 2311 2310 2782 2632 2921 3180 3056 3508 3403 3406 3598 3685 3763 3833 3944 3893 3988 4057 4027 4091 4090 4051 4072 4086 4088 4087 4013 3971 3922 3865 3800 3727 3646 3557 3460 3355 3242 3121 2992 2855 2710 2557 2396 2227 1865 1866 1672 1471 1261 1263  821 1045  346   97
 219  464  701  930 1363 1150 1364 1766 1955 2136 2309 2474 2631 2779 2781 3055 3177 3295 3297 3179 3681 3506 3760 3761 3943 3990 4075 3991 4026 4077 4076 4055 4050 4073 4046 4012 4045 3972 3923 3866 3801 3648 3728 3558 3461 3356 3243 3122 2994 2993 2711 2558 2397 2228 2051 1673 1674 1472  820 1262  588  587  347   98
 218  463  700  929 1149 1365 1569 1765 1954 2135 2308 2473 2630 2922 3053 3296 3178 3401 3891 3405 3505 3599 3682 3683 3945 3830 3989 4024 4054 4022 3983 4052 4019 4049 4071 4048 4014 3973 3924 3867 3729 3730 3647 3559 3462 3357 3244 3123 2995 2856 2712 2559 2398 2229 2052 1867 1675 1473 1264 1046  822  589   99  100
 217  462  698  699  928 1362 1568 1764 1953 2134 2307 2472 2629 2778 2919 3293 3502 2920 3294 3402 3503 3684 3596 3892 3829 3888 3940 4025 3984 3937 3935 4021 3980 3932 4018 4047 3977 4015 3925 3868 3802 3358 3731 3649 3561 3359 3245 3124 2996 2857 2713 2560 2399 2230 2053 1868 1474 1475 1265 1047  349  590  101  350
 216  461  697  927 1148 1361 1567 1763 2132 1951 2133 2471 2628 2777 2918 3052 3050 3597 3404 3176 3758 3595 3679 3759 3889 3941 3827 3986 4053 3981 3982 4020 3877 3979 4016 3976 3929 3974 3869 3804 3805 3803 3650 3560 3464 3463 3465 3246 3125 2858 2859 2561 2400 2231 2054 1869 1676 1476 1266 1049 1048  823  591  348
 215  460  926  925 1147 1360 1566 1565 1762 1952 2306 2305 2470 2776 2916 2917 3051 3292 3501 3504 3594 3757 3826 3756 3987 3822 3942 4023 3821 3880 3815 3933 3978 3876 3931 4017 3874 3975 3927 3926 3871 3732 3651 3734 3562 3360 3126 2999 2997 2860 2714 2402 2562 2232 2055 1870 1678 1677 1267  825  824  592  351  102
 214  459  696 1146 1359 1358 1564 1761 1950 2131 2304 2469 2627 2626 2915 3049 3173 3175 3291 3399 3680 3754 3886 3825 3828 3751 3939 3881 3985 3818 3936 3934 3878 3814 3875 3930 3811 3928 3872 3806 3870 3733 3653 3565 3361 3362 3127 3129 3128 2861 2715 2563 2401 2234 2233 2056 1871 1477 1268 1050  826  593  352  103
 213  458  695  924 1145 1357 1563 1760 1949 2130 2303 2468 2625 2775 2774 3174 3048 3290 3500 3400 3593 3589 3755 3824 3753 3823 3883 3671 3670 3938 3816 3879 3665 3744 3813 3812 3740 3873 3810 3807 3736 3652 3564 3467 3563 3249 3247 3248 3000 2717 2564 2403 2236 2235 2057 1872 1679 1478 1052 1051  827  594  353  104
 212  457  694  923 1144 1356 1562 1759 1948 2129 2302 2467 2624 2773 2914 3047 3171 3172 3289 3499 3592 3678 3675 3587 3885 3887 3820 3749 3882 3819 3746 3748 3817 3666 3742 3741 3659 3576 3808 3809 3737 3735 3468 3466 3363 3364 2862 2864 2863 2718 2720 2716 2565 2404 2058 1873 1680 1270 1269 1053  828  595  354  105
 211  456  693  921  922 1143 1561 1758 1947 2128 2301 2466 2623 2772 2913 3046 3170 3398 3397 3498 3591 3677 3492 3673 3672 3493 3674 3750 3581 3580 3582 3668 3667 3578 3577 3662 3743 3739 3738 3658 3657 3656 3654 3569 3130 3250 3365 2866 3001 2998 2865 2566 2719 2059 2060 1874 1480 1479 1271 1054  596  355  106  107
 210  455  692 1142 1355 1354 1560 1757 1946 2127 2465 2621 2464 2771 2912 3169 3043 3287 3288 3396 3497 3676 3586 3389 3752 3884 3386 3488 3583 3669 3747 3579 3745 3483 3663 3574 3660 3661 3477 3571 3570 3655 3568 3566 3469 3251 3252 3002 3131 2867 2568 2240 2405 2567 1682 1683 1681 1481 1272 1055  829  597  357  356
 209  454  691  920 1141 1353 1559 1756 1945 2300 2125 2463 2622 2770 3168 3045 2910 3286 3395 3496 3590 3495 3491 3276 3585 3487 3584 3275 3486 3485 3381 3382 3664 3379 3482 3480 3478 3572 3374 3476 3475 3474 3567 3470 3472 3366 3253 3132 3255 3003 2722 2407 2062 2237 2061 1685 1482 1273  832 1274 1056  598  831  108
 208  453  690 1140 1352 1557 1558 1944 2126 2299 2619 2295 2297 2769 2911 3041 3284 3394 3282 3283 3392 3588 3494 3279 3387 3490 3489 3385 3273 3384 3383 3484 3380 3481 3575 3146 3265 3573 3263 3373 3372 3371 3473 3370 3369 3471 3133 3007 3005 3004 2724 2721 2406 1877 2238 1875 1876 1484 1483 1059  830  358  359  109
 207  452  689  919 1139 1556 1754 1755 1943 2124 2298 2294 2767 2461 2909 3040 3044 3167 3393 3281 3162 3280 3160 3390 3388 3157 3029 3274 3272 3153 3271 3270 3269 3149 3268 3378 3264 3377 3479 3262 3261 3259 2877 3257 3138 3367 3368 3009 3134 2569 2869 2723 2570 2239 2063 1684 1485 1878 1057  833  599  600  360  110
 206  451  688  918 1138 1350 1351 1753 1942 2460 2620 2768 2618 2907 2766 3039 3285 3165 3164 3035 3161 3278 3277 3158 3391 3032 3159 3028 3155 3152 3025 3151 3023 3147 3266 3267 3376 3375 3145 3143 2879 3141 3140 3258 3011 3256 3254 3136 3008 3006 2868 2571 2409 2408 2410 2066 2064 1276 1058 1275  834  601  361  111
 205  450  687  917  916 1137 1555 1752 1941 2123 2121 2616 2459 2908 2765 2905 3042 3038 3037 3163 2901 3034 3033 3031 3156 3030 2894 2893 3154 2891 3026 3024 3150 3022 3148 3019 2885 3144 3017 3016 3260 3014 3139 2878 2873 3137 3012 2581 2872 2579 2871 2572 2573 2411 2067 1686 1486 1688 1277  835 1061  602  112  113
 204  449  686  915 1136 1349 1554 1751 1940 2122 2292 2293 2617 2458 2613 2762 3166 2903 2902 3036 2899 2900 2898 2754 2896 2895 2750 2599 3027 2892 2746 2890 2888 2744 3021 2741 3018 2884 3015 2883 3142 2586 2880 3013 2585 3010 2874 3135 2730 2577 2870 2725 2726 2065 2241 1880 1879 1687 1487 1278 1060  836  362  114
 203  448  685  914 1135 1348 1553 1750 1939 2120 2296 2614 2764 2763 2454 2906 2761 2760 2758 2756 2757 2755 2897 2603 2753 2752 2751 2749 2596 2747 2436 2889 2594 3020 2745 2743 2739 2886 2882 2881 2738 2735 2733 2583 2876 2875 2732 2729 2728 2727 2413 2414 2242 2412 2244 1881 1690 1882 1279 1281  363 1063  606  364
 202  447  684  913 1134 1347 1552 1749 1938 2119 2457 2615 2462 2453 2452 2611 2904 2610 2759 2608 2607 2606 2604 2605 2602 2600 2598 2597 2439 2748 2437 2595 2268 2592 2887 2591 2742 2740 2588 2587 2737 2425 2734 2584 2582 2422 2420 2731 2578 2076 2576 2417 2245 2068 2069 1691 1884 1488 1062 1885  837  365  605  839
 201  446  683  912 1133 1346 1551 1748 1937 2118 2291 2456 2455 2612 2110 2285 2450 2449 2283 2448 2447 2446 2445 2444 2276 2601 2441 2440 2272 2270 2269 2435 2434 2593 2266 2264 2431 2589 2430 2260 2426 2259 2257 2736 2424 2421 2580 2252 2253 2075 2416 2418 2243 2415 1883 1692 1489 1492 1689  838  840 1064  603  115
 200  445  682  911 1132 1345 1550 1747 1936 2117 2290 2289 2288 2287 2284 1928 2451 2609 2107 2282 2281 2280 2279 2443 2275 2442 2274 2273 2438 2097 2096 2091 2093 2433 2265 2432 2590 2263 2429 2258 2261 2082 1901 2423 2256 2255 2254 1704 2250 2575 2574 2249 2247 2070 2246 1887 1280 1282 1067  609  604  608  119  116
 199  444  681  910 1131 1344 1549 1746 1935 2116 2115 2114 2113 2112 1736 2286 2109 2108 1732 1922 1734 2104 2278 2277 1920 2102 2099 1915 2271 2098 1912 2094 2095 2092 1719 1907 1906 2087 1905 2086 2428 2427 1898 1899 2081 2079 2077 2078 2419 2251 1892 2074 1295 2248 2072 1693 1490 1696 1283 1069 1066  367  369  117
 198  443  680  909 1130 1343 1548 1745 1934 1933 1932 1931 1930 1929 1737 2111 1927 1926 1534 2106 2105 1531 2103 2101 1917 2100 1916 1724 1525 1722 1913 1911 1910 1718 2267 2089 1715 2262 1904 1903 1712 2085 2083 1900 1706 1897 1895 1896 1893 1891 1890 1502 1888 2073 2071 1694 1065 1284 1288  607  368  118  120  610
 197  442  679  908 1129 1342 1547 1744 1743 1742 1741 1740 1739 1738 1735 1924 1536 1733 1731 1923 1925    0 1921 1919 1918 1727 1726 1318 1524 1725 1720 1520 1521 1908 2090 1717 1309 1714 2088 1514 1710 1508 2084 1708 1301 2080 1300 1705 1702 1701 1294 1500 1700 1499 1889 1886  138 1491 1068 1493  615  366  842  121
 196  441  678  907 1128 1341 1546 1545 1544 1543 1542 1541 1540 1539 1538 1537 1328 1533 1730 1532 1530 1729 1323 1321 1728 1527 1526 1914 1721 1522 1315 1723 1313 1909 1519 1516 1093 1713 1902 1711 1305 1303 1509 1511 1089 1507 1505 1703 1297 1894 1296 1501 1699 1498 1292 1497 1494  130 1289  371 1071  373  841 1286
 195  440  677  906 1127 1340 1339 1338 1337 1336 1335 1334 1333 1332 1331 1115 1330 1329 1535 1325  888 1326  886 1528 1529 1322 1319 1103 1317 1316 1098 1100 1523 1314 1518 1716 1517 1306 1307 1513 1092 1510 1709 1707 1302 1298 1085  859 1082 1503 1079 1078 1293 1697 1075 1698 1077 1291 1285  844  845  843  611  380
 194  439  676  905 1126 1125 1124 1123 1122 1121 1120 1119 1118 1117 1116  892 1114 1113  890 1327 1111 1109  885 1106 1105 1104 1320  880 1102 1101 1099  875 1312 1095  872 1096 1310 1094 1515 1091 1308  867 1088  631 1086 1083 1087 1506  860 1504  858 1080 1290  856 1074 1495 1072 1287 1695  370  848 1073  131  128
 193  438  675  904  903  902  901  900  899  898  897  666  894  664  893  661  658 1112  656 1110  887 1324  655 1108  884  882  881  649  879  878  877  876 1311 1097  641  871  639 1512  869  868 1304 1090  866  864  392  863  862 1299  628  625  384  624  855  853  385  378 1496  847  618  849 1070  612  374  375
 192  437  674  673  672  671  670  669  668  667  427  895  896  662  663  660  891  419  659  170  415  653  416 1107  883  651  650  410  647  646  645  644  406  873  643  405  399  870  400  637  397  636  635  633  146  632  861  630 1084  629  857  622  626  854  851  620  382  619  614  381  133  122  125  124
 191  436  435  434  433  432  431  430  429  428  180  426  425  665  424  422  421  889  420  172  417  654  413  414  652  412  411  409  648  408  407  874  158  403  154  640  153  152  155  638  396  395  865  634  394  145  391  390  627  388  139 1081  623 1076  140  135  852  123  616  617  372  613  846  126
 190  189  188  187  186  185  184  183  182  181  179  178  177  176  423  175  174  173  418  657  171  169  168  167  166  165  164  163  162  161  160  159  157  404  642  401  402  156  151  398  150  149  148  393  147  144  143  142  389  387  141  386  137  136  383  134  621  850  379  132  129  127  376  377
