# This puzzle is unsolvable
56
 435    3  221  222  223    7  229    5  643  227  228  442   11  232  234   15   17   18   19   20   21   22   23   24   25   26   27   28   29   30   31   32   33   34   35   36   37   38   39   40   41   42   43   44   46   47   48   49  268   50   51   52   53   54   55   56
   1  218  219  434    4    6  439  437    8  441  646   10  443  231   13   16  236  449  237  239  240  241  242  243  244  245  246  247  248  249  250  251  252  253  254  255  256  257  258  259  260  261  262  263   45  264  476  266  267  269  270  271  272  273  274   57
 432    2  636  433  224  225    9 1206  230  440  645 1027  644  233  446 1030  445  447  238  450  451  452  453  454  455  456  457  458  459  460  461  462  463  464  465  466  467  468  469  470  471  472  473  474  475  265  477  478  479  480  481  482  483  484  275   58
 431  430  220  436  637  639  226  642  839  838  840  841  647  649   14  235  650  448  652  653  654  655  656  657  658  659  660  661  662  663  664  665  666  667  668  669  670  671  672  673  674  675  676  678  873  679  875  680  876  683  684  685  686  485  276   59
 216  217  634  834  832  638  640  438  835 1025 1205  844  444   12 1029  648  845  651  847  848  849  850  851  852  853  854  855  856  857  858  859  860  861  862  863  864  865  866  867  868  869  870  871  677 1059 1061  874  682  681  878  879  880  687  486  277   60
 429  428  831  635 1022  833 1020  641 1204 1024  842 1028 1210 1378 1031  843 1381  846 1032 1036 1215 1037 1038 1039 1040 1041 1042 1043 1044 1045 1046 1047 1048 1049 1050 1051 1052 1053 1054 1055 1056 1057 1058  872 1239 1060 1062 1063  877 1065 1066  881  688  487  278   61
 215  830  633 1019 1201 1021 1373  836  837 1203 1375 1026 1541 1207 1209 1544 1034 1033 1035 1213 1214 1216 1217 1218 1219 1220 1221 1222 1223 1224 1225 1226 1227 1228 1229 1230 1231 1232 1233 1234 1235 1236 1237 1238 1240 1241 1412 1242 1064 1243 1244 1067  882  488  279   62
 214  427  632  829 1018 1199 1371 1372 1023 1202 1374 1208 1377 1376 1380 1545 1382 1211 1212 1548 1386 1387 1388 1389 1390 1391 1392 1393 1394 1395 1396 1397 1398 1399 1400 1401 1402 1403 1404 1405 1406 1407 1408 1409 1410 1574 1411 1413 1414 1245 1068  884  689  883  280   63
 213  426  631 1017 1200 1016 1198 1535 1536 1537 1540 1538 1696 1379 1698 1543 1700 1383 1702 1384 1549 1550 1551 1552 1553 1554 1555 1556 1557 1558 1559 1560 1561 1562 1563 1564 1565 1566 1567 1568 1569 1570 1571 1572 1729 1876 1575 1576 1415 1246 1069  690  691  489  281   64
 212  425  630  828 1015 1195 1534 1370 1692 1693 1539 1694 1542 1844 1695 1546 1848 1701 1385 1547 1704 1705 1706 1707 1708 1709 1710 1711 1712 1713 1714 1715 1716 1717 1718 1719 1720 1721 1722 1723 1724 1725 1726 1727 1573 1875 1730 1577 1416 1247 1070  692  492  490  491   65
 211  424  628  827  629 1197 1533 1368 1691 1840 1842 1843 2114 2117 1846 1699 1986 1849 1850 1703 1851 1852 1853 1854 1855 1856 1857 1858 1859 1860 1861 1862 1863 1864 1865 1866 1867 1868 1869 1870 1871 1872 1873 2013 1874 1728 1731 1578 1417 1248 1072  885  886  693  282   66
 210  423  825 1014 1196  826 1688 1690 1689 1530 1980 1838 2238 1845 1847 2115 2240 1987 1988 1989 1990 1991 1992 1993 1994 1995 1996 1997 1998 1999 2000 2001 2002 2003 2004 2005 2006 2007 2008 2009 2010 2011 2012 2014 2015 1877 1733 1579 1418 1249  887 1071  694  284  283   67
 209  422  627  824 1013 1369 1194 1532 1839 1835 1841 2110 1979 2112 2352 1984 2116 2118 2119 2120 2121 2122 2123 2124 2125 2126 2127 2128 2129 2130 2131 2132 2133 2134 2135 2136 2137 2138 2139 2140 2141 2143 2266 2145 2144 1732 1878 1580 1419 1250 1073  889  695  493  285   68
 208  421  626  822  823 1012 1365 1367 1686 1366 1837 1836 1697 2109 2460 2350 2241 2354 2561 2356 2359 2244 2246 2247 2248 2249 2250 2251 2252 2253 2254 2255 2256 2257 2258 2259 2260 2261 2262 2263 2264 2142 2146 2147 2016 1879 1734 1581 1420 1074 1075  891  888  494  495   69
 207  420  625 1011 1193 1364 1191 1687 1531 1834 1981 1983 2349 2236 2459 2353 2461 2242 2358 2243 2564 2245 2361 2362 2363 2364 2365 2366 2367 2368 2369 2370 2371 2372 2373 2374 2375 2376 2377 2378 2379 2265 2267 2017 2018 1880 1735 1582 1252 1251 1253  890  697  498  696   70
 206  419  624  821 1009 1010 1192 1529 1977 1978 1982 1974 2111 2239 2558 1985 2463 2462 2562 2357 2466 2360 2467 2469 2470 2471 2472 2473 2474 2475 2476 2477 2478 2479 2480 2481 2482 2582 2483 2484 2487 2380 2381 2268 2019 1881 1736 1583 1421 1254 1077 1076  496  288  286   71
 205  418  623  820 1190 1189 1363 1527 1682 2113 1684 1973 2351 2458 2234 1976 2560 2355 2737 2563 2566 2468 2657 2567 2660 2570 2571 2572 2573 2574 2575 2576 2577 2578 2579 2580 2581 2673 2583 2486 2488 2382 2269 2148 2020 1882 1737 1584 1422 1423 1078  699  698  289   72   73
 204  417  622  819 1008 1362 1526 1528 1975 2105 2237 2107 2235 2108 2228 2559 2652 2653 2464 2465 2655 2741 2739 2569 2658 2568 2662 2663 2664 2665 2666 2667 2668 2669 2670 2671 2672 2756 2674 2485 2584 2383 2272 2271 2149 1883 1738 1585 1424 1255  893  892  497  499  287  290
 203  416  621  818 1007 1188 1524 1360 1833 1685 1972 2230 2231 2456 2345 2650 2457 2735 2565 2654 2656 2740 2742 2659 2819 2661 2743 2746 2747 2748 2749 2750 2751 2752 2828 2753 2755 2757 2675 2586 2585 2270 2384 2150 2022 2021 1587 1739 1425 1256 1079  894  700  291   74   76
 202  415  620  817 1005 1006 1186 1358 1361 2106 1832 1831 2229 2347 2348 2557 2736 2651 2811 2738 2812 2881 2816 2817 2818 2884 2745 2820 2822 2823 2824 2825 2826 2894 2754 2896 2829 2758 2676 2489 2490 2385 2151 2273 2023 1884 1885 1586 1426 1257 1080  702  701  501  500   75
 201  414  619  816 1004 1187 1525 1681 1830 2233 2346 1969 2232 2556 2454 2649 2648 2810 2813 2814 2815 2991 2883 2885 2886 2887 2888 2821 2889 2890 2891 2892 2952 2893 2895 2827 2830 2831 2677 2587 2588 2491 2386 2153 2152 1886 1740 1741 1427 1258 1081  895  704  503  703  292
 413  618  615  814  815 1185 1359 1523 1970 1683 2103 2104 2100 2344 2452 2455 2733 2734 2880 2940 2939 2882 2942 2943 2944 2945 2946 2947 2948 2949 2950 2951 3005 2953 2954 2897 2832 2759 2678 2589 2492 2387 2274 2024 2025 1887 1742 1588 1259 1082 1083  897  502  294  293   77
 200  411  617 1003 1184 1356 1522 1521 1679 1678 1680 1827 1829 2453 2226 2555 2731 2809 2878 2879 2941 2990 2993 2995 2996 2744 2997 2998 2999 3000 3001 3003 3046 3006 3004 2955 2898 2833 2679 2590 2493 2389 2388 2275 2154 1888 1743 1589 1431 1429  898  896  506  706  295  505
 199  412  410  812 1002 1357 1355 1828 1971 1966 2101 2227 2224 2342 2102 2554 2732 2451 2647 2876 2992 3034 3035 3037 3038 3039 3040 3041 3042 3043 3045 3002 3047 3080 2956 2899 2834 2760 2680 2592 2591 2494 2276 2155 2026 1889 1744 1590 1260 1428 1261 1084  705  296  504   78
 195  196  198 1182 1181 1180 1183 1520 1677 1826 1967 2341 2343 2225 2646 2340 2808 2645 2807 2875 2989 2938 3036 2994 3073 3074 3075 3076 3077 3078 3044 3081 3079 2957 2958 2900 2761 2762 2681 2495 2496 2390 2157 2028 2277 1890 1745 1591 1430 1592 1263  899  900  707  297   79
 194  612  409  197  616  999 1354 1519 1676 2099 1825 1965 2450 1968 2643 2551 2730 2644 2729 2877 2937 3071 3070 3072 3100 3101 3102 3103 3104 3105 3106 3048 3049 3007 3008 2901 2835 2763 2682 2497 2594 2278 2279 2156 2027 1891 1746 1593 1264 1085 1434  903  507   81   82   80
 408 1000  614  997 1001 1353 1352 1518 1675 1823 1824 2223 2339 2449 2549 2726 2642 2552 2936 2874 2934 2935 3031 3033 3099 3120 3132 3121 3122 3124 3109 3107 3083 3082 3009 2903 2902 2836 2683 2593 2392 2158 2596 2394 1893 1747 1748 1595 1594 1433 1432  509  901  298  709   83
 613  813  811  810  998  807 1516 1179 1674 1822 1964 2098 2338 2553 2550 2639 2728 2806 2805 2804 2873 2988 2986 3032 3098 3131 3130 3133 3123 3125 3111 3108 3050 3011 2959 2960 2837 2765 2595 2498 2283 2500 2393 2280 1892 1894 1435 1597 1089 1087 1262 1086  902  508  299   84
 193  610  809 1178  996 1175 1351 1517 1673 1821 2094 1963 2097 2337 2221 2448 2548 2803 2727 2872 2933 2987 3069 3068 3095 3097 3119 3115 3134 3110 3054 3084 3053 2961 3010 2766 2839 2685 2764 2282 2499 2161 2391 2160 2029 2031 1749 1750 1436 1088 1265  904  710  708  300  301
 611  405  407  808 1177  995 1350 1515 1349 1962 2096 2220 2222 2336 2446 2547 2447 2725 2802 2871 2931 2932 3030 2985 3067 3118 3116 3129 3126 3135 3112 3085 3051 3086 2905 2838 2767 2684 2904 2686 2597 2396 2162 2033 2159 1896 1895 1596 1267 1090  905  712  711  510  511   85
 406  189  190  192  609  994 1348 1513 1820 1672 2095 1961 2219 2334 2444 2445 2640 2641 2801 2870 2930 3028 2984 3029 3066 3096 3117 3114 3128 3127 3089 2906 3052 3012 2962 2840 2842 2768 2687 2598 2395 2030 2281 2163 2032 1751 1752 1437 1598  906 1266  907  713  512  302   86
 401  188  806 1174  804  993 1176 1671 1514 1819 2092 1959 2093 2443 2335 2546 2638 2724 2723 2800 2869 2983 3065 3064 3094 3092 3060 3061 3113 3090 3057 3058 3014 3055 2841 3013 2907 2769 2688 2599 2502 2398 2501 2397 2034 1898 1600 1268 1269 1091 1270 1092  714  513  304   87
 404  191  605  608  606 1347 1346 1512 1670 1668 1818 1960 2218 2217 2544 2637 2545 2722 2799 2868 2929 2982 3026 3027 3063 3093 3091 3022 3020 2972 3087 3059 3016 2963 2964 2909 2844 2843 2689 2600 2503 2399 2284 2164 2035 1899 1599 1438 1439 1271 1093  514  305  303  715   88
 186  607  805  399  803  992 1173 1511 1669 1817 1958 2333 2216 2215 2442 2543 2721 2720 2798 2867 2928 2981 2979 3025 3024 3062 3023 3021 3088 3018 3017 3056 2970 2969 3015 2908 2772 2770 2691 2690 2601 2504 2287 2165 2036 1753 1441 1601 1897 1094 1095  908  716  515  306   89
 402  604  403  802  400 1172 1345 1510 1667 1816 1957 2091 2332 2089 2441 2635 2634 2636 2797 2866 2927 2980 2978 2977 2976 2975 2974 2857 2973 2916 2852 3019 2913 2968 2966 2965 2776 2771 2692 2603 2506 2288 2285 2286 1900 2037 1755 1603 1602 1272  910  909  717  516  307   90
 187  990  185  991  801 1171 1344 1509 1666 1815 1956 2090 2088 2214 2541 2542 2633 2719 2796 2865 2926 2925 2924 2923 2922 2921 2920 2919 2918 2853 2851 2971 2850 2967 2847 2773 2848 2602 2505 2402 2401 2400 2167 2038 2039 1756 1901 1442 1440 1273 1096  911  718  517  308   91
 397  987  398  989  800 1169 1343 1508 1665 1814 1955 2330 2331 2438 2440 2540 2632 2718 2795 2864 2863 2862 2861 2860 2859 2858 2855 2786 2784 2917 2782 2914 2915 2912 2910 2845 2777 2846 2774 2507 2289 2168 2403 2166 2040 1754 1757 1443 1444 1274 1275 1097  719  518  309   92
 600  184  182 1170  799 1342 1507 1506 1664 1813 1954 2087 2213 2439 2329 2539 2631 2717 2794 2793 2792 2791 2790 2789 2788 2787 2856 2785 2783 2854 2781 2849 2779 2701 2911 2697 2611 2775 2604 2693 2510 2509 2290 2169 1758 1902 1759 1604 1445 1276 1098  912  720  519  310   93
 181  395  183  798  988 1168 1341 1663 1812 1953 1952 2211 2212 2328 2437 2537 2538 2630 2714 2627 2713 2712 2711 2709 2622 2708 2707 2706 2705 2704 2703 2702 2780 2699 2778 2610 2698 2696 2605 2508 2606 2404 2291 2170 1903 2041 1905 1904 1099 1277  914  913  721  520  311   94
 396  602  603  601  986 1167 1340 1505 1662 1811 2085 2086 2210 2327 2436 2629 2534 2535 2628 2715 2626 2625 2624 2710 2621 2620 2619 2618 2617 2616 2615 2520 2518 2612 2519 2613 2695 2513 2694 2608 2607 2405 2292 2171 2042 1606 1446 1607 1447 1605 1100  915  722  521  312   95
 179  180  599  797  796 1166 1339 1504 1661 1810 1950 2084 2209 2326 2434 2435 2432 2716 2533 2532 2531 2530 2529 2623 2527 2525 2422 2524 2523 2522 2521 2417 2614 2517 2516 2413 2515 2609 2514 2512 2511 2406 2293 2172 2043 1906 1760 1761 1608 1278 1101  916  723  522  313   96
 392  393  394  795  985  984 1338 1503 1660 1809 2082 1949 2083 1951 2536 2203 2433 2431 2430 2429 2428 2427 2426 2528 2425 2423 2526 2310 2420 2419 2418 2416 2415 2700 2414 2302 2412 2411 2410 2409 2408 2407 2294 2173 2044 1907 1762 1609 1448 1279 1102  917  724  523  314   97
 178  794  598  391 1164 1165 1337 1502 1658 2081 1659 2208 2324 2325 2322 2323 2321 2320 2319 2318 2317 2316 2315 2314 2424 2193 2421 2311 2190 2309 2308 2306 2305 2304 2303 2183 2301 2300 2299 2298 2297 2296 2295 2174 2045 1908 1763 1610 1449 1280 1103  918  725  524  315   98
 177  596  983  793  982 1163 1336 1501 1807 1806 1808 2206 2207 2205 2077 2204 2202 2201 2200 2199 2198 2197 2196 2195 2312 1932 2192 2064 2063 2189 2307 2187 2186 2185 2057 2182 2055 2181 2180 2179 2178 2177 2176 2175 2046 1909 1764 1611 1450 1281 1104  919  726  525  316   99
 176  390  792  981 1161 1162 1335 1500 1657 1948 1946 1947 2080 2078 1647 2076 1940 2074 2073 2072 1935 2071 2068 1933 2069 1930 2313 2191 2065 2062 2188 2060 2059 2058 2056 2184 2054 1919 2053 2052 2051 2050 2049 2048 2047 1910 1765 1612 1451 1282 1105  920  727  526  317  100
 389  597  595  791  593 1160 1334 1499 1656 1805 1945 1802 2079 1943 2075 1798 1941 1939 1938 1793 1937 2070 1934 2194 2067 2066 1787 1929 1928 1927 2061 1926 1781 1924 1922 1920 1778 1776 1918 1917 1773 1916 1914 1913 1912 1911 1766 1613 1452 1283 1106  921  728  527  318  101
 175  388  594  980  979 1333 1332 1498 1655 1653 1803 1944 1650 1942 1648 1799 1796 1795 1794 1936 1642 1792 1791 1790 1638 1788 1786 1635 1785 1784 1783 1925 1782 1923 1780 1779 1921 1777 1775 1774 1915 1621 1772 1770 1769 1768 1767 1614 1453 1284 1107  922  729  528  319  102
 174  387  592  790  789  978 1496 1331 1497 1654 1804 1651 1490 1801 1800 1645 1797 1644 1318 1643 1482 1641 1640 1479 1637 1931 1636 1633 1476 1474 1632 1473 1629 1470 1628 1627 1626 1625 1624 1623 1622 1461 1771 1620 1618 1617 1616 1615 1454 1285 1108  923  730  529  320  103
 173  386  591  788  977 1159 1330 1158 1494 1326 1652 1323 1492 1322 1488 1646 1649 1485 1319 1142 1484 1481 1639 1789 1313 1311 1477 1634 1133 1307 1472 1631 1304 1630 1469 1468 1467 1465 1299 1464 1463 1462 1460 1619 1459 1458 1457 1456 1455 1286 1109  924  731  530  321  104
 172  385  787  976  975 1157 1329 1495 1328 1327 1325 1493 1150 1321 1491 1487 1320 1486  962 1143 1483 1139 1480  955 1141 1478 1310 1309 1475 1471  948 1305 1129 1303 1302 1301 1300 1466 1298 1122 1297 1294 1119 1293 1292 1291 1290 1289 1288 1287 1110  925  732  531  322  105
 171  170  589  786  588 1156 1155 1154 1153 1152 1151  966 1324 1149 1147 1489 1145 1317  960  769 1316 1315 1138 1312 1140 1136  953 1134 1308    0 1306  945  947 1128 1127 1126 1125 1124 1123  938 1296 1121 1295 1117  933 1116  741 1115 1113 1112 1111  926  733  532  323  106
 383  169  590  785  974  973  972  779  971  969  968  965  575 1148  963  770 1146  959  768  364  957  766  569 1314 1137  952  954  951  950 1130 1132 1131  946  944  943  942  941  940  939  937  747 1120 1118  936  543  934  932 1114  930  929  928  927  734  533  324  107
 587  382  384  784  377  783  782  970  778  776  775  368  777  774  964  773 1144  772  146  362  958  956  764  763  564  761 1135  760  759  949  756  757  755  349  753  752  751  750  749  748  548  746  544  935  546  743  740  931  739  738  737  736  735  534  325  108
 168  381  586  584  585  583  581  780  579  578  580  967  371  572  366  576  573  961  574  767  568  566  765  565  563  762  562  561  560  758  351  134  556  754  555  553  552  551  550  549  341  547  545  744  337  542  742  541  540  539  538  537  536  535  326  109
 167  165  379  378  161  375  582  374  781  155  159  157  369  154  571  149  365  150  148  570  360  145  359  358  357  356  355  354  353  559  352  557  558  348  554  131  346  344  343  342  126  340  745  339  122  336  335  334  333  332  331  330  329  328  327  110
 166  164  380  163  376  162  160  577  158  373  372  370  156  367  153  152  771  147  151  567  363  361  144  143  142  141  140  139  138  137  136  350  135  133  347  132  345  130  129  128  127  125  124  338  123  121  120  119  118  117  116  115  114  113  112  111
