# This puzzle is unsolvable
45
 176    2    1  348  346    7  181  185    8  184  183  353   11   14   15   16   17   18   19   20   21  197   23   24   25   27   28  203  204   29   31  206   33  210  377   36   38   39  214   40   41   42   43   44   45
 178    3  179  347    5  180    6  350   10  352  186  187   13  189  190  191  192  193  194  195  196  198   22  200  201   26  202  370  372   30   32  375  205  209   35   37  212  380  213  215  216  217  218  219   46
 345  177  504    4  507  508  351  349    9  511  355  188   12  356  357  358  359  360  361  362  363  364  366  199  367  368  369  529  371  531  207  533  208   34  376  211  378  379  381  382  383  384  385  220   47
 502  505  174  656  657  506  182  510  661  806  663  354  514  515  516  517  518  519  520  521  522  523  365  525  526  527  528  530  532  373  374  684  534  535  536  537  538  539  540  541  542  543  386  221   48
 344  343  172  501  339  658  659  660  509  805  512  513  665  666  667  668  812  669  671  672  673  674  524  954  676  677  678  679  681  682  826  683  685  686  687  688  689  690  691  692  693  544  387  222   49
 175  503  173  655  798  800  803  938  804  662  807  664  808  809  810 1073  811  670  813  950  815  816  817  675  820  821  822  680  823  824  825  827  828  829  830  831  832  833  834  835  694  545  388  223   50
 342  500  654  799  338  802  801  936  939  940  941  942  943  944  945  946 1076 1075  814  949  952 1079  819  818  955 1084  957  958  959  960  961  962  963  964  965  966  967  968  969  836  695  546  389  224   51
 341  170  653  340  499  935  937 1065 1066 1067 1187 1068 1070 1190 1071 1074  947 1195  948 1077  951 1080  953 1081 1082  956 1083 1085 1086 1087 1088 1089 1090 1091 1092 1093 1094 1095  970  837  696  547  390  225   52
 168  171  169  651  652  934 1064 1183 1184 1185 1186 1069 1188 1191 1301 1302 1192 1193 1304 1196 1078 1198 1199 1200 1201 1202 1203 1204 1205 1206 1207 1208 1209 1210 1211 1212 1213 1096  971  838  697  548  391  226   53
 167  797  796  337  932  795 1063 1062 1295 1296 1298 1300 1403 1586 1404 1305 1499 1303 1410 1197 1308 1309 1310 1311 1312 1313 1314 1315 1316 1317 1318 1319 1320 1321 1322 1323 1214 1097  972  839  698  549  392  227   54
 336  497  498  794  649  933 1061 1182 1400 1401 1297 1398 1189 1585 1299 1405 1408 1194 1409 1307 1505 1412 1413 1414 1415 1416 1418 1513 1419 1420 1421 1422 1423 1424 1425 1324 1215 1098  973  840  699  550  393  228   55
 166  335  496  650  931  930 1060 1181 1294 1399 1496 1397 1587 1500 1072 1407 1588 1503 1306 1593 1411 1506 1508 1509 1510 1417 1512 1600 1514 1515 1516 1517 1518 1519 1426 1325 1216 1099  974  841  700  551  394  229   56
 165  334  495  648  792  793 1059 1180 1293 1494 1402 1493 1495 1498 1502 1406 1501 1591 1504 1592 1673 1507 1596 1595 1597 1676 1511 1601 1680 1602 1603 1604 1605 1520 1427 1326 1217 1100  975  842  701  552  395  230   57
 164  333  494  647  928 1057 1058 1179 1396 1582 1291 1581 1497 1665 1666 1667 1668 1589 1590 1671 1672 1594 1674 1746 1675 1598 1599 1678 1812 1681 1682 1683 1606 1521 1428 1218 1101 1102  976  843  702  553  396  231   58
 163  332  493  646  791  929 1056 1176 1178 1292 1583 1663 1584 1736 1738 1735 1858 1803 1670 1740 1744 1745 1808 1809 1747 1677 1869 1679 1752 1815 1753 1684 1607 1522 1429 1327 1329 1103  977  844  703  554  397  232   59
 162  331  492  645  789  790  927 1055 1177 1395 1664 1491 1492 1737 1800 1669 1856 1802 1741 1743 1742 1806 1863 1807 1810 1748 1811 1750 1751 1754 1686 1685 1608 1430 1431 1219 1220 1328  978  845  704  555  398  233   60
 161  330  491  644  788  926 1289 1490 1290 1393 1580 1579 1662 1661 1855 1854 1801 1857 1859 1739 1861 1862 1951 1864 1866 1813 1814 1749 1816 1755 1757 1687 1609 1523 1330 1221 1332 1104  979  846  705  556  399  234   61
 160  329  490  787  642  925 1054 1175 1288 1394 1392 1578 1660 1734 1798 1902 1904 1905 1860 1908 1804 1910 1982 1865 1911 1912 1953 1913 1870 1916 1756 1610 1525 1524 1432 1105 1331 1106  980  847  706  557  400  235   62
 159  328  489  640  643  924 1053 1052 1286 1391 1287 1659 1487 1733 1799 1797 1853 1944 1906 1946 1805 1907 1979 1909 2004 1867 1871 1917 1818 1758 1817 1688 1526 1528    0 1433 1107  981  982  848  707  558  401  236   63
 158  327  488  641  784 1173  922 1174 1172 1488 1576 1489 1657 1732 1731 1796 1903 1942 1977 1975 1978 1947 1949 1983 1914 1984 1952 1868 1915 1919 1819 1612 1527 1434 1333 1224 1222 1108  983  849  708  559  402  237   64
 157  326  485  487  786  785  923 1051 1285 1390 1486 1574 1577 1730 1852 1658 1850 1945 2008 1974 2002 1948 2022 1981 1950 2005 1918 1920 1954 1872 1690 1873 1691 1614 1435 1334 1223 1109  984  850  709  560  403  238   65
 156  325  484  486  639  921 1050 1171 1284 1389 1575 1573 1656 1795 1898 1793 1901 1940 1900 2015 2003 2017 2023 2018 1980 2006 1957 1921 1874 1820 1759 1611 1692 1529 1335 1336 1225 1226  985  851  710  561  404  239   66
 155  324  637  783  782  920 1049 1170 1283 1388 1485 1655 1571 1729 1794 1976 1897 1851 1943 1973 2016 2012 2020 2019 1956 1958 1986 1876 1875 1760 1761 1615 1613 1436 1530 1337 1227 1110  852  853  711  562  405  240   67
 154  322  323  638  781  919 1048 1169 1282 1387 1484 1572 1728 1727 1792 1849 1941 1997 1998 2014 2001 2000 1992 2021 1985 1955 1959 1823 1824 1821 1877 1689 1762 1693 1437 1338 1228 1111  987  986  563  564  406  241   68
 153  321  482  483  636  918 1047 1281 1167 1386 1652 1653 1654 1791 1847 1848 1995 1899 1972 1968 1938 1996 1991 1993 1963 2009 2007 1960 1822 1826 1764 1763 1616 1617 1438 1531 1230 1229 1112  713  712  407  408  242   69
 152  149  481  635  780  917 1046 1168 1279 1385 1483 1570 1790 1725 1789 1846 1937 1843 1939 1969 2013 2024 1886 1990 2010 1988 1989 1878 1922 1825 1695 1694 1533 1534 1439 1440 1339 1113  854  855  714  566  565  243   70
 151  150  480  915  634  916 1044 1166 1383 1280 1482 1569 1724 1726 1845 1896 1970 1971 1713 1933 1889 1999 1964 2011 1962 1987 1961 1923 1924 1879 1766 1696 1532 1618 1441 1340 1231 1114  988  989  715  409  244  245   71
 320  319  633  779  778 1045  914 1165 1384 1382 1481 1650 1651 1786 1935 1936 1893 1932 1887 1891 1994 1965 1929 1885 1927 1774 1926 1925 1880 1697 1765 1620 1619 1535 1442 1341 1233 1115  990  856  716  567  410  246   72
 148  478  631  477  775  913 1043 1164 1479 1480 1277 1568 1722 1787 1718 1721 1895 1781 1890 1966 1934 1930 1837 1836 1834 1884 1772 1883 1881 1699 1827 1698 1621 1536 1443 1232 1234 1116  991  857  858  569  568  411   73
 632  318  777  776  630 1041 1163  912 1275 1380 1567 1649 1648 1723 1844 1788 1894 1839 1780 1711 1838 1967 1888 1928 1833 1832 1882 1831 1829 1828 1768 1767 1700 1537 1444 1342 1235 1117  992  859  717  719  718  412   74
 317  146  479  774  315 1038  911 1276 1381 1379 1278 1566 1647 1720 1644 1715 1783 1842 1712 1639 1892 1931 1636 1777 1708 1776 1835 1771 1830 1770 1769 1623 1622 1538 1445 1343 1344  993  994  860  720  570  413  247  248
 145  316  147  771  629  909 1042 1161 1274 1477 1478 1476 1565 1645 1841 1641 1719 1559 1782 1555 1779 1638 1553 1635 1775 1630 1773 1548 1704 1702 1701 1624 1539 1446 1447 1346 1118 1236  995  861  571  414  415  249   75
 475  476  628  910 1039 1037 1272 1273 1162 1474 1564 1471 1646 1716 1470 1265 1785 1369 1714 1784 1710 1634 1633 1709 1462 1706 1705 1629 1628 1545 1542 1703 1626 1540 1450 1347 1345 1238 1120  862  721  572  416  250   76
 314  313 1040  137  143  472  772 1157 1378 1475 1160 1473 1563 1562 1640 1642 1561 1840 1145 1554 1463 1637 1778 1550 1707 1632 1549 1631 1546 1547 1453 1627 1625 1351 1448 1541 1121 1119  996  863  722  251   78   79   77
 473  142  627  626  908  907 1377 1159 1375 1271 1371 1374 1372 1558 1643 1467 1556 1717 1466 1464 1557 1143 1552 1460 1459 1458 1457 1456 1544 1356 1454 1543 1451 1352 1237 1239 1348 1122  997  864  573  574  417  252   80
 311  474  144  770  625 1035 1158 1376 1268 1028 1472 1373 1264 1469 1144 1148 1560 1365 1465 1468 1258 1461 1362 1551 1253 1360 1359 1248 1455 1355 1133 1353 1245 1129 1243 1449 1241 1349  998  865  723  575  418   81  254
 141  624  622 1036  621  769 1156  906 1269 1267 1029 1150 1149 1370 1027 1260 1364 1022 1261 1259 1256 1363 1255 1361 1254 1252 1358 1251 1134 1246 1354 1452 1131 1128 1350 1240 1123 1003 1124  866  724  576  725  419  253
 766  312  468  773  138 1033 1270  768 1154 1032 1266 1151  898 1147 1030 1367 1366 1021 1262 1142 1368 1141  886 1139 1138 1137 1013 1357 1249  877  879 1244 1007  735  875 1006 1242 1001 1000  867  999  577  420  255   82
 140  307  310  471  767  136  904 1155  901 1031  900 1152  607 1026 1146 1023 1263 1024  752 1020 1140 1018 1016 1017 1015 1014 1135 1250 1012 1136 1247 1008 1132  876 1127  873 1002 1125  869  730  726  578  421  256   83
 306  461  905  617  623  309  616  899  759 1153  613  896  754  454  756  893  287  891  889  750  888 1257 1019  744  885  884  883  880 1011  739  878 1009  874 1126 1130 1005  872  871  585  731  868  579  422  257   84
 464  466  467  131  462  298  126  457  903  760  612  758  897  610  894  609  449 1025  890  749  602  887  746  747  598  881  740  882  438  594 1010  738  737  736 1004  734  733  732  870  728  727  580  423  258   85
 469  139  465  619 1034  470  762  763  902  458  761  290  895  292  606  755  118  605  751  603  448  601  111  599  108  743  441  596  741  592  437  591  590  589  588  587  586  584  583  582  729  426  424  259   86
 303  308  304  305  618  133  128  615  614  293  611  455  291  608  892  115  285  286  450  604  446  748  112  442  597  742  745  595  593  276  439  436  435  434  433  432  431  430  429  428  581  427  425  260   87
 302  132  765  301  300  620  297  459  299  295  123  294  120  757  452  453  116  284  753  445  113  447  110  600  280  443  277  106  275  440  274  103  273  271  270  269  268  267  266  265  264  263  262  261   88
 463  134  127  135  129  130  764  125  296  121  460  124  456  122  451  289  119  117  288  114  282  283  281  444  279  109  107  278  105  104  102  101  272  100   99   98   97   96   95   94   93   92   91   90   89
