# This puzzle is unsolvable
34
 259  132  136  257    4  135    5    9   10  139   11   13  144   15   14   16   18   20  150  495  275  153   23   25   26   27   28  158   29  162  166   30   35   31
 254  133    2  137  130  373  262    7    8  141  142   12  380  268  266  147  148   19  273   21  272  152  154  392   24  156  157  289  283  160  399  287   33   36
 255  376  256    3    6  374  375  138  263  264  267  143  489  146  269   17  270  389  151  497  496   22  277  278  690  692  279  159  400   39   34  507  164   38
 134  372  481  480  260  370  377  261  140  486  487  679  382  491  591  683  271  388  492  274  276  601  155  688  915  394  693  504  604  284  502  161  165  285
 131    1  129  580  756  671  484  378  584  488  381  383  379  145  387  149  386  768  593  494  968  391  390  500  600  280  505  397  398  606  694  506   37  163
 253  127  126  483  128  581  258  583  676  586  485  490  680  589  384  493  385  592  594  499  599  597  393  774  395  282  396  603  288   32  286  401   41  168
 371  252  477  482  672  675  585  582  673  834  760  588  590  265  681  684  841 1018  687  498  595  842  685  598  775  281  403  605  510  503  291  404  170  167
 475  368  125  833  479  579  369  577  758  677  836  835  903  764  838  839  767  970  686  596  689  501  771  691  602  769  776  850  290  169  607  402  405   42
 478  251  366  576  755  829  575  901  674  907  761  762  678  587  763  682 1020  909  911  770  912  773  974  846  847  851  772  849  608  509  508  171   43   40
 250  123  578  249  669  759  754  897  752  959  900  904 1055 1015  766  765  966 1017  967 1062  971  844  914  848  845  916  700  778  696  511  406  407  294  173
 124  247  367  670  574  830  902  898  962  831  960  961  965  964  905  908  969 1061 1097  840 1024  913  975  918  852  917  855  695  777  408  513  295   44  292
 122  246  248  474  753  667  668  751  750 1008  958  906 1009 1092 1013 1093 1019 1103 1022  843 1021  910 1023  976  779  698  857  609  699  697  410  293  512   45
 121  365  473  472  476  471  573  832  899 1011 1056 1012  757 1124 1057  837 1065 1063 1064 1100  973 1067  977  923  856  854  780  610  611  516  409   47  296   46
 120  364  244  468  666  570  571  665 1010  827  824 1091  963 1058  956 1060 1014 1129 1138 1101 1066  972 1025  919  781  612  614  784  782  297  177  174  172  175
 118  470  245  661  572  362  826  825  828  896  895  955 1095 1119 1016 1059 1098 1122 1144  978 1099 1068  920 1028 1026  921  515  853  783  411  613  514   49   48
 243  119  363  360  748  749  952  894  746  957 1053 1089 1094 1121 1120 1143 1153 1149 1127 1074 1126 1069 1104 1030  859  858  701  517  413  299  412  298  176  178
 242  361  359  663  744  465  469  893  747  891 1007 1052 1151 1142 1136 1152 1096 1141 1145 1128 1102 1131 1031 1027  924  786  922  702  518  519  615  300  179   50
 117  241  115  568  566  567  664  655 1051  954 1090 1004 1117 1118 1123 1125 1132 1147 1154 1105 1071 1073  980  785  926  705  703  704  617  616  415  301  180   51
 116  239  569  892  745  467  660  890  821 1050  822 1048 1054 1140 1116 1111 1155 1150 1130 1070 1146  981  927  979  982  860  787  706  414  520  304  302   52   53
 114  358  466  659  823  564  662  820  887  819 1006  953 1087 1137 1045 1049 1041 1148 1133 1038 1029  925 1106 1072  928  861  788  707  618  521  416  181  303  182
 355  357  238  240  464  889  743  740  742 1005  888 1088 1086 1139 1135 1134 1112 1107 1080 1109 1108 1033 1032  984  986  862  789  708  619  523  522   54  183  184
 110  111  356  463  462  741  351  565 1000 1003  951  950 1113 1083 1114 1044 1081 1110 1079 1078 1077 1075 1034  929  983  790  709  620  621  524  419  418   56  306
 113  237  350  461  656  818  563  654  948  883 1084 1002 1046  941 1082 1115 1042 1040 1039 1037 1036 1076  985  987  864  863  791  710  622  527  525  305  417   55
 236  354  352  112  817  658 1085  561 1047  946  949 1001  999  996  943  878  995  993  992  991  989  935 1035  988  930  865  793  792  712  526  420  185   57   58
 109  234  235  233  739  560  562  458  816  886  947  881  997 1043  730  808  994  940  938  937  990  871  933  799  931  866  867  713  711  624  421  307  308  186
 107  460  353  652  651  558  653  657  885  944  812  882  732  998  942  877  939  875  873  936  801  872  934  870  797  869  868  794  623  423  309  188  187   59
 108  455  232  559  459  815  737  884  814  945  810  728  880  809  879  807  876  804  874  802  635  800  719  720  932  796  795  714  625  422  528  310  189   60
 231  349  348  457  736  557  735  648  734  813  733  644  645  729  727  806  639  726  803  723  722  634  633  798  718  717  716  715  626  529  424  311  190   61
 106  105  230  456  650  738  451  649  647  811  731  549  445  643  641  546  640  638  637  724  636  721  539  632  631  630  629  628  627  530  425  312  191   62
 104  229  347  346  453  554  452  553  552  646  551  550  642  333  545  547  544  725  543  541  438  540  538  537  536  535  534  533  532  531  426  313  192   63
 103  228  345  454  342  556  450  339  449  448  447  446  334  444  548  443  211  328  542  439  437  436  435  434  433  432  431  430  429  428  427  314  193   64
 102  227  344   97  343  555  341  340  338  337  336  335  332  331  330  805  442  209  441  327  326  325  324  323  322  321  320  319  318  317  316  315  194   65
 101  226  225    0  223  222  221  220  219  218  217  216  215  214  213  329  210   84  440  208  207  206  205  204  203  202  201  200  199  198  197  196  195   66
 100   99   98   96  224   95   94   93   92   91   90   89   88   87   86  212   85   83   82   81   80   79   78   77   76   75   74   73   72   71   70   69   68   67
