# This puzzle is unsolvable
33
   2    1    3    4    5    6    7    8    9   10  260   13   15  140   14  263  262   16  149  147  265  272  151  268  486   26  153  274  155   31  158   29  157
 128  129  130  131  132  133  134  254  135  137  138   11  139  371  264  143  145  375  150  148  480  266  380  269  152   25  154  383   28  277  273  276   35
 127  248  249  250  251  252  253  365  136  255  259  257  258  142  141   18  573  146  575   17  479   22    0   23  382  669  489   24  385  387  156   36   32
 126  360  359  362  466  465  468  366  367  470  368  261   12  370  472  475  477  374  574  662   20  377  267   27  487  384  271  386  488  275  162   34  160
 125  247  464  462  463  363  364  467  564  469  471  256  369  372  657  373  376  144  478  482  379  816  745   21  483  743  270  581  388   38  159  279   33
 244  356  245  124  361  560  650  561  649  565  566  567  474  473  568  570  476  572  663  742   19  381  578  665  666  583  491  485  280  391  278   37   41
 246  243  121  357  648  646  358  562  563  652  653  654  655  735  656  571  659  660  740  664  580  378  576  577  746  579  670  586  389  393   30   40  163
 123  242  558  647  559  557  556  729  651  731  732  733  734  736  569  658  738  661  739  741  481  876  819  484  815  667  588  582  490  492  161  165   39
 353  355  122  461  460  797  799  728  730  801  867  805  806  807  808  737  809  810  812  875  934  813  933  818  585  748  668  584  494  671  166  284  282
 120  237  459  241  727  643  800  726  864  802  865  804  869  870  868  871  872  873  811  878  877  814  932  747  672  817  390  493  392  283   43  164  167
 119  238  240  644  645  641  457  863  920  921  866  803  971  924  972  926  927  928  930  931  979  744  879  750  883  673  587  749  281  287  285   42   44
 117  239  235  458  236  725  798  919  862  918  922 1008  923  925  970  973  974  929  874  976 1017  978  935  821  820  675  751  495  590  394  168  395  170
 453  118  350  352  351  554  861  724  917  916  967 1009  969 1010 1011 1013 1045 1016  977  980  936  981  937  674  752  754  592  589  497  286  172  169   45
 234  354  553  722  723  642  796  795  860  968  965 1006 1007 1065 1042 1012 1067  975 1015 1046 1018 1019  938  880  882  591  676  753  498  496  397  288  171
 349  114  347  550  456  549  640  962  966  858  915 1040 1039 1064 1079 1014 1043 1044 1069 1068 1048  939  822  881  677  755  593  396  499  398  289   46   48
 455  552  555  637  551  859  856  721  794  914  964 1036 1038 1063 1088 1041 1066 1082 1083 1047 1049 1020  982  885  823  884  678  500  501  399  174   47   49
 116  115  348  548  638  546  719  911  855  793  912  792 1004 1037 1003 1080 1081 1055 1028 1086 1071  986 1021  886  824  756  679  594  502  291  173  290  292
 233  230  452  635  791  547  853  639  720 1005  857 1035  854  913 1061 1087 1074 1072 1052 1070  985  889  989  757  825  680  681  758  595  400  176  293  175
 454  447  345  450  451  448  449  960  718  910  959 1002 1000 1078 1077 1084 1075 1022 1051 1050  940  941  983  888  826  828  827  596  504  401  402  177   50
 346  232  634  545  633  632  715  717  789  958  954  961  963 1034 1062 1059 1056 1085 1073 1023  990  890  887  987  683  942  597  759  503  403  294  295  179
 112  344  110  342  341  716  787  636  852  788  955  909 1060  998 1032 1058 1029 1030  991 1025  947  984  762  988  682  598  505  404  599  684  507   52   51
 109  113  343  231  630  786  790  713  956 1001  905 1033  997  903 1031  953 1076 1027 1054 1057  951 1024  945  943  891  600  829  508  602  506  178  180   54
 107  111  444  544  714  543  631  907  850  908  848  843  845  992  994  906  952  841  993 1053  944  949  895  894  833  831  407  761  298   55  297  181   53
 229  108  228  442  446  224  445  542  849  851  779  999  995  902  996  844  900  901 1026  948  946  836  835  892  893  760  830  832  685  183  509   56  300
 105  340  106  339  540  712  710  784  785  847  846  778  430  777  704  842  774  897  950  898  771  693  837  609  766  764  409  763  299  296  406   57  184
 103  104  226  541  338  443  629  782  904  781  706  776  702  701  619  700  839  699  770  612  838  694  834  896  767  605  603  686  604  405  182   58  185
 101  441  102  336  628  709  711  783  708  532  622  780  957  775  773  616  698  840  772  695  613  518  768  601  691  692  765  687  411  408  301   60  302
 222  100  337  225  227  538  626  624  707  433  529   82  623  703  617  899  615  523  696  697  425  610  611  418  608  515  516  513  510  511  606  410  512
 221  223  335  539  537  438  535  625  531  705  621  431  620  528  526  618  424  319  207  317  423  769  519  419  517  690  689  688  607  186  414  303   61
  99  220  439  332  536  437  435  534  434  327  432  530  426  323   83  321  614   81  201   80  204  422  313  420  311  416  308  415  514  188  187  304   59
 219  334  333  331  330  627  436  328   88  533   86  208  427   84  429  318  428  522   78  205  316   74  417  312  310  195  307  413  191  412  305   62   65
  97   98  218  216  440  215  329   90  326  213  324   87  325  209  524  527  202   79  314  315  521  198  520   73  196   71  309  193   66  306   64   67   63
  96   95   94  217   93   92  214   91  212   89  210  211   85  525  322  206  203  199  320  200   77   76  421  197   75   72  194   70  192  190   69   68  189
