# This puzzle is unsolvable
56
   2    1    3    4    5    6    7    8    9   10   11   12   13   14   15   16   17   18   19   20   21   22   23   24   25   26   27   28   29   30   31   32   33   34   35   36   37   38   39   41  261   43  263  475   44  265   47   48   49   50   51   52   53   54   55   56
 220  221  222  223  224  225  226  227  228  229  230  231  232  233  234  235  236  237  238  239  240  241  242  243  244  245  246  247  248  249  250  251  252  253  254  255  256  257  258   40   42  260  264  474   46  266  267  478  268  479  270  271  272  273  274   57
 219  432  433  434  435  436  437  438  439  440  441  442  443  444  445  446  447  448  449  450  451  452  453  454  455  456  457  458  459  460  461  462  463  464  466  467  669  468  469  259  471  675  473  676  476   45  477  681  480  682  481  686  685  483  275   58
 218  431  636  637  638  639  640  641  642  643  644  645  646  647  648  649  650  651  652  653  654  655  656  657  658  659  660  661  662  663  664  665  666  667  465  668  670  672  866  470  472  870  262  872  677  678  875  679  683  269  482  684  485  484  276   59
 217  430  635  832  833  834  835  836  837  838  839  840  841  842  843  844  845  846  847  848  849  850  851  852  853  854  855  856  857  858  859  860  861  862  863  864  865  671  674 1057  869 1235  871 1060 1239  874  680  877  878  879 1066  880  687  486  277   60
 216  429  634  831 1020 1021 1022 1023 1024 1025 1026 1027 1028 1029 1030 1031 1032 1033 1034 1035 1036 1037 1038 1039 1040 1041 1042 1043 1044 1045 1046 1047 1048 1049 1050 1051 1052 1232 1053  867 1055 1058 1059  873 1061 1062 1242  876 1243 1067 1065  881  688  487  278   61
 215  428  633  830 1019 1200 1201 1202 1203 1204 1205 1206 1207 1208 1209 1210 1211 1212 1213 1214 1215 1216 1217 1218 1219 1220 1221 1222 1223 1224 1225 1226 1227 1228 1229 1230 1231 1233 1234  868 1054 1407 1056 1237 1238 1241 1413 1064 1063 1415  883  882  488  279   62   63
 214  427  632  829 1018 1199 1372 1373 1374 1375 1376 1377 1378 1379 1380 1381 1382 1383 1384 1385 1386 1387 1388 1389 1390 1391 1392 1393 1394 1395 1559 1396 1562 1400 1401 1564 1402 1403 1566 1405  673 1569 1236 1409 1240 1411 1576 1575 1414 1246  689 1069  691  884  690  280
 213  426  631  828 1017 1198 1371 1536 1537 1538 1539 1540 1541 1542 1543 1544 1545 1546 1547 1548 1549 1550 1551 1552 1553 1554 1555 1556 1557 1558 1714 1560 1561 1399 1398 1563 1565 1721 1722 1404 1406 1570 1408 1573 1410 1412 1729 1574 1417 1247 1416  491  886  489  490   64
 212  425  630  827 1016 1197 1370 1535 1692 1693 1694 1695 1696 1697 1698 1699 1700 1701 1702 1703 1704 1705 1706 1707 1708 1709 1710 1711 1712 1713 1860 1715 1716 1717 1718 1719 1720 1567 1723 1869 1568 1725 1572 1571 1727 1728 1418 1730 1244 1245  885 1070  283  692  281   65
 211  424  629  826 1015 1196 1369 1534 1691 1840 1841 1842 1843 1844 1845 1846 1847 1848 1849 1850 1851 1852 1853 1854 1855 1856 1857 1858 1859 1397 1861 2002 2132 1863 1864 1866 1867 1868 1724 2009 1870 1872 1726 2012 1874 1875 1876 1249 1248 1068  493 1577  282 1071  284   68
 210  423  628  825 1014 1195 1368 1533 1690 1839 1980 1981 1982 1983 1984 1985 1986 1987 1988 1989 1990 1991 1992 1993 1994 1995 1996 1997 1998 1999 2000 1862 2003 1865 2004 2005 2006 2007 2008 2262 2378 2010 2011 2016 1733 2015 1731 1578 1253 1073 1420  492  694   67   66  285
 209  422  627  824 1013 1194 1367 1532 1689 1838 1979 2112 2113 2114 2115 2116 2117 2118 2119 2120 2121 2122 2123 2124 2125 2126 2127 2128 2129 2130 2131 2133 2001 2134 2136 2137 2260 2138 2377 2139 1871 2142 1873 2144 2013 2014 1878 1580 1075 1419  695  891 1072  494  697  693
 208  421  626  823 1012 1193 1366 1531 1688 1837 1978 2111 2236 2237 2238 2239 2240 2241 2242 2243 2244 2245 2246 2247 2248 2249 2251 2366 2252 2368 2253 2371 2256 2257 2135 2259 2261 2263 2583 2143 2140 2141 2379 2145 2146 1879 1732 1579 1250  698  887 1251  888  495   69  287
 207  420  625  822 1011 1192 1365 1530 1687 1836 1977 2110 2235 2352 2353 2354 2355 2356 2357 2358 2359 2360 2361 2362 2363 2364 2365 2250 2666 2254 2577 2576 2478 2372 2258 2373 2374 2376 2375 2264 2485 2265 2266 2268 1734 1735 1581 1582 1421 1252 1074 1076  696  286   70   71
 206  419  624  821 1010 1191 1364 1529 1686 1835 1976 2109 2234 2351 2460 2461 2462 2463 2464 2465 2466 2467 2468 2470 2569 2571 2471 2474 2367 2574 2475 2255 2370 2579 2668 2481 2482 2582 2484 2381 2486 2487 2380 1736 2017 1877 1881 1584 1586 1583  889  700  699   72  289  288
 205  418  623  820 1009 1190 1363 1528 1685 1834 1975 2108 2233 2350 2459 2560 2561 2562 2563 2564 2565 2566 2568 2469 2661 2472 2662 2473 2572 2573 2749 2827 2480 2476 2670 2829 2580 2581 2584 2384 2269 2147 2267 2018 2019 1880 1258 1884 1423  498 1078  890  497  892  496   73
 204  417  622  819 1008 1189 1362 1527 1684 1833 1974 2107 2232 2349 2458 2559 2652 2653 2654 2655 2656 2657 2567 2658 2660 2659 2745 2663 2665 2477 2750 2369 2751 2479 2828 2669 2757 2675 2671 2483 2490 2488 2382 1882 2270 1883 1885 1422 1077 1256 1254 1255  894  499  290  501
 203  416  621  818 1007 1188 1361 1526 1683 1832 1973 2106 2231 2348 2457 2558 2651 2736 2737 2738 2739 2740 2741 2742 2744 2820 2821 2818 2748 2747 2824 2892 2578 2754 2575 2755 2830 2756 2585 2587 2383 2386 2489 1739 2148 1738 2149 1425 1585 1737 1080 1427  893  895  502   74
 202  415  620  817 1006 1187 1360 1525 1682 1831 1972 2105 2230 2347 2456 2557 2650 2735 2812 2813 2814 2883 2816 2817 2743 2570 2888 2949 2746 2823 2664 2752 2826 2894 2676 2673 2672 2758 2586 2150 2589 2272 2387 2271 2151 2021 2022 1587 1424 1588 1426  293  701  703  500  291
 201  414  619  816 1005 1186 1359 1524 1681 1830 1971 2104 2229 2346 2455 2556 2649 2734 2811 2880 2882 2815 2942 2884 2885 2819 2887 2822 2889 2891 2825 2667 2895 2753 2893 2954 2832 2677 2588 2674 2385 2154 2274 2152 1079 2023 1887 1261 1589 1259 1257  704  503  702   76   75
 200  413  618  815 1004 1185 1358 1523 1680 1829 1970 2103 2228 2345 2454 2555 2648 2733 2810 2879 2881 2940 2993 2943 2944 2886 2945 2947 2890 2948 3001 2951 2953 3004 3005 2896 2831 2759 2678 2273 2495 2493 2590 2024 2275 2153 1741 1886 1260 2020 1083  896 1081  294  292   78
 199  412  617  814 1003 1184 1357 1522 1679 1828 1969 2102 2227 2344 2453 2554 2647 2732 2809 2878 2939 2941 2992 2994 2995 2996 2997 2998 3000 3003 3045 3002 3047 2956 2957 2955 2833 2760 2679 2388 2491 2492 2390 2155 1743 1429 1590 1740 1430 1742 1428  897  705  505   77  504
 198  411  616  813 1002 1183 1356 1521 1678 1827 1968 2101 2226 2343 2452 2553 2646 2731 2808 2938 2937 2991 3036 3037 3038 3039 3042 3040 2946 3041 2999 2950 2952 3008 2899 2897 2761 2680    0 2592 2494 2593 2276 2027 1888 2025 1889 1744 1432 1082  898 1084  899  296  297  295
 197  410  615  812 1001 1182 1355 1520 1677 1826 1967 2100 2225 2342 2451 2552 2645 2730 2807 2877 2936 2990 3035 3072 3074 3101 3075 3076 3043 3079 3044 3046 3080 3048 3006 2898 2834 2835 2762 2591 2277 2389 2156 2158 1890 2026 1746 1592 1262 1591 1086  900  706  506   81   79
 196  409  614  811 1000 1181 1354 1519 1676 1825 1966 2099 2224 2341 2450 2551 2644 2729 2875 2876 2935 3033 2989 3071 3073 3120 3122 3078 3077 3109 3081 3007 3049 3108 2901 2900 2836 2764 2763 2681 2496 2157 2391 2030 2028 1745 1431 2029 1593 1085 1263  708  709  298   80   82
 195  408  613  810  999 1180 1353 1518 1675 1824 1965 2098 2223 2340 2449 2643 2728 2805 2806 2874 2987 3034 3070 3099 3100 3121 3102 3107 3125 3105 3103 3082 3083 3009 2959 2958 2960 2902 2682 2497 2498 2392 2278 2279 1748 1433 1891 1595 1265 1594 1087  904  707  507   83  300
 194  407  612  809  998 1179 1352 1517 1674 1823 1964 2097 2222 2339 2448 2550 2642 2727 2804 2873 2988 2934 3032 3069 3098 3119 3132 3133 3104 3106 3123 3134 3050 3010 2903 2838 2837 2684 2683 2595 2594 2393 2031 1893 2159 1747 1895 1892 1434 1264  902  903  901  509  710  301
 193  406  611  808  997 1178 1351 1516 1673 1822 1963 2096 2221 2338 2447 2549 2548 2726 2803 2872 2933 2986 3031 3068 3097 3118 3131 3129 3126 3127 3124 3110 3052 3051 2904 2839 2765 2766 2685 2499 2597 2281 2280 2160 1894 1750 1749 1596 1266 1088 1435  711  508   84  302  299
 192  405  610  807  996 1177 1350 1515 1672 1821 1962 2095 2220 2337 2446 2547 2641 2725 2802 2871 2932 2985 3030 3067 3096 3117 3130 3128 3135 3111 3086 3084 3085 2963 2905 2840 2841 2767 2686 2596 2395 2394 2282 2161 2032 1896 1597 1437 1436 1267 1090  712  510  511  303   85
 191  404  609  806  995 1176 1349 1514 1671 1820 1961 2094 2219 2336 2445 2546 2640 2724 2801 2870 2931 2984 3029 3066 3095 3116 3115 3114 3113 3112 2962 3011 3013 2961 3012 2906 2768 2769 2687 2598 2500 2396 2162 1751 1897 2033 1598 1600 1268 1091 1089  305  906  714  512   86
 190  403  608  805  994 1175 1348 1513 1670 1819 1960 2093 2218 2335 2444 2545 2639 2723 2800 2869 2930 2983 3028 3065 3094 3093 3092 3091 3090 3089 3088 3087 3053 3054 2964 2907 2843 2842 2688 2600 2599 2397 2502 2284 2283 2034 1752 1438 1439 1093  905  907 1092  713  513   87
 189  402  607  804  993 1174 1347 1512 1669 1818 1959 2092 2217 2334 2443 2544 2638 2637 2799 2868 2929 2982 3027 3064 3063 3062 3061 3060 3059 3058 3057 3056 3055 3014 2965 2908 2844 2770 2771 2689 2398 2285 2286 2164 2163 1599 2035 1601 1753 1269 1271  908  514  716  304   89
 188  401  606  803  992 1173 1346 1511 1668 1817 1958 2091 2216 2333 2442 2543 2636 2722 2798 2867 2928 2981 3026 3025 3024 3023 3022 3021 3020 2972 3019 3018 3017 3015 2966 2909 2772 2691 2773 2601 2503 2501 2399 2166 1754 1756 1901 1899 1440 1270  909  717  515  307   88  306
 187  400  605  802  991 1172 1345 1510 1667 1816 1957 2090 2215 2332 2441 2635 2634 2721 2720 2866 2927 2980 2979 2978 2977 2976 2975 2974 2973 2917 2969 2971 3016 2968 2967 2910 2845 2774 2603 2605 2504 2287 2505 2288 2165 2036 1898 1605 1604 1272  911  910  715  517  516   90
 186  399  604  801  990 1171 1344 1509 1666 1815 1956 2089 2214 2331 2541 2542 2633 2796 2797 2865 2926 2925 2924 2923 2922 2921 2920 2856 2919 2918 2853 2916 2970 2913 2912 2911 2846 2692 2690 2401 2506 2290 2289 2400 2168 2038 1755 1757 1441 1097 1274 1094  518  718  309  310
 185  398  603  800  989 1170 1343 1508 1665 1814 1955 2088 2213 2330 2440 2540 2718 2719 2795 2864 2863 2862 2861 2860 2859 2858 2857 2855 2784 2854 2703 2914 2915 2852 2849 2848 2847 2696 2693 2694 2602 2604 2167 1902 2037 1602 1603 1900 1606 1095  915 1098  912 1096   93   91
 184  397  602  799  988 1169 1342 1507 1664 1813 1954 2087 2212 2329 2439 2438 2716 2539 2717 2793 2792 2791 2790 2789 2788 2787 2786 2785 2783 2782 2702 2781 2780 2850 2779 2778 2777 2775 2697 2402 2507 2404 2403 2169 2039 2040 1758 1759  914 1444 1275  913   92  519  520  719
 183  396  601  798  987 1168 1341 1506 1663 1812 1953 2086 2211 2328 2437 2538 2631 2632 2794 2714 2713 2712 2711 2710 2709 2708 2707 2706 2705 2704 2616 2851 2519 2612 2699 2698 2776 2610 2695 2606 2508 2406 2170 2405 2041 1903 1904 1443 1442 1276 1273 1099  916  308  311   94
 182  395  600  797  986 1167 1340 1505 1662 1811 1952 2085 2210 2327 2436 2537 2630 2629 2715 2532 2628 2625 2624 2623 2622 2621 2620 2619 2618 2617 2615 2701 2613 2700 2517 2611 2515 2609 2607 2509 2407 2511 2293 2291 2171 1905 1760 1607 1445 1277 1100  722  721  720  522  312
 181  394  599  796  985 1166 1339 1504 1661 1810 1951 2084 2209 2326 2435 2536 2535 2534 2627 2429 2626 2531 2529 2528 2527 2526 2525 2524 2523 2522 2521 2520 2614 2415 2518 2412 2411 2413 2608 2510 2409 2512 2174 2292 2042 1906 1761 1446 1447 1278 1101  723  725  521  313   98
 180  393  598  795  984 1165 1338 1503 1660 1809 1950 2083 2208 2325 2434 2433 2432 2431 2533 2428 2427 2530 2426 2425 2424 2423 2421 2420 2309 2418 2417 2306 2416 2303 2414 2301 2516 2513 2514 2298 1772 2408 2172 2175 2044 1762 1609 1608 1448 1280 1102  917  314  724  315   96
 179  392  597  794  983 1164 1337 1502 1659 1808 1949 2082 2207 2324 2323 2322 2321 2320 2430 2318 2317 2316 2315 2314 2313 2312 2422 2311 1929 2419 2060 2305 2307 2304 2059 2184 2182 2300 2410 2299 2295 2294 2048 2173 2176 1907 1763 1610 1449 1103 1279  919  918  525  523   95
 178  391  596  793  982 1163 1336 1501 1658 1807 1948 2081 2206 2205 2204 2203 2202 2201 2319 2200 2198 2197 2196 2195 2194 2193 2065 2190 2064 2063 2308 2187 2186 2185 2302 2056 2181 2180 2179 1915 2178 2297 2046 2043 1771 2045 1764 1611 1450 1281 1104  920  726  316  524   97
 177  390  595  792  981 1162 1335 1500 1657 1806 1947 2080 2079 2078 2077 2076 2075 2074 2073 2199 1936 2071 2069 2068 2067 2066 2310 2192 2191 2189 2188 1925 1923 2057 2058 1921 2055 2054 2052 1917 2296 1916 2049 1913 1908 1768 1912 1910 1451 1282 1105  727  527  526  100   99
 176  389  594  791  980 1161 1334 1499 1656 1805 1946 1945 1944 1943 1942 1941 1940 1939 1938 2072 1937 2070 1935 1933 1932 1788 1931 1930 1928 1632 1629 1926 1922 1780 1778 1467 1920 1919 2053 2051 2050 1914 2177 1909 1765 1459 1766 1612 1613 1452 1106  921  729  528  317  319
 175  388  593  790  979 1160 1333 1498 1655 1804 1803 1802 1801 1800 1799 1798 1797 1796 1795 1794 1793 1792 1934 1790 1789 1787 1636 1635 1785 1786 2061 2062 1630 2183 1127 1628 1776 1918 1626 1775 1773 1621 1770 2047 1911 1767 1617 1614 1453 1283  923 1107  728  730  102  101
 174  387  592  789  978 1159 1332 1497 1654 1653 1652 1651 1650 1649 1648 1647 1646 1645 1644 1643 1641 1640 1791 1638 1637 1478 1309 1306 1475 1927 1782 1305 1634 1783 1470 1469 1777 1779 1627 1774 1624 1622 1620 1461 1619 1618 1615 1285 1454 1284 1109 1108  318  322  104  320
 173  386  591  788  977 1158 1331 1496 1495 1494 1493 1492 1491 1490 1489 1488 1487 1486 1485 1484 1483 1480 1482 1639 1479 1477 1308 1311 1784 1476 1473 1781 1924 1631 1471 1302 1466 1124 1299 1464 1623 1463 1294 1293 1769 1456 1455  737  333 1286 1111  922  731  529  732  531
 172  385  590  787  976 1157 1330 1329 1328 1327 1326 1325 1324 1323 1322 1321 1320 1319 1318 1317 1642 1316 1315 1481 1314 1313 1312  761 1310  949 1129 1304 1633 1126 1472 1303 1128 1300 1465 1625 1297 1462 1120  745 1457 1616 1290  930 1289 1112 1287  530  926  733  105  321
 171  384  589  786  975 1156 1155 1154 1153 1152 1151 1150 1149 1148 1147 1146 1145 1144 1143 1142 1141 1140 1139 1138 1137 1136 1135  952 1134 1133 1130 1131  945  757  753 1468  941 1125 1123 1296 1298  936  934 1292 1458  743 1291 1115 1113  929 1288  924  534  927  532  103
 170  383  588  785  974  973  972  971  970  969  968  967  966  965  964  963  962  961  960  959  958  957  956  955  954  762  953  560 1307 1132 1474  946  948 1301  553  552  943  750  746  548 1122  935  939 1119 1118 1295 1114  742  540  738 1110  925  533  107  110  323
 169  382  587  784  783  782  781  780  779  778  777  776  775  774  773  772  771  770  769  768  767  766  765  764  763  563  760  561  352  559  944  950  754  751  555  347  749  940 1121  342  341  937  933  339  932  739  740  336  541  331  734  931  736  324  106  535
 168  381  586  585  584  583  582  581  580  579  578  577  576  575  574  573  572  571  570  569  568  567  566  565  356  562  951  354  758  756  759  557  947  554  752  551  130  942  550  748  545  544 1117 1460  938  121 1116  741  115  539  537  114  928  327  326  108
 167  380  379  378  377  376  375  374  373  372  371  370  369  368  367  366  365  364  363  362  361  360  359  358  564  357  355  353  138  558  350  135  556  132  133  346  345  344  127  747  340  744  123  338  543  120  124  337  118  332  735  536  538  325  328  111
 166  165  164  163  162  161  160  159  158  157  156  155  154  153  152  151  150  149  148  147  146  145  144  143  142  141  140  139  137  351  136  134  348  349  755  131  129  343  128  549  126  125  546  547  122  335  542  119  334  117  116  330  329  113  109  112
