# This puzzle is unsolvable
60
   2    1    3    4    5    6    7    8    9   10   11   12   13   14   15   16   17   18   19   20   21   22   23   24   25   26   27   28   29   30   31   32   33   34   35   36   37   38   39   40   41   42   43   44   45   46   47   48   49   50   51   52   53   54   55   56   57   58   59   60
 236  237  238  239  240  241  242  243  244  245  246  247  248  249  250  251  252  253  254  255  256  257  258  259  260  261  262  263  264  265  266  267  268  269  270  271  272  273  274  275  276  277  278  279  280  281  282  283  284  285  286  287  288  289  290  291  292  293  294   61
 235  464  465  466  467  468  469  470  471  472  473  474  475  476  477  478  479  480  481  482  483  484  485  486  487  488  489  490  491  492  493  494  495  496  497  498  499  500  501  502  503  504  505  506  507  508  509  510  511  512  513  514  515  516  517  518  519  520  295   62
 234  463  684  685  686  687  688  689  690  691  692  693  694  695  696  697  698  699  700  701  702  703  704  705  706  707  708  709  710  711  712  713  714  715  716  717  718  719  720  721  722  723  724  725  726  727  728  729  730  731  732  733  734  735  736  737  738  521  296   63
 233  462  683  896  897  898  899  900  901  902  903  904  905  906  907  908  909  910  911  912  913  914  915  916  917  918  919  920  921  922  923  924  925  926  927  928  929  930  931  932  933  934  935  936  937  938  939  940  941  942  943  944  945  946  947  948  739  522  297   64
 232  461  682  895 1100 1101 1298 1104 1299 1105 1106 1107 1108 1109 1110 1111 1112 1113 1114 1115 1116 1117 1118 1119 1120 1121 1122 1123 1124 1125 1126 1127 1128 1129 1130 1131 1132 1133 1134 1135 1136 1137 1138 1139 1140 1141 1142 1143 1144 1145 1146 1147 1148 1149 1150  949  740  523  298   65
 231  460  681  894 1099 1296 1103 1102 1486 1301 1488 1490 1302 1304 1305 1306 1307 1308 1309 1310 1311 1312 1313 1314 1315 1316 1317 1318 1319 1320 1321 1322 1323 1324 1325 1326 1327 1328 1329 1330 1331 1332 1333 1334 1335 1336 1337 1338 1339 1340 1341 1342 1343 1344 1151  950  741  524  299   66
 230  459  680  893 1098 1295 1297 1484 1300 1485 1489 1303 1669 1491 1492 1493 1494 1495 1496 1497 1498 1499 1500 1501 1502 1503 1504 1505 1506 1507 1508 1509 1510 1511 1512 1513 1514 1515 1516 1517 1518 1519 1520 1521 1522 1523 1524 1525 1526 1527 1528 1529 1530 1345 1152  951  742  525  300   67
 229  458  679  892 1097 1294 1483 1664 1665 1487 1666 1668 1840 1670 1671 1672 1673 1674 1675 1676 1677 1678 1679 1680 1681 1682 1683 1684 1685 1686 1687 1688 1689 1690 1691 1692 1693 1694 1695 1696 1697 1698 1699 1700 1701 1702 1703 1704 1705 1706 1707 1708 1531 1346 1153  952  743  526  301   68
 228  457  678  891 1096 1293 1482 1663 1836 1837 1667 1838 2002 1841 1842 1843 1844 1845 1846 1847 1848 1849 1850 1851 1852 1853 1854 1855 1856 1857 1858 1859 1860 1861 1862 1863 1864 1865 1866 1867 1868 1869 1870 1871 1872 1873 1874 1875 1876 1877 1878 1709 1532 1347 1154  953  744  527  302   69
 227  456  677  890 1095 1292 1481 1662 1835 2000 2001 1839 2003 2004 2005 2006 2007 2008 2009 2010 2011 2012 2013 2014 2015 2016 2017 2018 2019 2020 2021 2022 2023 2024 2025 2026 2027 2028 2029 2030 2031 2032 2033 2034 2035 2036 2037 2038 2039 2040 1879 1710 1533 1348 1155  954  745  528  303   70
 226  455  676  889 1094 1291 1480 1661 1834 1999 2156 2157 2158 2159 2160 2161 2162 2163 2164 2165 2166 2167 2168 2169 2170 2171 2172 2173 2174 2175 2176 2177 2178 2179 2180 2181 2182 2183 2184 2185 2186 2187 2188 2189 2190 2191 2192 2193 2194 2041 1880 1711 1534 1349 1156  955  746  529  304   71
 225  454  675  888 1093 1290 1479 1660 1833 1998 2155 2304 2305 2306 2307 2308 2309 2310 2311 2312 2313 2314 2315 2316 2317 2318 2319 2320 2321 2322 2323 2324 2325 2326 2327 2328 2329 2330 2331 2332 2333 2334 2335 2336 2337 2338 2339 2340 2195 2042 1881 1712 1535 1350 1157  956  747  530  305   72
 224  453  674  887 1092 1289 1478 1659 1832 1997 2154 2303 2444 2445 2446 2447 2448 2449 2450 2451 2452 2453 2454 2455 2456 2457 2458 2459 2460 2461 2462 2463 2464 2465 2466 2467 2468 2469 2470 2471 2472 2473 2474 2475 2476 2477 2478 2341 2196 2043 1882 1713 1536 1351 1158  957  748  531  306   73
 223  452  673  886 1091 1288 1477 1658 1831 1996 2153 2302 2576 2575 2577 2578 2579 2580 2581 2822 2582 2584 2585 2586 2587 2588 2589 2590 2591 2592 2593 2594 2595 2596 2597 2598 2599 2600 2601 2602 2603 2604 2605 2606 2607 2608 2479 2342 2197 2044 1883 1714 1537 1352 1159  958  749  532  307   74
 222  451  672  885 1090 1287 1476 1657 1830 1995 2152 2442 2151 2443 2700 2702 2703 2704 2926 2705 2583 2706 2709 2710 2826 2825 2712 2713 2714 2715 2716 2717 2718 2719 2720 2721 2722 2723 2724 2842 2727 2841 2728 2729 2730 2609 2480 2343 2198 2045 1884 1715 1538 1353 1160  959  750  533  308   75
 221  450  671  884 1089 1286 1475 1656 1829 1994 2150 2301 2300 2441 2816 2701 2817 2818 2819 2821 2927 2823 2708 2930 2711 2827 2934 2828 2829 2830 2831 2832 2833 2834 2835 2836 2837 2838 2840 2725 2726 2949 2843 2844 2731 2610 2481 2344 2199 2046 1885 1716 1539 1354 1161  960  751  534  309   76
 220  449  670  883 1088 1285 1474 1655 1828 1993 2149 2574 2439 2697 2699 2698 2924 2925 3026 2820 2929 2707 2931 2824 2932 2933 2935 3034 2936 2937 2938 2939 2940 2941 2942 2943 2944 2945 2839 2947 2948 2950 2845 2846 2732 2611 2482 2345 2200 2047 1886 1717 1540 1355 1162  961  752  535  310   77
 219  448  669  882 1087 1284 1473 1654 1827 1992 2298 2299 2440 2572 2573 2815 2813 3024 3025 3116 2928 3028 3029 3030 3031 3032 3033 3125 3035 3036 3037 3038 3039 3040 3041 3042 3043 3044 2946 3046 3047 3048 2951 2733 2734 2612 2483 2346 2201 2048 1887 1718 1541 1356 1163  962  753  536  311   78
 218  447  668  881 1086 1283 1472 1653 1826 1991 2147 2148 2438 2570 2814 2923 2696 2922 3023 3118 3027 3119 3120 3121 3122 3123 3282 3124 3209 3127 3128 3129 3130 3131 3132 3133 3134 3135 3045 3138 3220 3049 2952 2847 2735 2613 2484 2347 2202 2049 1888 1719 1542 1357 1164  963  754  537  312   79
 217  446  667  880 1085 1282 1471 1652 1825 1990 2146 2297 2695 2571 2569 2812 2921 3022 3115 3117 3201 3202 3203 3204 3205 3206 3349 3126 3208 3210 3211 3212 3213 3214 3215 3216 3217 3218 3136 3137 3140 3139 3050 2849 2848 2614 2485 2348 2203 2050 1889 1720 1543 1358 1165  964  755  538  313   80
 216  445  666  879 1084 1281 1470 1651 1824 1989 2145 2437 2296 2295 2436 2811 2920 3021 3199 3200 3276 3277 3278 3279 3280 3281 3207 3284 3410 3285 3286 3287 3288 3289 3290 3291 3292 3293 3219 3221 3051 3052 2953 2954 2736 2615 2486 2350 2349 2051 1890 1721 1544 1359 1166  965  756  539  314   81
 215  444  665  878 1083 1279 1280 1469 1650 1823 1988 2294 2435 2568 2694 2693 2919 3111 3020 3114 3198 3344 3345 3346 3347 3348 3408 3283 3351 3352 3353 3354 3355 3356 3357 3358 3359 3360 3294 3141 3223 2955 2850 2737 2738 2616 2487 2352 2204 2052 1891 1722 1545 1360 1167  966  757  540  315   82
 214  443  664  876  877 1082 1468 1649 1822 1987 2144 2293 2434 2567 2692 2810 2918 3196 3019 3197 3275 3343 3404 3405 3406 3407 3459 3350 3409 3412 3413 3414 3415 3466 3416 3417 3418 3296 3222 3295 3224 3053 2854 2740 2851 2618 2617 2351 2205 2053 1892 1723 1546 1361 1168  967  758  541  316   83
 213  442  663  874 1081 1278 1277 1648 1821 1986 2143 2292 2433 2566 2807 2809 2808 3018 3110 3272 3274 3342 3403 3456 3457 3458 3460 3461 3411 3505 3463 3464 3465 3509 3467 3468 3419 3363 3297 3142 3143 3054 2853 2956 2852 2490 2488 2353 2206 2054 1893 1724 1547 1362 1169  968  759  542  317   84
 441  662  875 1080 1079 1466 1467 1647 1820 1985 2142 2291 2432 2565 2691 2690 2917 3113 3017 3273 3112 3341 3402 3455 3500 3501 3502 3503 3462 3539 3506 3542 3507 3508 3510 3469 3420 3299 3361 3225 3056 3144 2957 2960 2739 2489 2491 2208 2207 2055 1894 1725 1548 1363 1170  969  760  543  318   85
 211  440  661  660  872 1078 1465 1646 1819 1984 2141 2290 2430 2431 2564 2915 2916 2914 3016 3195 3194 3271 3401 3454 3499 3536 3537 3538 3504 3567 3540 3569 3545 3543 3511 3423 3470 3362 3421 3147 3145 3057 2959 2958 2620 2742 2619 2354 2209 2056 1895 1726 1549 1364 1171  970  761  544  319   86
 212  210  438 1276 1274  873 1275 1645 1818 1983 2140 2289 2429 2563 2688 2689 2913 3015 3109 3193 3339 3340 3400 3453 3498 3535 3564 3565 3587 3585 3568 3570 3544 3512 3471 3365 3298 3300 3424 3228 3226 3055 2855 3146 2741 2621 2492 2355 2210 2057 1896 1727 1550 1365 1172  971  762  545  320   87
 439  209  657  659 1077 1463 1643 1462 1817 1982 2139 2288 2428 2562 2687 2806 3014 3107 3108 3192 3270 3269 3399 3452 3497 3534 3563 3584 3566 3598 3541 3588 3571 3546 3513 3422 3368 3367 3227 3366 3301 2961 2743 2622 2623 2493 2494 2356 2211 2058 1897 1728 1551 1366 1173  972  763  546  321   88
 208 1076  207  436  871 1464 1273 1644 1981 1980 2138 2287 2560 2804 2803 2805 2912 3013 3106 3191 3337 3338 3397 3398 3451 3533 3562 3583 3596 3586 3599 3589 3572 3547 3474 3514 3472 3364 3150 3473 3302 2962 2856 2857 2744 2624 2495 2357 2212 2059 1898 1729 1552 1367 1174  973  764  547  322   89
 434  437  656 1461  868 1272 1642 1815 1816 2137 2286 2285 2561 2685 2684 2802 2911 3012 3105 3190 3268 3267 3396 3450 3496 3532 3561 3582 3595 3597 3590 3591 3548 3515 3517 3475 3426 3425 3229 3149 3151 3058 3059 3060 2858 2745 2746 2213 2214 1899 1730 1731 1553 1368 1175  974  765  548  323   90
 205  655 1073  658 1271 1269 1460 1641 1814 1979 2284 2426 2427 2559 2801 2686 2910 3011 3104 3189 3266 3336 3448 3449 3495 3494 3560 3581 3594 3593 3576 3550 3573 3574 3516 3369 3304 3230 3306 3370 2964 3061 3148 2859 2747 2626 2625 2496 2358 2061 2060 1732 1554 1369 1176  975  766  549  324   91
 204  203  433  206 1459 1072 1270 1640 1813 1978 2136 2135 2425 2558 2682 2909 3101 3010 3103 3188 3265 3335 3395 3493 3530 3531 3559 3580 3579 3578 3592 3577 3575 3520 3476 3427 3305 3303 3231 3152 3062 2963 2861 2748 2749 2360 2498 2359 2215 2062 1900 1901 1555 1556 1177  976  767  550  325   92
 435  432  869 1268 1075  866 1074 1812 1977 2134 1808 2424 2282 2683 3102 3009 2800 3100 3187 3186 3264 3334 3333 3447 3492 3529 3558 3557 3525 3556 3555 3554 3553 3518 3549 3477 3430 3371 3232 3234 3064 3153 3063 2966 2627 2628 2361 2362 2497 2063 1902 1733 1371 1557 1178  977  768  551  326   93
 654  865  867  870 1457 1458 1456 2133 1638 2280 1975 2421 2283 2556 2799 2908 2798 2907 3008 3185 3263 3393 3394 3446 3491 3489 3528 3527 3484 3524 3523 3522 3552 3519 3478 3429 3479 3372 3233 3235 3065 3067 2965 2863 2967 2499 2363 2500 2216 2064 1903 1734 1372 1370 1180  978  769  552  327   94
 431  864  652  202  651 1071 1637 1639 1810 1976 2423 2422 2420 2557 2555 2681 2796 2905 3006 3262 3099 3332 3392 3445 3490 3488 3441 3526 3486 3485 3483 3482 3521 3551 3481 3428 3432 3373 3308 3236 2860 3154 2969 2862 2751 2750 2630 2218 2217 2065 1904 1735 1558 1179 1373  979  770  553  328   95
 430  200  429  653 1455 1266 1267 1636 1635 1974 2131 2132 2281 2795 2680 2679 2904 2797 3007 3183 3261 3331 3330 3391 3444 3443 3442 3487 3439 3438 3437 3436 3435 3434 3480 3433 3431 3375 3309 3237 3307 3156 2864 2865 2968 2501 2629 2364 2219 2066 1905 1736 1559 1374 1181  980  771  554  329   96
 199  427  428 1069 1070  862 1634 1454 1807 1811 1973 2279 2554 2677 2553 2902 2903 3005 2906 3260 3184 3329 3390 3389 3388 3387 3386 3440 3384 3383 3319 3382 3380 3379 3378 3314 3374 3311 3310 3376 3155 3068 3066 2752 2632 2503 2502 2365 2220 2067 1906 1737 1560 1375 1182  981  772  555  330   97
 201  863 1064  648 1264 1265 1263 1453 1806 1809 2130 2278 2552 2794 2678 2793 3003 3004 3098 3182 3259 3328 3327 3326 3325 3324 3323 3385 3322 3321 3320 3381 3317 3316 3315 3243 3377 3162 3312 3238 3157 2971 2970 2753 2631 2754 2366 2221 2222 2068 1907 1738 1561 1376 1183  982  773  556  331   98
 198  650 1452  860 1068  861 1805 1261 2128 1972 2129 2277 2419 2676 2675 2551 2792 3096 3097 3181 3258 3257 3256 3255 3254 3253 3252 3251 3250 3249 3248 3318 3247 3245 3244 3242 3313 3241 3239 3160 3072 3069 2867 2866 2868 2755 2504 2367 2223 2069 1908 1739 1562 1377 1184  983  774  557  332   99
 197  426 1062  649 1450 1632 1804 1633 1970 1971 2418 2417 2412 2550 2415 2791 2901 2900 3095 3180 3179 3178 3177 3176 3175 3174 3173 3172 3170 2990 3168 3081 3246 3164 3165 3077 3076 3161 3240 3159 3070 3158 2972 2973 2756 2633 2507 2505 2368 2070 1909 1740 1563 1378 1185  984  775  558  333  100
 196  858 1067 1803 1802 1451 1631 1967 1969 2126 2127 2276 2273 2549 2674 2673 3001 3002 3094 3093 3092 3091 3090 3089 3088 3087 3086 2887 2989 3083 3169 3080 3167 3166 2880 2982 3075 3163 3074 3073 2977 3071 2974 2870 2869 2506 2634 2369 2224 2071 1910 1741 1564 1379 1186  985  776  559  334  101
 194  856  423 1260 1445  647  857 1630 2413 1449 2416 2275 2270 2672 2548 2789 2899 3000 2999 2998 2997 2996 2995 2994 2993 2992 2886 3171 3084 3085 3082 2985 3079 3078 2882 2981 2878 2980 2979 2978 2874 2976 2975 2871 2637 2508 2757 2226 2370 2072 1911 1742 1565 1380 1187  986  777  560  335  102
 421  859  425  646    0 1262 1448 1066 1963 1968 2125 2124 2546 2274 2790 2787 2414 2897 2896 2895 2894 2893 2892 2891 2890 2889 2991 2777 2885 2773 2772 2986 2652 2653 2983 2984 2768 2877 2876 2875 2763 2873 2872 2758 2638 2636 2640 2371 2225 2073 1912 1743 1566 1381 1188  987  778  561  336  103
 643  424  422  641 1065  640 1801  855 1800 1447 1256 1965 1966 2269 2671 2670 2898 2786 2785 2784 2783 2782 2781 2780 2779 2659 2776 2888 2775 2884 2988 2526 2525 2883 2881 2769 2879 2767 2766 2765 2644 2762 2761 2760 2635 2639 2509 2372 2227 2074 1913 1744 1567 1382 1189  988  779  562  337  104
 193  191  645  195 1629  644 1063 1628 1627 1799 2123 2271 2122 2547 2669 2541 2543 2667 2539 2665 2664 2663 2257 2535 2662 2778 2532 2657 2656 2529 2527 2987 2390 2650 2770 2523 2771 2647 2519 2517 2764 2643 2514 2641 2759 2512 2373 2228 2229 2075 1914 1745 1568 1383 1190  989  780  563  338  105
 190  420  854 1258 1060 1259 1444 1253 2411 1964 1625 1797 2545 2117 2788 2544 2410 2666 2540 2404 2403 2538 2536 2258 2660 2661 2658 2396 2655 2250 2774 2528 2651 2388 2387 2521 2648 2520 2241 2646 2380 2642 2237 2378 2515 2511 2510 2374 2230 2076 1915 1746 1569 1384 1191  990  781  564  339  106
 642  192  188 1255  419 1254 1624 1443 1446 1626 2268 2267 2272 2263 2407 2542 2265 2406 2405 2261 2537 2401 2402 2534 2398 2533 2531 2530 2395 2654 2394 2392 2391 2248 2522 2649 2386 2383 2239 2518 2240 2645 2516 2377 2381 2379 2376 2232 2375 2077 1916 1747 1570 1385 1192  991  782  565  340  107
1058 1057  853 1061 1442 1252 2118 1796 1257 1623 2266 1956 2121 2115 1798 2408 2668 2111 2262 2260 2108 2106 2400 2105 2399 2253 2397 2252 2251 2249 2393 2247 2246 2245 2524 2244 2243 2385 2384 2242 2088 2382 2238 2086 2235 2513 2233 2081 2231 2078 1917 1748 1571 1386 1193  992  783  566  341  108
1056  852 1441  417 1059  416 1054 2119 1794 1960 1790 2120 1614 2409 1958 2114 2113 1952 2110 2109 2107 2259 1947 1945 2255 2256 2103 2101 2100 2099 1939 2097 2389 2095 1935 2094 2093 2092 1931 2089 2090 2087 2085 2236 2084 2234 1923 2082 2080 2079 1918 1749 1572 1387 1194  993  784  567  342  109
 418  849  186  639 1962  848 1250 1621 1793 1791 2116 1618 1954 1789 1429 2112 2264 1953 1951 1949 1783 1782 1780 1948 2104 2254 1944 1943 1941 1940 1937 2098 1769 1770 2096 1934 1933 2091 1932 1930 1929 1928 1927 1926 1925 2083 1924 1755 1921 1920 1919 1750 1573 1388 1195  994  785  568  343  110
 638  189  415  637 1051 1053  851 1251 1619 1622 1959 1957 1434 1432 1792 1955 1788 1786 1784 1950 1781 1946 1779 1778 1777 1601 2102 1942 1600 1773 1938 1772 1771 1936 1768 1592 1766 1765 1764 1763 1762 1761 1760 1759 1758 1754 1922 1581 1579 1753 1752 1751 1574 1389 1196  995  786  569  344  111
 847 1052  187  845  850  635 1440 1249 1437 1613 1795  838 1615 1431 1238 1787 1610 1427 1423 1785 1033 1606 1421 1420 1605 1775 1599 1774 1598 1597 1596 1595 1412 1594 1767 1593 1591 1590 1589 1588 1587 1586 1585 1584 1583 1757 1398 1756 1580 1578 1577 1576 1575 1390 1197  996  787  570  345  112
 412  414  636  413 1049 1620 1248 1961 1045  837 1043 1617 1042 1430 1612 1242 1611 1428 1425  830 1609 1232 1422 1604 1602 1418 1776 1417 1416 1415 1414 1413 1221 1411 1410 1409 1408 1407 1406 1405 1404 1403 1402 1401 1400 1582 1397 1206 1396 1395 1394 1393 1392 1391 1198  997  788  571  346  113
 411  185  184  633 1055 1438  840 1436 1435 1439 1245 1616 1243 1240 1237 1607 1234 1037 1036 1424  826 1233 1231 1229 1603 1419 1028 1227 1226 1225 1224 1023 1222 1220 1219 1218 1217 1216 1215 1214 1213 1212 1211 1210 1209 1399 1208 1207 1205 1204 1203 1202 1201 1200 1199  998  789  572  347  114
 632  630  843  408  628 1048  839  841 1046 1047  836 1433  620 1041 1241 1038 1426 1235 1608 1035  829  828 1230 1030 1031 1029  820  821 1026 1025 1223 1024 1022 1021 1020 1019 1018 1017 1016 1015 1014 1013 1012 1011 1010 1009 1008 1007 1006 1005 1004 1003 1002 1001 1000  999  790  573  348  115
 631  183  846  406  634  844  627  625  171  623 1044  624  397  833  832 1236  614  615  613  612  617  825 1034  608 1228  822  606 1027  819  818  817  816  815  814  813  812  811  810  809  808  807  806  805  804  803  802  801  800  799  798  797  796  795  794  793  792  791  574  349  116
 629  179 1247  404 1050  410  169  405  170 1244 1246  835  166  621  831  394  392  396  391  393  389  387  157 1032  823  607  605  382  604  603  602  601  600  599  598  597  596  595  594  593  592  591  590  589  588  587  586  585  584  583  582  581  580  579  578  577  576  575  350  117
 181  407  182  842  409  175  400  403  398  168  622  167  395 1040  834  163  390 1039  159  158  388  610  827  824  385  384  152  383  381  380  379  378  377  376  375  374  373  372  371  370  369  368  367  366  365  364  363  362  361  360  359  358  357  356  355  354  353  352  351  118
 178  180  176  626  177  174  173  402  172  401  399  165  164 1239  619  616  618  162  160  161  156  611  609  155  386  154  153  151  150  149  148  147  146  145  144  143  142  141  140  139  138  137  136  135  134  133  132  131  130  129  128  127  126  125  124  123  122  121  120  119
