# This puzzle is unsolvable
38
   1  148  151    3    4    6    7    8    9   10   11   12   13  162   14   15  165  305   18   19   20   22   23   24   25   26   27   28   29   30   31   32   33   34   35   36   37   38
   2  152    5  290  154  294  155  156  296  426  157  299  298  163   16  164  303   17  166  167   21  169  170  171  172  173  174  175  176  177  178  179  180  181  182  183  184   39
 287  149  288  153  421  546  292  424  295  550  297  159  430  161  160  302  304  434  306  437  168  308  309  310  311  312  313  314  315  316  317  318  319  320  321  322  185   40
 147  419  146  150  289  291  662  293  427  428  158  429  553  301  432  556  557  436  435  559  307  562  440  441  442  443  444  445  446  447  448  449  450  451  452  323  186   41
 145  420  418  544  423  425  547  548  549  665  551  552  554  670  555  431  558  672  438  560  439  561  563  564  565  566  567  568  569  570  571  572  573  574  453  324  187   42
 144  286  543  545  422  658  663  770  664  772  666  667  300  668  671  433  673  674  781  675  676  677  678  679  680  681  682  683  684  685  686  687  688  575  454  325  188   43
 284  142  542  660  659  767  769  868  771  871  773  775  669  874  779  777  778  780  879  880  783  784  785  786  787  788  789  790  791  792  793  794  689  576  455  326  189   44
 141  285  417  541  960  661  768  870 1043  872  774 1046 1047  875  969  876  968  878  972  782  882  883  884  885  886  887  888  889  890  891  892  795  690  577  456  327  190   45
 280  143  415  655  539  540  869  961 1042  962  873  964  966  776 1050  877  970  971 1054  881  973  974  975  976  977  978  979  980  981  982  893  796  691  578  457  328  191   46
 140  282  279  283  766  657  765  867  958 1044 1045 1048 1124  963  965  967 1051 1053 1129 1055 1056 1057 1058 1059 1060 1061 1062 1063 1064  983  894  797  692  579  458  329  192   47
 139  412  414  538  413  866  959 1118 1041 1120 1121 1189 1122 1049 1125 1126 1052 1194 1128 1130 1131 1132 1133 1134 1135 1136 1137 1138 1065  984  895  798  693  580  459  330  193   48
 138  536  416  281  535  656  652  956  957 1119 1117 1251 1248 1191 1192 1193 1127 1196 1256 1255 1197 1199 1200 1201 1202 1203 1204 1139 1066  985  896  799  694  581  460  331  194   49
 278  277  410  653  537  764 1039  862  761 1188 1185 1247 1123 1249 1302 1253 1252 1303 1304 1257 1198 1258 1259 1260 1261 1262 1205 1140 1067  986  897  800  695  582  461  332  195   50
 275  137  411  651  865  762 1187 1040  955 1186 1300 1190 1345 1344 1250 1381 1305 1195 1254 1307 1308 1309 1310 1311 1312 1263 1206 1141 1068  987  898  801  696  583  462  333   51   53
 135  532  276  408  654  864  863 1115 1038 1114  954 1246 1116 1298 1342 1382 1384 1347 1349 1386 1352 1353 1388 1354 1313 1264 1207 1142 1069  988  899  802  697  584  463  334  196  198
 134  136  534  763  760 1037  861 1113  859  953 1296 1301 1299 1244 1343 1346 1409 1383 1306 1351 1385 1387 1389 1355 1314 1265 1144 1208 1070  989  900  803  698  585  464  336  197   54
 133  406  649  409  533  860  952  759  857 1182 1380 1245 1184 1341 1407 1408 1428 1410 1348 1350 1411 1412 1390 1356 1315 1266 1209 1143 1071  990  901  804  699  586  465  337  335  200
 274  758  531  273  951  650 1034 1036  950  756 1111 1243 1378 1340 1377 1379 1439 1426 1431 1415 1432 1414 1413 1357 1316 1267 1210 1145 1072  991  902  805  700  587  466  199  201   52
 405  132  407  646  858  757 1033 1112 1110 1035  949 1339 1183 1242 1406 1427 1424 1441 1429 1442 1420 1433 1416 1358 1318 1213 1212 1317 1146 1073  992  903  806  701  467  338   55   56
 131  400  403  529  271  528  855  648  644 1181 1295 1376 1294 1401 1405 1437 1373 1440 1438 1443 1435 1392 1391 1360 1359 1270 1211 1268 1074  994  904  807  702  588  589  202   57   58
 129  647  753  527  645  946  948  853  856 1241 1180    0 1240 1297 1293 1375 1404 1398 1430 1423 1436 1434 1393 1269 1319 1076 1148 1147 1075  905  993  808  703  590  339  470  340  203
 402  270  130  125  750 1032  854  755  754 1109 1177 1179 1292 1290 1338 1337 1367 1422 1425 1368 1396 1417 1419 1394 1361 1214 1320 1077  996  906  811  809  704  591  468  205  341   59
 265  127  404  643  642  399 1238 1028  947 1108 1235 1105 1291 1178 1402 1374 1371 1403 1397 1421 1366 1418 1362 1321 1271 1323 1215  908  907  995  810  705  593  592  469  204   61  206
 128  269  530  123  268  526  272  752  945 1239 1027 1289 1237 1166 1285 1372 1369 1331 1395 1281 1327 1365 1364 1363 1274 1273 1149 1078  998  706  812  707  472  595  343  473   60   62
 525  264  640  124  641  749  944  852 1031 1335 1176 1336 1106 1234 1228 1097 1330 1328 1370 1280 1165 1279 1325 1322 1272 1324 1151 1216 1150  997 1218  999  909  814  344  471  476  207
 267  401  121  639  943  848  849 1029 1107 1030 1175 1287 1332 1232 1231 1167 1284 1329 1283 1399 1162 1225 1224 1277 1276 1275 1217 1079 1152 1080  911  910  815  594  342  596  208   63
 396  266  521  751  398  941  746 1104 1026 1024 1233 1236 1334 1171 1093 1230 1400 1014 1286 1094 1326 1160 1278 1222 1221 1220 1219 1153 1154 1002 1000  708  709  475  474  345  209   64
 263  523  522  850  637  119  748  942  743 1102 1174  747 1288 1168 1170 1169 1164 1016 1013 1229 1226 1161 1223 1159 1158 1157 1156 1155 1081 1003 1001  813  710  711  347  346  210   65
 122  257  258  851  517  938  937  847 1100  940 1172  840 1020 1099  933  834 1090 1095 1163 1091 1092 1012 1089 1088 1087 1086 1085 1084 1082  913  816  912  598  597  477  348  211   66
 261  126  256  519  638  845  841 1103  742  934 1173  936 1333 1096 1019  929  928  729 1227 1282 1011  923  924 1009  921 1008 1007 1006 1083 1004  914  817  712  599  478  349  212   67
 395  118  518  120  391  262  843  745  939  844 1021  846  842  835 1018  733  836  927  832  616 1010  925  922  826  722  920  919  917 1005  916  915  818  713  600  479  350  213   68
 520  114  116  636  744  629  254  739  732  627 1025  735 1022 1098  930  931 1017 1015  619  830  831  726  828  827  825  721  823  918  822  821  820  819  714  601  480  351  214   69
 260  111  115  514  110  634  935  510  635  632  737  838 1023  734  379  932  833  621  728  727  926  724  613  725  723  611  824  720  607  719  717  716  715  602  481  352  215   70
 388  397  255  385  630  390  512  741  511  626  623 1101  837  622  504  375  731  498  730  500  617   92  614  495  494  612  610  608  489  718  606  605  604  603  482  353  216   71
 633  524  389  387  392  249  631  628  508  738  839  624  380  507  503  502  499  501  372  371  829  497  234  496  367  232  493  491  490  488  487  486  485  484  483  354  217   72
 117  516  259  253  252  384  383  247  740  382  381  736  625  377  241  242  376  618  620  374  235  233  615  368  492  365  609  364  362  361  360  359  358  357  356  355  218   73
 113  112  107  393  108  106  509  394  378  246  102  101  506  505  243  240  239  373  238   94  236   88  369   89  366  363  228   85  227  226  225  224  223  222  221  220  219   74
 515  109  251  513  386  248  250  104  245  105  103  244   99  100   98   97   96   95  237   91   90  230   93  370  231   87   86  229   84   83   82   81   80   79   78   77   76   75
