# This puzzle is unsolvable
9
 0 39 21 71 32 18 19 72 62
33 31 34 27 55  6 12 16 41
61 65 48 11 64 44 67 36 59
68 47  2  5 38 25 35 49 54
40  1 29 73 57 28  9 58 10
22  4 66 74 80 37 45 23 79
26 24 78 75 56 70  3 17  7
30 63 46 43 76 15 14 13 77
20 69 42 50 52 60  8 51 53
