# This puzzle is unsolvable
18
  1 181   2  70   6   7  72   3 234   9  10  11  78  80 141  22 143 189
 68  64  67  66 226 130 131 187   8 266 136  76 267 231 138  17  82  87
289  63 124 180 128 224 264  75  12 291  14  13 137  85 188  16 232  19
127  61   5 261 309 287   0  71 133  77 135 190 229  88  84  18  83  81
125 222 132  69  73 256 134 285 139 262 290 269 312  79 183 144  15  23
123 178 129   4  65 259  74 186 185  20 140 293 265 233 196  86  21 193
122 217 179 286 227 230 184 182 283 195 192 194 268 294 191  24  25  89
257 175 221 220 219 228 223 292 235 307 295 197 146 142 237 145 236 239
218 126 225 174 281 260  60 311 252 318 148 323 273 153 147 154 296  90
177  62 263 121 255 258 250 322 172 272 288 270 271 151  93  29 238  30
118 213 173 310 284 319 308 297 247 277 298 159 245 149  91  27 243  94
176 171  58 114 282 305 251 304 241 276 198 301 300  92  96 202 201  26
163 216 303 169 254 111 306 321 313 279 314  41 316 162  38 275  31  32
253 249  57  49 168 117 315  55 166 320 211 299 161 199 150 152 240  28
 59  51 116 108  42  43 107 164 110 112 101 158 103 200 274 242 156 155
 52 115 165 170  54  56  46 105 280 248 204 104  40 317 244 203  97  98
119 113 120 215  47  53 212 210 208 246 207 209 100  33  34 205  39  35
 50  44 167  48 278 214 109  45 160 102 106  37 206 302 157  95  36  99
