# This puzzle is unsolvable
69
   2    1    3    4    5    6    7    8    9   10   11   12   13   14   15   16   17   18   19   20   21   22   23   24   25   26  298   27   28   29   32  303  568  304   35   36  308   37   39   40   41   42   43  315   44   46  835   47   48   49   52  323   53   54   55   56   57   58   59   60   61   62   63   64   65   66   67   68   69
 272  273  274  275  276  277  278  279  280  281  282  283  284  285  286  287  288  289  290  291  292  293  294  295  296  297  561  299  300  301   31  567  565   33   34  306   38  309  310  311  312  313  314  578  581  317  319  320  584   50   51  324  325  843  326  590  327  592  329  330  332  333  334  335  336  337  338  339   70
 271  536  537  538  539  540  541  542  543  544  545  546  547  548  549  550  551  552  553  554  555  556  557  558  559  560  562  563  818   30  302  821  823  822  826 1312  570 1074  573  574  575  576  577   45  318  316  836  837  582  321  322  586  587  842  588  589  328  591  593  331  595  597  852  598  599  600  601  340   71
 270  535  792  793  794  795  796  797  798  799  800  801  802  803  804  805  806  807  808  809  810  811  812  813  814  815  816  817 1065  564  820 1068 1071  825  566  569  571 1314  828  829  830  831  832  580  579 1082 1084  834  583  585  840 1326 1089  841  844 1092  845  847  849  594 1097  850  596  853  854  855  602  341   72
 269  534  791 1040 1041 1042 1043 1044 1045 1046 1047 1048 1049 1050 1051 1052 1053 1054 1055 1056 1057 1058 1059 1060 1061 1062 1063 1064  819 1305 1067 1069 1070  305  307  824  572 1075  827 1076 1077 1078 1079  833 1319 1320 1081 1085 1324 1086 1088  839 1327 1090 1091  846 1094 1332 1093 1096 1335  851 1099 1100 1101  856  603  342   73
 268  533  790 1039 1280 1281 1282 1283 1284 1285 1286 1287 1288 1289 1290 1291 1292 1293 1294 1295 1296 1297 1298 1299 1300 1301 1302 1534 1303 1535 1307 1308 1763 1310 1073 1311 1766 1313 1545 1315 1316 1317 1318 1550 1080 1321 1083 1323 1325  838 1557 1087 1328 1329 1561 1331 1566 1095  848 1336 1567 1098 1337 1339 1102  857  604  343   74
 267  532  789 1038 1279 1512 1513 1514 1515 1516 1517 1518 1519 1520 1521 1522    0 1524 1525 1526 1527 1528 1529 1530 1531 1532 1533 1066 1758 1304 1536 1765 1539 1309 1764 1762 1072 2191 2389 1547 1769 1548 1549 1773 1551 1552 1322 1554 1555 1779 1556 1558 1559 1330 1560 1564 1334 1333 1565 1789 1568 1569 1338 1340 1103  858  605  344   75
 266  531  788 1037 1278 1511 1736 1737 1738 1739 1740 1741 1742 1743 1744 1745 1523 1747 1748 1749 1965 1750 1751 1967 1754 1970 1755 1756 1757 1537 1759 1976 1306 1980 2187 1541 1544 1767 1546 2192 1770 1986 1987 1988 1774 1776 1553 1777 1993 1778 1780 1781 1782 1783 1784 1562 1563 1786 1788 1790 1791 1570 1571 1341 1104  859  606  345   76
 265  530  787 1036 1277 1510 1735 1952 1953 1954 1955 1956 1957 1958 1959 1961 1746 1962 1963 1964 2172 1966 1753 1752 1968 1969 1971 1972 2180 1760 1973 1974 1538 2185 1543 1977 1542 1979 1768 2388 2193 1985 1772 2196 2197 1775 1990 2199 1992 1994 1995 1996 2203 2205 1999 2208 1785 2000 1787 2003 2005 1792 1793 1342 1105  860  607  346   77
 264  529  786 1035 1276 1509 1734 1951 2160 2161 2162 2163 2164 2165 2366 1960 2167 2169 2170 2171 2173 2174 2373 2175 2176 2177 2178 2378 2179 2181 1975 2382 2184 1761 2385 2188 2387 2186 1984 1983 2190 2392 2194 1771 2195 2396 1989 2198 2201 2202 2402 2204 1997 2206 1998 2207 2407 2002 2210 2004 2007 1795 2006 1343 1106  861  608  347   78
 263  528  785 1034 1275 1508 1733 1950 2159 2360 2361 2362 2363 2364 2166 2365 2168 2368 2560 2369 2370 2563 2372 2374 2375 2376 2377 2379 2380 2571 2383 2182 2183 1978 1540 1981 2386 1982 2189 2390 2391 2582 2393 2394 2587 2771 1991 2397 2200 2591 2592 2403 2594 2404 2596 2406 2599 2001 2408 2213 2009 1794 1572 1573 1107  862  609  348   79
 262  527  784 1033 1274 1507 1732 1949 2158 2359 2552 2553 2554 2555 2556 2557 2367 2742 2559 2561 2371 2562 2564 2565 2566 2567 2568 2569 2570 2572 2381 2573 2574 2384 2575 2577 2762 2578 2579 2764 2766 2583 2767 2586 2945 2399 3114 2398 2400 2773 2590 2593 2777 2595 2779 2405 2781 2209 2211 2409 2410 2212 1574 1108 1346  863  611  349   80
 261  526  783 1032 1273 1506 1731 1948 2157 2358 2551 2736 2737 2738 2739 2740 2558 2741 2743 2744 2745 2746 2747 2748 2749 2750 2751 2752 2753 2754 2755 2756 2932 2758 2576 2759 2761 2937 2581 2580 2765 2584 2941 2585 2395 2588 2589 2775 2948 2401 2950 2776 3120 2597 2778 2957 2956 2601 2411 2008 2214 1797 1344 1576 1109  610  865  350  613
 260  525  782 1031 1272 1505 1730 1947 2156 2357 2550 2735 2912 2913 2914 2915 2916 2917 2918 2919 2920 2921 2922 2923 2924 2925 2926 2927 2928 2929 2930 3099 2933 2757 2934 2760 2935 2938 2763 3106 2939 3269 2942 3268 2769 2772 2770 3274 2951 2774 3117 3430 2952 2955 2600 3122 2598 3121 2412 2215 1796 1798 2010 1347 1345  867  612   82   81
 259  524  781 1030 1271 1504 1729 1946 2155 2356 2549 2734 2911 3080 3081 3082 3083 3084 3085 3086 3087 3088 3089 3090 3091 3092 3093 3094 3095 3096 3097 2931 3258 3100 3101 3102 2936 3104 3105 3107 3421 2943 2940 2768 2944 2947 3112 3115 3275 2949 3276 3280 3118 2780 2954 2953 2783 2602 2414 2216 2011 1800 1575 1578 1111 1110   84  615  614
 258  523  780 1029 1270 1503 1728 1945 2154 2355 2548 2733 2910 3079 3240 3241 3242 3243 3244 3245 3246 3247 3248 3249 3250 3251 3252 3253 3254 3255 3407 3098 3257 3259 3260 3262 3103 3263 3264 3265 3267 3108 3109 3420 3110 3270 3271 3273 3277 3427 3428 3116 3119 3278 3279 2782 2605 2784 2413 2012 2217 1799 1112  864  619  351 1577  868  352
 257  522  779 1028 1269 1502 1727 1944 2153 2354 2547 2732 2909 3078 3239 3392 3393 3394 3395 3396 3397 3398 3399 3400 3401 3402 3403 3404 3405 3406 3552 3256 3408 3411 3412 3261 3413 3414 3558 3415 3266 3418 3419 3272 3565 3111 2946 3424 3423 3830 3570 3569 3426 3124 3429 2958 2606 2604 2603 2417 2218 1579 1348 1349 1113  353  357  355   83
 256  521  778 1027 1268 1501 1726 1943 2152 2353 2546 2731 2908 3077 3238 3391 3536 3537 3538 3539 3540 3541 3542 3543 3544 3545 3546 3547 3548 3549 3550 3409 3553 3410 3554 3555 3556 3557 3416 3559 3562 3417 3561 3698 3563 3564 3566 3113 3425 3572 3704 3432 3126 3281 2959 3123 2960 2220 2787 2013 2219 1580 1351 1350  869  870 1114  354  866
 255  520  777 1026 1267 1500 1725 1942 2151 2352 2545 2730 2907 3076 3237 3390 3535 3672 3673 3674 3675 3676 3677 3678 3679 3680 3681 3682 3810 3683 3685 3551 3687 3688 3689 3690 3691 3692 3693 3694 3560 3695 3696 3697 3699 3422 3700 3827 3567 3707 4060 3706 3571 3431 3125 2415 2785 2607 2416 2786 2015 1801 1581 1352 1118  358 1116   86  356
 254  519  776 1025 1266 1499 1724 1941 2150 2351 2544 2729 2906 3075 3236 3389 3534 3671 3800 3801 3802 3803 3804 3805 3806 3807 3808 3809 3929 3684 3811 3686 3813 3934 3815 3816 3817 3818 3820 3821 3822 3940 3824 3943 3825 3828 4058 3701 3702 3703 3568 3282 3705 3433 3574 2961 2788 2419 2608 2418 2014 1584 1115  875  873 1354   85  618   89
 253  518  775 1024 1265 1498 1723 1940 2149 2350 2543 2728 2905 3074 3235 3388 3533 3670 3799 3920 3921 3922 4034 3923 3925 3926 3927 3928 4143 4040 4146 4043 3814 3933 3935 3936 3937 3819 4050 3939 4052 3823 4054 3944 3826 3946 3948 3573 3951 3833 3709 3708 3832 3127 3283 2962 2963 2789 2221 2017 2019 2223 1582 1583  871   88   90   87  620
 252  517  774 1023 1264 1497 1722 1939 2148 2349 2542 2727 2904 3073 3234 3387 3532 3797 3798 4032 3918 4136 3924 4035 4037 4038 4141 4041 4145 4144 3812 3931 3932 4045 4046 4047 4048 4049 4051 3938 3942 3941 4157 4055 3945 3947 4160 3829 3949 4161 3831 3434 3285 3577 3128 3129 2420 2609 1357 2610 1805 1804 1803 1355  872  617  876  622  616
 251  516  773 1022 1263 1496 1721 1938 2147 2348 2541 2726 2903 3072 3233 3386 3531 3669 3668 3919 4031 4137 4033 4138 4036 4140 4237 4039 4142 4325 4405 4044 4147 4148 4149 4150 4151 4152 4153 4154 4251 4053 4156 4158 4159 4056 4057 3950 3711 3836 3436 3575 3286 3284 3131 2964 2790 2225 2222 2421 2224 1802 1120 2016 1587  874  361  359  360
 250  515  772 1021 1262 1495 1720 1937 2146 2347 2540 2725 2902 3071 3232 3385 3530 3667 3796 3917 4030 4135 4232 4233 4139 4234 4235 4238 4403 3930 4240 4042 4242 4243 4244 4245 4246 4247 4248 4249 4155 4338 4252 4253 4254 4255 4162 4061 4059 3834 3835 3576 3435 3287 3130 2965 2791 2792 2422 1807 1585 1808 1121 1806 1117 2018 1353 1119   91
 249  514  771 1020 1261 1494 1719 1936 2145 2346 2539 2724 2901 3070 3231 3384 3529 3666 3795 3916 4029 4134 4231 4320 4322 4323 4236 4324 4326 4327 4239 4241 4329 4330 4331 4332 4333 4334 4414 4335 4250 4336 4339 4340 4341 4163 4257 3953 3952 3710 3837 3578 3437 3288 3132 2966 2793 2020 2426 2423 1809 2227 2226 1586 1356   95  880   93  621
 248  513  770 1019 1260 1493 1718 1935 2144 2345 2538 2723 2900 3069 3230 3383 3528 3665 3794 3915 4028 4133 4230 4319 4321 4400 4402 4475 4474 4404 4478 4328 4408 4409 4410 4411 4412 4413 4415 4337 4416 4417 4418 4419 4343 4256 4063 4062 3954 3712 3579 3580 3438 3289 2967 2968 2794 2611 2613 2612 1589 2021 1358 1811  363 1590 1122   94 1359
 247  512  769 1018 1259 1492 1717 1934 2143 2344 2537 2722 2899 3068 3229 3382 3527 3664 3793 3914 4027 4132 4229 4318 4399 4401 4536 4473 4477 4540 4407 4406 4479 4480 4481 4482 4483 4484 4485 4486 4487 4488 4421 4342 4420 4258 4164 3955 4065 3838 3714 3713 3439 3290 3133 2795 2614 2228 2023 1810 2424 2024 1591 1123 1361  877 1125  881   97
 246  511  768 1017 1258 1491 1716 1933 2142 2343 2536 2721 2898 3067 3228 3381 3526 3663 3792 3913 4026 4131 4228 4317 4398 4472 4535 4537 4476 4594 4539 4538 4542 4543 4544 4545 4546 4547 4548 4549 4550 4551 4489 4422 4344 4166 4165 4064 3958 3956 3581 3440 3441 3291 3134 2796 2799 2615 2425 1588 2231 1362 1364  362  628  627  625   92  364
 245  510  767 1016 1257 1490 1715 1932 2141 2342 2535 2720 2897 3066 3227 3380 3525 3662 3791 3912 4025 4130 4227 4316 4397 4471 4470 4592 4593 4641 4595 4541 4596 4597 4599 4600 4601 4602 4603 4604 4552 4553 4491 4490 4259 4261 4167 3957 3715 3840 3582 3442 3292 3135 2970 2969 2797 2429 2617 2022 1812 1815  878 1360  367 1124  365  624   96
 244  509  766 1015 1256 1489 1714 1931 2140 2341 2534 2719 2896 3065 3226 3379 3524 3661 3790 3911 4024 4129 4226 4315 4396 4469 4534 4591 4640 4642 4681 4643 4645 4598 4646 4647 4648 4650 4651 4606 4605 4492 4423 4260 4346 4262 4168 4066 3839 3959 3717 3716 3583 3293 3136 2798 2972 2616 2229 1813 2025 2428  630  623 1126   98  882  626   99
 243  508  765 1014 1255 1488 1713 1930 2139 2340 2533 2718 2895 3064 3225 3378 3523 3660 3789 3910 4023 4128 4225 4314 4395 4468 4533 4590 4639 4680 4712 4682 4644 4685 4716 4687 4688 4649 4689 4652 4607 4554 4493 4345 4348 4347 4169 4067 4068 3841 3718 3584 3443 3294 3137 2971 2618 2230 2619 2427 2232 2027 1592  879 1593  884 1363  101  366
 242  507  764 1013 1254 1487 1712 1929 2138 2339 2532 2717 2894 3063 3224 3377 3522 3659 3788 3909 4022 4127 4224 4313 4394 4467 4532 4589 4638 4679 4713 4683 4684 4714 4717 4686 4718 4719 4690 4653 4608 4555 4494 4424 4425 4264 4170 4069 3960 3842 3843 3586 3444 3295 3138 2973 2800 2430 2028 2026 2029 1594 1814  883 1129  368 1128  371  100
 241  506  763 1012 1253 1486 1711 1928 2137 2338 2531 2716 2893 3062 3223 3376 3521 3658 3787 3908 4021 4126 4223 4312 4393 4466 4531 4588 4637 4678 4711 4736 4752 4715 4738 4740 4741 4720 4691 4654 4609 4556 4495 4426 4263 4349 4171 4070 3961 3844 3585 3587 3445 3296 3139 2974 2801 2620 2233 2234 1816 1595 1596 1365 1127 1366  885  369  629
 240  505  762 1011 1252 1485 1710 1927 2136 2337 2530 2715 2892 3061 3222 3375 3520 3657 3786 3907 4020 4125 4222 4311 4392 4465 4530 4587 4636 4677 4710 4735 4753 4737 4739 4755 4742 4721 4692 4655 4610 4557 4496 4427 4350 4265 4172 4071 3962 3845 3719 3720 3446 3297 3140 2975 2802 2433 2431 2235 2030 1817 1597 1369 1130 1367  633  631  370
 239  504  761 1010 1251 1484 1709 1926 2135 2336 2529 2714 2891 3060 3221 3374 3519 3656 3785 3906 4019 4124 4221 4310 4391 4464 4529 4586 4635 4676 4709 4734 4751 4760 4754 4756 4743 4722 4693 4656 4611 4558 4497 4428 4351 4266 4173 4072 3963 3846 3721 3588 3447 3142 2977 3143 2976 2432 2621 2434 2031 1818 1368 1370 1131  632  103  634  886
 238  503  760 1009 1250 1483 1708 1925 2134 2335 2528 2713 2890 3059 3220 3373 3518 3655 3784 3905 4018 4123 4220 4309 4390 4463 4528 4585 4634 4675 4708 4733 4750 4759 4758 4757 4744 4723 4694 4657 4612 4559 4498 4429 4352 4267 4174 4073 3964 3847 3722 3589 3448 3298 3300 3141 2622 2803 2435 2236 2032 2033 1819 1598 1132  887  372  890  102
 237  502  759 1008 1249 1482 1707 1924 2133 2334 2527 2712 2889 3058 3219 3372 3517 3654 3783 3904 4017 4122 4219 4308 4389 4462 4527 4584 4633 4674 4707 4732 4749 4748 4747 4746 4745 4724 4695 4658 4613 4560 4499 4430 4353 4268 4175 4074 3965 3848 3723 3590 3449 3299 2978 2805 2804 2238 2625 2239 2237 1599 1600 1371  888  889  105  374  373
 236  501  758 1007 1248 1481 1706 1923 2132 2333 2526 2711 2888 3057 3218 3371 3516 3653 3782 3903 4016 4121 4218 4307 4388 4461 4526 4583 4632 4673 4706 4731 4730 4729 4728 4727 4726 4725 4696 4659 4614 4561 4500 4431 4354 4269 4176 4075 3966 3849 3724 3591 3450 3301 2807 2808 2979 2623 2436 2241 1821 2034 1822 1372 1133  637  636  106  104
 235  500  757 1006 1247 1480 1705 1922 2131 2332 2525 2710 2887 3056 3217 3370 3515 3652 3781 3902 4015 4120 4217 4306 4387 4460 4525 4582 4631 4672 4705 4704 4703 4702 4701 4700 4699 4698 4697 4660 4615 4562 4501 4432 4355 4270 4177 4076 3967 3850 3725 3592 3451 3302 3144 3146 2980 2437 2624 2438 2240 1820 1601 1135 1134  891  376  635  638
 234  499  756 1005 1246 1479 1704 1921 2130 2331 2524 2709 2886 3055 3216 3369 3514 3651 3780 3901 4014 4119 4216 4305 4386 4459 4524 4581 4630 4671 4670 4669 4668 4667 4666 4665 4664 4663 4662 4661 4616 4563 4502 4433 4356 4271 4178 4077 3851 3969 3727 3593 3452 3303 3145 2806 2627 2626 2439 2035 1824 2037 1603 1373  892 1137  639  108  375
 233  498  755 1004 1245 1478 1703 1920 2129 2330 2523 2708 2885 3054 3215 3368 3513 3650 3779 3900 4013 4118 4215 4304 4385 4458 4523 4580 4629 4628 4627 4626 4625 4624 4623 4622 4621 4620 4619 4618 4617 4564 4503 4434 4357 4272 4179 4078 3968 3852 3728 3595 3454 3304 3147 2981 2982 2628 2809 2243 2242 2036 1604 1823  894 1136  893  377  107
 232  497  754 1003 1244 1477 1702 1919 2128 2329 2522 2707 2884 3053 3214 3367 3512 3649 3778 3899 4012 4117 4214 4303 4384 4457 4522 4579 4578 4577 4576 4575 4574 4573 4572 4571 4570 4569 4568 4567 4566 4565 4504 4435 4358 4273 4180 3854 3970 3726 3729 3453 3594 3305 3148 2985 2983 2810 2440 2629 2038 1602 1375 1374 1377 1140 1138  109  378
 231  496  753 1002 1243 1476 1701 1918 2127 2328 2521 2706 2883 3052 3213 3366 3511 3648 3777 3898 4011 4116 4213 4302 4383 4456 4521 4520 4519 4518 4517 4516 4515 4514 4513 4512 4511 4510 4509 4508 4507 4506 4505 4436 4359 4275 4274 4079 3972 3853 3730 3455 3308 3151 3306 3149 2984 2630 2441 2244 2040 1825 1826 1605  640  641  380  381  111
 230  495  752 1001 1242 1475 1700 1917 2126 2327 2520 2705 2882 3051 3212 3365 3510 3647 3776 3897 4010 4115 4212 4301 4382 4455 4454 4453 4452 4451 4450 4449 4448 4447 4446 4445 4444 4443 4442 4441 4440 4439 4438 4437 4360 4081 4182 3971 3856 4183 3597 3596 3458 3456 3307 3150 2811 2631 2443 2442 2245 1606 1607 1139 1376  895  112  110  379
 229  494  751 1000 1241 1474 1699 1916 2125 2326 2519 2704 2881 3050 3211 3364 3509 3646 3775 3896 4009 4114 4211 4300 4381 4380 4379 4378 4377 4376 4375 4374 4373 4372 4371 4370 4369 4368 4367 4366 4365 4364 4363 4362 4361 4276 4080 4181 3857 3731 3855 3732 3598 3457 2986 2812 2814 2813 2632 2246 1829 1827 2041 1378 1142  896  382  644  384
 228  493  750  999 1240 1473 1698 1915 2124 2325 2518 2703 2880 3049 3210 3363 3508 3645 3774 3895 4008 4113 4210 4299 4298 4297 4296 4295 4294 4293 4292 4291 4290 4289 4288 4287 4286 4285 4284 4283 4282 4281 4280 4279 4278 4186 3974 3975 4082 3735 3734 3599 3459 3153 2988 3310 2815 2633 2444 2247 2039 1828 1608 1379  643 1141  642  383  114
 227  492  749  998 1239 1472 1697 1914 2123 2324 2517 2702 2879 3048 3209 3362 3507 3644 3773 3894 4007 4112 4209 4208 4207 4206 4205 4204 4203 4202 4201 4200 4199 4198 4197 4196 4195 4194 4193 4192 4191 4190 4189 4188 4187 4087 3976 3973 4083 3858 4084 3461 3860 3600 2987 3155 3154 2816 2445 2248 2042 1830 1609 1380 1143  897  898  113  116
 226  491  748  997 1238 1471 1696 1913 2122 2323 2516 2701 2878 3047 3208 3361 3506 3643 3772 3893 4006 4111 4110 4109 4108 4107 4106 4105 4104 4103 4102 4101 4100 4099 4098 4097 4096 4095 4094 4093 4092 4091 4090 4089 3981 4088 4086 4277 4085 4185 3460 3309 3733 3152 3311 2989 2635 2634 2446 2249 2043 1831 1610 1381  645  899  646  115  385
 225  490  747  996 1237 1470 1695 1912 2121 2322 2515 2700 2877 3046 3207 3360 3505 3642 3771 3892 4005 4004 4003 4002 4001 4000 3999 3998 3997 3996 3995 3994 3993 3992 3991 3990 3989 3988 3987 3986 3985 3984 3983 3867 3865 3741 3979 4184 3859 3738 3861 3601 3978 3313 2990 3312 2817 2636 2447 2250 2044 1832 1611 1382 1144 1145  900  386  117
 224  489  746  995 1236 1469 1694 1911 2120 2321 2514 2699 2876 3045 3206 3359 3504 3641 3770 3891 3890 3889 3888 3887 3886 3885 3884 3883 3882 3881 3880 3879 3878 3877 3876 3875 3874 3873 3872 3871 3870 3746 3869 3868 3982 3980 3742 3863 3977 3736 3603 3604 3602 3462 3156 2818 2819 2637 2449 2448 2045 1612 1613 1383 1146  901  647  648  118
 223  488  745  994 1235 1468 1693 1910 2119 2320 2513 2698 2875 3044 3205 3358 3503 3640 3769 3768 3767 3766 3765 3764 3763 3762 3761 3760 3759 3758 3757 3756 3755 3754 3753 3752 3751 3750 3749 3748 3747 3745 3744 3743 3866 3864 3612 3740 3862 3739 3737 3605 3463 3314 3157 2991 2638 2639 2251 2252 1833 2046 2047 1384 1147  649  650  387  388
 222  487  744  993 1234 1467 1692 1909 2118 2319 2512 2697 2874 3043 3204 3357 3502 3639 3638 3637 3636 3635 3634 3633 3632 3631 3630 3629 3628 3627 3626 3625 3624 3623 3622 3621 3620 3619 3618 3617 3616 3615 3614 3474 3613 3611 3610 3609 3608 3607 3606 3466 3464 3315 3158 2992 2993 2450 2451 2253 1834 1615 1835 1148  903  902  389  390  119
 221  486  743  992 1233 1466 1691 1908 2117 2318 2511 2696 2873 3042 3203 3356 3501 3500 3499 3498 3497 3496 3495 3494 3493 3492 3491 3490 3489 3488 3487 3486 3485 3484 3483 3482 3481 3480 3479 3478 3477 3476 3475 3327 3473 3472 3471 3470 3469 3320 3165 3319 3465 3316 3159 2994 2820 2640 2254 2255 2048 1614 1386 1385 1149  904  651  391  120
 220  485  742  991 1232 1465 1690 1907 2116 2317 2510 2695 2872 3041 3202 3355 3354 3353 3352 3351 3350 3349 3348 3347 3346 3345 3344 3343 3342 3341 3340 3339 3338 3337 3336 3335 3334 3333 3332 3331 3330 3329 3328 3326 3171 3325 3324 3167 3468 3467 3166 3163 3317 3160 2995 2822 2821 2452 2453 2051 2049 1836 1616 1387 1150  905  652  392  121
 219  484  741  990 1231 1464 1689 1906 2115 2316 2509 2694 2871 3040 3201 3200 3199 3198 3197 3196 3195 3194 3193 3192 3191 3190 3189 3188 3187 3186 3185 3184 3183 3182 3181 3180 3179 3178 3177 3176 3175 3174 3173 3172 3170 3169 3006 3322 3323 3004 3164 3001 3318 3162 2996 2823 2641 2642 2256 2257 2050 1837 1617 1388 1151  906  653  393  122
 218  483  740  989 1230 1463 1688 1905 2114 2315 2508 2693 2870 3039 3038 3037 3036 3035 3034 3033 3032 3031 3030 3029 3028 3027 3026 3025 3024 3023 3022 3021 3020 3019 3018 3017 3016 3015 3014 3013 3012 3011 3010 3009 3008 3007 3005 3168 3003 3002 3321 3000 2999 2828 3161 2827 2824 2643 2455 2454 1838 2052 1839 1618 1152  908  907  124  123
 217  482  739  988 1229 1462 1687 1904 2113 2314 2507 2692 2869 2868 2867 2866 2865 2864 2863 2862 2861 2860 2859 2858 2857 2856 2855 2854 2853 2852 2851 2850 2849 2848 2847 2846 2845 2844 2843 2842 2841 2840 2839 2838 2837 2836 2835 2834 2833 2832 2831 2830 2829 2826 2998 2997 2825 2644 2258 2053 2054 1840 1619 1153  654 1154  395  657  125
 216  481  738  987 1228 1461 1686 1903 2112 2313 2506 2691 2690 2689 2688 2687 2686 2685 2684 2683 2682 2681 2680 2679 2678 2677 2676 2675 2674 2673 2672 2671 2670 2669 2668 2667 2666 2665 2664 2663 2662 2661 2660 2659 2658 2657 2656 2655 2654 2653 2652 2651 2650 2649 2648 2647 2646 2645 2456 2259 2055 1620 1390 1389 1155 1391  656  129  655
 215  480  737  986 1227 1460 1685 1902 2111 2312 2505 2504 2503 2502 2501 2500 2499 2498 2497 2496 2495 2494 2493 2492 2491 2490 2489 2488 2487 2486 2485 2484 2483 2482 2481 2480 2479 2478 2477 2476 2475 2474 2473 2472 2471 2470 2469 2468 2467 2466 2465 2464 2463 2462 2461 2460 2459 2458 2457 2260 2056 1841 1621 1392  910  658  398  127  394
 214  479  736  985 1226 1459 1684 1901 2110 2311 2310 2309 2308 2307 2306 2305 2304 2303 2302 2301 2300 2299 2298 2297 2296 2295 2294 2293 2292 2291 2290 2289 2288 2287 2286 2285 2284 2283 2282 2281 2280 2279 2278 2277 2276 2275 2274 2273 2272 2271 2270 2269 2268 2267 2266 2265 2264 2263 2262 2261 1843 1842 1622 1156  911  909  660  397  126
 213  478  735  984 1225 1458 1683 1900 2109 2108 2107 2106 2105 2104 2103 2102 2101 2100 2099 2098 2097 2096 2095 2094 2093 2092 2091 2090 2089 2088 2087 2086 2085 2084 2083 2082 2081 2080 2079 2078 2077 2076 2075 2074 2073 2072 2071 2070 2069 2068 2067 2066 2065 2064 2063 2062 2061 2060 2059 2058 1845 1844 1624 1393 1157  130 1159  396  128
 212  477  734  983 1224 1457 1682 1899 1898 1897 1896 1895 1894 1893 1892 1891 1890 1889 1888 1887 1886 1885 1884 1883 1882 1881 1880 1879 1878 1877 1876 1875 1874 1873 1872 1871 1870 1869 1868 1867 1866 1865 1864 1863 1862 1861 1860 1859 1858 1857 1856 1855 1854 1853 1852 1851 1850 1849 1848 1401 2057 1399  913 1623 1394 1160  659  399  131
 211  476  733  982 1223 1456 1681 1680 1679 1678 1677 1676 1675 1674 1673 1672 1671 1670 1669 1668 1667 1666 1665 1664 1663 1662 1661 1660 1659 1658 1657 1656 1655 1654 1653 1652 1651 1650 1649 1648 1647 1646 1645 1644 1643 1642 1641 1640 1639 1638 1637 1636 1635 1634 1633 1632 1631 1630 1629 1627 1395 1847 1846 1396 1161 1158  912  662  132
 210  475  732  981 1222 1455 1454 1453 1452 1451 1450 1449 1448 1447 1446 1445 1444 1443 1442 1441 1440 1439 1438 1437 1436 1435 1434 1433 1432 1431 1430 1429 1428 1427 1426 1425 1424 1423 1422 1421 1420 1419 1418 1417 1416 1415 1414 1413 1412 1411 1410 1409 1408 1407 1406 1405 1404 1403 1402 1628 1398  915  918 1397  914 1164  133  400  402
 209  474  731  980 1221 1220 1219 1218 1217 1216 1215 1214 1213 1212 1211 1210 1209 1208 1207 1206 1205 1204 1203 1202 1201 1200 1199 1198 1197 1196 1195 1194 1193 1192 1191 1190 1189 1188 1187 1186 1185 1184 1183 1182 1181 1180 1179 1178 1177 1176 1175 1174 1173 1172 1171 1170 1169 1168 1165 1166 1400  920 1626 1625 1162  661  663  401  134
 208  473  730  979  978  977  976  975  974  973  972  971  970  969  968  967  966  965  964  963  962  961  960  959  958  957  956  955  954  953  952  951  950  949  948  947  946  945  944  943  942  941  940  939  938  937  936  935  934  933  932  931  930  929  928  927  926  925 1167  924  923  922 1163  916  921  917  139  403  135
 207  472  729  728  727  726  725  724  723  722  721  720  719  718  717  716  715  714  713  712  711  710  709  708  707  706  705  704  703  702  701  700  699  698  697  696  695  694  693  692  691  690  689  688  687  686  685  684  683  682  681  680  679  678  677  676  675  415  674  672  670  919  668  142  406  664  666  138  137
 206  471  470  469  468  467  466  465  464  463  462  461  460  459  458  457  456  455  454  453  452  451  450  449  448  447  446  445  444  443  442  441  440  439  438  437  436  435  434  433  432  431  430  429  428  427  426  425  424  423  422  421  420  419  418  417  416  673  413  669  671  144  143  410  404  667  407  405  665
 205  204  203  202  201  200  199  198  197  196  195  194  193  192  191  190  189  188  187  186  185  184  183  182  181  180  179  178  177  176  175  174  173  172  171  170  169  168  167  166  165  164  163  162  161  160  159  158  157  156  155  154  153  152  151  150  149  148  414  145  147  146  411  412  409  141  408  136  140
