# This puzzle is unsolvable
31
  1   2   4 119 519 126 236 125   8 242 347  11 131  10 134 133  17 243 137  22 248 142 255 145 146  26  27  29 257  28 148
121 117 336   3   5 122 337   6 130 127   9 244 345 443 246  14  16 138  19 251  21 254 143  25  23 359  24 147  30 259  32
234 232 233 434 436 338 239 238 343   7 129 245  13 679  12 135  15  20 139 247 141 249 140 357 457 454 541 362 144  35  34
335 120 230   0 124 237 235 520 128 524 344 241 348 444 346 132 445  18 136 353 250 354 252 689 453 149 258 261  31 262 154
229 123 672 339 116 340 435 437 525 438 240 440 350 605 610 351 448 349 449 446 253 450 356 358 540 360  33 361 150 158 260
227 332 118 334 341 599 523 439 606 527 342 526 607 441 531 530 535 352 613 536 539 618 687 616 366 456  36 452 455  38 151
333 428 231 600 432 431 521 671 433 602 603 675 608 680 529 533 682 447 749 685 614 537 451 752 688 460 692 153 619 264 263
114 115 331 225 430 598 522 673 604 738 677 528 676 609 612 744 611 532 746 683 615 538 747 617 690 458 256 544 459 156 265
327 109 224 426 429 517 601 670 791 674 740 796 797 798 442 681 800 883 355 805 534 686 542 620 753 691 267 266 155 363  40
113 228 112 597 514 427 669 736 735 792 739 678 843 741 742 917 684 802 801 889 803 751 851 693 754 543 152  37 364 159  41
111 330 110 329 596 518 734 838 737 793 840 794 842 795 845 745 743 887 847 849 850 809 852 806 621 622 365 368  39 161  42
226 328 424 515 516 595 668 790 733 880 881 879 882 885 916 884 799 848 888 804 756 624 810 755 750 369 271 157 367 268 160
223 326 324 594 425 593 667 732 836 839 841 912 936 913 846 886 954 918 941 748 807 695 808 626 549 548 461 462 162  44  43
221 222 423 512 513 666 728 731 837 729 877 878 911 844 915 950 939 943 959 853 854 893 623 545 546 465 547 371 269 373  45
107 220 108 422 511 665 592 787 788 935 952 910 914 927 919 955 890 956 892 960 855 696 694 625 550 628 463 464 370 270  47
219 105 421 325 510 662 786 784 876 664 909 835 953 930 951 938 921 932 924 891 942 920 811 758 553 627 629 551 372 272 163
104 106 420 218 590 591 785 730 663 934 783 908 937 928 922 947 945 948 957 812 759 856 697 757 631 469 467 273 374 274 165
322 217 323 419 509 727 782 789 833 832 929 933 834 900 874 958 944 925 858 894 897 760 818 699 552 554 466 276  46  49  48
103 216 320 507 508 587 418 661 726 830 872 931 873 867 907 866 940 923 762 860 946 895 700 698 632 814 468 375 164 275 166
101 215 318 321 584 589 588 659 658 905 826 906 949 820 875 771 714 898 763 761 764 859 630 471 813 472 377 555 167 168  50
214 102 319 417 506 505 725 660 781 831 718 901 903 772 865 822 926 769 864 862 896 816 767 702 633 470 376 378 277  51  52
100 213 412 415 503 504 722 724 723 775 780 870 774 904 899 575 768 823 709 712 556 766 857 634 703 557 381 379 278 170 169
 99 212 416 317 413 586 585 657 779 827 719 871 648 869 863 868 861 819 641 711 710 704 639 701 560 706 474 473 279  55  53
 98 211 316 414 502 583 656 655 778 828 829 776 651 492 825 902 489 715 645 484 640 815 565 636 765 559 558 380 172 280 171
210 315 313 411 582 654 580 721 720 652 576 777 400 824 647 713 716 821 773 642 482 817 707 635 637 382 705 475 383  54  56
 97 209 314 501 499 406 581 497 653 494 574 573 717 571 570 485 569 643 644 566 567 708 638 563 562 477 281 561 282 173  57
 95  96 410 500 407 496 579 495 403 578 404 399 572 490 397 488 646 770 295 486 391 564 481 182 478 387 476 384 284 283 174
206 207 312 310 498 408 307 405 577 650 304 493 649 401 396 300 568 395 297 394 483 393 390  68 479 386 287 385 177 175  59
 94 208 204 409 311 309 308 306 305 198 302 491 193 194 301 192 487 298 296 294 392 388 185 480 290 286 285  64  65  62 176
 90  92 205  89 203 201 200 199  83 197 303 195 398 402 299  77 191 189 188 186 293 292  70 389  66 183 288 289 179  60  58
 93  91  88  87 202  86  85  84  82  81 196  80  79  78  76  75 190  74  73 187  72  71 184  69 291  67 181 180 178  63  61
