# This puzzle is unsolvable
47
 360    1  527  359    3   10    7  190    8  193  371  369   11  196   15   16   17   18   20  203   22  205   23   24   25   26   27  211   29   31   32  214   33   34   35   36   37   38   39   40   41   42   43   44   45   46   47
 184  361    6  187  185    5    4  367  191  192  845  194   14   12  198  199  201  375  202   19   21  380  206  207  208  209  210   30  387  213  390  389  215  217  218  219  220  221  222  223  224  225  226  227  228  229   48
 182  183  534    2  983  366 1123  189    9  693  197  532  695   13  538  373  537  378  545  377  379  204  381  382  383  384  385  212  555  554  556  388  216  392  393  394  395  396  397  398  399  400  401  402  403  230   49
 363  528  531  358  530  984  535  368  691  843  372  539  195  844  541  851  200  374  542  376  546  548  549  709  710  552  553   28  713  867  557  558  717  559  560  561  562  563  564  565  566  567  568  569  404  231   50
 178  688  179  836  364  839  990  362  988  365 1122 1124  697  698  849  700  540  543  544  855  854  547  707  550  712 1004  551  386  714 1008  866  391  868  718  719  720  721  722  723  724  725  726  727  570  405  232   51
 181  840  692  357 1118 1121  982  985  188  533  846  370  696  992  994  995  701 1132  702  853 1000 1135  861 1137 1384  863 1269 1003  711  862  865  715 1010  869  870  871  872  873  874  875  876  877  728  571  406  233   52
 186  526  529  841  981  689  685  986 1370  847  987 1250  536  991  850  699  852  703 1133  706  704 1263  999  708 1140 1002 1267 1388 1006  864 1009 1145  716 1012 1013 1150 1014 1016 1017 1018 1019  878  729  572  407  234   53
 686  354  180  355 1120 1244  690  989 1246  694 1368  842 1481 1125  993 1377 1131 1130  997  705 1001  858 1265 1260 1141 1005 1386  860 1144 1143 1271 1391 1272 1146 1147 1148 1015 1151 1152 1153 1020  879  730  573  408  235   54
 356  177  523  838  681 1119 1245 1369 1251  837 1254 1485 1129 1375 1126 1255 1588 1378  856  996  857 1262 1136 1382  859 1138 1007 1498 1387 1142 1393 1390 1011 1275 1276 1149 1395 1277 1279 1154 1021  880  731  574  409  236   55
 176  522  524  175  352  835 1114 1480 1247 1367 1253 1482 1371 1257 1373 1487 1376 1259 1489 1261  998 1492 1493 1381 1264 1139 1599 1600 1500 1268 1270 1603 1273 1394 1608 1506 1397 1278 1280 1156 1022  881  732  575  410  237   56
 521  687  525  682  976  680  830 1478 1249 1117 1372 1479  848 1681 1587 1484 1486 1590 1589 1379 1134 1595 1593 1597 1383 1495 1496 1266 1601 1698 1501 1502 1504 1392 1609 1505 1396 1398 1155 1281 1023  882  733  576  411  238   57
 350  174  684  683  834 1115  980 1365 1252 1477 1476 1584 1128 1483 1684 1374 1127 1256 1688 1490 1687 1594 1596 1598 1494 1497 1385 1697 1604 1389 1699 1274 1503 1607 1703 1508 1507 1399 1282 1157 1024  883  734  577  412  239   58
 353  173  975  519  974  979 1364 1116 1248 1366 1585 1586 1583 1582 1770 1771 1591 1686 1488 1776 1491 1690 1779 1691 1693 1694 1783 1602 1695 1864 1700 1701 1605 1606 1702 1610 1509 1400 1283 1158 1025  884  735  578  413  240   59
 172  678  520  679  833  517  973 1113  978 1475 1680 1767 1848 1850 1683 1685 1258 1773 1592 1380 1689 1855 1775 1692 1780 1782 1861 1860 1933 1784 1786 1787 1788 1704 1611 1612 1510 1401 1284 1159 1026  885  736  579  414  241   60
 171  832  349  677  518 1241 1112 1242 1363 1580 1678 1768 1849 1682 1679 1922 1772 1923 1774 1925 1777 1928 1778 1856 1929 1859 1499 1696 2051 1862 1865 1866 1790 1789 1705 1511 1512 1402 1285 1160 1027  886  737  580  415  242   61
 170  351  348  674  516  831  977 1240 1361 1581 1676 1769 1766 1919 1920 1984 1986 1853 1926 1854 1991 2092 1927 1858 1993 1996 1781 1785 1863 1935 1937 1868 1867 1791 1706 1613 1513 1403 1286 1161 1028  887  738  581  416  243   62
 168  347  515  829  514 1109 1243 1362 1677 1473 1579 1675 1765 1847 1846 1851 1921 1988 1987 2043 2094 1857 1989 2045 1931 1994 1932 1934 1995 1999 1936 1938 1869 1792 1707 1615 1614 1404 1287 1162 1029  888  739  582  417  244   63
 167  345  675  676  827 1111 1110 1360 1359 1577 1764 1759 1845 1843 1983 1916 1985 1852 2086 1924 2129 2042 2044 1990 2047 2050 2048 2097 1997 1998 2000 1939 1870 1793 1708 1616 1514 1405 1288 1163 1030  889  740  583  418  245   64
 169  344  346  826  828  673 1239 1238 1472 1578 1763 1474 1674 1673 1918 2039 2040 2160 2041 2088 2091 2133 2046 2049 1930 2095 2096 2052 2098 2053 2001 1940 1871 1795 1794 1709 1515 1406 1289 1164 1031  890  741  584  419  246   65
 166  342  343  672  972  970 1237 1108 1236 1468 1471 1575 1576 1841 1917 1844 1982 2090 2087 2127 2131 2186 1992 2164 2135 2136 2137 2099 2055 2054 2002 1941 1872 1796 1710 1617 1516 1407 1290 1165 1032  891  742  585  420  247   66
 341  163  507  825 1107  823  671  971 1358 1668 1470 1573 1762 1672 1981 1980 2038 2084 2037 2126 2128 2132 2185 2165 2163 2166 2167 2101 2100 2056 2003 1942 1873 1711 1712 1618 1517 1408 1291 1166 1033  892  743  586  421  248   67
 512  511  509  513  967  969 1106 1354 1357 1355 1356 1574 1840 1760 1842 1979 2085 2035 2130 2161 2183 2093 2184 2134 2200 2187 2168 2139 2102 2057 2005 2004 1874 1797 1713 1619 1410 1518 1292 1167 1034  893  744  587  422  249   68
 165  164  821  670  824 1105 1234 1669 1466 1572 1670 1761 1758 1914 1915 1911 2036 2089 2125 2159 2158 2162 2202 2188 2204 2189 2190 2103 2141 2138 2058 1943 1944 1798 1620 1621 1519 1409 1293 1168 1035  894  745  588  423  250   69
 339  162  337  968  508  965 1232 1235 1469 1570 1757 1913 1837 1838 1912 1977 2123 2124 2157 2180 2208 2182 2201 2203 2191 2170 2140 2060 2104 2006 2007 1945 1875 1876 1799 1622 1520 1411 1294 1169 1036  895  746  589  424  251   70
 340  506  820  510  505  822  966 1352 1571 1231 1569 1756 1910 1836 2034 1908 1976 2032 2083 2082 2181 2199 2207 2206 2205 2192 2172 2169 2105 2059 1946 1947 1877 1800 1714 1623 1521 1412 1295 1170 1037  896  747  590  425  252   71
 161  964  667  669  963 1467 1230 1104 1233 1351 1353 1671 1909 1839 1978 2033 2078 1975 2122 2179 2156 2198 2196 2195 2194 2193 2142 2171 2106 2061 2008 1878 1948 1801 1715 1716 1522 1413 1296 1171 1038  897  748  591  426  253   72
 160  338  335  668 1103  666 1102 1465 1463 1461 1667 1755 1754 1753 1833 2030 1973 2120 2079 2155 2152 2197 2154 2177 2175 2174 2173 2144 2143 2107 2062 2009 1803 1879 1717 1624 1523 1414 1297 1172 1039  898  749  592  427  254   73
 336  159  504 1100  818 1101  819  961 1228 1462 1663 1666 1664 1665 1907 1974 2028 2081 2118 2121 2116 2114 2178 2176 2148 2111 2112 2146 2145 2064 2010 2063 1880 1802 1718 1625 1524 1415 1298 1173 1040  899  750  593  428  255   74
 158  334  503  665  663  816 1098 1464 1350 1565 1568 1752 1566 1835 1834 1971 2029 2026 2150 2153 2117 2151 2149 2113 2070 2147 2110 2108 2066 2109 2011 1950 1881 1804 1719 1626 1525 1301 1416 1174 1041  900  751  594  429  256   75
 157  156  502  664  817 1097  962 1099 1227 1832 1348 1662 1564 1750 1906 1905 1969 2119 2031 1968 2074 2073 2115 2020 2071 2069 2068 2016 2067 2015 1952 1951 1949 1806 1883 1627 1526 1417 1299 1300  902 1042  752  595  430  257   76
 155  333  501  662  814  815 1229  960 1347 1460 1567 1563 1831 1751 2077 1902 1972 2080 2075 2024 2023 2022 2072 2021 2019 2018 1958 2017 2014 2065 1805 2012 1882 1721 1720 1628 1528 1527 1302 1175 1177  901  753  596  431  258   77
 154  332  331  500  661  959 1096 1226 1349 1345 1458 1562 1970 1661 1830 1967 1900 2027 2076 2025 1966 1821 1962 1961 1960 1959 1891 1957 1956 1955 2013 1953 1884 1807 1722 1629 1529 1303 1420 1043 1176 1044  754  597  432  259   78
 153  330  499  660  813  958 1095 1224 1225 1561 1459 1457 1749 1903 1904 1827 1899 1898 1824 1822 1897 1963 1895 1894 1893 1892 1890 1889 1317 1812 1954 1811 1808 1886 1723 1724 1630 1418 1304 1178 1045  903  755  598  433  260   79
 152  329  498  659  812  957 1094 1223 1343 1346 1660 1747 1659 1829 1828 1826 1743 1901 1965 1964 1739 1738 1820 1818 1735 1643 1816 1734 1815 1888 1728 1885 1813 1809 1631 1530 1421 1531 1305 1179 1046  904  756  599  434  261   80
 151  328  497  658  811  956 1093 1221 1455 1344 1560 1656 1658 1655 1745 1651 1653 1652 1741 1825 1740 1823 1737 1646 1736 1644 1732 1814 1640 1730 1887 1637 1810 1727 1725 1632 1419 1423 1532 1180 1047  905  757  600  435  262   81
 150  327  496  657  810  954 1092 1342 1456 1454 1559 1657 1746 1654 1555 1744 1552 1742 1650 1896 1648 1647 1645 1819 1545 1641 1541 1817 1642 1731 1636 1536 1638 1635 1634 1633 1422 1424 1306 1048  907  906  758  601  436  263   82
 149  326  495  656  808 1091  955 1220 1222 1341 1558 1557 1556 1748 1448 1554 1553 1551 1550 1649 1549 1548 1547 1546    0 1733 1544 1542 1434 1729 1430 1639 1432 1537 1535 1534 1533 1425 1307 1181 1049  908  759  602  437  264   83
 148  325  494  655  953  809 1090 1219 1340 1453 1452 1451 1450 1449 1333 1447 1445 1328 1444 1443 1442 1441 1440 1439 1438 1437 1543 1436 1435 1540 1433 1318 1538 1726 1428 1311 1310 1308 1183 1182 1050  909  760  603  438  265   84
 147  324  493  654  807  952 1089 1218 1339 1338 1337 1336 1335 1334 1332 1331 1208 1446 1329 1205 1327 1326 1325 1324 1323 1322 1321 1320 1319 1193 1062 1539 1429 1427 1314 1312 1313 1189 1309 1184 1051  910  761  604  439  266   85
 146  323  492  653  806  951 1088 1217 1216 1215 1214 1213 1212 1211 1210 1209 1077 1330 1207 1206 1204 1203 1202 1201 1200 1199 1198 1197 1196 1195 1431 1194 1316 1192 1059 1057 1058 1426 1187 1186 1185  911  762  605  440  267   86
 145  322  491  652  805  950 1087 1086 1085 1084 1083 1082 1081 1080 1079 1078  938 1076  936 1074 1073 1072 1071 1070 1069 1068 1067 1066 1065 1063  924 1060 1315 1190 1191 1188 1056 1055 1054 1053 1052  912  763  606  441  268   87
 144  321  490  651  804  949  948  947  946  945  944  943  942  941  940  792  939  937  935 1075  934  933  931  930  929  928  927  926  925 1064  777  923 1061  922  772  919  918  917  916  915  914  913  764  607  442  269   88
 143  320  489  650  803  802  801  800  799  798  797  796  795  794  793  637  791  790  788  787  786  785  784  932  629  783  781  780  779  778  776  620  621  921  920  773  771  770  769  768  767  766  765  608  443  270   89
 142  319  488  649  648  647  646  645  644  643  642  641  640  639  638  474  636  634  789  633  632  631  467  630  628  782  626  625  624  623  622  775  619  774  618  617  616  615  614  613  612  611  610  609  444  271   90
 141  318  487  486  485  484  483  482  481  480  479  478  477  476  475  303  473  635  471  470  469  468  296  466  465  627  464  292  462  460  459  458  457  456  455  454  453  452  451  450  449  448  447  446  445  272   91
 140  317  316  315  314  313  312  311  310  309  308  307  306  305  304  124  302  472  300  299  298  297  295  294  293  291  113  290  289  461  288  287  286  285  284  283  282  281  280  279  278  277  276  275  274  273   92
 139  138  137  136  135  134  133  132  131  130  129  128  127  126  125  123  122  301  121  120  119  118  117  116  115  114  112  463  111  110  109  108  107  106  105  104  103  102  101  100   99   98   97   96   95   94   93
