# This puzzle is unsolvable
19
  2   1 141  76 197   5  79 286 135  81  80  12 206 205  15  86 148 204  16
134  73 190  71  69   3 194   8 199  78 139 316 318  19 290 149  90 153  17
 72  68  74 280 243 200 138 142 278 241  82   7  11 250  23  85  89  27  94
191 133 136   4 282 312 193 357 202 152  10 150  83 320 246  18  91  87 151
239 238  75  70 195 196   6 242 338 147 144  84 140 291 288 248  92  25 157
240 132 192 279  77 137 283 358 201 146 293   9 203  14  88 251 207  24  96
 67 236 354 128 311 188 198 244 348 319 321 143 208 287  21  93 247 156 155
189 129 281 352 334 285 245 310 341 336 254 340 253 342  20 322 159 210 256
233 131  66  64 130 349 313 315 266 227 249 145 211 255 325  95 209  22  30
127  62  65 275 337 314 350 360 284 356 289 302 323 257  13 212 252 158 154
183 184 277 273 237 187 339 276 333 355 298 335 343 220 295 100  34  97 160
232 359 229 307 234 185 308 309 329 225 317 292 297 324  98 258  28  26  99
186  63  61 182 231 347 235 328 267 116 299 326   0 262 214 213  31 216 103
125 181 126 306 180 274 228 351 170 223 346 353 344 264 164 161 296 102 260
230  57 121 270 175 332 265 301 114 268 327 331 263 167 224 294 163  29  32
118 124  53 271 330 269 117 221 222  45 111 115 172 108 162 259 215 101 104
 60 123 177  52 272 305 304 113 171 226 166 261 169  41 109 107 106 165 217
 59 120 179 122 300 174 178  51 176 303 110 218 219 168  42  38  33  36  35
 54  55  58  56 119  48  47  50  46  49 112 345  44  40  43 173  37  39 105
