# This puzzle is unsolvable
30
  2   1   3   5 120   6   8   7 423 231   9 333 127 129 134  15  19 135 340 436 343 434 138  24  26 249 142  28  29 145
118 116 225   4 121 227 229  10 419 125 332 128 331 237  16 130 133 338 339  18  21  22 345 244 141 143 349 146  31  32
115 224 324 226 327 330 500 123 421 230 334 234  11 425  14  17 427 239 429 432 136  23 341  25 140 250  27 248  33 348
117 322 119 325 417 124 122  13 329 705  12 126 583 235 240 132 428 512 243 433  20 591 137 342 346 247 245  30 252 144
114 113 323 416 326 418 506 328 232 420 424 422 507 131 587 509 589 426 238 592 516 242 352 440 438 519 522 350 251 148
112 320 223 415 577 501 414 504 502 581 580 335 582 236 584 585 654 241 716 514 517 431 139 518 593 439 351 441  35  34
222 221 412 319 498 503 228 643 576 649 757 709 648 510 508 588 657 513 515 435 658 344 246 347 521 353 254 147 256 149
111 107 411 499 642 574 578 575 645 707 233 505 336 337 711 712 590 430 717 768 767 718 659 442 444 523 253 150  37  36
219 321 413 495 496 646 497 701 647 644 760 650 801 710 586 810 763 653 656 766 808 660 596 594 437 255 443 151 153  38
109 218 318 316 641 706 493 753 702 573 651 579 708 803 762 511 652 845 871 807 714 719 598 520 445 354 597 154  39 258
216 220 408 410 572 638 703 704 802 756 759 804 839 761 713 806 841 655 870 715 663 525 661 595 524 662 355 257  41  40
215 110 317 409 571 836 832 798 864 837 754 755 884 838 840 805 765 809 843 769 811 720 724 599 600 358 446 356 260  42
104 108 315 494 569 752 492 796 640 865 797 835 758 866 868 888 764 842 771 721 844 772 664 666 528 527 357 152 259  43
106 313 217 312 213 105 570 700 834 860 800 861 833 885 863 847 886 813 846 812 770 723 722 665 526 359 261 262 155 156
214 212 407 314 699 567 697 795 698 639 831 859 883 898 869 867 872 889 848 815 773 603 669 668 601 447 360 448 157  44
103 311 406 488 208 102 635 799 751 862 881 794 880 887 896 899 890 891 874 775 774 667 529 725 530 604 602 263 158  45
 99 209 490 565 696 568 491 750 749 828 636 793 895 894 897 892 877 875 873 814 816 726 671 605 450   0 361 264 159  46
101 211 309 404 566 405 637 633 634 792 790 882 858 856 893 878 849 851 817 852 776 727 670 531 452 449 532 160  49  47
 98 100 402 632 564 489 486 694 695 830 829 879 791 857 855 854 822 876 782 818 780 777 728 606 363 533 451 362 162  48
207 310 693 746 484 308 690 487 691 692 745 827 826 825 824 853 821 820 734 850 819 729 608 607 454 163 161 672 364 268
306 403 206 401  97 748 744 561 630 747 788 741 686 785 784 823 738 783 781 733 779 730 673 536 453 534 273 266 267  50
304 203 485 210 563 483 631 562 689 743 742 789 685 740 786 736 682 679 376 732 676 367 610 540 535 365 265 366 269 270
400 204 399 307 397 560 559 627 625 688 787 622 687 684 739 618 546 735 616 545 609 614 674 731 612 456 167 455  53 164
305  94 396 481 479 558 629 557 556 623 626 553 683 621 681 467 680 544 548 778 678 677 613 541 611 457 537 271  52  54
303  96 398  95 392 482 395 628 552 554 473 471 619 551 620 547 383 466 284 380 465 543 463 460 165 368 168  51 169  55
 93  86 205  91 299 480 478 477 624 555 291 387 469 472 386 737 468 617 377 382 542 462 539 373 538 275 166 459 272  56
202 394 200 300 391 201 475 296 476 191 474 289 292 384 287 470 549 181 379 615 283 464 282 176 175 675 369 370 274  57
 85  90  92 301 198 195 297 294 193 389 293 388 290 550 286 185 381  69 285 178 180 281 374 461 278 375  62 172 170  58
199  87  88 302  83 298 192 190 390  78  79 187 189  75 288  74  71 183 182  73 378 280  66  64 372 458 371 171 173  59
196  89 197  84 393  82 194 295  81  80  77  76 188 385 186 184  72  70  68 179 177  67 279  65 276  63 277 174  60  61
