# This puzzle is unsolvable
75
   2    1    3    4    5    6    7    8    9   10   11   12   13   14   15   16   17   18   19   20   21   22   23   24   25   26   27   28   29   30   31   32   33   34   35   36   37   38   39   40   41   42   43   44   45   48   47  342  345   50   51  634  637  917   53   55   57  353   59   60   61   62   63   64   65   68   67   69   70   71   73  368  367   74   75
 296  297  298  299  300  301  302  303  304  305  306  307  308  309  310  311  312  313  314  315  316  317  318  319  320  321  322  323  324  325  326  327  328  329  330  331  332  333  334  335  336  337  338  339  340  908   46  343  344  912  347  346  635  633  349   54   58   56  351  355  356  357  358  359  360   66  362  363  364  365   72  366  655   76   77
 295  584  585  586  587  588  589  590  591  592  593  594  595  596  597  598  599  600  601  602  603  604  605  606  607  608  609  610  611  612  613  614  615  616  617  618  619  620  621  622  623  624  625  626  627  628  907  629  911 1181   49  916  348   52 1187  638  640  641  354  642  643  644  646  647  361  648  649  929  651  652  653  654  656  369   78
 294  583  864  865  866  867  868  869  870  871  872  873  874  875  876  877  878  879  880  881  882  883  884  885  886  887  888  889  890  891  892  893  894  895  896  897  898  899  900  901  902  903  904  905 1177  906  341  630  632  631  913 1447  350 1188  636  639  352  919  920  921  922  923  645  926  925 1197  927  650  931 1201  932  371  372  370   79
 293  582  863 1136 1137 1138 1139 1140 1141 1142 1143 1144 1145 1146 1147 1148 1149 1150 1151 1152 1153 1154 1155 1156 1157 1158 1159 1160 1161 1162 1163 1164 1165 1166 1167 1168 1169 1170 1171 1172 1173 1174 1175 1176 1178 1442 1444 1441  909 1182  910 1183  914 1184 1450  915 1451 1190 1191 1192 1194 1195  924 1196 1198 1461 1199 1717 1200 1202  934  933  935  657  373
 292  581  862 1135 1400 1401 1402 1403 1404 1405 1406 1407 1408 1409 1410 1411 1412 1413 1414 1415 1416 1417 1418 1419 1420 1421 1422 1423 1424 1425 1426 1427 1428 1429 1430 1431 1432 1433 1434 1435 1436 1437 1438 1439 1440 1696 1179 1180 1699 1445 1446 1448 1186 1185 1705 1189  918 1453 1454 1455 1193 1457 1458 1459 1460 1718 1963  928 1462 1464 1465 1203 1204  658   80
 291  580  861 1134 1399 1656 1657 1658 1659 1660 1661 1662 1663 1664 1665 1666 1667 1668 1669 1670 1671 1672 1673 1674 1675 1676 1677 1678 1679 1680 1681 1682 1683 1684 1685 1686 1687 1688 1689 1690 1691 1692 1693 1694 1695 1697 1944 1443 1698 1700 1701 1702 1703 1449 1452 2192 1709 1953 2864 1710 1456 1711 1960 1713 1962 1715 1716 1463  930 1720 1205  936  659  374   81
 290  579  860 1133 1398 1655 1904 1905 1906 1907 1908 1909 1910 1911 1912 1913 1914 1915 1916 1917 1918 1919 1920 1921 1922 1923 1924 1925 1926 1927 1928 1929 1930 1931 1932 1933 1934 1935 1936 1937 1938 1939 1940 1941 1942 1943 2183 1945 1946 1948 1947 1949 1951 1704 1706 2424 1955 1707 1708 1957 2199 1712 2200 1714 2201 1964 2203 1721 1466 1719 1206  937  660  375   82
 289  578  859 1132 1397 1654 1903 2144 2145 2146 2147 2148 2149 2150 2151 2152 2153 2154 2155 2156 2157 2158 2159 2160 2161 2162 2163 2164 2165 2166 2167 2168 2169 2170 2171 2172 2173 2174 2175 2176 2177 2178 2179 2180 2181 2413 2184 2182 2419 2187 1950 2644 2188 1952 2421 2425 1954 1956 2193 2195 2196 2651 2430 2432 2654 2202 2204 1965 1966 1722 1207  661  376  377   83
 288  577  858 1131 1396 1653 1902 2143 2376 2377 2378 2379 2380 2381 2382 2383 2384 2385 2386 2387 2388 2389 2390 2391 2392 2393 2394 2395 2396 2397 2398 2399 2400 2401 2402 2403 2404 2405 2406 2407 2408 2409 2410 2411 2412 2637 2417 2415 2185 2643 2190 2418 2420 2422 2861 2423 2194 2649 2428 2427 1959 2197 2198 2655 1961 2207 2433 1723 1468 1467 1469 1208  938  939   84
 287  576  857 1130 1395 1652 1901 2142 2375 2600 2601 2602 2603 2604 2605 2606 2607 2608 2609 2610 2611 2612 2613 2614 2615 2616 2617 2618 2619 2620 2621 2622 2623 2624 2625 2626 2627 2628 2629 2630 2631 2632 2633 2634 2635 2636 3059 2414 2638 2640 2855 2642 3262 3064 2647 2646 2191 3071 2648 2650 2868 2866 2653 2869 2434 2431 2435 2205 1470 1473 1209  940  662  663   85
 286  575  856 1129 1394 1651 1900 2141 2374 2599 2816 2817 2818 2819 2820 2821 2822 2823 2824 2825 2826 2827 2828 2829 2830 2831 2832 2833 2834 2835 2836 2837 2838 2839 2840 2841 2842 2843 2844 2845 2846 2847 2848 2849 3057 2850 3631 2852 2853 3062 2639 2857 2186 3269 3066 2189 2860 3067 2426 2652 1958 3074 2429 2867 1970 2206 1968 1967 1724 1725 1471  942  664  378   86
 285  574  855 1128 1393 1650 1899 2140 2373 2598 2815 3024 3025 3026 3027 3028 3029 3030 3031 3032 3033 3034 3035 3036 3037 3038 3039 3040 3041 3042 3043 3044 3045 3046 3047 3048 3049 3050 3051 3052 3053 3054 3055 3056 3451 3058 2851 3258 2416 2854 2641 3263 3264 2858 3641 2859 2862 3070 3072 2865 3073 3075 2871 2870 2656 2658 2657 2436  943 1211 1212  941 1210  379   87
 284  573  854 1127 1392 1649 1898 2139 2372 2597 2814 3023 3224 3225 3226 3227 3228 3229 3230 3231 3232 3233 3234 3235 3236 3237 3238 3239 3240 3241 3242 3243 3244 3245 3246 3247 3248 3249 3250 3251 3252 3253 3255 3446 3630 3257 3449 3060 3636 3452 3453 3454 3981 3063 3065 3267 3270 3271 3461 2863 3463 3272 3077 3076 2438 2210 2209 1972 1969 1213  944  381  665  380   88
 283  572  853 1126 1391 1648 1897 2138 2371 2596 2813 3022 3223 3416 3417 3418 3419 3420 3421 3422 3423 3424 3425 3426 3427 3428 3429 3430 3431 3432 3433 3434 3435 3436 3437 3438 3439 3440 3441 3442 3443 3444 3254 3628 3447 3256 3448 3450 3259 3061 2856 3456 3638 3266 3265 3268 2645 3645 3458 3069 3644 3465 3274 2872 2659 2437 2208 1971 1728 1726 1472  667  666  382   89
 282  571  852 1125 1390 1647 1896 2137 2370 2595 2812 3021 3222 3415 3600 3601 3602 3603 3604 3605 3606 3607 3608 3609 3610 3611 3612 3613 3614 3615 3616 3617 3618 3619 3620 3621 3622 3623 3624 3625 3626 3627 3445 3971 3632 3629 3633 3260 3637 3261 3455 3813 3815 3818 3068 3460 4140 3459 3817 3643 3462 3466 3275 2873 2661 2440 2660 2439 1973 1474 1475  668  383  384   90
 281  570  851 1124 1389 1646 1895 2136 2369 2594 2811 3020 3221 3414 3599 3776 3777 3778 3779 3780 3781 3782 3783 3784 3785 3786 3787 3788 3789 3790 3791 3792 3793 3794 3795 3796 3797 3799 3800 3966 3801 3802 3970 3803 3807 3806 3974 3975 3634 3976 4287 3810 3639 3980 3457 4293 3984 3642 3983 3273 3464 3276 3081 2874 2662 2212 2211 1729 1727 1476 1214 1215  945  669   91
 280  569  850 1123 1388 1645 1894 2135 2368 2593 2810 3019 3220 3413 3598 3775 3944 3945 3946 3947 3948 3949 3950 3951 3952 3953 3954 3955 3956 3957 3958 3959 3960 3961 3962 3963 3964 3798 3965 3967 3968 3969 3972 4131 4282 3804 4133 3808 3809 3635 3977 3811 4139 3640 3982 3816 3986 4143 3647 3820 3646 3079 3278 3082 2663 2441 1976 1975 1730 1477 1216  946  947  671  670
 279  568  849 1122 1387 1644 1893 2134 2367 2592 2809 3018 3219 3412 3597 3774 3943 4104 4105 4106 4107 4108 4109 4110 4111 4112 4113 4114 4115 4116 4117 4118 4119 4120 4121 4122 4123 4124 4126 4127 4278 4128 4129 3805 4689 4691 3973 4284 4563 4288 4138 3814 4141 4432 3979 4142 4433 3649 3467 3819 3078 2876 2875 3080 2442 2213 2214 1974 1731 1478 1217  948  385  386   92
 278  567  848 1121 1386 1643 1892 2133 2366 2591 2808 3017 3218 3411 3596 3773 3942 4103 4256 4257 4258 4259 4260 4261 4262 4263 4264 4265 4266 4267 4268 4269 4271 4272 4273 4416 4274 4275 4125 4277 4279 4280 4281 4425 4283 4132 4692 4134 4285 4137 4290 3812 4431 4144 4292 4294 3988 3826 3989 3821 3650 3648 2878 2879 2877 2664 2215 1479 1733 1480 1218  949  672   94   93
 277  566  847 1120 1385 1642 1891 2132 2365 2590 2807 3016 3217 3410 3595 3772 3941 4102 4255 4400 4401 4402 4403 4404 4405 4406 4407 4408 4409 4410 4411 4412 4270 4413 4415 4551 4417 4418 4276 4419 4420 4422 4424 4426 4427 4565 4428 4135 4566 3978 4286 4567 4291 4569 4289 3822 3987 4145 4435 3468 3279 3277 2880 3085 2665 2443 1978 1977 1735 1481 1219  673  388  387   95
 276  565  846 1119 1384 1641 1890 2131 2364 2589 2806 3015 3216 3409 3594 3771 3940 4101 4254 4399 4536 4537 4538 4539 4540 4541 4542 4543 4544 4545 4546 4547 4548 4414 4550 4552 4679 4555 4680 4556 4421 4558 4559 4561 4686 4130 4560 4429 4562 4136 4564 4430 4570 4295 4147 3985 4146 4148 3823 3653 3470 3280 3652 3083 1981 2444 2666 1980 1734 1220  951  950  674  391   96
 275  564  845 1118 1383 1640 1889 2130 2363 2588 2805 3014 3215 3408 3593 3770 3939 4100 4253 4398 4535 4664 4665 4666 4667 4668 4669 4670 4671 4672 4673 4674 4675 4549 4677 4798 4909 4553 4554 4802 4557 4684 4423 4685 4688 4687 4810 4809 4812 4923 4813 4693 4694 4436 4438 3824 4296 3990 3471 3651 3084 3281 3282 2881 2446 2445 2216 1979 1732 1482 1221  952  389  390   97
 274  563  844 1117 1382 1639 1888 2129 2362 2587 2804 3013 3214 3407 3592 3769 3938 4099 4252 4397 4534 4663 4784 4785 4786 4787 4788 4789 4790 4791 4792 4904 4793 4796 4795 4797 4799 4911 4801 4683 4682 4803 4804 4805 4806 4807 4808 4690 4921 4811 4696 4695 4571 4568 4297 4437 4298 3825 3992 3472 3654 3285 3469 2882 2667 2217 2447 2218 1736 1483 1222  953  676  675   98
 273  562  843 1116 1381 1638 1887 2128 2361 2586 2803 3012 3213 3406 3591 3768 3937 4098 4251 4396 4533 4662 4783 4896 4897 4898 4899 4900 4901 4902 5006 4903 4794 4676 4906 4908 4678 4800 4681 4912 5015 4913 4914 4916 4917 4918 4919 5024 5119 5025 4922 4814 4434 4441 4574 4299 4149 4440 3991 3474 3088 3086 2669 3283 2668 2219 1982 1737 1739 1484 1223  954  677  392   99
 272  561  842 1115 1380 1637 1886 2127 2360 2585 2802 3011 3212 3405 3590 3767 3936 4097 4250 4395 4532 4661 4782 4895 5000 5001 5002 5003 5100 5004 5101 5007 5104 5008 5106 5012 4910 5107 5014 5110 5016 5017 4915 5019 5114 5021 5117 5022 4920 5026 4924 4815 4697 4573 4150 4301 4439 3828 3655 3827 3473 3475 3087 2670 2671 2450 2448 2449 2220 1485 1224  955  678  393  100
 271  560  841 1114 1379 1636 1885 2126 2359 2584 2801 3010 3211 3404 3589 3766 3935 4096 4249 4394 4531 4660 4781 4894 4999 5096 5097 5099 5005 5187 5102 5189 5103 4905 4907 5010 5011 5013 5109 5198 5112 5113 5200 5201 5018 5115 5204 5023 5118 4817 4926 4699 4698 4575 4151 4572 4152 3993 3829 3831 3476 3286 3284 3089 2883 2451 2221 1738 1740 1486  957 1225  956  679  101
 270  559  840 1113 1378 1635 1884 2125 2358 2583 2800 3009 3210 3403 3588 3765 3934 4095 4248 4393 4530 4659 4780 4893 4998 5095 5184 5098 5265 5266 5268 5190 5009 5342 5191 5270 5193 5194 5108 5196 5197 5199 5277 5278 5280 5202 5116 5205 5120 4925 5028 4700 4818 4443 4300 4442 3995 3994 3658 3656 3477 3090 2884 2672 2673 1984 2453 1983 1741 1487 1226  680  681  394  102
 269  558  839 1112 1377 1634 1883 2124 2357 2582 2799 3008 3209 3402 3587 3764 3933 4094 4247 4392 4529 4658 4779 4892 4997 5094 5183 5186 5185 5334 5338 5340 5188 5105 5192 5343 5272 5195 5275 5111 5347 5349 5283 5279 5020 5203 5206 5207 5027 5121 4927 4816 4702 4701 4444 4302 3996 3830 3287 3657 3091 3288 2674 3093 2452 2224 2222 1985 1986 1488 1227  958  396  395  103
 268  557  838 1111 1376 1633 1882 2123 2356 2581 2798 3007 3208 3401 3586 3763 3932 4093 4246 4391 4528 4657 4778 4891 4996 5093 5263 5262 5264 5504 5401 5180 5339 5269 5271 5341 5345 5273 5409 5346 5276 5348 5350 5351 5281 5282 5354 5208 5122 5029 4928 4819 4703 4576 4577 4303 4153 4154 3997 3832 3478 3289 2886 3092 2887 2454 2223 1987 1742 1489 1228  959  682  397  104
 267  556  837 1110 1375 1632 1881 2122 2355 2580 2797 3006 3207 3400 3585 3762 3931 4092 4245 4390 4527 4656 4777 4890 4995 5092 5182 5181 5267 5336 5404 5459 5505 5403 5460 5405 5406 5274 5344 5465 5410 5467 5412 5413 5416 5284 5353 5209 5123 5030 4929 4820 4704 4578 4445 4304 4155 3998 3833 3660 3659 2889 3094 2885 2888 2675 2225 1988 1743 1490 1229  960  683  398  105
 266  555  836 1109 1374 1631 1880 2121 2354 2579 2796 3005 3206 3399 3584 3761 3930 4091 4244 4389 4526 4655 4776 4889 4993 4994 5091 5335 5337 5455 5398 5402 5506 5507 5458 5461 5407 5408 5463 5513 5553 5468 5469 5414 5355 5352 5285 5286 5125 5031 4821 4931 4705 4579 4305 4306 4156 3999 3834 3661 3479 3291 3095 2676 2455 2456 2226 1989 1744 1491 1230  961  684  399  106
 265  554  835 1108 1373 1630 1879 2120 2353 2578 2795 3004 3205 3398 3583 3760 3929 4090 4243 4388 4525 4654 4775 4888 5090 5179 5261 5399 5333 5400 5396 5456 5457 5508 5578 5547 5462 5510 5464 5552 5411 5516 5515 5417 5415 5356 5287 5124 5210 5032 4930 4825 4706 4580 4446 4307 4157 4000 3835 3293 3290 3480 3292 2890 2677 2459 2227 1990 1745 1492 1231  962  685  400  107
 264  553  834 1107 1372 1629 1878 2119 2576 2352 2794 3003 3204 3397 3582 3759 3928 4089 4242 4387 4524 4652 4653 4887 4992 5089 5258 5397 5259 5503 5454 5544 5545 5546 5548 5603 5509 5549 5511 5550 5466 5512 5471 5470 5418 5357 5288 5211 5126 5034 5033 4932 4824 4581 4448 4159 4001 4003 3836 3481 3482 3294 3483 2458 2891 2678 2228 1746 1493 1232 1233  963  686  401  108
 263  552  833 1371 1628 1877 1876 2118 2351 2577 3002 3001 3203 3396 3581 3758 3927 4088 4241 4386 4523 4774 4773 4991 4990 5088 5176 5178 5453 5257 5395 5600 5576 5598 5575 5601 5579 5618 5581 5551 5554 5514 5517 5472 5419 5358 5289 5212 5127 4822 4933 4708 4823 4582 4449 4158 4447 3837 3665 3838 3662 3664 3097 3096 2457 2229 1992 1991 1747 1494 1234  964  687  402  109
 262  551 1105 1106 1370 1626 1627 2117 2350 2792 2793 3202 3395 3580 3579 3757 3926 4087 4240 4385 4522 4651 4885 4886 5087 5331 5175 5177 5332 5542 5502 5394 5452 5543 5574 5577 5602 5580 5604 5606 5584 5583 5518 5473 5420 5359 5290 5213 5128 5035 4934 4707 4709 4583 4450 4308 4002 4004 4160 3663 3484 3295 2892 2893 2679 2230 2231 1993 1748 1495 1235  965  688  403  110
 550  831  832 1104 1369 1625 1875 2116 2574 2575 2790 2999 2791 3201 3392 3756 3925 4086 4239 4384 4521 4771 4772 4884 4989 5086 5256 5260 5329 5392 5330 5393 5500 5540 5501 5498 5617 5624 5605 5582 5555 5556 5519 5474 5421 5360 5291 5215 5214 5129 4936 4826 4585 4451 4310 4309 4161 4005 3839 3666 3485 3296 3099 2894 3098 2680 2232 1994 1750 1749 1496  966  689  404  111
 261  549  830 1103 1368 1624 1874 2115 2349 2347 2573 2998 3000 3394 3393 3924 4085 4383 4520 4649 4518 4650 4770 4883 4988 5085 5174 5255 5327 5328 5451 5539 5541 5572 5597 5615 5616 5623 5620 5608 5585 5558 5557 5520 5475 5422 5361 5292 4937 5036 4827 4935 4584 4710 4452 4311 4163 4162 3840 3667 3486 3297 3100 2895 2681 2460 2682 1996 1995 1497 1236  967  690  405  112
 260  548  829 1102 1367 1873 2114 2113 2346 2348 2789 2572 3200 3578 3755 3754 3923 4084 4238 4382 4381 4519 4769 4882 4987 5084 5173 5254 5253 5391 5449 5499 5538 5599 5596 5614 5622 5621 5619 5586 5607 5587 5521 5476 5423 5362 5293 5217 5130 5037 5038 4828 4711 4586 4453 4312 4006 4007 3841 3668 3487 2896 3103 2683 2684 2462 2461 2233 1751 1498 1237  968  691  406  113
 259  828  827 1101 1366 1623 1872 2345 2571 2788 2787 2997 3198 3199 3391 3753 3921 3922 4237 4380 4236 4646 4768 4881 4986 5083 5171 5390 5252 5325 5326 5497 5537 5571 5570 5573 5612 5611 5610 5609 5588 5559 5522 5477 5424 5363 5294 5131 5216 5039 4938 4829 4712 4587 4454 4313 4008 3842 3669 3488 3101 3102 3298 2685 2897 2463 2234 1997 1752 1499 1238  969  692  407  114
 258  547 1365 1100 1099 1622 1871 2112 2344 2570 2786 2996 3197 3390 3577 3752 3920 4235 4081 4516 4647 4648 4766 4767 4985 5081 5082 5172 5324 5447 5450 5448 5495 5496 5594 5613 5593 5592 5591 5590 5589 5560 5523 5478 5425 5364 5295 5218 5132 5133 5040 4830 4713 4588 4455 4314 4164 3843 3844 3671 3299 3489 3300 3104 2686 2899 2464 1998 1753 1500 1239  970  693  408  115
 257  255  546  826 1620 1364 1870 2111 2569 2567 2568 2995 3196 3388 3576 3389 4082 4083 4234 4643 4515 4644 4645 4880 4879 4984 5080 5251 5323 5389 5446 5536 5534 5535 5595 5568 5531 5565 5564 5563 5562 5561 5524 5479 5426 5365 5296 5219 5134 5041 4939 4940 4831 4714 4456 4315 4009 4165 3672 3490 3670 3301 3105 2898 2465 2236 2235 1999 1754 1501 1240  971  694  409  116
 254  256  824  545 1363 1867 1621 2110 2343 2566 2785 2994 3195 3575 3573 3751 3750 3919 4233 4379 4514 4517 4378 4878 4983 5169 5170 5248 5250 5322 5445 5494 5491 5490 5569 5566 5567 5530 5529 5528 5527 5526 5525 5480 5427 5366 5297 5220 5135 5042 4941 4832 4715 4589 4457 4316 4166 4167 4010 3491 3492 3302 2900 2687 2901 2688 2237 2000 1755 1502 1241  972  695  410  117
 253  252 1098  825 1097 1869 1361 1868 2342 2565 2784 2993 3194 3387 3574 3572 3918 4080 4079 4232 4376 4765 4763 4877 4981 4982 5249 5168 5444 5388 5443 5493 5492 5440 5532 5533 5488 5487 5486 5485 5484 5483 5482 5481 5428 5367 5298 5221 5136 5043 4942 4716 4591 4590 4458 4317 4168 4011 3847 3846 3845 3303 3106 2690 2903 2466 2467 2001 1756 1503  973  975  974  696  118
 823  543  544 1362 1096 1618 1619 2109 2341 2340 2783 2992 3193 3386 3571 3749 3748 4078 4231 4377 4512 4513 4764 4762 4980 5079 5078 5167 5386 5387 5384 5442 5441 5380 5379 5489 5437 5436 5435 5434 5433 5432 5431 5430 5429 5368 5299 5222 5137 5044 4943 4833 4834 4592 4459 4318 4169 4012 3673 3674 3494 3493 3305 3107 2902 2468 2238 2002 1506 1757 1242  700 1243  411  412
 541  542 1359 1095 1360 1865 1617 2108 2107 2564 2782 2991 3192 3385 3570 3747 3917 3916 4077 4230 4375 4640 4876 4642 4875 5077 5166 5321 5247 5320 5385 5316 5383 5314 5439 5381 5378 5377 5376 5375 5374 5373 5372 5371 5370 5369 5300 5223 5138 5045 4944 4835 4717 4718 4460 4319 4170 4013 3848 3675 3495 3108 3304 2691 2470 2689 2469 2239 1759 1505 1244  976  697  698  119
 251  822  821  820 1094 1616 2106 2104 2105 2339 2781 2990 3191 3384 3569 3746 3915 4076 4229 4374 4641 4511 4761 4874 4979 5076 5165 5246 5319 5318 5317 5382 5240 5315 5313 5438 5311 5310 5309 5308 5307 5306 5305 5304 5303 5302 5301 5224 5139 5046 4945 4836 4719 4593 4594 4461 4320 3678 3850 3496 3849 3306 3109 2904 2240 2243 2003 2242 2472 1758 1245 1507 2005  413  120
 250  540  539 1093 1358 1615 1864 2337 1866 2338 2780 2989 3190 3383 3568 3745 3914 4075 4228 4373 4510 4639 4760 4873 4978 5075 5164 5245 5244 5243 5242 5158 5241 5156 5238 5312 5236 5235 5234 5233 5232 5231 5230 5229 5228 5227 5226 5225 5140 5047 4946 4837 4721 4595 4720 4462 4014 4172 4323 3677 3676 3110 2905 2906 2908 2004 2241  977 1504 1760  979  416  415  122  701
 249  538  819 1092 1357 1614 1862 1863 2336 2563 2779 2988 3189 3382 3567 3744 3913 4074 4227 4372 4509 4638 4759 4872 4977 5074 5163 5162 5161 5160 5159 5239 4966 5155 5154 5237 5153 5152 5151 5150 5149 5148 5147 5146 5145 5144 5143 5142 5141 5048 4947 4838 4839 4596 4324 4173 4463 4017 3679 3851 3497 3308 3111 2473 2907 2471 2474 2007 2006  702  121  699  978  414  123
 248  537  818 1091 1356 1613 1861 2103 2561 2562 2778 2987 3188 3381 3566 3743 3912 4073 4226 4371 4508 4637 4758 4871 4976 5073 5072 5071 5070 5069 5068 5067 5065 5157 5064 5063 5062 5061 5060 5059 5058 5057 5056 5055 5054 5053 5052 5051 5050 4950 5049 4840 4722 4598 4322 4321 4171 4015 3852 4016 3498 3307 2694 3112 2692 2245 2008 1761 1508 1764  703  704 1249  418  124
 247  536  817 1090 1355 1612 2102 2101 2335 2560 2777 3186 2986 3565 3742 3741 3911 4072 4225 4370 4507 4636 4757 4870 4975 4974 4973 4972 4971 4970 4969 4968 5066 4967 4965 4964 4963 4962 4961 4960 4959 4958 4957 4956 4955 4954 4953 4952 4843 4844 4948 4725 4600 4465 4601 4466 4464 3853 4019 3854 3500 3309 3113 3114 2475 2244 2246 1763 1510 1250 1247 1248 1246  417  125
 246  535  816 1089 1354 1611 1860 2334 2333 2559 2776 3187 3185 3380 3379 3740 3910 4071 4224 4369 4506 4635 4756 4869 4868 4867 4866 4865 4864 4863 4862 4861 4860 4859 4858 4857 4856 4855 4854 4853 4852 4851 4850 4849 4848 4847 4846 4845 4951 4842 4841 4949 4599 4723 4597 4174 4175 4179 3502 3499 3680 3681 2695 2693 2909 2696 2009 1511  981 1762  982  980  706  705  126
 245  534  815 1088 1353 1610 1859 2100 2558 2775 2984 2985 3378 3563 3564 3909 3908 4070 4223 4368 4505 4634 4755 4754 4753 4752 4751 4750 4749 4748 4747 4746 4745 4744 4743 4742 4741 4740 4739 4738 4737 4736 4735 4734 4733 4732 4731 4730 4729 4728 4603 4604 4724 4726 4176 4327 4467 4018 3855 3311 3501 3310 3115 2910 2697 2476 2247 1765 1253 1251 1512 1509  419  421  127
 244  533  814 1087 1609 1350 2099    0 2332 2557 2774 2983 3184 3562 3739 3738 3907 4069 4222 4367 4504 4633 4632 4631 4630 4629 4628 4627 4626 4625 4624 4623 4622 4621 4620 4619 4618 4617 4616 4615 4614 4613 4612 4611 4610 4609 4608 4607 4606 4605 4727 4602 4468 4326 4329 4325 4023 3684 4020 3683 3682 3312 3116 2911 2698 2477 2010 2011 2248 1513 1766  420 1254  422  128
 243  532  813 1086 1352 1857 1858 2098 2331 2556 2772 2773 3183 3377 3375 3561 3906 4068 4221 4366 4503 4502 4501 4500 4499 4498 4497 4496 4495 4494 4493 4492 4491 4490 4489 4488 4487 4486 4485 4484 4483 4482 4481 4480 4479 4478 4477 4476 4475 4474 4473 4472 4471 4470 4177 4469 4021 4178 3856 4022 3503 3313 3117 2912 2700 2699 2249 2013 1514 1252  984  983  708  707  129
 242  531  812 1085 1349 1351 1856 2097 2330 2555 2771 2982 2981 3182 3376 3560 3737 4067 4220 4365 4364 4363 4362 4361 4360 4359 4358 4357 4356 4355 4354 4353 4352 4351 4350 4349 4348 4347 4346 4345 4344 4343 4342 4341 4340 4339 4338 4337 4336 4335 4334 4333 4332 4331 4330 4328 4180 4024 3857 3685 3315 3314 3118 2913 2478 2479 1767 2251 1769 2012 1515  985  423  424  130
 241  530  811 1084 1348 1608 1855 2096 2328 2329 2554 2980 2979 3374 3559 3736 3905 4066 4219 4218 4217 4216 4215 4214 4213 4212 4211 4210 4209 4208 4207 4206 4205 4204 4203 4202 4201 4200 4199 4198 4197 4196 4195 4194 4193 4192 4191 4190 4189 4188 4187 4186 4185 4182 4183 4027 4181 3858 3859 3686 3504 3316 3119 2914 2701 2481 2480 2250 2015 1517 1516  986  710  709  131
 240  529  810 1083 1606 1607 1853 1854 2095 2553 2770 3180 3181 3373 3558 3735 3904 4065 4064 4063 4062 4061 4060 4059 4058 4057 4056 4055 4054 4053 4052 4051 4050 4049 4048 4047 4046 4045 4044 4043 4042 4041 4040 4039 4038 4037 4036 4035 4034 4033 4032 4031 4030 4184 3865 4028 4026 4025 3687 3506 3505 3317 3120 2915 2702 2482 2252 1768 2014 1770 1255  987  711  425  132
 239  528  809 1082 1347 1605 1604 2094 2327 2552 2769 2978 3179 3372 3557 3734 3903 3902 3901 3900 3899 3898 3897 3896 3895 3894 3893 3892 3891 3890 3889 3888 3887 3886 3885 3884 3883 3882 3881 3880 3879 3878 3877 3876 3875 3874 3873 3872 3871 3870 3869 3868 3867 4029 3866 3864 3863 3862 3860 3690 3688 3507 3318 3121 2916 2703 2253 2016 1771 1518 1256 1257  426  427  133
 238  527  808 1081 1346 1603 1852 2093 2326 2551 2768 2977 3178 3371 3556 3733 3732 3731 3730 3729 3728 3727 3726 3725 3724 3723 3722 3721 3720 3719 3718 3717 3716 3715 3714 3713 3712 3711 3710 3709 3708 3707 3706 3705 3704 3703 3702 3701 3700 3699 3698 3697 3696 3695 3694 3693 3692 3691 3689 3861 3508 3319 3122 2917 2704 2483 2254 2017 1772 1519 1259  988  989  712  135
 237  526  807 1080 1345 1602 1851 2092 2325 2550 2767 2976 3177 3370 3555 3554 3553 3552 3551 3550 3549 3548 3547 3546 3545 3544 3543 3542 3541 3540 3539 3538 3537 3536 3535 3534 3533 3532 3531 3530 3529 3528 3527 3526 3525 3524 3523 3522 3521 3520 3519 3518 3517 3516 3515 3514 3513 3512 3511 3510 3509 3320 3123 2918 2705 2484 2255 2018 1773 1520  990 1258  713  134  428
 236  525  806 1079 1344 1601 1850 2091 2324 2549 2766 2975 3176 3369 3368 3367 3366 3365 3364 3363 3362 3361 3360 3359 3358 3357 3356 3355 3354 3353 3352 3351 3350 3349 3348 3347 3346 3345 3344 3343 3342 3341 3340 3339 3338 3337 3336 3335 3334 3333 3332 3331 3330 3329 3328 3327 3326 3325 3324 3323 3322 3321 3124 2919 2706 2485 2256 2019 1774 1521 1260  991  714  429  136
 235  524  805 1078 1343 1600 1849 2090 2323 2548 2765 2974 3175 3174 3173 3172 3171 3170 3169 3168 3167 3166 3165 3164 3163 3162 3161 3160 3159 3158 3157 3156 3155 3154 3153 3152 3151 3150 3149 3148 3147 3146 3145 3144 3143 3142 3141 3140 3139 3138 3137 3136 3135 3134 3133 3132 3131 3130 3129 3128 3127 3126 3125 2920 2707 2486 2257 2020 1775 1522 1261  992  715  430  137
 234  523  804 1077 1342 1599 1848 2089 2322 2547 2764 2973 2972 2971 2970 2969 2968 2967 2966 2965 2964 2963 2962 2961 2960 2959 2958 2957 2956 2955 2954 2953 2952 2951 2950 2949 2948 2947 2946 2945 2944 2943 2942 2941 2940 2939 2938 2937 2936 2935 2934 2933 2932 2931 2930 2929 2928 2927 2926 2925 2924 2923 2922 2921 2708 2487 2258 2021 1776 1523 1262  993  716  431  138
 233  522  803 1076 1341 1598 1847 2088 2321 2546 2763 2762 2761 2760 2759 2758 2757 2756 2755 2754 2753 2752 2751 2750 2749 2748 2747 2746 2745 2744 2743 2742 2741 2740 2739 2738 2737 2736 2735 2734 2733 2732 2731 2730 2729 2728 2727 2726 2725 2724 2723 2722 2721 2720 2719 2718 2717 2716 2715 2714 2713 2712 2711 2710 2709 2488 2259 2022 1777 1524 1263  994  717  432  139
 232  521  802 1075 1340 1597 1846 2087 2320 2545 2544 2543 2542 2541 2540 2539 2538 2537 2536 2535 2534 2533 2532 2531 2530 2529 2528 2527 2526 2525 2524 2523 2522 2521 2520 2519 2518 2517 2516 2515 2514 2513 2512 2511 2510 2509 2508 2507 2506 2505 2504 2503 2502 2501 2500 2499 2498 2497 2496 2495 2494 2493 2492 2491 2490 2489 2260 2023 1778 1525 1264  995  718  433  140
 231  520  801 1074 1339 1596 1845 2086 2319 2318 2317 2316 2315 2314 2313 2312 2311 2310 2309 2308 2307 2306 2305 2304 2303 2302 2301 2300 2299 2298 2297 2296 2295 2294 2293 2292 2291 2290 2289 2288 2287 2286 2285 2284 2283 2282 2281 2280 2279 2278 2277 2276 2275 2274 2273 2272 2271 2270 2269 2268 2267 2266 2265 2264 2263 2262 2261 2024 1779 1526 1265  996  719  434  141
 230  519  800 1073 1338 1595 1844 2085 2084 2083 2082 2081 2080 2079 2078 2077 2076 2075 2074 2073 2072 2071 2070 2069 2068 2067 2066 2065 2064 2063 2062 2061 2060 2059 2058 2057 2056 2055 2054 2053 2052 2051 2050 2049 2048 2047 2046 2045 2044 2043 2042 2041 2040 2039 2038 2037 2036 2035 2034 2033 2032 2031 2030 2029 2028 2027 2026 2025 1780 1527 1266  997  720  435  142
 229  518  799 1072 1337 1594 1843 1842 1841 1840 1839 1838 1837 1836 1835 1834 1833 1832 1831 1830 1829 1828 1827 1826 1825 1824 1823 1822 1821 1820 1819 1818 1817 1816 1815 1814 1813 1812 1811 1810 1809 1808 1807 1806 1805 1804 1803 1802 1801 1800 1799 1798 1797 1796 1795 1794 1793 1792 1791 1790 1789 1788 1787 1786 1785 1784 1783 1782 1781 1528 1267  998  721  436  143
 228  517  798 1071 1336 1593 1592 1591 1590 1589 1588 1587 1586 1585 1584 1583 1582 1581 1580 1579 1578 1577 1576 1575 1574 1573 1572 1571 1570 1569 1568 1567 1566 1565 1564 1563 1562 1561 1560 1559 1558 1557 1556 1555 1554 1553 1552 1551 1550 1549 1548 1547 1546 1545 1544 1543 1542 1541 1540 1539 1538 1537 1536 1535 1534 1533 1532 1531 1530 1529 1268  999  722  437  144
 227  516  797 1070 1335 1334 1333 1332 1331 1330 1329 1328 1327 1326 1325 1324 1323 1322 1321 1320 1319 1318 1317 1316 1315 1314 1313 1312 1311 1310 1309 1308 1307 1306 1305 1304 1303 1302 1301 1300 1299 1298 1297 1296 1295 1294 1293 1292 1291 1290 1289 1288 1287 1286 1285 1284 1283 1282 1281 1280 1279 1278 1277 1276 1275 1274 1273 1272 1271 1270 1269 1000  723  438  145
 226  515  796 1069 1068 1067 1066 1065 1064 1063 1062 1061 1060 1059 1058 1057 1056 1055 1054 1053 1052 1051 1050 1049 1048 1047 1046 1045 1044 1043 1042 1041 1040 1039 1038 1037 1036 1035 1034 1033 1032 1031 1030 1029 1028 1027 1026 1025 1024 1023 1022 1021 1020 1019 1018 1017 1016 1015 1014 1013 1012 1011 1010 1009 1008 1007 1006 1005 1004 1003 1002 1001  724  439  146
 225  514  795  794  793  792  791  790  789  788  787  786  785  784  783  782  781  780  779  778  777  776  775  774  773  772  771  770  769  768  767  766  765  764  763  762  761  760  759  758  757  756  755  754  753  752  751  750  749  748  747  746  745  744  743  742  741  740  739  738  737  736  735  734  733  732  731  730  729  728  727  726  725  440  147
 224  513  512  511  510  509  508  507  506  505  504  503  502  501  500  499  498  497  496  495  494  493  492  491  490  489  488  487  486  485  484  483  482  481  480  479  478  477  476  475  474  473  472  471  470  469  468  467  466  465  464  463  462  461  460  459  458  457  456  455  454  453  452  451  450  449  448  447  446  445  444  443  442  441  148
 223  222  221  220  219  218  217  216  215  214  213  212  211  210  209  208  207  206  205  204  203  202  201  200  199  198  197  196  195  194  193  192  191  190  189  188  187  186  185  184  183  182  181  180  179  178  177  176  175  174  173  172  171  170  169  168  167  166  165  164  163  162  161  160  159  158  157  156  155  154  153  152  151  150  149
