# This puzzle is unsolvable
52
 205    1    2    3    4  209    5    7    9   10   11   12   13   14   15   16   17   18   19   21  226  227   25  421  230   26   27   29  232  614   32   34  427  236  238  432  437   43   39   37   42  442  440  247   44   46   47   48   49  448   52   53
 204  400  207  402    6  210  211    8  212  213  214  215  216  217  218  219  220  221  419  223   20   22   23   28  229   30  231  428  235  234  233   31  429  237  433   35   38  240  241  805   41  244   40  245   45  443  444  250  446  253   51   50
 203  206  401  588  208  592  405  406  407  409  410  411  412  413  780  414  415  416  222  417  418  224  420  423   24  790  610  425  615  616  618  430  431   33  621  622  804  972  436  623  441  977  246  634  808  249  445  633  812  254  256   54
 202  399  587  589  404  770  591  593  594  408  596  597  598  599  778  600  603  781  604  785  225  606  422  228  424 1123  962 1431  426  794  617  967  797  796  434   36  800  239  242  974  625  439  248  629  982  631  635  811  447  255   55   56
 200  201  768  590  403  941 1104  771  772  595  947  775  950  777 1114  779  601  783  954  605  607  958  609  611  789  792  613  959  793  965  795  970  969  619  798  435  620  438 1136  626  627 1294  628  810 1446  630  981  636  251  452  259  450
 199  398  397  767  769  942 1106  773  945  774  946  776  949 1113 1115  953  602  951  782  784 1274 1118 1120  608  786 1124  612  961 1126  963  966  968 1131  799 1135  801  802 1290  976  243  803  807 1297  979  809 1144  814  983  252  449  451   57
 198  585  586  765  938  940 1107  943 1261  944 1109 1111  948 1112 1419 1269 1116 1271 1272 1117 1278 1121  957  788 1119 1426 1279  791  964 1127 1430 1129 1287 1133 1288  971 1134 1439 1440 1577 1142 1137 1141  806 1295  632  813  637  638  258  257   58
 197  396  395  939  766 1103 1105 1263 1410 1108 1411 1110 1413 1266 1268 1415 1555  955 1417 1418 1273  960  956  787 1122 1277 1280 1125 1281 1429 1128 1285 1434 1132 1286 1436  973 1708  978 1292 1299 1140 1139 1143 1138 1298  818  984  817  639  260   59
 394  393  582  937  936 1262 1259 1260 1548 1265 1681 1552 1414 1267 1554 1416 1270  952 1557 1276 1423 1693 1275 1563 1424 1428 1567 1568 1282 1130 1284 1433 1704 1826 1289 1435 1293 1579  624 1709  975 1443 1581  980 1145  986 1147  454  815  453  261   60
 196  581  584  583 1102  763 1101 1408 1258 1409 1680 1550 1412 1684 1553 1687 1559 1556 1688 1421 1420 1422 1560 1562 1425 1565 1697 1427 1283 1569 1570 1941 1573 1703 1575 1576 1438 1437 1578 1296 1580 1833 1710 1447 1149  985 1448 1146  456  640  262   61
 195  764  580  762  935 1407 1406 1547 1264 1682 1549 1679 1683 1807 1685 1810 1689 1811 1558 1813 1691 1692 1815 1816 1564 1695 1696 1820 1699 1700 1701 1432 1572 1828 1705 1574 1830 1706 1291 2055 1442 1711 1712 1301 1444 1148 1300  987  641  455  263   62
 391  579  392  761 1256 1100 1405 1404 1546 1257 1804 1551 1921 1806 1808 1686 1924 1926 2034 2036 1690 1817 1561 1694 1819 1934 1698 1566 1822 1823 1824 1571 1825 1943 1827 1944 1831 1707 1948 1947 1950 1583 1584 1445 1152 1305 1582  816  642  457  265  264
 578  390  758  760 1099 1255 1545 1543 1544 1677 1678 1805 1920 1922 1923 1927 2032 2132 1928 2134 1929 1814 1931 1818 1933 1935 1936 1821 1937 1938 1939 1702 2049 2148 1942 2051 1832 2053 1951 1441 1587 1302 1713 1303 1150  988  819  989  820  459   63   64
 194  192  388  934  932 1095 1098 1094 1254 1402 1918 1803 1919 2028 2029 2030 1809 2037 2224 2136 1812 2225 2038 2039 2040 2041 2042 2043 2044 2045 2046 1940 2146 1829 2048 2239 2241 1946 1835 1834 1952 2057 1714 1585  990  821  644  822  460  643  266  458
 193  389  577 1097  759  930  931 1253 1403 1676 1802 2027 2128 2130 2131 2031 1925 2133 2033 2227 1932 1930 2137 2230 2138 2140 2141 2142 2143 2144 2145 2047 2237 2147 2052 1945 2324 1836 2153 1588 1949 1715 1451 1304 1151 1449  991  645  646  267   66   65
 387  576  386  933  756 1251 1400 1673 1542 1800 1801 1917 2026 2220 2129 2221 2222 2035 2223 2135 2385 2228 2311 2229 2139 2231 2232 2233 2234 2235 2236 2238 2396 2149 2050 2152 2243 2242 2054 1586 1839 1717 1837 1450 1306 1153  992  823  461  462  268   67
 188  189  754 1096  929 1401 1252 1675 1399 1798 1674 1916 2025 2127 2219 2304 2305 2306 2307 2382 2309 2308 2384 2312 2387 2314 2315 2316 2317 2318 2319 2240 2320 2322 2325 2323 2150 2245 1838 2056 1840 1589 1718 1453 1452 1154  993  824  647  463  269   68
 190  575  573  757 1092  927 1250 1540 1541 1799 1915 1797 1796 2126 2218 2302 2303 2381 2449 2450 2383 2386 2310 2226 2313 2389 2390 2391 2392 2393 2394 2395 2397 2321 2328 2244 2154 2326 2151 2156 1841 1716 1591 1590 1307 1308  994  826  825  648  270   69
 191  385  384  928 1093  926 1249 1397 1398 1672 1539 1913 2124 2125 2217 2301 2380 2448 2445 2507 2451 2452 2512 2454 2388 2457 2516 2458 2459 2519 2462 2518 2522 2398 2464 2402 2399 2058 2059 1954 1953 1720 1592 1454 1309 1155 1156  995  827  464  271   70
 186  185  184  571  574  925 1091 1248 1538 1671 1914 2022 1669 2024 2023 2559 2379 2378 2509 2561 2510 2511 2455 2453 2513 2515 2456 2517 2569 2460 2461 2520 2463 2521 2401 2246 2157 2155 1956 2060 1955 1719 1593 1455 1310 1157  996  650  649  465  272   71
 572  383  569  924  755  752 1247 1396 1537 1670 2020 2123 1912 2021 2216 2215 2298 2446 2447 2506 2562 2605 2563 2564 2514 2565 2567 2568 2612 2570 2572 2523 2571 2465 2466 2327 2400 2158 2061 1843 1842 1722 1594 1456 1311 1158  997  828  651  466  273   72
 187  183  753  567  923 1090 1089 1395 1536 1794 1535 2121 2214 2299 2122 2444 2300 2377 2505 2508 2604 2640 2606 2607 2608 2566 2645 2610 2611 2613 2573 2524 2467 2575 2329 2331 2162 2247 2062 1957 1844 1721 1723 1457 1312 1159  998  829  652  467  274   73
 381  568  921  382  751 1245 1246 1394 1533 1668 1909 1795 2019 1911 2212 2213 2376 2560 2443 2558 2602 2603 2641 2642 2643 2609 2671 2644 2648 2650 2614 2525 2526 2330 2249 2468 2248 2161 2159 2063 1959 1595 1597 1458 1313 1160  999  830  653  468  275   74
 379  570  380  749  922 1088 1087 1393 1667 1534 1793 1908 1910 2120 2119 2297 2375 2504 2442 2557 2601 2639 2668 2669 2670 2672 2691 2646 2647 2649 2615 2574 2616 2405 2403 2407 2250 2160 1724 1725 1596 1958 1726 1314 1161 1000 1001  831  654  276  277   75
 377  181  566  750  920 1086 1244 1243 1392 1666 1792 1791 2018 2118 2211 2210 2374 2373 2441 2555 2556 2638 2667 2688 2689 2701 2690 2673 2674 2675 2617 2576 2404 2406 2469 2163 2251 2065 2064 1848 1960 1846 1462 1459 1461 1162  469  832  472  470   76   77
 378  182  180  747  748 1085 1242 1391 1532 1665 1790 1907 2017 2016 2117 2295 2296 2372 2503 2502 2600 2637 2666 2687 2700 2693 2692 2703 2702 2651 2528 2530 2527 2529 2333 2332 2252 2164 2066 1847 1849 1598 1845 1315 1460 1316 1003 1002  655  656  279  278
 179  376  565  746  919 1084 1241 1390 1531 1664 1789 1906 2015 2116 2209 2294 2371 2440 2501 2554 2599 2636 2665 2686 2699 2696 2697 2652 2676 2679 2653 2577 2471 2470 2334 2335 2165 2166 2067 1961 1728 1727 1600 1463 1599 1163 1164  833  834  471  280   78
 178  375  564  745  918 1083 1240 1389 1530 1663 1788 1905 2014 2115 2208 2293 2370 2439 2500 2553 2598 2635 2663 2664 2685 2698 2694 2695 2678 2579 2618 2472 2578 2473 2409 2408 2253 2068 2069 1962 1850 1729 1601 1318 1165 1317 1004  835  657  473   81  281
 177  374  563  917  743 1082 1239 1388 1529 1662 1787 1904 2013 2114 2207 2292 2369 2438 2499 2552 2597 2662 2633 2684 2683 2682 2681 2657 2677 2655 2620 2619 2533 2532 2474 2254 2255 2337 2167 1963 1964 1464 1319 1602 1006 1167 1005  660  836  658  475   79
 176  373  562  744  915  916 1081 1387 1661 1527 1786 1903 2012 2113 2291 2205 2368 2437 2551 2497 2596 2632 2634 2661 2660 2659 2658 2626 2654 2680 2622 2531 2581 2475 2410 2336 2256 2168 2070 2071 1851 1730 1731 1321 1166 1465  837  662  661  474  659   82
 175  372  560  561  742 1080 1238 1237 1386 1528 1785 1902 2011 2112 2204 2206 2290 2436 2498 2549 2550 2595 2631 2630 2629 2628 2627 2625 2656 2624 2621 2623 2476 2477 2411 2338 2257 2169 1966 1965 1852 1853 1732 1603 1320 1007  838  477  663  283  478  282
 174  371  741  913  914 1079 1236 1385 1526 1660 1784 1901 2010 2110 2111 2289 2367 2366 2435 2496 2594 2593 2592 2591 2590 2589 2588 2587 2586 2585 2580 2584 2583 2534 2412 2339 2258 2170 1967 1968 1734 1854 1604 1467 1466 1168 1009  476  840  284   84   80
 173  370  559  740  912 1078 1384 1525 1658 1659 1783 1899 1900 2009 2203 2288 2365 2434 2495 2548 2547 2546 2545 2544 2543 2542 2541 2540 2539 2538 2537 2582 2535 2478 2413 2340 2259 2073 2072 1855 1733 1735 1605 1468 1322 1169 1171  839 1008  285  479   85
 172  558  739  738 1077 1076 1235 1383 1524 1657 1782 2008 2109 2108 2202 2287 2364 2433 2494 2493 2492 2491 2490 2489 2488 2487 2486 2485 2484 2483 2482 2536 2480 2479 2415 2341 2260 2171 2074 1969 1856 1606 1325 1323 1469 1010 1170  665  842   83  286   86
 171  369  557  909  911 1233 1234 1382 1523 1656 1781 1898 2007 2107 2200 2201 2363 2432 2431 2430 2429 2428 2427 2426 2425 2424 2423 2422 2421 2420 2419 2481 2417 2416 2342 2414 2343 2172 2075 1970 1857 1609 1607 1608 1324 1326 1172  841  480  664  287   87
 170  368  367  555  737 1075    0 1232 1522 1655 1780 1897 2005 2105 2006 2286 2362 2361 2360 2359 2358 2357 2356 2355 2354 2353 2352 2351 2350 2349 2348 2418 2347 2345 2344 2262 2261 2173 2076 1971 1858 1738 1736 1737 1470 1173 1011  843  666  481  288   88
 169  366  556  910 1074 1231 1380 1381 1521 1654 1779 1896 2106 2104 2284 2285 2283 2282 2281 2280 2279 2278 2277 2276 2275 2274 2273 2272 2271 2270 2269 2268 2346 2266 2265 2264 2263 2174 2077 1972 1859 1472 1610 1471 1327 1174 1012  844  667  482  289   89
 168  554  553  736 1072  908 1230 1379 1520 1653 1778 1894 1895 2004 2199 2197 2196 2195 2194 2193 2192 2191 2190 2189 2188 2187 2186 2185 2184 2182 2087 2088 2267 2179 2178 2177 2176 2175 2078 1973 1860 1739 1473 1328 1175 1014 1013  845  668  483  290   90
 167  365  734  735  907 1073 1229 1378 1519 1652 1777 2002 2001 1893 2198 2102 2101 2100 2099 2098 2097 2096 2095 2094 2093 2092 2091 2090 2089 1985 2181 2086 2180 2084 2083 1979 2082 2081 1976 1864 2079 1861 1740 1611 1475 1176 1015  847  846  669  484  291
 166  364  551  552  733  906 1228 1377 1517 1518 1651 1776 1892 2003 2103 1999 1998 1997 1996 1995 1994 1993 1992 1991 1990 1989 1988 1987 1986 1984 2183 1983 2085 1868 1870 1750 1978 2080 1977 1745 1974 1741 1612 1476 1474 1329 1017  670  485  293  487   91
 165  363  362  732 1070 1071 1227 1375 1376 1650 1775 1773 1891 1889 2000 1888 1887 1886 1885 1884 1883 1882 1881 1880 1879 1878 1877 1876 1875 1874 1872 1871 1981 1982 1980 1866 1749 1748 1975 1865 1863 1742 1613 1477 1330 1016 1177  671  672  486  292  488
 164  361  550  730  905 1069 1226 1374 1516 1649 1774 1646 1771 1890 1770 1769 1768 1767 1766 1765 1764 1763 1762 1761 1760 1759 1758 1757 1756 1755 1873 1753 1752 1751 1869 1622 1620 1867 1747 1617 1862 1743 1614 1332 1178 1331  849  848  294  674  673   93
 163  162  360  549  731 1068 1225 1373 1515 1648 1647 1645 1772 1644 1643 1642 1641 1640 1639 1638 1637 1636 1635 1634 1633 1632 1631 1630 1629 1628 1754 1491 1492 1625 1624 1623 1487 1485 1744 1481 1746 1334 1479 1333 1179 1181 1180 1020  852  489   96   92
 161  548 1067  903  729 1066 1224 1514 1513 1219 1370 1512 1510 1509 1508 1507 1506 1505 1504 1503 1502 1501 1500 1499 1498 1497 1496 1495 1494 1493 1627 1348 1626 1346 1488 1486 1621 1342 1619 1484 1618 1615 1616 1185 1335 1018  853  850  851  675   95   94
 160  357  547  546  904 1065 1223 1372 1371 1369 1218 1511 1367 1366 1365 1364 1363 1362 1361 1360 1359 1358 1357 1356 1355 1354 1353 1352 1351 1350 1349 1197 1490 1489 1345 1344 1343 1191 1189 1483 1482 1480 1338 1478 1026 1337 1182 1021  491  299  296  295
 358  159  544  728  902  901 1222 1221 1061  891 1059 1368 1217 1215 1214 1213 1212 1211 1210 1209 1208 1207 1206 1205 1204 1203 1202 1201 1200 1199 1198 1196 1195 1347 1194 1034 1193 1031 1341 1030 1340 1187 1028 1186 1336 1025 1019  676   98  297  490   97
 545  359  726  727  900 1064 1063 1062 1060 1220 1058 1057 1216 1056 1055 1054 1053 1052 1051 1050 1049 1048 1047 1046 1045 1044 1043 1042 1041 1040 1039 1038 1037 1036 1035  867 1033 1192 1032 1029  862 1339 1027  858 1024 1022 1183  854 1023  300  298   99
 355  542  157  898  899  722  896  895  894  718  893  892  890  889  888  887  886  885  884  883  882  881  880  879  878  877  876  875  874  873  872  871  870  869  868  866  865  507  864 1188  863  685  861  859  857  856 1184  678  677  493  301  492
 158  353  356  725  897  724  721  720  719  535  717  716  715  714  713  712  711  710  709  708  707  706  705  704  703  702  701  700  699  698  697  696  695  694  693  692  691  690 1190  687  686  502  684  860  683  682  855  681  680  679  494  100
 352  354  541  543  723  538  348  537  345  536  534  533  532  531  530  529  528  527  526  525  524  523  522  521  520  519  518  517  516  515  514  513  512  511  510  318  316  509  505  688  504  503  311  501  500  499  498  497  496  495  302  101
 156  153  351  350  540  349  148  347  346  344  343  342  341  340  339  338  337  336  335  334  333  332  331  330  329  328  327  326  325  324  323  322  321  320  319  317  118  506  689  315  115  112  113  310  309  308  307  306  305  304  303  102
 155  154  152  151  150  539  149  147  146  145  144  143  142  141  140  139  138  137  136  135  134  133  132  131  130  129  128  127  126  125  124  123  122  121  120  119  117  508  116  313  314  114  312  111  110  109  108  107  106  105  104  103
