# This puzzle is unsolvable
22
161   1   2  86   5  90  92   6   7   9  10  11  15 173  99  97 101 105  20 106  22  23
 84   3  85   4  88  91 163  94  95 170 235  12 171  14 174  17 100  98  19 102 103  21
 83 160  87 227 162  89 164 293 166   8 169 296 299  16 178 453 354 244 246 179  26 177
158 339  81 288 228 229 231 165 167 234  96 295 348 350 241 396 426 351 245 104 349  24
 80 159 224 226 338 225 420 341 384 294  93 237 240 346 391 239  18 107 176 247 109  25
 79  82 285 385 289 230 290 232 452 168 389 482 297 172  13 305 355 184 308 108 301 302
155 286 157 340 342 382 233 387 345 236 390 242 238 461 175 300 352 180 303  27 182  29
223 156 287 383 337 386 291 450 421 292 451 471 425 347 243 304 353 111 181 249  31 183
334 152 153 284 336 417 449 422 470 468 424 423 476 298 392 397 427 251 185 399  32  30
154 335 279  77 151 332 344 440 343 388 456 469 431 472 477 400 394 393 248 187 113 186
220  78 283 380 331 333 281 444 418 474 448 458 455 254 432 454 114 395 110 356 309 189
 75 282 149  76 419 381 379 446 475 480 416 429 401 357  28 483 428 402 307  33 358 252
150 221 216 222 378 377 415 414 372 467 481 457 433 478 459 306 263 398 116 250 112 115
280 215 217  73 219 330 413 447 439 466 441 473 463 320 430 311 406 359 310 253 188  37
 72 412  68  71  59 218 442 465 445 443 464 408 366 434 367 360 316 403 436 190  34 117
 74 146 276 138 274 323 208 376 370 266 479 269 369 365 407 435 130 315 313  36  35 122
147 277 148 275 278 409 265 411 213 131 325 437 460 321 134 318 314 317 361 191 118  40
 69 142 270 327 273 145 410 324 139 438 129 206 462 261 119 319 363 260 259 120 255  38
144 329  70  66 203 214 136 374 135 373  50 405 199 368 133  51 312   0 193 121 256 194
 65 212  67 140 375 143 326  55 202 267 404  54 200 264 258 125 196 364  47 192 195  44
 64  62  63  61 272 207 209 328 262 205  56 137 201 362 128  49 126 124  48  39 123  42
211 141 210  60 271 371  58 204  57 268 322  52 132  53 198 127 197  45  43 257  46  41
