# This puzzle is unsolvable
46
   2    1    3    4    5    6  186  188    7   11   13   15  366  194  365   17  196   19  198   20   21   22   23   24   25   26   27   28   29   30   31   32   33   34   35   36   37   38   39   40   41   42   43   44   45   46
 180  181  182  183  184  185    8  358  360  192   10    9  364  529   16   14   18  368  197  369  200  201  202  203  205  206  377  207  208  209  210  211  212  213  214  216  217  388  218  219  391  220  222  223  224   47
 179  352  353  354  355  356  357  187  359  190   12  191  525  193  682  367  530  830  531  370  371  372  374  537  204  376  378  541  379  380  381  382  383  384  385  215  387  389  552  708  390  555  393  394  225   48
 178  351  516  517  518  519  520  522  523  361  828  363  526  683  831  528  195  685  690  199  688  692  691  375  538  536  694  540  542  543  544  545  546  547  548  386  550  551  553  392  554  221  556  395  226   49
 177  350  515  672  673  674  676  521  677  678  362  680  524  681  829  527  686  533  532  534  373  689  535  839  840  539  695  696  697  698  699  700  701  702  703  549  704  706  707  856  710  712  557  558  227   50
 176  349  514  671  820  821  675  823  825  189  679  826  967  968 1099  832  684 1102  687  834  835 1105  838  979  981  693  841  843  844  845  846  847  848  849  850  851  705  853  854  709  711  559  855  396  228  229
 175  348  513  670  819  960  822  962  824  963  964  827  966 1097 1222  970  969  833  972  836  974  837  975  978 1109  980  842  982  983  984  985  986  987  988  989  990  852  992  993  994  713  397  715  231   52   51
 174  347  512  669  818  959  961 1092 1094 1095  965 1443 1334 1540 1223  971 1101 1103  973 1229  977 1107 1233  976 1112 1234 1111 1113 1114 1115 1116 1117 1118 1119 1120 1121  991 1123 1124  995  857  859  560  400  398   53
 173  346  511  668  817  958 1216 1093 1217 1219 1220 1096 1221 1336 1098 1224 1227 1342 1447 1230 1228 1231 1108 1454 1232 1348 1350 1235 1236 1238 1239 1240 1241 1242 1243 1244 1122 1245 1125  996  563  858  232  399   54   55
 172  345  510  667  816  957 1091 1214 1215 1218 1333 1444 1442 1337 1100 1339 1225 1106 1448 1343 1104 1347 1453 1346 1351 1352 1458 1237 1459 1353 1354 1355 1356 1357 1358 1360 1247 1246 1126  998  714  562  561  403  230   56
 171  344  509  666  815  956 1090 1089 1332 1440 1441 1541 1543 1542 1544 1335 1445 1341 1446 1450 1344 1452 1550 1110 1349 1456 1457 1557 1460 1559 1461 1462 1463 1465 1466 1359 1361 1248 1127  860  862  402  401  404  233    0
 170  343  508  665  814  955 1088 1213 1331 1330 1539 1439 1634 1338 1635 1226 1638 1547 1549 1548 1642 1641 1345 1645 1555 1551 1554 1731 1648 1558 1560 1561 1562 1464 1564 1467 1362 1249 1128  999  861  997  564  717  234   57
 169  342  507  664  813  954 1087 1212 1329 1438 1632 1631 1633 1718 1719 1546 1340 1721 1449 1639 1451 1726 1725 1644 1455 1556 1650 1733 1730 1732 1651 1652 1654 1563 1565 1363 1364 1250 1130 1129  863  716  718  565  235   59
 168  341  506  663  812  953 1086 1211 1328 1437 1538 1716 1717 1792 1720 1637 1636 1796 1723 1640 1643 1799 1553 1728 1646 1649 1552 1647 1806 1808 1809 1734 1568 1655 1365 1566 1471 1251 1131 1000  864  720  719  567  236  405
 167  340  505  662  811  952 1085 1210 1327 1436 1537 1630 1714 1715 1793 1545 1795 1722 1798 1924 1797 1800 1802 1727 1870 1805 1873 1729 1811 1807 1876 1653 1737 1736 1470 1567 1472 1468 1252 1001 1002  865  406  237   58  407
 166  339  504  661  810  951 1209 1326 1325 1435 1535 1536 1629 1791 1860 1794 1862 1865 1864 1866 1724 1801 1868 1869 1929 1803 1980 1981 1874 1983 1877 1810 1878 1738 1569 1469 1368 1253 1132 1003  866  721  569  568  238   60
 165  338  503  660  809  950 1084 1208 1207 1434 1627 1534 1713 1859 1861 1921 1922 1863 1923 2018 1978 1925 1867 1927 1871 2022 1804 1872 1984 1875 1935 1735 1659 1658 1657 1474 1366 1133 1134 1005  867  722  239   62  566   61
 164  337  502  659  808  949 1083 1206 1324 1533 1432 1628 1788 1790 1920 1711 1789 1972 1973 1974 1926 1979 2020 2103 1928 2024 1930 1931 1932 1933 1812 1934 1740 1656 1570 1571 1367 1004 1254 1255  868  723  570  408  240   63
 163  336  501  658  807  948 1082 1081 1323 1433 1532 1787 1712 1626 1918 1971 1919 2016 2017 1977 1975 2019 2084 2023 2021 2026 1936 1985 2028 1815 1879 1813 1739 1661 1660 1473 1258 1007 1256 1135  725  869  410  409  241   64
 162  335  500  657  806  947 1079 1080 1322 1321 1431 1625 1856 1858 1857 1916 1917 2052 2051 2100 2053 2054 2057 2060 2059 2025 2027 1982 1937 1986 1881 1742 1814 1741 1572 1475 1369 1257 1008  870  724 1137  571  411  242   65
 161  334  499  656  805  946 1078 1204 1205 1430 1531 1709 1710 1786 1855 1915 1969 1970 2050 1976 2102 2083 2055 2058 2056 2061 2064 2062 1987 1880 1816 1744 1743 1662 1476 1373 1370 1259 1371 1009  728  726  573  412  243   66
 160  333  498  655  804  944 1077  945 1203 1429 1530 1624 1708 1785 1854 1967 2015 2014 2081 2080 2079 2082 2113 2086 2105 2114 2085 2063 1939 1988 1883 1882 1818 1663 1573 1372 1478 1260  872 1006 1136  572  575  413  574  244
 159  332  497  942  654  943 1074 1076 1319 1428 1529 1623 1622 1707 1783 1914 2013 1968 2049 2078 2099 2112 2104 2106 2101 2087 2029 2030 1938 1940 1989 1479 1942 1745 1666 1574 1477 1262 1138  871  576 1010  727  730  245   67
 156  157  496 1075  802  803  940 1201 1320 1427 1705 1621 1853 1852 1851 1784 1913 1966 2012 2076 2098 2077 2111 2107 2108 2088 2090 1990 2032 2031 1819 1817 1941 1665 1579 1575 1576 1139 1011  873  875  874  415   68  246   69
 330  158  653  331 1073  941 1200 1202 1318 1426 1527 1620 1528 1706 1782 1911 1912 2010 2048 2009 2047 2097 2115 2109 2092 2089 2065 1991 1821 1943 1884 1944 1667 1746 1577 1664 1374 1141 1261  729 1142  731  416  577  247  249
 651  155  652  495  494  800 1199 1526 1317 1315 1619 1704 1703 1850 1849 1964 2011 2008 2046 2096 2075 2073 2095 2093 1999 2068 2091 2036 2033 1992 1886 1822 1885 1578 1481 1480 1376 1375 1143 1013  876  877   70  414  248   71
 329  328  493  650  799 1314 1316 1197 1425 1198 1525 1618 1780 1781 1963 1910 1965 2007 2045 2074 2072 2094 2071 2110 1897 1998 1949 2066 2034 1947 1889 1747 1669 1748 1750 1482 1378 1263 1140  878  732  578  417  579  251   72
 153  325  801  327  648  649 1072 1422 1313 1424 1617 1616 1702 1779 1848 1961 1909 2006 1958 2043 2042 2070 2002 2069 2001 2038 1945 2067 1994 1887 1820 1668 1824 1749 1580 1264 1377 1265 1266 1015 1012 1014  580  419  581   73
 326  492  154  647  797  798  939 1071 1194 1423 1523 1615 1701 1778 1907 1847 1962 1904 2044 1957 1954 2041 2039 1951 1834 1997 2037 1993 1995 2035 1828 1890 1888 1582 1483 1268 1146 1379 1144 1016  880  879  734  250  421  418
 152  491  490  796  795  937 1196  938 1195 1312 1524 1522 1700 1777 1960 1845 1908 2005 1902 1839 2004 2003 2040 2000 1953 1996 1830 1894 1948 1682 1892 1674 1825 1672 1581 1486 1485 1484 1017 1145  737  881  733  252   75  423
 151  324  489  646  794 1069 1070 1311 1193 1421 1521 1614 1699 1776 1846 1905 1841 1959 1903 1901 1955 1956 1896 1833 1950 1761 1764 1832 1946 1952 1757 1670 1823 1487 1583 1383 1488 1267 1380 1148  582  736  735  422   77   74
 150  323  488  644 1067  936 1068 1310 1308 1420 1520 1613 1698 1775 1844 1906 1843 1770 1840 1767 1838 1836 1898 1837 1763 1835 1680 1829 1592 1591 1826 1673 1891 1754 1584 1381 1270 1019 1147 1018  882  883  583  253   76  254
 149  322  487  793  935  645 1191 1192 1309 1417 1419 1697 1696 1774 1773 1772 1842 1771 1769 1900 1688 1600 1899 1895 1760 1831 1679 1758 1827 1893 1593 1752 1756 1751 1677 1586 1272 1271 1149 1150 1020  586  587  420  424  584
 321  486  643  791  792  934 1190 1189 1418 1609 1519 1612 1695 1694 1513 1693 1692 1691 1690 1768 1687 1601 1766 1598 1765 1686 1762 1595 1501 1759 1497 1493 1675 1494 1585 1269 1382 1273 1021  886  585  884  588  738  739  425
 148  147  485  642  790  933 1065 1066 1307 1415 1517 1611 1608 1607 1606 1512 1604 1603 1506 1403 1599 1602 1685 1597 1500 1502 1683 1498 1678 1496 1283 1671 1676 1755 1490 1385 1753 1152 1151 1022  426  741  740  258   80  255
 146  320  484  640  641  932 1306 1305 1516 1416 1518 1413 1412 1514 1410 1510 1605 1509 1508 1689 1405 1401 1400 1399 1288 1287 1395 1284 1396 1681 1499 1590 1390 1587 1492 1588 1153 1384 1274  885  888  742   78  256  259   79
 483  319  930  639  789  931 1063 1064 1188 1414 1610 1515 1300 1411 1409 1511 1408 1295 1507 1406 1504 1505 1290 1289 1503 1398 1594 1286 1394 1281 1495 1393 1589 1280 1389 1491 1275 1386 1024 1023  887  589   81  257   83   82
 145  318  317  638  788  928  929 1186 1304 1303 1302 1301 1181 1299 1298 1297 1296 1177 1293 1407 1045 1292 1171 1596 1402 1397 1684 1285 1392 1162  900 1035 1277 1279 1391 1276 1388 1030 1489 1028 1025  743  429  590  431   84
 144  316  482  637  786  787 1059 1062 1187 1185 1184 1183 1182 1180 1179 1178 1050 1048 1047 1404 1172 1291 1170 1167 1169 1040 1165 1038 1166 1282  901  898 1161 1158 1159  751  894 1157  893  746  592 1026  427  428   85  260
 143  481  142  480  927  926 1061 1060 1058 1057 1056 1055 1054 1053 1052 1051 1176 1174 1294  913 1046 1173 1044 1042 1041  905 1039  902  761 1163 1164  899 1034  755 1387 1154 1278  897 1029  430 1155  263  261  262   86  433
 141  315  479  636  785  783  925  924  923  922  921  920  919  918  917  916  915 1049 1175  769  912  911  910 1043  908 1168  906  904  759 1037  756  606 1036 1031 1032  895  754 1156 1027  890  747  748  591  264   87  434
 140  314  313  478  635  633  782  781  780  779  778  777  776  775  774  773  772  914  771  768  767  617  909  765  907  763  610  762  608  453  758  447  604 1160 1033  896  753  750  599  892  891  598  744  889   95   88
 139  312  477  634  631  784  472  630  629  469  628  626  625  624  623  622  621  620  770  619  766  287  457  616  614  612  611  760  903  450  607  605  757  445  603  602  752  749  442  597  745  594  593  436  265   90
 138  311  309  476  474  632  304  305  301  470  627  468  467  465  464  463  462  460  291  456  459  290  458  764  454  615  286  284  285  609  449  448  446  278  444  443  601  440  273  600  439  596  437  268  269  438
 136  137  310  132  473  471  475  306  129  126  300  299  466  298  297  296  295  461  294  293  292  618  455  613  114  112  452  108  283  451  282  281  280  279  277  275  274  441  272  271  270  435  267  595   91  266
 135  134  133  307  308  131  130  128  127  302  303  125  124  123  122  121  120  119  118  117  116  115  289  288  113  111  110  109  107  106  105  103  104  102  101  276  100   99   98   97   96  432   94   93   89   92
