# This puzzle is unsolvable
19
195 281 137  71   6 140 142 132  76 199  12  82  11 202 149  91  15  88  89
135  72 134 313 279 239  70 240  77  83 286  10  84 203  13  85  20  92  93
 73   1 136   8  74  78 197  80   9 248  16  87 147  14  18  19  86 151  21
  7 280  75 192 242 196 141 245 143 200 198  81 293 252 201 148 152   0  22
131  69   3   5 310   4 194 311 246 144 250 146 287 145 204 150  90  17 289
189 138   2 188 276 282 244 312 243 317 247 256 358 355 321 206 205  96  23
190 133 275  66 314 186 139 359  79 284 288 341 255 251 319 153 207  24  94
 68  63 235 128 334 241 283 193 316 346 254 318 249 285 158 292 157 258  25
273 185 305 308 274 353 236 332 357 253 315 296 294 342 155 290  26  27 154
 64 127 187  67 351 354 338 337 350 211 325 345 210 322 259 208  98  28 156
 61 130 129 237 335 238 309 360 339 347 340 162 257 324 295 212  95 213 160
233 191 278 231 277 184 352 320 356 267 301 299 327 291  97  30  99  29 214
 59  62 183  65 330 270 333 336 224 226 302 297 328  31 323 220  34 101  33
304 230 232 234 182  51 271 229 116 331 343 112 298 269 263 261 159 217  32
 60 123 228 177 303 176 307 117 326 348 264 262 268 209  43 218 167 100 164
 54 180 178 126  57  52  49 227 221 300  46 222 265 102 103  35 161 216  37
125  58 121 223  53 272  50 225 260 172 266 105  40 111 163 168  39  38 219
124  56 120 181 118 174 166 113 306 329 344 171 169 215 107 109 110 106 104
 55 179  48 122 175 119 115 173 349 114  45 108  47  44  42  41 170 165  36
