# This puzzle is unsolvable
8
 1 43  9 47 56 14 24 63
46 51 20  7 11 39  2 15
 5 45 21  0 57  3 55 31
40 26 30 54 22 35 53 52
19 23 13 28 49 32 58 50
37 33 48 12 25 60 27  6
29 44 61 42 10 38 16 59
34 36  8  4 41 62 18 17
