# This puzzle is unsolvable
38
   2    1    3    4    5    6    7    8  155    9   11  159   13  162   14   16   17   18  166   19   21   22   23   24   25  173   27  312   28   29   30   31   33  180   34   37  183   38
 148  149  150  151  152  153  294  154  296  157   10  160  299   12  434  164  432  165  304   20  167  168  169  170  174  311   26  314  315  175  178  177  318  181   35  182   36   39
 147  288  289  290  422  291  292  156  427  298  428  551  671  554  556  163  300  303  305  306  307  308  440  309  172  789  443  445  313  176  317   32  179  320  322  185  184   40
 146  287  419  420  421  424  293  295  549  426  158  297  429  161   15  553  559  435  301  437  438  439  310  441  442  171  565  569  571  316  448  572  450  451  321  324  186   41
 145  286  544  543  545  423  425  548  664  666  667  670  665  673  781  879  783  674  302  675  561  562  563  566  567  886  788  446  790  570  447  319  574  688  323  452  325  187
 283  144  285  542  660  546  663  547  772  771  668  552  430  555  550  778  777  558  883  676  560  678  786  680  681  978  444  682  793  685  684  449  573  454  453  188   43   42
 284  418  541  417  658  661  662  769  770  773  872  669  775  876 1052  779  436  880 1053  881  677  884  679  785  564  787  568  683  890  686  795  687  455  575  328  190  189   44
 143  142  416  659  765  768  868  869  870  871  963  431  874  776  971  878  782  882  972  433  784  974 1134 1058  885  888  887  791  889  893  792  794  689  690  327   45  326   46
 141  282  413  415  657  767  766  960  867  962 1045  774  964  967  968  557 1128  672  875  973  780  975 1198 1059 1060  977  979  982  891  892  797  456  579  576  577  191  330   47
 140  281  539  540  414  656  957  866  961  865 1046  873 1123 1048  965 1194 1049  877 1055 1051 1197 1057 1200  976 1061 1132 1062  981 1064  983  800  329  692  694  578  691  580   48
 280  279  412  538  655  764  958  959 1044 1187 1122 1047 1050 1126  966 1250 1130  969 1056  970 1054 1195 1133 1202 1135 1063 1139 1204 1065  984  796  696  895  894  457  459  192  195
 139  278  411  537  763  762  864  956 1043 1120 1188 1119 1249 1125 1251 1124 1127 1254 1255 1129 1131 1257 1261 1201 1205 1136 1067  980 1138  985  799  583  899  458  798  194   49   50
 138  277  536  653  654  861 1042 1118  953 1116 1121 1189 1192 1117 1253 1193 1304 1196 1258 1256 1307 1260 1309 1313 1262 1141 1263  987 1137 1070  897  896  462  801  695  331  193  198
 137  134  410  534  535  862  863 1041 1299 1115 1186 1191 1248 1190 1345 1302 1252 1347 1306 1349 1308 1199 1314 1265 1203 1206 1140 1066  986  901  693  582  581  584  461  333   51  197
 136  135  409  649  408  761  955 1040 1039  860 1247 1185 1301 1245 1344 1348 1383 1303 1305 1350 1351 1352 1312 1259 1310 1354 1264 1068  989 1069  988  898  697  700  460  332  334  196
 276  274  275  652  859  760  858 1038  954 1114 1300 1184 1342 1343 1379 1346 1384 1382 1385 1386 1413 1389 1388 1353 1316 1143 1207 1071 1142  803  802  699  804  587  463  465   53   55
 133  533  406  532  650  651  759 1037 1036 1244 1183 1246 1297 1298 1408 1380 1410 1411 1412 1432 1415 1311 1387 1390 1144 1315 1209 1266 1210  698  900  701  339  586  199   52  585  201
 132  407  758  530    0  757  951 1035  950 1113 1242 1182 1243 1340 1381 1427 1409 1406 1437 1430 1414 1394 1356 1357 1358 1360 1267  807 1208  806  905  903  808  588  466   54  467  337
 131  273  531  647  648  756  857  952 1112 1181 1296 1294 1377 1341 1378 1407 1426 1429 1442 1440 1431 1416 1355 1317 1148 1268 1145 1073 1211  902  994  992  702  468  338  200  335   56
 130  272  529  405  646  755  856  949 1034 1111 1180 1241 1339 1295 1404 1428 1405 1443 1400 1434 1433 1417 1319 1391 1318 1146 1213  907 1072  336  993  704  703  805  464  202  203   58
 129  270  271  528  645  754  855  948 1110 1179 1240 1293 1292 1338 1376 1374 1425 1439 1436 1422 1392 1435 1359 1270 1269 1362  904 1212  995 1075 1215  906  809  707  340   57  589  590
 128  269  404  403  753  752  947  946 1033 1032 1108 1109 1291 1403 1371 1337 1369 1333 1423 1421 1420 1395 1361 1271 1320 1322 1150 1147  997 1077  991  990 1074  708  470  469  204   59
 127  268  401  402  644  525  853  854 1031 1177 1176 1178 1237 1239 1335 1286 1424 1402 1401 1366 1398 1418 1419 1393 1274 1078 1324 1149  996 1076  909  910  591  341  593  205   60   61
 126  267  400  527  526  642  751  944 1029  945 1289 1236 1334 1375 1373 1331 1330 1438 1370 1399 1364 1325 1396 1279 1278 1273 1323 1153 1216 1079  810  342  343  473  596  471  472  206
 266  265  399  524  643  749  852  851 1030 1106 1238 1336 1290 1287 1235 1284 1329 1441 1281 1367 1328 1224 1225 1321 1277 1272 1276  812 1214 1080 1151  998  706  592  207  345   63   62
 124  125  263  398  750  641  850 1028 1107 1104 1175 1234 1288 1231 1285 1372 1228 1282 1227 1280 1397 1326 1221 1157 1217 1365 1081 1152 1275  999  912  705  908  811  594  344   65   64
 123  397  522  523  640  748  849  943 1027 1103 1174 1105 1173 1229 1332 1168 1230 1223 1283 1327 1368 1226 1363 1087 1220  823 1158 1007 1083 1154  816  814  709  474  815  475  211  208
 262  396  264  521  639  638  848  942  941 1102 1023 1101 1232 1170 1165 1169 1167 1166 1164 1163 1160 1091 1010 1088 1222 1085 1156 1155 1218 1082  713  598  813  595  710  209  348  347
 260  518  395  520  637  747  847  940 1026 1022 1171 1233 1098 1099 1018 1019 1095 1094 1093 1013 1162 1161  831 1011 1159 1008 1000 1004 1219 1003  817  818  597  911  477   66  346  210
 120  519  121  635  636  746  939 1024 1025  935  841  733 1100  836 1172 1096  838 1017  927 1014  925  924  922 1089 1090 1012 1006 1001 1084 1005 1002  916  711  599  349  212  476  214
 122  118  394  742  517  845  843  737 1097  937 1020  834  839  932  837  931  933  729 1016 1015  923  726  616 1009  921 1086  919  917  821  712  914  913  717  600  478  480  351   67
 261  119  393  633  846  745  511  938  512  842  504  625  505 1021  929  928  732  832  728 1092  926  724  613  725  827  825  824  920  918  820  915  716  819  714  601  479  352   68
 117  259  392  390  741  743  744  628  384  936  627  623  840  835  930  734  622  731  833  830  617  829  828  723  721  826  609  607  822  718  606  715  484  481  215  350  213   69
 116  258  257  631  632  391  515  249  844  626  739  736  624  735  503  620  621  730  618  615  496  727  369  494  612  722  608  610  720  719  605  486  602  482  353  216   72   71
 115  256  389  388  516  634  250  630  247  104  740  380  507  243  377  502  619  500  372  499  498  234  614  493  611  492  491  490  489  488  487  483  604  354  603  356   73   70
 114  255  387  513  514  251  738  510  382  248  934  100  241  375  378  242  501  374  371  236  497  370  495  368  367   90  364  363  362  361  224  485  359  222  357  355  219  218
 113  254  253  109  386  252  106  629  383  509  245  508  379  506  240  239  238   94  373   96  235  232   89   88  366  365  229  228  227  226  360  358   80  223  217  221  220   74
 112  111  110  108  385  105  107  246  381  103  102  101  244   99   98  376   95   97  237   93   92  233   91  231  230   87   86   85   84   83  225   82   81   79   78   77   76   75
