# This puzzle is unsolvable
51
   3    1  202  752    5  207  398  580    8    9   10  211   12   13   14   15  215   16   17   20   21   22   23   24   25   26   27   28   30  420   31   32   33   34  234   37   35   38   40  432  239  240   44  242  436  246  245   46   48   51   49
 200  201  391    4  397    7  205  579  208  400   11  210  212  403  214  407  217   18   19  219  220  412  222  223  224  225  226  227   29  419  229  232  422  607  425  235   36  237   39  612   41  788  241  244   45  437   47  249  248   53   50
   2  393  204  396  921  575  206    6  209  399  401  402  404  213  588  405  216  408  218  593  594  411  221  414  415  416  417  418  602  228  230  231  424  233  426  427  430  238  789  614   43   42  435  243  619  620  247  440  439  438   52
 199  196  392  576  394  577 1082  395  582  583  584  585  586  587  764  406  589  591  592  409  769  935  413  771  597  599  600  601  603  421  604  779  605  782  608  236  610  428  787  431  791  433  434  960  618  623 1119  622  250  251   54
 197  753  203  920  754  751  756  581  758  924  759  760  761  763  930  765  766  767  768  410  770  772  595  598 1099  773  774  775  776  777  778  948  423  783  785  611  609  429  952  956  613  790  961  792  616  794  797  624  621  252   55
 388  389  573  574  578  919  757  923  755  926  927  928  929  762 1089  931  590 1091  934  936  937 1096  596  940  938 1250 1103  943  946 1105  947  780  606  949  784  781  951  786  953  954 1116 1266  615  617 1120  958  795  442  441  253   57
 387  194  198  918  390  750 1078  922 1083  925 1085 1236 1087 1088 1090 1241  932  933 1093 1094 1095 1247  939 1097 1098 1100  942 1102  944 1104  945 1258 1109 1537  950 1107 1111 1112 1265 1113 1267 1268  957  793 1118  959  796  798  256  255   56
 193  195  571 1233 1080  748 1231 1232 1081 1235 1379 1086 1238 1239 1240 1242 1092 1243 1244 1245 1246 1248 1249 1392 1251  941 1101 1396 1254 1257 1106 1259 1536 1108 1403 1406 1261 1262 1263 1117 1408  955 1544  966  963 1410  443  625  254  445   58
 192  570  385  749  747 1079  917 1376 1377 1514 1237 1378 1381 1382 1518 1383 1385 1386 1387 1388 1389 1391 1527 1393 1395 1394 1253 1398 1658 1399 1400 1663 1662 1256 1402 1540 1667 1407 1541 1264 1114 1269  800 1272 1271 1123 1270  962  258  444   59
 386  190  572  384 1509  916 1375 1512 1234 1084 1380 1641 1517 1873 1645 1384 1647 1520 1522 1521 1523 1390 1525 1526 1529 1656 1528 1777 1779 1531 1533 1401 1260 1405 1110 1786 1543 1785 1668 1789 1115 1411 1409 1121 1124  964  447  257   61   60  260
 383  569  746 1372 1076 1077 1230 1511 1373 1510 1513 1515 1643 1516 1761 1519 1766 1646 1768 1880 1524 1769 1653 1654 1773 1657 1252 1397 1659 1532 1534 1661 1404 1538 1539 1666 1897 1787 1669 1671 1670 1545 1413  801 1414 1122  627  799  802  626  259
 191  381  382  568  915 1228  913 1229 1374 1869 1640 1871 1979 1762 1644 1764 1765 1649 1648 1767 1882 1650 1770 1772 2083 1774 1530 1775 1887 1255 1780 1781 1783 1535 1999 1895 1542 1674 1899 1790 1546 1416 1672 1274 1412  969  449  965  448   62   64
 188  189  914  745 1074 1073 1075 1227 1508 1507 1639 1637 1876 1874 1763 1877 1878 1980 1879 1983 1651 1652 1771 1883 1886 1655 1990 1776 1991 1889 1778 1890 1892 1665 1784 1894 1788 1901 2002 1791 1549 1673 1127 1547  629  630  628  803  632   65  446
 566  187  380  567  743 1226 1371 1506 1635 1638 1642 1872 1875 1976 1758 2072 2073 2078 1984 2166 1982 1881 1987 1884 1989 1988 2086 1885 2088 1660 1891 1994 1995 1782 1998 1893 2181 2093 2000 1792 1415 1551 1276  804 1126 1273  967  631   63  805   66
 565  564  744  912  911  740 1071 1225 1636 1505 1760 1868 1870 2071 1977 2074 1978 1981 2315 2077 2165 2079 1985 2170 2084 2172 1888 1992 2173 1993 2089 2090 2091 1664 1996 1997 1896 1902 1898 1900 1793 1417 1275 1277  968 1128 1125  451  450  453  262
 379  563  910  741  742 1072  909 1370 1368 1634 1975 1973 1867 2070 2160 1974 2075 2162 2076 2080 2164 2167 2168 1986 2171 2169 2251 2085 2175 2087 2176 2177 2178 2092 2094 2095 2001 2096 2003 1676 1675 1418 1550 1278  972 1548  806  452  970  263  264
 186  378  908  737 1224 1070 1369 1223 1503 1630 1757 1754 2069 1865 2158 2240 2312 2163 2243 2246 2245 2082 2081 2319 2323 2248 2252 2387 2325 2174 2254 2256 2257 2259 2180 2329 1904 2183 2004 1794 1677 1553 1552 1419 1129  971  808  261  633   67   68
 377  185  184 1069 1220  739 1222 1504 1502 1753 1759 1756 2067 2156 2157 2239 2313 2242 2241 2378 2482 2244 2320 2247 2484 2385 2321 2250 2253 2443 2255 2326 2327 2179 2182 2260 2328 2098 1903 1796 1795 1678 1279 1281 1130  807  809  634  454  265  267
 736  560  375  561    0  738 1501 1367 1631 1221 1752 1755 2159 2068 1972 2161 2376 2377 2314 2379 2434 2318 2317 2249 2382 2322 2384 2324 2491 2390 2389 2330 2331 2258 2184 2005 2097 1906 2006 1905 1679 1280 1421 1420 1131  973  974  635  455  268  266
 183  376  562 1066  906 1068 1632 1628 1364 1219 1971 1970 1866 2066 2309 2238 2311 2432 2380 2431 2316 2435 2381 2437 2383 2486 2439 2388 2386 2492 2528 2391 2332 2261 2262 2393 2185 2099 1798 1797 1680 1554 1423 1422 1132  975  810  636  637  457   69
 179  182  181  558  905 1361  904 1499 1366 1217 1633 1862 1969 2237 2155 2310 2374 2375 2480 2481 2521 2483 2436 2485 2438 2487 2526 2442 2440 2559 2445 2444 2392 2186 2100 2263 2007 2008 2009 1907 1681 1555 1556 1282 1133  976  811  638   71  456   70
 178  180  735  559  374 1067  733 1863 1363 1864 1750 1751 2064 2154 2235 2236 2308 2373 2433 2520 2479 2552 2522 2523 2524 2525 2488 2527 2441 2530 2529 2446 2394 2333 2264 2187 2103 1908 2102 1799 1682 1557 1424 1283 1134  977  812  639  459  269   72
 734  557  373  556  903  907 1065 1365 1747 1498 1629 1966 2065 2063 2153 2307 2152 2428 2477 2478 2430 2551 2553 2554 2555 2556 2558 2490 2451 2489 2493 2560 2395 2334 2265 2188 2010 2101 1909 1800 1683 1558 1425 1284 1135  978  813  640  270  458   73
 368  371  902 1063 1062 1064 1218 1625 1362 1216 1861 1968 1967 1860 2151 2233 2305 2429 2371 2518 2519 2550 2576 2577 2579 2580 2557 2581 2535 2532 2396 2447 2397 2335 2266 2190 2189 2011 1910 1801 1684 1559 1426 1285 1136  979  814  641  460  271   74
 176  177  372  732  901 1360 1500 1060 1359 1745 1964 1748 1749 1497 2306 2234 2372 2427 2475 2476 2517 2575 2574 2578 2593 2592 2595 2594 2448 2450 2494 2449 2337 2398 2267 2105 2012 2104 1911 1802 1685 1560 1427 1286 1137  980  815  642  461  272   75
 369  555  370  554  731 1058  899 1627 1496 1624 1859 1965 1963 2060 2149 2230 2231 2370 2426 2425 2516 2549 2591 2599 2600 2582 2531 2496 2561 2497 2562 2597 2399 2336 2268 2191 2106 2013 1912 1803 1686 1561 1428 1287 1138  981  816  643  462  273   76
 174  175  553 1214  898 1211 1061 1495 1215 1626 1623 1858 1961 2059 2062 2232 2303 2304 2367 2424 2515 2548 2573 2590 2588 2596 2584 2583 2533 2564 2498 2495 2499 2338 2269 2192 2107 2014 1913 1804 1687 1562 1429 1288 1139  982  817  644  463  274   77
 366  367  552 1212  730 1057 1358 1356  900 1746 1210 1857 1856 2150 2061 2229 2302 2369 2368 2474 2473 2514 2547 2589 2586 2569 2598 2563 2587 2534 2536 2452 2400 2339 2270 2193 2108 2015 1914 1805 1688 1563 1430 1289 1140  983  818  645  464  275   78
 550  173  729  728 1059 1213  896 1493 1494 1741 1744 1960 2058 2148 2147 2228 2301 2366 2423 2472 2513 2546 2572 2571 2570 2568 2567 2585 2566 2453 2565 2454 2401 2340 2271 2194 2109 2016 1915 1806 1689 1564 1431 1290 1141  984  819  646  465  276   79
 172  365  549  725  727 1355  897 1621 1357 1492 1620 1855 1959 1962 2146 2227 2300 2365 2422 2471 2512 2545 2544 2543 2542 2541 2540 2539 2538 2537 2500 2455 2402 2341 2272 2195 2110 2017 1916 1807 1690 1565 1432 1291 1142  985  820  647  466  277   80
 364  551  548 1056 1491 1209 1208 1354 1854 1742 1622 2057 1853 2056 2145 2226 2299 2364 2421 2470 2511 2510 2509 2508 2507 2506 2505 2504 2503 2502 2501 2456 2403 2342 2273 2196 2111 2018 1917 1808 1691 1566 1433 1292 1143  986  821  648  467  278   81
 170  171  363  895  724 1055 1353 1351 1489 1490 1743 1619 1740 1958 2055 2144 2225 2298 2420 2469 2468 2467 2466 2465 2464 2463 2462 2461 2460 2459 2458 2457 2404 2343 2274 2197 2112 2019 1918 1809 1692 1567 1434 1293 1144  987  822  649  468  279   82
 168  362  544  547  726  894 1488 1206 1352 1618 1739 1852 1957 2054 2143 2224 2297 2363 2419 2418 2417 2416 2415 2414 2413 2412 2411 2410 2409 2408 2407 2406 2405 2344 2275 2198 2113 2020 1919 1810 1693 1568 1435 1294 1145  988  823  650  469  280   83
 359  360  361  892  893  722 1053 1207 1487 1617 1738 1956 2052 2051 2142 2295 2361 2362 2360 2359 2358 2357 2356 2355 2354 2353 2352 2351 2350 2349 2348 2347 2346 2345 2276 2199 2114 2021 1920 1811 1694 1569 1436 1295 1146  989  824  651  470  281   84
 166  546  890 1054  723 1052 1205 1350 1616 1615 1737 1851 2053 2141 2223 2296 2220 2294 2293 2292 2291 2290 2289 2288 2287 2286 2285 2284 2283 2282 2281 2280 2279 2278 2277 2200 2115 2022 1921 1812 1695 1570 1437 1296 1147  990  825  652  471  282   85
 169  167  721  545  889 1051 1204 1349 1486 1849 1736 1954 1850 2139 2140 2222 2138 2136 2218 2217 2216 2215 2214 2213 2212 2211 2210 2209 2208 2207 2206 2205 2204 2203 2202 2201 2116 2023 1922 1813 1696 1571 1438 1297 1148  991  826  653  472  283   86
 165  718  542  891  541 1050 1203 1348 1485 1614 1734 1735 1953 1955 2221 2219 2050 2047 2135 2134 2133 2132 2131 2130 2129 2128 2127 2126 2125 2124 2123 2122 2121 2120 2119 2118 2117 2024 1923 1814 1697 1572 1439 1298 1149  992  827  654  473  284   87
 719  357  543  887  720 1049 1201 1202 1347 1613 1733 1848 1952 2049 2048 1948 2137 2046 2044 2043 2042 2041 2040 2039 2038 2037 2036 2035 2034 2033 2032 2031 2030 2029 2028 2027 2026 2025 1924 1815 1698 1573 1440 1299 1150  993  828  655  474  285   88
 164  356  540  888  358  885 1048 1346 1484 1483 1612 1847 1846 1951 1949 1947 1946 2045 1945 1944 1943 1942 1941 1940 1939 1938 1937 1936 1935 1934 1933 1932 1931 1930 1929 1928 1927 1926 1925 1816 1699 1574 1441 1300 1151  994  829  656  475  286   89
 163  355  716  717  886 1047 1200 1345 1482 1611 1732 1845 1844 1950 1842 1841 1840 1839 1723 1837 1836 1835 1834 1833 1832 1831 1830 1829 1828 1827 1826 1825 1824 1823 1822 1821 1820 1819 1818 1817 1700 1575 1442 1301 1152  995  830  657  476  287   90
 161  354  539  715  884 1199 1344 1343 1481 1610 1731 1730 1729 1843 1727 1726 1725 1838 1724 1722 1721 1720 1719 1718 1717 1716 1715 1714 1713 1712 1711 1710 1709 1708 1707 1706 1705 1704 1703 1702 1701 1576 1443 1302 1153  996  831  658  477  288   91
 160  159  353  714  883 1046 1198 1342 1480 1609 1608 1606 1605 1728 1474 1603 1602 1601 1600 1599 1598 1597 1596 1595 1594 1593 1592 1591 1590 1589 1588 1587 1586 1585 1584 1583 1582 1581 1580 1579 1578 1577 1444 1303 1154  997  832  659  478  289   92
 352  162  351 1045  537 1044 1196 1197 1479 1478 1477 1607 1476 1335 1604 1472 1471 1470 1469 1468 1467 1466 1465 1464 1463 1462 1461 1460 1459 1458 1457 1456 1455 1454 1453 1452 1451 1450 1449 1448 1447 1446 1445 1304 1155  998  833  660  479  290   93
 158  536  538  713  881 1043  882 1341 1340 1338 1337 1336 1475 1188 1473 1333 1332 1331 1330 1329 1328 1327 1326 1325 1324 1323 1322 1321 1320 1319 1318 1317 1316 1315 1314 1313 1312 1311 1310 1309 1308 1307 1306 1305 1156  999  834  661  480  291   94
 157  350  535  712  880 1042 1195 1194 1192 1339 1191 1190 1189 1187 1334 1186 1185 1184 1183 1182 1181 1180 1179 1178 1177 1176 1175 1174 1173 1172 1171 1170 1169 1168 1167 1166 1165 1164 1163 1162 1161 1160 1159 1158 1157 1000  835  662  481  292   95
 156  349  534  711  879 1040 1039 1038 1193 1037 1036 1035 1034 1033 1032 1031 1030 1029 1028 1027 1026 1025 1024 1023 1022 1021 1020 1019 1018 1017 1016 1015 1014 1013 1012 1011 1010 1009 1008 1007 1006 1005 1004 1003 1002 1001  836  663  482  293   96
 155  348  533  710  878 1041  877  876  875  874  873  872  871  870  869  868  867  866  865  864  863  862  861  860  859  858  857  856  855  854  853  852  851  850  849  848  847  846  845  844  843  842  841  840  839  838  837  664  483  294   97
 154  347  532  709  708  707  706  705  704  703  702  701  700  699  698  697  696  695  694  693  692  691  690  689  688  687  686  685  684  683  682  681  680  679  678  677  676  675  674  673  672  671  670  669  668  667  666  665  484  295   98
 153  346  531  530  529  528  527  526  525  524  523  522  521  520  519  518  517  516  515  514  513  512  511  510  509  508  507  506  505  504  503  502  501  500  499  498  497  496  495  494  493  492  491  490  489  488  487  486  485  296   99
 152  345  344  343  342  341  340  339  338  337  336  335  334  333  332  331  330  329  328  327  326  325  324  323  322  321  320  319  318  317  316  315  314  313  312  311  310  309  308  307  306  305  304  303  302  301  300  299  298  297  100
 151  150  149  148  147  146  145  144  143  142  141  140  139  138  137  136  135  134  133  132  131  130  129  128  127  126  125  124  123  122  121  120  119  118  117  116  115  114  113  112  111  110  109  108  107  106  105  104  103  102  101
