# This puzzle is unsolvable
8
44 42 59  2 12 14 40 34
 9 29 60  4  5 48 19 35
17 39 53 31 56 58 22 37
10 36 63  7 49 13 52 55
30 33 41 46 20  0 45 26
38 54 28 24 18 57 61 23
25 21  1 47 27  6 51 50
32 43  8 11 16 62 15  3
