# This puzzle is unsolvable
11
  8   1   9 118  44  41   0   5  88  69  14
 42  38  18 101  70  49  71  48  12  13  52
 94  32  45  79  51  74   4  89  83  98  99
  7  19   2  73 104  68  80 103  15  54  50
 43  39  29  37  11 107  76  85 106  58  75
 35  63 100  96 114 112  77  47  78 110  26
 46  91 111  60   3  72  27 117  97  10  53
119  25  28 116  56  21 115 109  20  40  95
 59  90  31  87   6 102  33  92  16 108  62
 64 113  66  34  23  55  36  82 120  17  86
 67  61  65  30  24  57  81  84  22 105  93
