# This puzzle is unsolvable
76
   2    1    3    4    5    6    7    8    9   10   11   12   13   14   15   16   17   18   19   20   21   22   23   24   25   26   27   28   29   30   31   32   33   34   35   36   37   38   39   40   41   42   43   44   45   46   47   48   49   50   51   52   53   54   55   56   57   58   59   60   61   62   63   64   65   66   67   68   69   70   71   72   73   74   75   76
 300  301  302  303  304  305  306  307  308  309  310  311  312  313  314  315  316  317  318  319  320  321  322  323  324  325  326  327  328  329  330  331  332  333  334  335  336  337  338  339  340  341  342  343  344  345  346  347  348  349  350  351  352  353  354  355  356  357  358  359  360  361  362  363  364  365  366  367  368  369  370  371  372  373  374   77
 299  592  593  594  595  596  597  598  599  600  601  602  603  604  605  606  607  608  609  610  611  612  613  614  615  616  617  618  619  620  621  622  623  624  625  626  627  628  629  630  631  632  633  634  635  636  637  638  639  640  641  642  643  644  645  646  647  648  649  650  651  652  653  654  655  656  657  658  659  660  661  662  663  664  375   78
 298  591  876  877  878  879  880  881  882  883  884  885  886  887  888  889  890  891  892  893  894  895  896  897  898  899  900  901  902  903  904  905  906  907  908  909  910  911  912  913  914  915  916  917  918  919  920  921  922  923  924  925  926  927  928  929  930  931  932  933  934  935  936  937  938  939  940  941  942  943  944  945  946  665  376   79
 297  590  875 1152 1153 1154 1155 1156 1157 1158 1159 1160 1161 1163 1164 1165 1432 1166 1167 1168 1169 1170 1171 1172 1173 1174 1175 1176 1177 1178 1179 1180 1181 1182 1183 1184 1185 1186 1187 1188 1189 1190 1191 1192 1193 1194 1195 1196 1197 1198 1199 1200 1201 1202 1203 1204 1205 1206 1207 1208 1209 1210 1211 1212 1213 1214 1215 1216 1217 1218 1219 1220  947  666  377   80
 296  589  874 1151 1420 1421 1422 1423 1424 1425 1426 1427 1428 1162 1430 1431 1433 1692 1434 1435 1436 1437 1438 1439 1440 1441 1442 1443 1444 1445 1446 1447 1448 1449 1450 1451 1452 1453 1454 1455 1456 1457 1458 1459 1460 1461 1462 1463 1464 1465 1466 1467 1468 1469 1470 1471 1472 1473 1474 1475 1476 1477 1478 1479 1480 1481 1482 1483 1484 1485 1486 1221  948  667  378   81
 295  588  873 1150 1419 1680 1681 1682 1683 1684 1685 1686 1687 1429 1689 1690 1691 1693 1944 1694 1695 1696 1697 1698 1699 1700 1701 1702 1703 1704 1705 1706 1707 1708 1709 1710 1711 1712 1713 1714 1715 1716 1717 1718 1719 1720 1721 1722 1723 1724 1725 1726 1727 1728 1729 1730 1731 1732 1733 1734 1735 1736 1737 1738 1739 1740 1741 1742 1743 1744 1487 1222  949  668  379   82
 294  587  872 1149 1418 1679 1932 1933 1934 1935 1936 1937 2416 1688 1940 1941 1942 1943 2187 1945 1946 1947 1948 1949 1950 1951 1952 1953 1954 1955 1956 1957 1958 1959 1960 1961 1962 1963 1964 1965 1966 1967 1968 1969 1970 1971 1972 1973 1974 1975 1976 1977 1978 1979 1980 1981 1982 1983 1984 1985 1986 1987 1988 1989 1990 1991 1992 1993 1994 1745 1488 1223  950  669  380   83
 293  586  871 1148 1417 1678 1931 2176 2177 2178 2179 2181 2643 1938 1939 2183 2185 2186 2422 2188 2189 2190 2191 2192 2193 2194 2195 2196 2197 2198 2199 2200 2201 2202 2203 2204 2205 2206 2207 2208 2209 2210 2211 2212 2213 2214 2215 2216 2217 2218 2219 2220 2221 2222 2223 2224 2225 2226 2227 2228 2229 2230 2231 2232 2233 2234 2235 2236 1995 1746 1489 1224  951  670  381   84
 292  585  870 1147 1416 1677 1930 2175 2412 2413 2414 2180 2644 2418 2419 2184 2420 2648 2421 2423 2424 2425 2426 2427 2428 2429 2430 2431 2432 2433 2434 2435 2436 2437 2438 2439 2440 2441 2442 2443 2444 2445 2446 2447 2448 2449 2450 2451 2452 2453 2454 2455 2456 2457 2458 2459 2460 2461 2462 2463 2464 2465 2466 2467 2468 2469 2470 2237 1996 1747 1490 1225  952  671  382   85
 291  584  869 1146 1415 1676 1929 2174 2411 2640 2641 2415 2417 2182 2645 2646 2647 2649 2650 2869 2651 2652 2653 2654 2655 2656 2657 2658 2659 2660 2661 2662 2663 2664 2665 2666 2667 2668 2669 2670 2671 2672 2673 2674 2675 2676 2677 2678 2679 2680 2681 2682 2683 2684 2685 2686 2687 2688 2689 2690 2691 2692 2693 2694 2695 2696 2471 2238 1997 1748 1491 1226  953  672  383   86
 290  583  868 1145 1675 1928 1927 2173 2410 2639 2860 2862 2861 2863 3075 2864 2866 2867 2868 3080 2870 2871 2872 2873 2874 2875 2876 2877 2878 2879 2880 2881 2882 2883 2884 2885 2886 2887 2888 2889 2890 2891 2892 2893 2894 2895 2896 2897 2898 2899 2900 2901 2902 2903 2904 2905 2906 2907 2908 2909 2910 2911 2912 2913 2914 2697 2472 2239 1998 1749 1492 1227  954  673  384   87
 289  582  867 1144 1414 1413 1926 2172 2409 2638 2859 2642 3276 3072 3073 2865 3279 3281 3280 3079 3081 3082 3083 3084 3085 3086 3087 3088 3089 3090 3091 3092 3093 3094 3095 3096 3097 3098 3099 3100 3101 3102 3103 3104 3105 3106 3107 3108 3109 3110 3111 3112 3113 3114 3115 3116 3117 3118 3119 3120 3121 3122 3123 3124 2915 2698 2473 2240 1999 1750 1493 1228  955  674  385   88
 288  581  866 1143 1411 1674 2171 2407 2858 2170 2857 3070 3071 3277 3074 3278 3077 3076 3078 3283 3284 3285 3286 3287 3288 3289 3290 3291 3292 3293 3294 3295 3296 3297 3298 3299 3300 3301 3302 3303 3304 3305 3306 3307 3308 3309 3310 3311 3312 3313 3314 3315 3316 3317 3318 3319 3320 3321 3322 3323 3324 3325 3326 3125 2916 2699 2474 2241 2000 1751 1494 1229  956  675  386   89
 287  580  865 1142 1924 1412 1925 2168 1672 2637 2406 2856 3275 3472 3473 3474 3475 3477 3282 3478 3479 3480 3481 3482 3483 3484 3485 3486 3487 3488 3489 3490 3491 3492 3493 3494 3495 3496 3497 3498 3499 3500 3501 3502 3503 3504 3505 3506 3507 3508 3509 3510 3511 3512 3513 3514 3515 3516 3517 3518 3519 3520 3327 3126 2917 2700 2475 2242 2001 1752 1495 1230  957  676  387   90
 285  286  864 1410 1139 1141 2408 2632 1923 2635 2633 3069 3274 3471 3660 3661 3663 3476 3664 3665 3666 3667 3668 3669 3670 3671 3672 3673 3674 3675 3676 3677 3678 3679 3680 3681 3682 3683 3684 3685 3686 3687 3688 3689 3690 3691 3692 3693 3694 3695 3696 3697 3698 3699 3700 3701 3702 3703 3704 3705 3706 3521 3328 3127 2918 2701 2476 2243 2002 1753 1496 1231  958  677  388   91
 576  579  863 1140  577 1408 2636 2169 2404 1673 2405 3068 3273 3470 3659 3838 3662 3842 4013 3844 3845 3846 4018 3847 3848 3849 3850 3852 3853 3854 3855 3856 3857 3858 3859 3860 3861 3862 3863 3864 3865 3866 3867 3868 3869 3870 3871 3872 3873 3874 3875 3876 3877 3878 3879 3880 3881 3882 3883 3884 3707 3522 3329 3128 2919 2702 2477 2244 2003 1754 1497 1232  959  678  389   92
 575  578 1406 1669  859 1671 1409 2164 2403 2854 2855 3067 3272 3468 3469 3841 3840 3843 4014 4015 4016 4180 4017 4019 4020 4021 3851 4023 4024 4025 4026 4027 4028 4029 4030 4031 4032 4033 4034 4035 4036 4037 4038 4039 4040 4041 4042 4043 4044 4045 4046 4047 4048 4049 4050 4051 4052 4053 4054 3885 3708 3523 3330 3129 2920 2703 2478 2245 2004 1755 1498 1233  960  679  390   93
 574 1666  283 1138 1670 1922 2167 2630 2634 2852 2851 2853 3066 3270 3658 3839 4012 4176 4177 4333 4178 4179 4181 4182 4183 4184 4022 4186 4187 4188 4189 4190 4191 4192 4193 4194 4195 4196 4197 4198 4199 4200 4201 4202 4203 4204 4205 4206 4207 4208 4209 4210 4211 4212 4213 4214 4215 4216 4055 3886 3709 3524 3331 3130 2921 2704 2479 2246 2005 1756 1499 1234  961  680  391   94
 861  857 1134 1667 2400 2165 1921 1665 2166 2631 2850 3065 3467 3271 3657 4010 4011 4175 4331 4332 4334 4335 4336 4337 4338 4340 4185 4487 4341 4342 4344 4345 4346 4347 4348 4349 4350 4351 4352 4353 4354 4355 4356 4357 4358 4359 4360 4361 4362 4363 4364 4365 4366 4367 4368 4369 4370 4217 4056 3887 3710 3525 3332 3131 2922 2705 2480 2247 2006 1757 1500 1235  962  681  392   95
 281 1407 1405  284 1668 1918 1919 1920 2162 2402 2629 3064 3269 3655 3837 3656 3836 4009 4174 4480 4481 4482 4483 4484 4485 4339 4488 4629 4489 4343 4491 4492 4493 4494 4495 4496 4497 4498 4499 4500 4501 4502 4503 4504 4505 4506 4507 4508 4509 4510 4511 4512 4513 4514 4515 4516 4371 4218 4057 3888 3711 3526 3333 3132 2923 2706 2481 2248 2007 1758 1501 1236  963  682  393   96
 282  572 1136  858  862 1404 1137 2401 2399 2398 2848 3268 3267 3466 3654 3835 4008 4173 4330 4479 4620 4621 4622 4624 4625 4486 4626 4628 4758 4490 4630 4631 4632 4633 4634 4635 4636 4637 4638 4639 4640 4641 4642 4643 4644 4645 4646 4647 4648 4649 4650 4651 4652 4653 4654 4517 4372 4219 4058 3889 3712 3527 3334 3133 2924 2707 2482 2249 2008 1759 1502 1237  964  683  394   97
 280  279  860  573 1664 1916 2160 1917 2161 1914 3062 2849 3464 3465 3653 3834 4007 4172 4329 4478 4619 4751 4752 4623 4755 4879 4757 4627 4760 4883 4761 4762 4763 4764 4765 4766 4767 4768 4769 4770 4771 4772 4773 4774 4775 4776 4777 4778 4779 4780 4781 4782 4783 4784 4655 4518 4373 4220 4059 3890 3713 3528 3335 3134 2925 2708 2483 2250 2009 1760 1503 1238  965  684  395   98
 278  571  855 1400 1403 1135 2159 1915 2628 2163 3266 3063 3463 3652 3651 3833 4006 4171 4328 4477 4618 4753 4992 4754 4877 4878 4994 4756 4881 4759 4884 4885 4886 4887 4888 4889 4890 4891 4892 4893 4894 4895 4896 4897 4898 4899 4900 4901 4902 4903 4904 4905 4906 4785 4656 4519 4374 4221 4060 3891 3714 3529 3336 3135 2926 2709 2484 2251 2010 1761 1504 1239  966  685  396   99
 277  570  856 1663 1402 1662 1913 2394 1912 2626 2627 3061 3265 3461 3832 3831 4005 4170 4327 4476 4617 4750 4876 4991 4993 4995 4880 4997 4882 4998 4999 5000 5001 5002 5003 5004 5005 5006 5007 5008 5009 5010 5011 5012 5013 5014 5015 5016 5017 5018 5019 5020 4907 4786 4657 4520 4375 4222 4061 3892 3715 3530 3337 3136 2927 2710 2485 2252 2011 1762 1505 1240  967  686  397  100
 276  568 1132 1133 1661 1399 1911 2395 2397 2625 3060 2846 3264 3650 3462 3830 4004 4169 4326 4475 4616 4749 4875 4874 5100 5102 5200 4996 5104 5105 5106 5107 5108 5109 5110 5111 5112 5113 5114 5115 5116 5117 5118 5119 5120 5121 5122 5123 5124 5125 5126 5021 4908 4787 4658 4521 4376 4223 4062 3893 3716 3531 3338 3137 2928 2711 2486 2253 2012 1763 1506 1241  968  687  398  101
 275  853  569 1401 1129  854 1658 2396 2624 2845 2847 3059 3263 3648 3459 3649 4003 4168 4325 4474 4615 4748 4990 5099 5201 5098 5291 5103 5203 5204 5205 5206 5207 5208 5209 5210 5211 5212 5213 5214 5215 5216 5217 5218 5219 5220 5221 5222 5223 5224 5127 5022 4909 4788 4659 4522 4377 4224 4063 3894 3717 3532 3339 3138 2929 2712 2487 2254 2013 1764 1507 1242  969  688  399  102
1131  567  851  852 1398 2156    0 1660 2158 2623 2844 3058 3262 3458 3460 3829 4002 4167 4324 4473 4614 4747 4873 4989 5101 5292 5293 5202 5452 5294 5296 5297 5298 5299 5300 5301 5302 5303 5304 5305 5306 5307 5308 5309 5310 5311 5312 5313 5314 5225 5128 5023 4910 4789 4660 4523 4378 4225 4064 3895 3718 3533 3340 3139 2930 2713 2488 2255 2014 1765 1508 1243  970  689  400  103
 274  273 1130 1128 1396 1655 1910 2155 2157 2622 3056 3057 3260 3261 3647 3646 4001 4166 4323 4472 4613 4746 4872 4871 5097 5199 5290 5376 5377 5295 5379 5380 5381 5382 5383 5384 5385 5386 5387 5388 5389 5390 5391 5392 5393 5394 5395 5396 5315 5226 5129 5024 4911 4790 4661 4524 4379 4226 4065 3896 3719 3534 3341 3140 2931 2714 2489 2256 2015 1766 1509 1244  971  690  401  104
 565  566  850 1397 1127 2843 2393 1657 2619 2842 2841 3055 3259 3457 3827 3828 4000 4165 4322 4471 4612 4745 4870 4988 4987 5197 5198 5375 5453 5378 5454 5455 5456 5457 5458 5459 5460 5461 5462 5463 5464 5465 5466 5467 5468 5469 5470 5397 5316 5227 5130 5025 4912 4791 4662 4525 4380 4227 4066 3897 3720 3535 3342 3141 2932 2715 2490 2257 2016 1767 1510 1245  972  691  402  105
 272  271  564 1126 1395 1908 1659 2153 1909 2620 2840 3054 3258 3456 3645 3826 3999 4164 4470 4611 4610 4744 4869 4986 5096 5095 5289 5374 5451 5520 5521 5522 5523 5524 5525 5526 5527 5528 5529 5530 5531 5532 5533 5534 5535 5536 5471 5398 5317 5228 5131 5026 4913 4792 4663 4526 4381 4228 4067 3898 3721 3536 3343 3142 2933 2716 2491 2258 2017 1768 1511 1246  973  692  403  106
 270  563  849  848 1393 2154 1907 2152 2617 1656 2621 2838 3052 3455 3825 3643 3998 4163 4321 4469 4609 4743 4868 4985 5195 5196 5288 5373 5450 5519 5580 5581 5582 5583 5584 5585 5586 5587 5588 5589 5590 5591 5592 5593 5594 5537 5472 5399 5318 5229 5132 5027 4914 4793 4664 4527 4382 4229 4068 3899 3722 3537 3344 3143 2934 2717 2492 2259 2018 1769 1512 1247  974  693  404  107
 269  562  847 1125 1394 1906 1654 2389 2392 2391 3053 2839 3257 3454 3644 3824 3997 4162 4320 4468 4742 4867 4984 5093 5094 5194 5287 5372 5449 5518 5579 5632 5633 5634 5635 5636 5637 5638 5639 5640 5641 5642 5643 5644 5595 5538 5473 5400 5319 5230 5133 5028 4915 4794 4665 4528 4383 4230 4069 3900 3723 3538 3345 3144 2935 2718 2493 2260 2019 1770 1513 1248  975  694  405  108
 268  561  846 1124 1121 1392 2151 2390 2388 2615 2616 2837 3256 3453 3996 3822 4318 4161 4319 4465 4466 4741 4866 4983 5092 5193 5286 5371 5448 5517 5578 5631 5676 5677 5678 5679 5680 5681 5682 5683 5684 5685 5686 5645 5596 5539 5474 5401 5320 5231 5134 5029 4916 4795 4666 4529 4384 4231 4070 3901 3724 3539 3346 3145 2936 2719 2494 2261 2020 1771 1514 1249  976  695  406  109
 267  560 1122 1120 1123 1389 1391 1905 2150 2618 2386 3051 3255 3641 3642 3823 4160 4317 4467 4608 4607 4740 4864 4865 5091 5192 5285 5370 5447 5516 5577 5630 5675 5712 5713 5714 5715 5716 5717 5718 5719 5720 5687 5646 5597 5540 5475 5402 5321 5232 5135 5030 4917 4796 4667 4530 4385 4232 4071 3902 3725 3540 3347 3146 2937 2720 2495 2262 2021 1772 1515 1250  977  696  407  110
 266  842  559  845 1652 1653 1904 2148 2149 2387 2835 3050 3254 3452 3451 3640 4158 3994 3993 4464 4605 4738 4739 4982 4981 5191 5284 5369 5446 5515 5576 5629 5674 5711 5740 5741 5742 5743 5744 5745 5746 5721 5688 5647 5598 5541 5476 5403 5322 5233 5136 5031 4918 4797 4668 4531 4386 4233 4072 3903 3726 3541 3348 3147 2938 2721 2496 2263 2022 1773 1516 1251  978  697  408  111
 265  844  558  843 1390 1649 1651 1903 2385 2614 3048 2836 3450 3449 3639 3820 3818 4316 4159 4463 4606 4315 4863 4980 5090 5089 5283 5368 5445 5514 5575 5628 5673 5710 5739 5760 5772 5763 5775 5761 5747 5722 5689 5648 5599 5542 5477 5404 5323 5234 5137 5032 4919 4798 4669 4532 4387 4234 4073 3904 3727 3542 3349 3148 2939 2722 2497 2264 2023 1774 1517 1252  979  698  409  112
 556 1648 1119 1117 1388 2146 1900 1901 1902 2613 3047 3049 3252 3253 3821 3992 3995 4156 4604 4313 4462 4737 4862 4979 5088 5189 5281 5282 5444 5513 5574 5627 5672 5709 5738 5758 5770 5759 5765 5764 5748 5723 5690 5649 5600 5543 5478 5405 5324 5235 5138 5033 4920 4799 4670 4533 4388 4235 4074 3905 3728 3543 3350 3149 2940 2723 2498 2265 2024 1775 1518 1253  980  699  410  113
 841  557  264 1118  555 1647 2145 2382 2384 2612 2834 2833 3251 3448 3638 3819 3991 3990 4314 4860 4603 4734 4736 5087 5190 5188 5185 5512 5366 5573 5571 5626 5671 5708 5737 5771 5762 5774 5773 5766 5749 5724 5691 5650 5601 5544 5479 5406 5325 5236 5139 5034 4921 4800 4671 4534 4389 4236 4075 3906 3729 3544 3351 3150 2941 2724 2499 2266 2025 1776 1519 1254  981  700  411  114
 263  840  554 1387 1650 1646 1899 2383 2144 2381 2380 2832 3250 3636 3637 3817 3249 4312 4157 4311 4461 4735 4975 4861 5086 5280 5443 5367 5279 5440 5511 5625 5670 5707 5736 5757 5769 5754 5768 5752 5750 5725 5692 5651 5602 5545 5480 5407 5326 5237 5140 5035 4922 4801 4672 4535 4390 4237 4076 3907 3730 3545 3352 3151 2942 2725 2500 2267 2026 1777 1520 1255  982  701  412  115
 259  262 1116 1114 1386 2147 2143 2142 2609 3045 2611 3046 3044 3447 3446 3816 4155 4153 4154 4460 4602 4733 4977 5187 4978 4859 5186 5442 5365 5572 5510 5624 5669 5706 5735 5756 5755 5753 5730 5726 5767 5727 5693 5652 5603 5546 5481 5408 5327 5238 5141 5036 4923 4802 4673 4536 4391 4238 4077 3908 3731 3546 3353 3152 2943 2726 2501 2268 2027 1778 1521 1256  983  702  413  116
 261  837  836  553  838 1897 1385 2610 2608 2831 2830 3043 3248 3635 3989 3815 3988 4309 4152 4459 4601 4732 4976 5084 5085 5278 5363 5277 5364 5509 5570 5623 5668 5705 5734 5733 5732 5731 5699 5728 5751 5696 5694 5653 5604 5547 5482 5409 5328 5239 5142 5037 4924 4803 4674 4537 4392 4239 4078 3909 3732 3547 3354 3153 2944 2727 2502 2269 2028 1779 1522 1257  984  703  414  117
 839  260  551 1112 1645 1115 1898 1644 2378 2607 2829 3042 3247 3634 3632 3633 3814 3987 4310 4458 4600 4857 4858 4974 5083 5184 5441 5439 5362 5508 5569 5622 5667 5704 5703 5702 5701 5700 5698 5729 5697 5657 5695 5654 5605 5548 5483 5410 5329 5240 5143 5038 4925 4804 4675 4538 4393 4240 4079 3910 3733 3548 3355 3154 2945 2728 2503 2270 2029 1780 1523 1258  985  704  415  118
 258  552  835 1383 1384 1642 1896 2141 1641 2140 2606 2828 2379 3445 3443 3813 3986 4151 4308 4457 4599 4730 4856 4973 5082 5183 5276 5361 5438 5507 5568 5621 5666 5665 5664 5663 5662 5661 5660 5659 5658 5656 5655 5608 5606 5549 5484 5411 5330 5241 5144 5039 4926 4805 4676 4539 4394 4241 4080 3911 3734 3549 3356 3155 2946 2729 2504 2271 2030 1781 1524 1259  986  705  416  119
 257  550 1379 1113 1643 1892 1895 2826 2605 2139 2827 3040 3444 3041 3812 3985 4150 4456 4597 4598 4731 4855 4854 4972 5081 5182 5275 5360 5437 5506 5567 5620 5619 5618 5617 5616 5615 5614 5613 5612 5611 5610 5609 5553 5607 5550 5485 5412 5331 5242 5145 5040 4927 4806 4677 4540 4395 4242 4081 3912 3735 3550 3357 3156 2947 2730 2505 2272 2031 1782 1525 1260  987  706  417  120
 256  549 1111  833 1382 1381 1109 2370 3436 1893 3245 3631 3441 3630 3442 3984 3438 4304 4596 4307 4594 4728 4729 4971 5080 5181 5274 5359 5436 5505 5566 5565 5564 5563 5562 5561 5560 5559 5558 5557 5556 5555 5554 5488 5490 5552 5489 5486 5332 5243 5146 5041 4928 4807 4678 4541 4396 4243 4082 3913 3736 3551 3358 3157 2948 2731 2506 2273 2032 1783 1526 1261  988  707  418  121
 255  548 1894  832 2137 2138 1639 2373 2604 3039 3243 3246 3244 2825 3809 3810 3983 4306 4149 4305 4455 4595 4852 4853 5079 4970 5273 5358 5435 5504 5503 5502 5501 5500 5499 5498 5497 5496 5495 5494 5493 5492 5491 5418 5339 5417 5551 5413 5333 5244 5147 5042 4929 4808 4679 4542 4397 4244 4083 3914 3737 3552 3359 3158 2949 2732 2507 2274 2033 1784 1527 1262  989  708  419  122
 547  253  834 1110 1380 3440 1890 1638 2603 2377 2824 3239 3629 3980 3628 3807 3982 4148 3811 4454 4969 5078 4727 4968 5178 5180 5179 5357 5434 5433 5432 5431 5430 5429 5428 5427 5426 5425 5424 5423 5422 5421 5420 5419 5338 5415 5487 5414 5334 5245 5148 5043 4930 4809 4680 4543 4398 4245 4084 3915 3738 3553 3360 3159 2950 2733 2508 2275 2034 1785 1528 1263  990  709  420  123
 545  830 1376 1108 1888 2376 1891 2600 2602 3038 2821 2822 3437 3037 3626 4147 3808 4146 4303 4452 4453 4726 4850 4851 5077 4967 5272 5356 5355 5354 5353 5352 5351 5350 5349 5348 5347 5346 5345 5344 5343 5342 5341 5340 5252 5416 5337 5336 5335 5246 5149 5044 4931 4810 4681 4544 4399 4246 4085 3916 3739 3554 3361 3160 2951 2734 2509 2276 2035 1786 1529 1264  991  710  421  124
 546  254 1107  544 2371 1377 1374 2136 2820 2375 3035 3435 3242 3033 3439 3625 3981 3979 4301 4302 4593 4592 4725 4966 5076 5177 5271 5269 5268 5267 5266 5265 5264 5263 5262 5261 5260 5259 5258 5257 5256 5255 5254 5156 5157 5250 5155 5249 5248 5247 5150 5045 4932 4811 4682 4545 4400 4247 4086 3917 3740 3555 3362 3161 2952 2735 2510 2277 2036 1787 1530 1265  992  711  422  125
 831 1889 1105 2134 1378 1373 2374 3036 2133 2372 3032 3028 3241 3034 2823 3240 3806 4145 4451 4299 4450 4724 4849 4965 5176 5073 5270 5174 5173 5172 5171 5170 5169 5168 5167 5166 5165 5164 5163 5162 5161 5160 5159 5253 5054 5251 5154 5153 5152 5049 5151 5046 4933 4812 4683 4546 4401 4248 4087 3918 3741 3556 3363 3162 2953 2736 2511 2278 2037 1788 1531 1266  993  712  423  126
 543  827  251 1106 1640 1635 1636 2132 2599 2818 3238 3235 3236 3237 3627 4142 3978 4144 4300 4590 4446 4723 4848 5074 5075 4961 5175 5071 5070 5069 5068 5067 5066 5065 5064 5063 5062 5061 5060 5059 5058 5057 5056 5158 5055 5053 5052 5051 5050 4938 5048 5047 4934 4813 4684 4547 4402 4249 4088 3919 3742 3557 3364 3163 2954 2737 2512 2279 2038 1789 1532 1267  994  713  424  127
 252  249  829 1104 1375 2601 1633 1634 2367 2815 1637 3029 3433 3434 3804 3976 4143 4298 4449 4448 4591 4722 4847 4964 4963 4842 5072 4960 4959 4958 4957 4956 4955 4954 4953 4952 4951 4950 4949 4948 4947 4946 4945 4944 4943 4942 4941 4940 4939 4819 4937 4936 4935 4814 4685 4548 4403 4250 4089 3920 3743 3558 3365 3164 2955 2738 2513 2280 2039 1790 1533 1268  995  714  425  128
 248  541 1103  826  539 1372 1632 2131 2135 1885 2598 3031 3624 3623 3801 3975 3805 4140 4588 4447 4297 4721 4846 4845 4844 4962 4716 4841 4840 4839 4838 4837 4836 4835 4834 4833 4832 4831 4830 4829 4828 4827 4826 4825 4824 4823 4822 4821 4820 4692 4818 4817 4816 4815 4686 4549 4404 4251 4090 3921 3744 3559 3366 3165 2956 2739 2514 2281 2040 1791 1534 1269  996  715  426  129
 247  542  828  250 1370 1631 1887 2130 2597 2596 1886 3030 3233 3621 3622 3800 4139 3803 4445 4443 4589 4720 4587 4719 4718 4843 4715 4714 4713 4712 4711 4710 4709 4708 4707 4706 4705 4704 4703 4702 4701 4700 4699 4698 4697 4696 4695 4694 4693 4691 4556 4690 4689 4688 4687 4550 4405 4252 4091 3922 3745 3560 3367 3166 2957 2740 2515 2282 2041 1792 1535 1270  997  716  427  130
 245  825  823 1371 1099 1101 1100 2369 1630 1883 2368 2817 3432 2819 3234 4138 3973 4296 3977 4291 4444 4442 4585 4441 4717 4584 4580 4579 4578 4577 4576 4575 4574 4573 4572 4571 4570 4569 4568 4567 4566 4565 4564 4563 4562 4561 4560 4559 4558 4557 4555 4412 4554 4553 4552 4551 4406 4253 4092 3923 3746 3561 3368 3167 2958 2741 2516 2283 2042 1793 1536 1271  998  717  428  131
 824  822 1102  540  243 2365 2126 1882 2595 2128 2366 3429 3619 3430 3802 3431 3620 4141 3974 4586 4290 4439 4582 4583 4129 4581 4438 4436 4435 4434 4433 4432 4431 4430 4429 4428 4427 4426 4425 4424 4423 4422 4421 4420 4419 4418 4417 4416 4415 4414 4413 4411 4410 4259 4409 4408 4407 4254 4093 3924 3747 3562 3369 3168 2959 2742 2517 2284 2043 1794 1537 1272  999  718  429  132
 534  538  537  820 1369 2362 2125 1881 2129 1884 3024 3027 3232 3799 3428 3798 4294 4137 4295 4135 4293 4132 4289 4440 4130 4287 4437 4285 4284 4283 4282 4281 4280 4279 4278 4277 4276 4275 4274 4273 4272 4271 4270 4269 4268 4267 4266 4265 4264 4263 4262 4261 4260 4100 4258 4257 4256 4255 4094 3925 3748 3563 3370 3169 2960 2743 2518 2285 2044 1795 1538 1273 1000  719  430  133
1368  246  242  536 1629 1367 2816 2593 2123 2364 2814 2594 3617 3618 3426 3970 3972 4136 4134 3967 4133 3965 4131 4288 3962 4128 4286 4126 4125 4124 4123 4122 4121 4120 4119 4118 4117 4116 4115 4114 4113 4112 4111 4110 4109 4108 4107 4106 4105 4104 4103 4102 4101 3933 3756 4099 3930 4098 4095 3926 3749 3564 3371 3170 2961 2744 2519 2286 2045 1796 1539 1274 1001  720  431  134
 244  535  819 1365 1098 1626 1364 2124 2363 2127 3026 2812 2813 3231 3616 3971 3796 3969 3968 3792 4292 3966 3964 3963 3961 3960 4127 3959 3958 3957 3956 3955 3954 3953 3952 3951 3950 3949 3948 3947 3946 3945 3944 3943 3942 3941 3940 3939 3938 3937 3936 3759 3760 3934 4097 3757 3929 4096 3928 3927 3750 3565 3372 3171 2962 2745 2520 2287 2046 1797 1540 1275 1002  721  432  135
 821  533  818  241 1097 1627 1628 1880 2591 3025 2592 2811 3230 3229 3427 3615 3797 3794 3610 3793 3791 3790 3789 3788 3787 3786 3785 3784 3783 3782 3781 3780 3779 3778 3777 3776 3775 3774 3773 3772 3771 3770 3769 3768 3767 3766 3765 3764 3763 3579 3762 3761 3935 3932 3758 3931 3755 3754 3753 3752 3751 3566 3373 3172 2963 2746 2521 2288 2047 1798 1541 1276 1003  722  433  136
 240  817 1363 1094 1096 1877 2121 2361 2360 2589 2810 3023 3228 3425 3614 3421 3795 3612 3611 3609 3608 3607 3606 3605 3604 3603 3602 3601 3600 3599 3598 3597 3596 3595 3594 3593 3592 3591 3590 3589 3588 3587 3586 3585 3584 3583 3582 3581 3580 3578 3387 3577 3576 3384 3574 3573 3572 3571 3570 3569 3568 3567 3374 3173 2964 2747 2522 2289 2048 1799 1542 1277 1004  723  434  137
 238  239  531 1362 1095 1879 1366 2590 2588 2587 2809 3022 3227 3424 3423 3613 3422 3420 3419 3418 3417 3416 3415 3414 3413 3412 3411 3410 3409 3408 3407 3406 3405 3404 3403 3402 3401 3400 3399 3398 3397 3396 3394 3195 3393 3193 3392 3390 3190 3389 3388 3386 3575 3385 3383 3382 3381 3380 3379 3378 3377 3376 3375 3174 2965 2748 2523 2290 2049 1800 1543 1278 1005  724  435  138
 237  532  530 1875 1624 1623 1621 1876 2358 2359 2808 3021 3226 3225 3224 3223 3222 3221 3220 3219 3218 3217 3216 3215 3214 3213 3212 3211 3210 3209 3208 3207 3206 3205 3204 3203 3202 3201 3200 3199 3198 3197 3395 2989 3194 2986 3391 3192 3191 3189 3188 3187 3186 3185 3184 3183 3182 3181 3180 3179 3178 3177 3176 3175 2966 2749 2524 2291 2050 1801 1544 1279 1006  725  436  139
 236  815  816 1361 1622 1878 2119 2120 2118 2586 2807 3020 3019 3018 3017 3016 3015 3014 3013 3012 2795 3011 3009 3008 3007 3006 3005 3004 3003 3002 3001 3000 2999 2998 2997 2996 2995 2994 2993 2992 2991 2990 2774 3196 2988 2987 2985 2984 2768 2982 2765 2767 2979 2978 2977 2976 2975 2974 2973 2972 2971 2970 2969 2968 2967 2750 2525 2292 2051 1802 1545 1280 1007  726  437  140
 528  235 1090 1360 1874 1625 2122 2356 2357 2585 2806 2805 2804 2803 2802 2801 2800 2799 2798 2797 2796 3010 2794 2793 2792 2791 2790 2789 2788 2787 2786 2785 2784 2783 2782 2781 2780 2325 2779 2777 2776 2552 2775 2773 2772 2771 2770 2983 2312 2769 2766 2980 2764 2763 2762 2761 2760 2759 2758 2757 2756 2755 2754 2753 2752 2751 2526 2293 2052 1803 1546 1281 1008  727  438  141
 814  529 1093 1358 1091 1088 1359 1873 1619 2584 2583 2582 2581 2580 2579 2578 2577 2576 2575 2574 2572 2341 2340 2571 2569 2568 2567 2566 2565 2564 2563 2562 2561 2560 2559 2558 2557 2555 2778 2554 2553 2321 2551 2550 2549 2548 2547 2315 2545 2544 2981 2542 2541 2540 2539 2538 2537 2536 2535 2534 2533 2532 2531 2530 2529 2528 2527 2294 2053 1804 1547 1282 1009  728  439  142
 527 1089  813 1092 1620  234 1617 2354 1871 1866 2353 2112 2351 2110 2349 2348 2347 2346 2344 2343 2342 2573 2339 2570 2338 2337 2336 2335 2333 2094 2332 2331 2330 2328 2089 2327 2326 2086 2556 2323 2322 2082 2320 2319 2318 2317 2316 2546 2313 2074 2543 2311 2310 2309 2308 2307 2306 2305 2304 2303 2302 2301 2300 2299 2298 2297 2296 2295 2054 1805 1548 1283 1010  729  440  143
 810  525  232 1356  812 1870 1618 1872 2355 2115 2352 2114 2113 1863 2109 2108 2107 2345 2106 2104 2103 2102 2100 2099 1852 2098 1849 1850 2096 1846 2334 2092 2091 1842 2090 2087 1841 1320 2324 2084 2083 2081 2080 2079 1832 2078 2076 2314 2075 2073 1826 2072 2071 2070 2069 2068 2067 2066 2065 2064 2063 2062 2061 2060 2059 2058 2057 2056 2055 1806 1549 1284 1011  730  441  144
 524  526 1087  811 1357 1869 2116 2117 1868 1611 1867 1865 2350 1864 1862 1861 1860 1859 2105 1858 1857 1336 2101 1854 1597 1851 2097 2095 1847  777 1593 1845 1844 1586 1587 1324 2088 2329 2085 1838 1836 1835 1579 1834 1833 1830 2077 1829 1828 1572 1827 1825 1824 1823 1822 1821 1820 1819 1818 1817 1816 1815 1814 1813 1812 1811 1810 1809 1808 1807 1550 1285 1012  731  442  145
 809  233 1085 1083 1355 1616 1615 1614 1613 1612 1610 1609 2111 1346 1608 1606 1605 1603 1338 1601 1855 1856 1600 1853 1598 1596 1595 1594 1848 2093 1592 1329 1591 1588 1843 1325 1585 1319 1839 1837 1581 1580 1316 1578 1831 1577 1576 1574 1573 1309 1571 1570 1569 1568 1567 1566 1565 1564 1563 1562 1561 1560 1559 1558 1557 1556 1555 1554 1553 1552 1551 1286 1013  732  443  146
 231  523  808 1354 1353 1086 1352 1351 1350 1349 1348 1347 1075 1345 1607 1343 1071 1604 1341 1340 1066 1339 1335 1064 1334 1333 1332  781 1060 1330 1057 1056 1590 1054 1326 1322 1840 1584 1583 1582 1318 1317 1315 1044 1314 1313 1575 1312 1310 1038 1308 1306 1035 1305 1304 1303 1302 1301 1300 1299 1298 1297 1296 1295 1294 1293 1292 1291 1290 1289 1288 1287 1014  733  444  147
 230  521  522  807 1084 1082 1081 1080 1079 1078 1077 1076  796 1073 1344 1072 1070 1342 1069 1602 1068 1599 1337 1065 1063 1062  495 1061 1331 1059 1058 1327  489 1589 1053  776 1051 1321 1049 1048 1047 1046  766 1045 1043 1042 1041 1311 1040  759  757 1037 1307 1034 1033 1032 1031 1030 1029 1028 1027 1026 1025 1024 1023 1022 1021 1020 1019 1018 1017 1016 1015  734  445  148
 229  520  806  805  804  803  802  801  800  799  798  797  795 1074  794  793  792  791  790  789 1067  787  786  785  784  783  782  493  780  779 1328  778 1055 1052  486 1323  772 1050  771  769  768  767  479  765  764  763  762  761 1039  760  758 1036  756  755  754  753  752  751  750  749  748  747  746  745  744  743  742  741  740  739  738  737  736  735  446  149
 228  225  519  518  517  516  515  514  513  512  511  510  509  508  507  506  505  504  503  502  788  500  499  498  497  496  199  200  492  491  196  488  192  775  773  774  485  484  770  483  481  480  183  184  478  476  475  474  473  472  471  470  469  468  467  466  465  464  463  462  461  460  459  458  457  456  455  454  453  452  451  450  449  448  447  150
 227  226  224  223  222  221  220  219  218  217  216  215  214  213  212  211  210  209  208  207  501  206  205  204  203  202  201  494  198  197  490  195  193  194  487  191  190  189  188  482  187  186  185  182  477  181  180  179  178  177  176  175  174  173  172  171  170  169  168  167  166  165  164  163  162  161  160  159  158  157  156  155  154  153  152  151
