# This puzzle is unsolvable
15
  5 103 143 202   2   4 183 113 104  65 115  11 154  14  13
 56 197  61   1  57 107   8 108  17 116  67 114  20  69  15
 54  53  55 112 165 200  10 110  66 220 204 181 157  19 122
101  59 216  60 106  64   9  68 150  63 109 153 218  62  26
178  47 105   3 198 179 177 192 185 151 161 203  23 158  74
171 163 102   6 141 199 222  72   7 121  75  70  22 117 219
 52 100 148 147  94 176  58 182  71  32 156 137 159 162 119
172 139 144 194 155  89 111  51 184 146  77 152  21  73 186
 49  99 223 145  91 187 190 224 214 149  25  16 120  18 118
135  50 131 180  97   0 221 201 215 127 206  81 189  76  12
 96 140  95 175 136 166  87 193 212 210 129 217  24 188 126
 90  42 170 133 213 130  44 142 173 211  28 128 209 160  80
195 196  93  37  88  38  30 167 168  98 138 205  84 125  79
 40  48  92  34 169  41 132 207 123 191 164  78 124  31 208
 45  46 134  43  33  36  39  35 174  83  86  85  27  82  29
