# This puzzle is unsolvable
23
 88   1 242   5  89  86 173  95 174 313  99 249 100 180 181  18 182 104 105  17 110 109  23
  2 167 235  92   4   7 243  96 247  10 248  11 176  13 183  15 102 255 184  19 107  22  24
170   3  91 241 305 175  94 172 411   8   9 250 251 179  14  16 178  21 108 185  20  26  27
304  87 166 171   6 408 362 177  12 307 505 309 369  98 252 101 254 318 106 186  25 187 112
169 303  90 240  84 306 409 359 308 244 310 412 246 315 419 253 316 371 256 111 259 320  30
164 168  93  83 236 239 448 451 452 450  97 311 368 370 103 314 317 319 373 258  28 257 189
 80 361 358 301 302 357 504 364 367 366 413 312 454 416 417 418 372 457 376 374 192 113 188
237 360  85 234 405 410 479 365 407 482 406 502 414 421 455 415 261 378 321 262 260  29 193
158 238 163 162 300 447 449 518 356 245 522 485 484 524 420 456 377 488 322 114 323 190 191
 82  78  81 160 299 355 445 477 507 363 515 453 509 508 422 375 263 195 265 264 116  31 115
165 232 297 354 230 478 298 480 481 511 483 512 459 506 486 460 458 117 266 325 194 324  36
229 233 231 296 475 404 403 519 446 526 503 427 380 424 462 523 426 381 121 328  35 196  33
161  79 228  77 295 444 501 500 513 520 521 498 487 527 510 525 463 461 331 379  34  32 119
293  75 159 294 396 472 499 441 476 517 466 490 434 528 495 433 493 122 327 197 118 199 198
402 156 353 350 400 351 352 473 497 390   0 468 467 514 465 489 425 329 382 123 326  39 268
 76 223 348 292 442 401 395 516 440 435 387 494 429 389 211 385 200 431 271 267 270 120 269
 74 290 443 227 349 226 392 471 436 393 491 391 496 492 428 423 384 330 335 332 202  38 128
291 289  73 155 224 437 399 386 394 143 340  50 341 282 210 337 275 276 432 201 209 273  37
154 148 153 346 397 439 225 344 347 284 342 136 474 281 336 135 334 278 272 333 203  41 127
150 151  70 157 152 398 343  60 438 470 286  57 140 339  52 469 338 279 430 124 204 125  43
 71  68 221  72 222 146 219 345 218 214 215 464 285  59 383 131  54 207 274  48 206  40  44
149 147 220 288  63  69 145 144 280  56 141 212  53 139 133 138 132 277 388  46 126  42 130
 67  66  65 287  64  62  61 142 216 217 283  58  55 213 137  51  49 208 134 129  47  45 205
