# This puzzle is unsolvable
63
   2    1    3    4    5    6    7    8    9   10   11   12   13   14   15   16   17   18   19   20   21   22   23   24  272   25   27   28  276   29   30   32   33  280   35   36   37   38   39   40   41  289  531  292   42  291  534  294   49   50   51   52   53   54   55   56   57   58   59   60   61   62   63
 248  249  250  251  252  253  254  255  256  257  258  259  260  261  262  263  264  265  266  267  268  269  270  273  510   26  274  275   31  278  279  518  281   34  283  523  522  284  286  527  288  290  529  764   46   48   45  295  296  297  298  299  300  301  302  303  304  305  306  307  308  309   64
 247  488  489  490  491  492  493  494  495  496  497  498  499  500  501  502  503  504  505  506  507  508  509  271  511  513  512  514  277  516  748  519  521  750  753  524  285  755  525  287  526  528  761   44   43  985  293  763   47  766  537  538  539  540  541  542  543  544  545  546  547  310   65
 246  487  720  721  722  723  724  725  726  727  728  729  730  731  732  733  734  735  736  737  738  739  740  741  742  743  744  745  746  515  747 1187  517  974  520  975  754  977  756  757  759  981  760  530  762  532  765  533  988  536  768  769  770  771  772  773  774  775  776  777  548  311   66
 245  486  719  944  945  946  947  948  949  950  951  952  953  954  955  956  957  958  959  960  961  962  963  964  965  966  967  969  970 1185  749  973  751 1189  976  972 1190 1789  978 1196 1195  982 1198  983  984  986  987  535 1204  767  991  992  993  994  995  996  997  998  999  778  549  312   67
 244  485  718  943 1160 1161 1162 1163 1164 1165 1166 1167 1168 1169 1170 1171 1172 1173 1174 1175 1176 1177 1178 1179 1180 1181 1182 1183  968 1391 1393 1186 1593 1596  282 1396  752 1193 1194 1402  758  980 1197 1199 1200  989 1202 1410 1203  990 1206 1207 1208 1209 1210 1211 1212 1213 1000  779  550  313   68
 243  484  717  942 1159 1368 1369 1370 1371 1372 1373 1374 1375 1376 1377 1378 1379 1380 1381 1382 1383 1384 1385 1386 1387 1388 1389 1184 1390 1392 1591 1394  971 1595 1399 1395 1401 1192  979 1601 1403 1795 1405 1407 1606 1201 1406 1609 1411 1205 1412 1612 1415 1416 1417 1418 1419 1214 1001  780  551  314   69
 242  483  716  941 1158 1367 1568 1569 1570 1571 1572 1573 1574 1575 1576 1577 1578 1579 1580 1581 1582 1583 1584 1585 1586 1587 1779 2136 1588 1590 1592 1966 1788 1970 1397 1597 1191 1400 1600 1794 1602 2152 1977 1404 1408 1607 1409 1800 1610 1414 1803 1413 1613 1615 1616 1617 1420 1215 1002  781  552  315   70
 241  482  715  940 1364 1157 1567 1760 1761 1762 1763 1764 1765 1766 1767 1768 1769 1770 1771 1772 1773 1774 1775 1960 1962 1963 1589 1782 1965 1781 1784 1785 2146 2142 1594 1786 1598 1599 1975 1791 1792 1603 2153 1604 1978 1797 1608 1983 2157 1802 1805 1614 1988 1806 1807 1618 1421 1216 1003  782  553  316   71
 240  481  714  939 1365 1366 1566 1759 1944 1945 1946 1947 1948 1949 1950 1951 1952 1953 1954 1955 1956 1957 1959 1776 1778 2300 2304 2138 1783 2140 2141 2309 1972 1188 1969 1790 1398 2312 1973 2477 2317 2318 1976 1605 1979 1799 2158 2325 1611 1984 1986 1804 2162 1989 1808 1619 1422 1217 1004  783  554  317   72
 239  480  713 1155 1154 1156 1565 1758 1943 2120 2121 2122 2123 2124 2125 2126 2127 2128 2129 2130 2131 2132 2301 2134 1780 2303 1961 2305 1964 2306 2469 2143 1967 2310 1787 2313 2147 1971 1793 2149 2316 2320 2155 2322 1796 1981 1798 1982 2159 1801 1985 2161 1987 1990 1809 1620 1423 1218 1005  784  555  318   73
 238  712  937  936  938 1363 1564 1757 1942 2119 2288 2289 2290 2291 2292 2293 2294 2295 2297 2456 2298 2299 2459 1958 2135 2460 2463 2137 2464 2466 2308 2467 2468 2145 2311 2144 2473 2315 2148 2478 2151 2321 2154 2156 1980 2483 2323 2635 2326 2160 2328 2329 2163 1991 1810 1621 1424 1219 1006  785  556  319   74
 478  479  711  935 1153 1362 1563 1756 1941 2118 2287 2448 2449 2450 2451 2452 2453 2454 2296 2607 2457 2610 2458 2133 2615 2754 2757 2307 2139 2614 2618 1968 2619 2471 2470 2314 2472 2626 1974 2150 2479 2476 2774 2480 2482 2324 2484 2485 2486 2327 2330 2165 2164 1992 1811 1622 1425 1220 1007  786  557  320   75
 237  236  477 1152 1361 1151 1562 1755 1940 2117 2286 2447 2600 2601 2602 2603 2604 2606 2749 2608 2609 2753 1777 2612 2611 2462 2755 2893 2613 2616 2620 2761 2763 2621 2622 2766 2624 2474 2770 2475 2627 2319 2773 2630 2481 2632 2634 2778 2636 2488 2487 2331 2166 1993 1812 1623 1426 1221 1008  787  558  321   76
 235  476  710  709 1150  934 1561 1754 1939 2116 2285 2446 2599 2744 2745 2746 2747 2605 2750 2455 2751 2888 2752 2889 2302 2756 2758 2894 2759 2465 2896 2617 2762 2900 2623 2767 2768 2625 2769 2904 2628 2629 2908 2631 2775 2633 2777 2779 2638 2637 2489 2332 2167 1994 1813 1624 1427 1222 1009  788  559  322   77
 234  475  708  933 1360 1359 1752 1560 1753 2115 2284 2445 2598 2743 2880 2881 2882 2748 2884 2885 2886 2887 3135 2461 3020 2891 3021 2892 2760 3141 3024 3023 3026 2897 2765 2901 3028 2902 2903 2771 2906 2907 2772 2909 2910 2776 2912 2913 2780 2639 2490 2333 2168 1995 1814 1625 1428 1223 1010  789  560  323   78
 233  474  707  932 1149 1358 1559 1937 1938 2114 2283 2444 2597 2742 2879 3008 3009 2883 3010 3011 3014 3132 3015 3136 2890 3017 3137 3022 3140 3251 3143 2895 2899 2898 2764 3147 3029 3032 3031 2905 3034 3153 3035 3036 3037 2911 3039 2914 2781 2640 2491 2334 2169 1996 1815 1626 1429 1224 1011  790  561  324   79
 232  473  706  931 1148 1357 1751 1750 1936 2113 2282 2443 2596 2741 2878 3007 3128 3129 3012 3131 3013 3134 3244 3133 3016 3350 3018 3250 3354 3139 3025 3255 3145 3256 3027 3258 3261 3030 3033 3152 3263 3154 3368 3156 3157 3038 3040 2915 2782 2641 2492 2335 2170 1997 1816 1627 1430 1225 1012  791  562  325   80
 231  472  705  930 1147 1356 1558 1935 2112 2111 2281 2442 2595 2740 2877 3006 3127 3240 3130 3241 3242 3347 3442 3245 3247 3019 3138 3249 3253 3355 3142 3144 3358 3146 3360 3148 3259 3150 3260 3151 3262 3265 3159 3266 3158 3042 3041 2916 2783 2642 2493 2336 2171 1998 1817 1628 1431 1226 1013  792  563  326   81
 230  471  704  929 1146 1354 1557 1556 1934 2110 2280 2441 2594 2739 2876 3005 3126 3239 3344 3345 3243 3346 3348 3246 3446 3349 3351 3352 3353 3451 3538 3356 3254 3359 3257 3454 3363 3149 3365 3370 3264 3549 3369 3155 3267 3160 2917 2918 2784 2643 2494 2337 2172 1999 1818 1629 1432 1227 1014  793  564  327   82
 229  470  703  927  928 1555 1355 1932 1933 2109 2279 2440 2593 2738 2875 3004 3125 3238 3343 3440 3443 3528 3444 3531 3445 3248 3447 3448 3449 3450 3252 3357 3452 3541 3361 3455 3456 3362 3460 3367 3462 3625 3547 3268 3272 3269 3043 2785 2786 2644 2495 2338 2173 2000 1819 1630 1433 1228 1015  794  565  328   83
 228  469  702 1145 1353 1143 1747 1749 1748 2108 2278 2439 2592 2737 2874 3003 3124 3237 3342 3439 3441 3608 3529 3530 3532 3533 3534 3535 3616 3615 3537 3539 3453 3620 3543 3544 3623 3459 3545 3364 3366 3461 3463 3550 3271 3371 3044 2919 2787 2645 2496 2339 2174 2001 1820 1631 1434 1229 1016  795  566  329   84
 227  468  701  926 1144 1553 1554 1552 1930 1931 2277 2438 2591 2736 2873 3002 3123 3236 3341 3438 3527 3607 3609 3681 3610 3612 3613 3614 3536 3687 3617 3618 3540 3619 3542 3622 3624 3458 3457 3696 3546 3464 3548 3697 3048 3161 3162 3045 2920 2646 2497 2340 2175 2002 1821 1632 1435 1230 1017  796  567  330   85
 226  467  700  925 1142 1743 1351 1745 1746 2107 2276 2437 2590 2735 2872 3001 3122 3235 3340 3437 3526 3606 3680 3745 3611 3683 3684 3685 3686 3751 3750 3689 3690 3692 3621 3693 3694 3695 3628 3698 3626 3627 3466 3373 3270 3372 3164 3046 2923 2647 2498 2341 2176 2003 1822 1633 1436 1231 1018  797  568  331   86
 225  466  699  924 1141 1352 1550 1551 1929 2106 2275 2436 2589 2734 2871 3000 3121 3234 3339 3436 3525 3679 3744 3682 3800 3746 3747 3748 3749 3805 3688 3752 3691 3754 3755 3756 3757 3758 3761 3760 3629 3554 3553 3551 3465 3047 2922 2788 3168 2648 2499 2342 2177 2004 1823 1634 1437 1232 1019  798  569  332   87
 224  465  698  923 1140 1350 1549 1744 1928 2105 2274 2435 2588 2870 2732 2999 3120 3233 3231 3338 3435 3524 3604 3678 3743 3847 3849 3802 3803 3804 3806 3809 3753 3810 3857 3811 3812 3759 3813 3699 3552 3467 3468 3273 3374 3163 2921 2790 2789 2649 2500 2343 2178 2005 1824 1635 1438 1233 1020  799  570  333   88
 223  464  697  922 1139 1349 1742 1548 1927 2104 2273 2434 2587 2731 2733 2998 3119 3336 3433 3434 3523 3603 3605 3742 3801 3799 3848 3850 3851 3852 3854 3808 3856 3895 3896 3859 3815 3814 3762 3700 3469 3375 3165 3167 3166 3275 3049 2924 2791 2650 2501 2344 2179 2006 1825 1636 1439 1234 1021  800  571  334   89
 222  463  696  921 1138 1348 1547 1347 1925 1926 2103 2433 2585 2586 2869 2868 2997 3232 3337 3522 3676 3677 3741 3740 3888 3797 3887 3890 3892 3853 3855 3807 3894 3926 3897 3858 3763 3861 3701 3633 3630 3377 3472 3376 3274 3050 2925 2926 2792 2651 2502 2345 2180 2007 1826 1637 1440 1235 1022  801  572  335   90
 221  462  695  920 1137 1345 1346 1741 1924 2102 2272 2271 2432 2730 2996 3117 3118 3230 3335 3432 3520 3521 3675 3739 3798 3846 3920 3889 3921 3891 3923 3893 3924 3948 3899 3927 3862 3860 3702 3471 3631 3632 3557 3279 3276 3277 3278 2927 2793 2652 2503 2346 2181 2008 1827 1638 1441 1236 1023  802  573  336   91
 220  461  694  919 1136 1344 1546 1740 1738 2101 2270 2431 2584 2729 2867 2866 3116 3229 3333 3334 3431 3602 3673 3674 3796 3845 3886 3919 3944 3946 3947 3962 3928 3929 3933 3898 3816 3703 3817 3558 3470 3474 3635 3379 3473 3380 3051 3054 2794 2653 2504 2347 2182 2009 1828 1639 1442 1237 1024  803  574  337   92
 219  460  693  918 1135 1343 1923 1739 1922 2100 2269 2430 2583 2728 2865 2995 2994 3115 3228 3430 3519 3601 3600 3738 3795 3844 3885 3918 3943 3922 3960 3925 3949 3901 3935 3951 3863 3818 3764 3634 3555 3636 3556 3560 3559 3052 3169 2928 2795 2654 2505 2348 2183 2010 1829 1640 1443 1238 1025  804  575  338   93
 218  459  692  917 1134 1544 1545 1737 2268 2099 2267 2429 2582 2727 2864 2993 3114 3227 3332 3429 3518 3599 3672 3737 3794 3843 3883 3884 3968 3945 3961 3964 3950 3965 3931 3930 3819 3765 3766 3706 3476 3561 3170 3171 3053 3281 3055 2929 2796 2655 2506 2349 2184 2011 1830 1641 1444 1239 1026  805  576  339   94
 217  458  691  916 1133 1342 1543 1736 1921 1920 2266 2428 2581 2726 2863 2992 3113 3226 3331 3428 3517 3598 3671 3736 3793 3842 3882 3941 3942 3958 3967 3954 3963 3900 3866 3953 3864 3865 3704 3821 3705 3638 3562 3378 3382 3173 3172 2930 2797 2656 2507 2350 2185 2012 1831 1642 1445 1240 1027  806  577  340   95
 216  457  690  915 1132 1341 1542 1735 1919 2098 2097 2427 2580 2725 2862 2991 3112 3225 3330 3427 3516 3597 3670 3735 3792 3841 3916 3917 3915 3956 3957 3938 3966 3909 3903 3902 3768 3820 3767 3381 3637 3280 3475 3477 3174 3383 3056 2931 2798 2657 2508 2351 2186 2013 1832 1643 1446 1241 1028  807  578  341   96
 215  456  689  914 1131 1340 1541 1734 1918 2096 2265 2426 2579 2724 2861 2990 3111 3224 3329 3426 3515 3596 3669 3734 3791 3840 3881 3914 3913 3959 3908 3955 3937 3907 3934 3906 3932 3904 3708 3563 3707 3642 3640 3478 3282 3175 3283 2932 2799 2658 2509 2352 2187 2014 1833 1644 1447 1242 1029  808  579  342   97
 214  455  688  913 1130 1339 1540 1733 2095 2264 2263 2425 2578 2723 2860 2989 3110 3223 3328 3425 3514 3595 3668 3733 3790 3839 3940 3878 3911 3910 3833 3874 3873 3952 3905 3869 3867 3823 3822 3481 3639 3769 3479 3384 3284 3058 3057 2933 2800 2659 2510 2353 2188 2015 1834 1645 1448 1243 1030  809  580  343   98
 213  454  687  912 1129 1338 1539 1732 1917 2094 2262 2424 2577 2722 2859 2988 3109 3222 3327 3424 3513 3594 3667 3732 3789 3838 3880 3835 3912 3834 3832 3875 3831 3936 3868 3827 3826 3771 3773 3770 3709 3480 3385 3285 3286 3176 3059 2934 2801 2660 2511 2354 2189 2016 1835 1646 1449 1244 1031  810  581  344   99
 212  453  686  911 1128 1337 1538 1731 1916 2093 2261 2423 2576 2721 2858 2987 3108 3221 3326 3423 3512 3593 3666 3731 3788 3837 3877 3836 3939 3723 3876 3780 3778 3871 3870 3776 3775 3825 3772 3824 3641 3644 3566 3387 3287 3177 3060 2935 2802 2661 2512 2355 2190 2017 1836 1647 1450 1245 1032  811  582  345  100
 211  452  685  910 1127 1336 1537 1730 1915 2092 2422 2575 2574 2857 2856 2986 3107 3220 3325 3422 3511 3592 3665 3730 3787 3786 3785 3879 3783 3724 3781 3779 3652 3830 3872 3829 3717 3715 3711 3565 3710 3564 3386 3388 3288 3178 3061 2936 2803 2662 2513 2356 2191 2018 1837 1648 1451 1246 1033  812  583  346  101
 210  451  684  909 1126 1335 1536 1729 1914 2091 2260 2421 2719 2718 2720 2985 3106 3219 3324 3421 3510 3591 3664 3729 3728 3727 3784 3725 3782 3656 3722 3721 3650 3720 3649 3828 3716 3774 3572 3712 3643 3646 3389 3179 3289 3063 3181 2937 2804 2663 2514 2357 2192 2019 1838 1649 1452 1247 1034  813  584  347  102
 209  450  683  908 1125 1334 1535 1728 1913 2090 2259 2420 2573 2717 2855 2984 3105 3218 3323 3420 3509 3590 3663 3662 3661 3660 3726 3659 3657 3658 3654 3653 3651 3777 3719 3648 3647 3713 3714 3645 3571 3482 3390 3391 3290 3064 3062 2938 2664 2665 2515 2358 2193 2020 1839 1650 1453 1248 1035  814  585  348  103
 208  449  682  907 1124 1333 1534 1727 1912 2089 2258 2418 2419 2572 2854 2983 3104 3217 3322 3419 3508 3589 3588 3587 3586 3585 3501 3583 3582 3498 3655 3580 3578 3577 3718 3576 3575 3574 3487 3488 3483 3484 3485 3392 3297 3182 3180 2939 2516 2807 2517 2359 2194 2021 1840 1651 1454 1249 1036  815  586  349  104
 207  448  681  906 1123 1332 1533 1726 1911 2088 2257 2571 2716 2853 2852 2982 3103 3321 3418 3507 3415 3506 3504 3503 3412 3411 3502 3584 3581 3499 3496 3579 3495 3494 3402 3493 3491 3573 3397 3299 3567 3298 3568 3394 3292 3291 2805 2940 2808 2806 2666 2360 2195 2022 1841 1652 1455 1250 1037  816  587  350  105
 206  447  680  905 1122 1331 1532 1725 1910 2087 2256 2417 2570 2715 2851 2981 3102 3216 3215 3320 3416 3414 3505 3413 3313 3312 3410 3409 3500 3407 3405 3306 3305 3304 3400 3301 3492 3490 2955 3399 3489 3296 3569 3188 3295 3183 3065 3066 2942 2809 2667 2361 2024 2196 1842 1653 1456 1251 1038  817  588  351  106
 205  446  679  904 1121 1330 1531 1724 1909 2086 2255 2416 2713 2714 2850 2980 3101 3214 3318 3417 3317 3316 3315 3314 3206 3311 3309 3204 3200 3199 3406 3497 3085 3201 3404 3303 3300 3194 3191 3398 3076 2951 3293 3393 3184 3071 3067 2943 2941 2519 2518 2362 2197 2023 1843 1654 1457 1252 1039  818  589  352  107
 204  445  678  903 1120 1329 1530 1723 1908 2085 2254 2415 2569 2712 2568 2979 3100 3213 3319 2973 3096 3209 3093 3208 3207 3205 3089 3088 3087 3308 3203 3408 3197 3195 3403 3401 3081 3302 3396 3192 3570 2952 3190 3486 3294 3187 3068 2810 2668 2669 2670 2520 2363 2025 1844 1655 1458 1253 1040  819  590  353  108
 203  443  444  902 1119 1328 1529 1722 1907 2084 2253 2414 2710 2565 2711 2978 3099 3098 3212 2974 3211 3210 3094 3092 3091 3090 3202 2961 2834 3307 3086 3083 3084 3082 3196 2957 3080 3077 3193 3075 3074 2950 3073 3395 3189 3186 3070 3069 2811 2671 2521 2364 2198 2199 1845 1656 1459 1254 1041  820  591  354  109
 202  677  675  676  901 1118 1528 1721 1906 2083 2847 2412 2413 2566 2567 2849 2976 2975 3097 2843 2842 3095 2970 2969 2968 2967 2965    0 3310 2693 2963 3198 2960 2959 2958 2687 3079 2824 2956 3078 2953 2949 3072 2678 3185 2947 2946 2944 2945 2522 2523 2365 2200 2026 1846 1657 1460 1255 1042  821  592  355  110
 442  674  900  899 1117 1327 1326 1527 2082 1905 2250 2252 2251 2848 2243 2977 2845 2844 2841 2972 2840 2971 2839 2838 2395 2835 2550 2966 2391 2545 2832 2691 2831 2828 2827 2537 2686 2954 2684 2822 2820 2681 2819 2948 2818 2816 2815 2674 2812 2672 2366 2028 2029 2027 1847 1658 1461 1256 1043  822  593  356  111
 201  441  440  673 1325 1324 1526 1719 1720 1904 2081 2411 2564 2709 2846 2708 2705 2558 2704 2703 2701 2700 2552 2698 2836 2551 2694 2833 2964 2543 2389 2692 2544 2387 2688 2826 2685 2825 2382 2823 2821 2533 2680 2817 2679 2677 2676 2675 2814 2527 2367 2201 2524 2203 2030 1659 1462 1257 1044  823  594  357  112
 200 1116  439  898 1115 1525 1524 1903 2080 2249 2410 2563 2407 2561 2707 2559 2706 2403 2557 2556 2702 2554 2553 2699 2233 2837 2697 2695 2962 2546 2542 2830 2388 2690 2829 2540 2539 2538 2218 2682 2380 2535 2534 2532 2531 2530 2529 2813 2528 2673 2526 2204 2202 1849 1848 1463 1661 1258 1045  824  595  358  113
 198  199  672  897  896 1323 1523 1718 1902 2079 2248 2409 2562 2408 2405 2560 2404 2402 2401 2238 2555 2399 2234 2398 1883 2396 2548 2696 2549 2228 2227 2226 2390 2689 2223 2385 2384 2383 2536 2683 2217 2379 2378 2377 2376 2375 2374 2373 2372 2525 2368 2370 2205 1851 1850 1660 1259 1046 1047  825  596  359  114
 197  438  671 1113 1114 1322 1716 1717 1901 2078 2247 2246 2245 2406 2244 2242 2241 2240 1889 2237 2400 2235 2397 2064 2063 2232 2231 2547 2229 2392 1690 2055 2386 2541 2054 2222 2221 2220 2219 2381 2045 2216 2215 2213 2212 2041 2211 2210 2207 2371 2206 2369 2032 2031 1662 1465 1464 1260 1048  826  597  360  115
 196  437  670  894 1112 1321 1522 1715 1900 2077 2076 2075 2074 2073 2072 2071 2070 2069 2068 2239 1888 2236 2065 2062 1697 2060 2394 2393 2230 1879 1877 2225 2058 2224 1874 2051 2050 2049 2048 2047 2046 2044 1864 2214 2042 2039 1674 1860 2208 2038 2036 2035 2034 2033 1852 1663 1466 1261 1049  827  598  361  116
 195  436  669 1111  895 1320 1521 1714 1899 1898 1897 1896 1895 1894 1893 1892 1891 1890 1702 1887 2067 2066 1884 1885 1696 2061 1694 2059 1692 1689 2056 1876 1875 2052 2053 1871 1684 1870 1869 1868 1867 1866 2043 1865 1863 2040 1862 1275 2209 2037 1857 1856 1855 1854 1853 1664 1467 1262 1050  828  599  362  117
 194  435  668  893 1110 1319 1520 1713 1712 1711 1710 1709 1708 1707 1706 1705 1704 1703 1507 1701 1505 1886 1700 1699 1698 1499 1498 1880 1691 2057 1496 1688 1290 1873 1686 1075 1872 1682 1487 1681 1680 1679 1678 1677 1676 1859 1861 1478 1858 1672 1671 1669 1668 1667 1666 1665 1468 1263 1051  829  600  363  118
 193  434  667  892 1109 1318 1519 1518 1517 1516 1515 1514 1513 1512 1511 1510 1509 1508 1093 1304 1302 1504 1503 1502 1882 1501 1881 1693 1497 1293 1494 1878 1687 1492 1288 1286 1685 1489 1683 1486 1485 1484 1482 1481 1277 1675 1480 1673 1274 1476 1670 1475 1473 1269 1472 1471 1470 1469 1264  830  601  364  119
 192  433  666  891 1108 1317 1316 1315 1314 1313 1312 1311 1310 1309 1308 1096 1307 1305 1506  874 1301 1090 1300 1299 1695 1500 1295 1294 1082  862 1292 1078 1495 1493  858 1491 1285 1488 1284 1283 1282 1281 1483 1279 1278 1066 1276 1273 1479 1477 1272 1474 1270 1058 1268 1267 1266 1265 1052  831  602  365  120
 191  432  665  890 1107 1106 1105 1104 1103 1102 1101 1100  879  880 1097  876 1306 1095 1303 1089  644  870 1088  642 1298 1297  866 1296  635 1080 1291  860 1490 1289 1077 1287 1076 1074 1073 1072 1071 1070 1280 1069 1068 1067 1065 1064 1063 1062 1061 1271 1059  839 1057 1056 1055 1054 1053  832  603  366  121
 190  431  664  889  888  887  886  885  884  883  882  881  653  652 1098  878  651 1094  411  871  872  409  643 1085 1087  403 1083  864  637 1081  634 1079  400  857  396  856  629  855  854  853  852  851  850  849  848  620  847  846  845  844  842 1060  841  840  838  837  836  835  834  833  604  367  122
 189  430  663  662  661  660  659  658  657  656  655  654  418 1099  877  650  648 1092 1091  873  647  410  869  641 1086  407  640  865  636  863  159  861  631  633  153  632  394  628  627  626  625  624  623  622  621  385  619  617  843  380  615  614  613  612  611  610  609  608  607  606  605  368  123
 188  429  428  427  426  425  424  423  422  421  420  419  174  417  416  172  649  875  413  645  170  166  406  162  405  868 1084  638  639  161  158  399  155  398  397  395  151  393  392  391  390  389  388  387  386  384  383  618  382  616  137  379  378  377  376  375  374  373  372  371  370  369  124
 187  186  185  184  183  182  181  180  179  178  177  176  175  173  415  414  171  169  168  646  412  167  165  408  164  163  867  404  160  401  402  157  156  154  859  152  630  150  149  148  147  146  145  144  143  142  141  140  139  381  138  136  135  134  133  132  131  130  129  128  127  126  125
