# This puzzle is unsolvable
41
   2    1    3    4    5    6    7    8    9   10   11   12   13   14   15   16   17   18   19   20   21   22   23   24  184   25   26  186   28   29  189   32   30   34   36  195   39  197  349   41  348
 160  161  162  163  164  165  166  167  168  169  170  171  172  173  174  175  176  177  178  179  180  181  182  183  335  185  187  338  188  340  192  343  194  487   35  489  196  868   37  200   40
 159  312  313  314  315  316  317  318  319  320  321  322  323  324  325  326  327  328  329  330  331  332  333  334  478  336   27  337  339  191  190  486   31  345  342  202  491   42   38  201   43
 158  311  456  457  458  459  460  461  462  463  464  465  466  467  468  469  470  471  472  473  474  475  476  477  613  479  480  481  482  483  746  622  485   33  347  493  488  199  353  490   44
 157  310  455  592  593  594  595  596  597  598  599  600  601  602  603  604  605  606  607  608  609  610  738  611  612  614  742  616  617  745  620  341  344  624  979  869  492  351  627  346   46
 156  309  454  591  720  721  722  723  724  725  726  727  728  729  730  731  732  733  734  735  736  737  857  740  859  615  741  743  744  974  748  484  867  621  753  629   47  352  350  203   48
 155  308  453  590  719  840  841  842  843  844  845  846  847  848  849  850  851  852  853  854  855  856  858  739  970  860  861  863  864  619  618  623  975  749  870  752  198  750  494   45  625
 154  307  452  589  718  839  952  953  954  955  956  957  958  959  960  961  962  963  964  965  966  967  968 1072  969  971  972  862 1077 1260  865 1081  751  193  626  204  628  871  355  206  354
 153  306  451  588  717  838  951 1056 1057 1058 1059 1060 1061 1062 1063 1064 1065 1066 1067 1068 1069 1070 1071 1167 1073 1074 1075  973 1172 1076  976 1078 1080  977  754  978  755  207  495  356  210
 152  305  450  587  716  837  950 1055 1152 1153 1154 1155 1156 1157 1158 1159 1160 1161 1162 1163 1164 1165 1252 1166 1169 1256 1257 1170 1171 1173 1176 1261  747 1082  982 1083  757  208  630  205   49
 151  304  449  586  715  836  949 1054 1151 1240 1241 1242 1243 1244 1245 1246 1247 1248 1249 1250 1251 1402 1333 1332 1253 1168 1408 1258 1338 1174 1177 1175  873  357 1079  496  498  633  499  209  758
 150  303  448  585  714  835  948 1053 1150 1239 1320 1321 1322 1323 1324 1325 1326 1327 1328 1329 1330 1254 1404 1255 1405 1335 1336 1407 1337 1259 1084  981  866  631  875  756  635  497  358   52   50
 149  302  447  584  713  834  947 1052 1149 1238 1319 1392 1393 1394 1395 1396 1397 1398 1399 1400 1401 1403 1331 1467 1406 1334 1471 1472 1263 1339 1262  983 1085  872 1086  984  874  211   53  632  363
 148  301  446  583  712  833  946 1051 1148 1237 1318 1391 1456 1457 1458 1459 1460 1461 1462 1463 1464 1465 1466 1468 1523 1469 1470 1410 1409 1340 1264 1181 1179  980  360  760  501  362   51  502  761
 147  300  445  582  711  832  945 1050 1147 1236 1317 1390 1455 1512 1513 1561 1514 1516 1517 1518 1519 1520 1521 1522 1524 1571 1525 1411 1341 1265 1413 1268  989  987  359  759   57  500  213   55   56
 146  299  444  581  710  831  944 1049 1146 1235 1316 1389 1454 1510 1511 1600 1515 1563 1564 1565 1566 1567 1568 1569 1570 1526 1412 1342 1343 1180  986  985 1089 1178  878  636  634  876  212   54  214
 145  298  443  709  708  830  943 1048 1145 1234 1315 1388 1453 1560 1558 1559 1562 1602 1603 1604 1605 1606 1607 1608 1609 1572 1527 1473 1474 1266 1267 1088 1087  988  877  762  503  637  505  364  365
 144  297  442  580  578  829  942 1047 1144 1233 1314 1387 1452 1509 1557 1599 1601 1632 1633 1634 1635 1637 1638 1639 1610 1573 1528 1475 1414 1344 1269 1345 1182 1090  764  880  638  506  504   58  361
 295  143  296  441  579  826  828 1046 1143 1232 1313 1386 1451 1507 1508 1598 1631 1656 1657 1658 1636 1660 1661 1640 1611 1574 1529 1476 1415 1348 1346 1091 1183 1184  990  763  765  507  216  215   59
 142  577  437  438  707  939  941  940 1142 1231 1312 1385 1450 1506 1556 1597 1630 1655 1672 1673 1659 1675 1662 1641 1612 1575 1576 1530 1477 1347 1270  991  879 1092  881  640  639  508  366  217   60
 294  440  439  705  704  827 1045 1044 1141 1230 1310 1311 1384 1449 1555 1596 1629 1654 1671 1680 1674 1676 1663 1642 1613 1577 1531 1478 1417 1416 1186 1185 1093  883  882  641  642  367  368  218   61
 141  139  293  576  706  825  936 1140 1226 1228 1229 1309 1448 1505 1554 1595 1628 1653 1670 1679 1678 1677 1664 1643 1614 1578 1532 1480 1479 1349 1271 1272 1187 1094  884  766  643  767  644  219   62
 140  574  572  575  703  824  937 1040  938 1224 1382 1383 1447 1504 1553 1594 1627 1652 1669 1668 1667 1666 1665 1644 1481 1533 1419 1422 1418 1350 1273 1188  994  992  993  769  768  509  220  511   63
 138  292  435  436 1043  823 1042  935 1139 1136 1308 1307 1227 1502 1552 1593 1626 1651 1650 1649 1648 1647 1646 1645 1615 1534 1485 1579 1355 1351 1274 1096  886  888  885  770  645  369  510  221   64
 137  291  433 1038  702  573  822 1138 1133 1137 1381 1380 1503 1446 1551 1592 1625 1624 1623 1622 1621 1620 1582 1540 1616 1617 1420 1421 1276 1275 1189 1190  995  887  996  512  514  372  222  223   65
 136  290  571  700  821  701 1135 1041 1223 1225 1306 1445 1444 1500 1591 1497 1590 1589 1588 1587 1586 1585 1619 1581 1618 1538 1536 1278 1535 1423 1098 1097  771  997  772  646  890  371  513  370   66
 135  434  289  288  818  933  934 1039 1221 1302 1134 1305 1501 1378 1550 1547 1438 1546 1545 1544 1543 1542 1584 1580 1583 1486 1483 1539 1482 1353 1193 1191 1192 1095 1100 1001  647  515  373   67   68
 287  431  132  820  432  569  931  932 1222 1442 1379 1443 1499 1549 1548 1439 1440 1495 1494 1492 1433 1491 1541 1490 1489 1487 1484 1537 1279 1352 1277 1101 1099  775  999  516  889  374  225  224   69
 134  286  697  819  570 1037 1035  696 1036 1300 1131 1377 1376 1304 1498 1437 1496 1369 1434 1493 1432 1365 1431 1430 1429 1488 1428 1427 1357 1200 1102  998 1194 1002  773  649  648  517  375  227  226
 285  430  284  568  699  817 1034  929  930 1033 1132 1298 1296 1441 1372 1371 1436 1368 1293 1435 1291 1366 1364 1363 1362 1285 1203 1360 1426 1354 1424 1356 1425 1000  777  891  776  650  376  228   70
 133  428  566  565  698  695  567 1220 1301 1130 1217 1303 1125 1373 1213 1297 1295 1370 1294 1367 1292 1290 1288 1287 1015 1286 1361 1358 1283 1282 1280 1195 1196 1103  893  774  519  378  523  377   71
 131  283  429  564  694  816  928 1032 1129 1299 1219 1375 1026 1216 1374 1212 1120 1211 1019 1209 1118 1289 1204 1115  906 1112 1110 1359 1199 1011 1198 1281 1005 1104  892  894  651  895  518  229   72
 130  282  427  693  814  815  927 1030 1029  922 1218 1215 1124  919 1214 1022  914 1020  916 1121 1210 1208 1116 1205 1117 1113  537 1202 1284 1107 1108 1003 1007  781  898  779  520  653  778  379   73
 129  128  426  563  691  925  692  924  926 1031  921 1027 1123 1025  798 1023  676  799 1018 1021 1017 1206  667 1016 1114  905 1010 1109 1009  902  788 1004 1106 1006  896  521  780  522  233  656  230
 127  281  425  562  812  813  810  807  923 1128  806 1126 1028 1122  681  802  915  260  917  911  543 1207  793  670  910  908  790 1201 1013 1008 1197  784  899  652  382  783  381  384  654  380   74
 126  280  279  424  561  811  687  554  809  682  805  803 1127 1024  680  800  678 1119  913  796  797  912 1014 1111  907  904 1012  396  900  786  903  666  659  528 1105  660  655  383   75  231  232
 125  278  423  560  689  690  686  417  556  684  551  920  804  549  677  801  675  106  544  673  795  909  794  671  672  792  791  535  665  901  663  532  389  897  524  782  657  525   78   76   77
 124  123  559  275  557  416  688  555  553  552  683  412  550  918  409  679  408  545  258  674  542  539  100  669  255  399  789  397  536  787  391  664  393  529  243  386  530   85  235  236  237
 120  121  277  420  558  418  269  270  808  685  414  110  411  548  547  107  405  259  402  256  253  102  540  538  252  395   92  394  662  668  785  392    0  661  658  387  242  526  238   79  234
 119  422  272  273  419  271  115  113  415  267  413  265  264  262  263  546  105  407  103  404  403   99  541  401  251  398  250   96  249  534   90  531  533  244  527  241  239  240   84   83   80
 122  276  421  118  274  117  116  268  114  112  266  111  109  410  261  108  104  406  257  254  101  400   98   97  248   95   93   91   94  246  247  245  390   89   88  388   87  385   86   82   81
