# This puzzle is unsolvable
9
47 57 26 36 50 77 31 38 13
28 74 33 12 42  8  6 11 64
55 49 54 34 66 32  5 14 76
16 46 25  2 80 61 10 39 60
40 23 22 15 75 45  0 52  3
53 59 37 65 56 63 24 51 19
18 69 20 27  7  4 67  1 43
58 70 73 71 29 17 44  9 78
72 79 68 30 21 35 62 41 48
