# This puzzle is unsolvable
23
  1  88  87  92 173 244   7  11 175 174 248 179  14 252  16 104  18  17  20 107  22  23  24
 85   3   5   6  93 247 170 176 172   8  13   9 251 418 103 181 106 256 318  19  21 109  25
 90   4 242  91 241 307 357  95 178 245  97  15  10  99 180 316 253 105 108 186 110 187  26
169   2 239 237 243 306  86  94 408 309 246 365 183 101 250 182 371 255 319 188 189 373 111
 89  82 168 240 305 304 448 249 310 451  96 177 488  12 184 315 314 317 257 191 113 112  27
171 301 166 300 406 409 308 311 452 366  98 370 313 511 254 417 258 374 185 322 114 115  28
165  84 163 299 167 479 405 411 410 100 412 364 454 413 455 458 456 320 372 321 259 117  29
234  83 303 164  81 235 446 450 445 525 508 415 312 416 485 102 487 375 262 260 193 190 116
 80  79 238 360 363 362 442 499 449 453 482 483 522 367 457 419 377 420 376 261 192  33  30
159 236 302 358 478 359 407 444 505 477 369 414 486 421 368 424 378 422 323 263 194  32  31
162 404 356 354 403 350 447 504 473 472 503 520 490 523 489 510 324 379 325 264 118 196 119
158 160 476 355 298 361 502 507 481 515 480 521 526 524 460 509 459 326 265 327 120 121  34
161 232  77 233 231 401 349 501 471 528 506 514 491 513 461 462 423 328 425 266 195  35  36
 78 230 294  76 352 227 475 396 517 474 394 516 484 466 467 492 381 383 380 329 197  37 123
 74 228 150 351  75 353 443 397 518 500 498 527 512 494 493 426 464 382 268 199 267 201 122
157  69 440 293 156 297 347   0 395 400 392 469 463 433 432 465 427 384 198  49 125 274  39
151 155 292  73 348 291 399 439 496 468 519 495 435 390 389 430 429 331 330 270 124 200 203
295 153 296 441 229 222 438 402 437 213  57 434 388 215 136 335 336 271  48 269 202  38  43
290  67 225 289 398 286 340 436 145 497 339 391 278 431 211 386 277 334 209 428 332  40 126
154  72 147 344 343 287  62 283 342 346 140 470 216 137 337 276  41 387 129 207 128  42  44
 66 224  70 345  71 220 143  56 285 142 281  55 141  58 275 138 134 333 204 272 135 205 127
149  68 223 226 219 148 393  59  63 139 144  51 282 280 279 212 133 385 210 273 131 206  45
 65 152  64 288 218 221 146  60 284 341 217  61 214  52 338  54  53 132  50  47 208 130  46
