# This puzzle is solvable
10
 68  64    78  41   5  49  26  15  83
 24  81    40  66  67  50  11  51   8
 80  74    96  25  42  88  55  91  75
 45  89    34   4  13  76  33  79  44
 20  93    70  23  57  39  73  36  62
  3  27     6  52   9  98  92  95  43
 97  28     2  10  32  21  82  17  94
 85  58    35  71  47   0  59  48  12
 84  63    90  77  60  53  72  99  30
 61  19    18  69  38  16  54  86  14
