# This puzzle is solvable
12
  0   3  84  48 109   2  10  88  58   7  13
 40  43  78   5  91   8   4  47  20 141  11
 44  45  81 135 143 106 132   9  54  99  14
 79  87 140 128 113  65  90  26  80  51  92
 41 137  73  67 142  97 114  18  93  86 116
110  85 136  71 138   6 121  12  49  89 119
102  74 126  46  55  98  53 105  29  50  25
115  37 117 124  15  59  62 118 103 100  56
 77 130  27  22  19  57  61  30  95  17  64
 76  42  35 104  60  52 129  21  23  82 122
 36 108  32 120  33  83 127  70  28 123  16
 75  72  31 139  94 133 101  96  66  24  63
