# This puzzle is solvable
32
 124    1  125    4    5  130    6    8  132    9   10   12  136   13   16   142   20  143  363   21  148  366  368   25  149   27   28   36   34   33  267
   3  241  126    2  128  242  243  131  246  248   14   11  251   15  139    18  141  464  638  145  260   23  150  262  372  151   30  373  152  155  472
 123  240  448  238  450  127    7  129  247  134  133  135  250  137  252   140  256  259  552  144  258   24  470  147   31   26  154  269   35  157   32
 239  349  347  352  244  353  245  625  453  457  249  548  358  359  360   361   19  551  257  466  261  367  637  563   22  374  473  471  153  270  268
 122  121  447  540  351  542  452  451  354  455  704  357  355  549  462   461  465  255  635  365  719  556  469  146  375  370  158  263  265   29  271
 120  236  237  350  541  449  539  628  626  456  546  454  356  458  460   779  364  839  557  371  554  468  559  644  642  266  562  561  272  274   37
 119  348  345  346  543  446  700  544  545  771  703  547  707  459  630   463  885  889  775  467  555  369  715  718  564  645  476  264  156  160  162
 118  235  344  445  538  624  627  701  702  829  706  629  705  774  709   711  633  636  716  643  560  785  568  720  475  275  646  161   38  377  273
 117  234  343  444  537  623  769  535  768  828  772  880  632  550  776   836  778  842  781  838  713  783  640  717  641  474  558  376  378   39   42
 116  342  230  443  621  622  699  620  766  881  773  834  832  930  708   967  777  712  933  639  714  841  650  648  383  723  784  380   41  159   40
 232  233  340  341  442  536  767  696  770  830  924  710  923  831  887   969  837  780  932  935  894  782  722  787  379  565  478  566  479  276   43
 339  231  229  441  534  763  698  824  765  695  826  959  631  965  925   891  888  934  993  890  968  893  843  786  647  569  381  477  382  278  163
 115  440  112  437  619  693  697  113  877  879  926  922  983  833  882   931 1013  992  892  937  840  789  971  721  567  480  482  481  164  277   44
 228  110  439  531  618  615  762  694  876  827  962  960 1007  961 1010   963  994  897  997  896  847  725  652  790  788  724  726  385   45  165   46
 336  111  226    0  338  533  532  617  761  823  764  957  990 1008 1006   991  996  970  936  938  895  845  850  649  791  571  384  483  280  167  166
 109  335  337  114  614  692  875  825  920  878  956  921  919 1022  964  1011 1017 1000  972  976  995  654  727  846  570  651  386  279  282  168   47
 107  108  435  438  616  760  529  819  872  758  822 1020  984  989  958  1005 1015 1023  853  844  848  939  794  653  574  573  572  281  284  169  170
 224  227  225  530  691  528  690  688  759  917  873  955  918  928  987   954  944 1014  998  973  940  849  898  792  793  484  485  387  388   49  283
 106  331  333  222  434  611  613  814  871 1019 1003  950  914 1009 1018   999  947  974  975  900  899  852  851  728  655  486  576  389  171   50   48
 332  105  334  433  436  527  757  821  874  816  820  986  869  985  982  1016  979  977  942  901  902  943  795  730  577  656  657  575  390  172   51
 223  432  104  431  525  689  610  755  817  915  981  864  951 1004  912   948  907  946  945  904  856  855  798  797  658  488  286  731  285  173   52
 218  524  609  684  526  612  686  756  687  749  870  916  980  808  866   909  860  906  905  732  941  903  799  734  578  489  487  391  287  174   53
 221  330  329  427  753  815  608  752  868  913  953  867  746  911  952   908  861  859  858  857  801  733  661  854  729  579  393  392  288  175   54
 327  103  102  219  523  754  683  751  812  818  810  809  910  865  807   806  805  804  803  738  737  796  800  666  660  659  490  395  289  176   55
  97  220  430  217  607  685  605  602  750  679  748  813  811  745  595   743  742  741  740  802  587  739  664  735  581  580  394  491  290  177   56
  99  522  100  216  606  318  520  682  681  512  599  677  511  747  508   672  593  670  590  669  668  586  665  663  662  493  583  396  291  178   57
 325   94  604  428  326  429  515  521  601  600  676  597  678  675  594   592  671  591  503  667  588  736  499  584  582  496  492  397  292  179   58
 323  425  423  215  519  426  517  516  420  680  417  509  510  414  596   412  505  504  502  589  501  500  498  585  497  495  494  398  293  180   59
 424  324  101  328  518  212  421  514  419  204  513  415  598  315  313   506  410  409  408  407  406  405  404  403  402  401  400  399  294  181   60
  98  213  321  320  322  422  317  603  207  202  418  314  416  200  310   411  307  306  305  304  303  302  301  300  299  298  297  296  295  182   61
  96   95  211  209  210  319  206   89  205  316  203  201   82  199  309   197  196  195  194  193  192  191  190  189  188  187  186  185  184  183   62
  93   92   90  214  208   91   87   86   88   85   84  312   83   81   79    78   77   76   75   74   73   72   71   70   69   68   67   66   65   64   63
