# This puzzle is solvable
61
   1    2    3  243    4    5     7    8    9   10   11   13   14   15   16   17   18   19   20   21   22   23   24   25   26   27   28   29   30   31   32   33   34   35   36   37   38   39   40   41   42   43   44   45   46   47   48   51  288   52  290  523  292   55  295   58  299   60   61   62
 240  241  242  474  244  246   477  248  249  250   12  251  253  254  255  256  257  258  259  260  261  262  263  264  265  266  267  268  269  270  271  272  273  274  275  276  277  278  279  280  281  282  283  284  285  286  287   49   50  521  289  525  524  750  293   56  526  527  298  300
 239  472  473  475  698  476   247  478  480  481  482  252  484  485  486  487  488  489  490  491  492  493  494  495  496  497  498  499  500  501  502  503  504  505  506  507  508  509  510  511  512  513  514  515  516  517  518  519  520  745  522  746   54  963  528  294   59  297  530   63
 238  471  696  697  913  699   702  479  703  704  705  483  706  708  709  710  711  712  713  714  715  716  717  718  719  720  721  722  723  724  725  726  727  728  729  730  731  732  733  734  735  736  737  738  739  740  741  742  744  958  291  960    0  968   53  529   57  531  301   64
 237  470  694  695  912 1122   701  917  918  919  920  921  707  923  924  925  926  927  928  929  930  931  932  933  934  935  936  937  938  939  940  941  942  943  944  945  946  947  948  949  950  951  952  953  954  955  956 1164  957  743 1167  962  747 1171  749  296  752  302  303   65
 468  236  693  911 1120  914   916 1124 1125 1126 1127 1128  922 1131 1132 1331 1133 1134 1135 1136 1137 1138 1139 1140 1141 1142 1143 1144 1145 1146 1147 1148 1149 1150 1151 1152 1153 1154 1155 1156 1157 1158 1159 1160 1161 1162 1163 1363 1165 1166  961  959  748  964 1367 1372  751  532   67   66
 469  232  692 1117 1119  910  1319 1323 1324 1325 1326 1327 1129 1130 1330 1329 1332 1333 1334 1335 1336 1337 1338 1339 1340 1341 1342 1343 1344 1345 1346 1347 1348 1349 1350 1351 1543 1352 1354 1355 1356 1357 1358 1360 1361 1551 1554 1553 1364 1365 1366 1558 1369 1168 1560  969 1172  533  534   68
 234  235  909 1318 1512 1696  1513 1322 1515 1516 1517 1518 1328 1702 1522 1704 1523 1524 1525 1526 1527 1528 1529 1530 1531 1532 1533 1534 1535 1536 1537 1538 1539 1540 1541 1725 1542 1353 1545 1546 1547 1548 1549 1359 1550 1910 1735 1362 1555 1556 1740 1557 1170  965 1368  753  305  966  755  304
1116  467  466 1508  908 1118  1694 1698 1873 1699 1700 1701 1703 1521 1880 1881 1705 1707 1708 1709 1710 1711 1712 1713 1714 1715 1716 1717 1718 1719 1720 1721 1722 1723 1724 1901 1726 1544 1904 1728 1730 1731 1732 1733 1734 2078 1552 1736 1738 1739 1914 1174 1559 1169  967 1175  754   70  306   71
 464  233  231  906 1511  904  1510 1317 1874 2201 2352 1877 2203 1520 1519 1879 2049 2051 1882 1883 1885 1886 1887 1888 1889 1890 1891 1892 1893 1894 1895 1896 1897 1898 1899 1902 2067 1727 1903 1729 1905 1906 1907 2075 1911 1908 1737 2239 2081 1913 1915 1742 1561 1373 1371 1173  756  535   69  758
 230  690  903 1113  907 1115  1695 1872 2041 1876 2044 2043 2204 1878 2045 2048 1706 2207 1884 2210 2052 2053 2054 2055 2056 2057 2058 2059 2060 2061 2062 2063 2064 2065 2069 1900 2227 2378 2228 2070 2072 2233 2384 2074 1909 2236 1912 2238 2079 2083 1916 1370 1741 1745 1176 1177  757  536  307  539
 463  689  465 1509  905 1693  1506 1691 2040 1875 2199 2202 2042 2357 2046 2047 2358 2209 2050 2361 2211 2212 2213 2215 2366 2216 2218 2369 2219 2220 2221 2222 2223 2224 2225 2377 2226 2066 2068 2071 2229 2073 2234 2235 2237 2530 2077 2387 2080 2082 1744 1743 1562  759  970   75 1374  538  971   72
 229  228  688  686 1114 1316  2198 2039 1870 2200 2197 2353 2354 2499 2356 2501 2208 2503 2359 2504 2363 2506 2364 2214 2367 2510 2217 2370 2513 2371 2372 2373 2376 2375 2519 2658 2521 2379 2380 2382 2525 2524 2528 2663 2076 2527 2241 2666 2240 1919 1917 1564 1563  973  972 1178  537  309  974   73
 461  462 1112  902  687 1314  1690 1692 1868 2038 2495 2496 2632 2205 2206 2355 2634 2502 2360 2505 2362 2507 2508 2365 2509 2645 2368 2512 2648 2514 2516 2374 2517 2518 2782 2657 2230 2231 2522 2905 2523 2232 2661 2532 2665 2385 2531 2388 2389 2391 1921 1918 1746 1377  761  762  310  760  308   76
 227  460  459  901 1311 1507  1867 1869 2037 2351 2036 2350 2631 2497 2633 2500 2636 2638 2637 2766 2767 2639 2768 2642 2771 2646 2511 2647 2775 2649 2515 2651 2652 2780 2520 2655 2653 2381 2781 2659 2660 2383 2790 2526 2794 2529 2243 2533 2084 2242 2087 1920 1375 1566  975 1179  313  542   74  312
 226  684  685 1110 1111 1313  1504 1866 2035 2196 2349 2494 2630 2498 2760 2635 2762 2763 2884 2765 2640 2769 2888 2644 2641 2772 2773 2774 2650 2895 2776 2779 2898 2899 2654 3211 2784 2783 3013 2902 2787 2788 2662 2791 2793 2667 2390 2393 2392 1747 1567 1748 1568 1182 1180 1376  541  764  311  540
 225  458  683  900 1109 1310  1688 1865 2034 2195 2348 2493 2629 2759 2761 2882 2993 2764 2883 2885 2887 2999 2770 2889 2643 3001 2892 3106 2893 2777 3007 2896 2778 3114 3011 3010 3113 2906 2903 2785 2907 3018 2789 2386 2909 2792 2536 2086 2245 2085 1749 1378 1565 1183  977 1181  763  543   77   78
 224  457  682  899 1108 1309  1687 1864 2033 2194 2347 2492 2628 2758 2880 2992 2881 2994 2995 2996 2886 2997 3102 3000 2891 2890 3201 3004 3003 3006 2897 3008 3208 2901 2656 2900 3297 2904 3017 2786 3121 2908 2797 2910 2664 2911 2244 2088 2394 1923 1922 1751 1569 1379  976  979 1184  544  315  314
 223  456  681  898 1107 1308  1686 1863 2032 2193 2346 2491 2757 2756 2878 2991 3096 3097 3098 3099 3100 2998 3101 3103 3104 3002 3105 3005 2894 3109 3110 3111 3116 3296 3009 3295 3012 3212 3119 3118 3215 3120 3019 2912 2395 2396 2668 2089 2246 2090 1750 1925 1570 1380 1381  978  765  766  316   79
 222  455  680  897 1106 1307  1685 1862 2031 2192 2345 2490 2627 2877 2990 2879 3095 3192 3193 3194 3195 3196 3197 3198 3286 3199 3200 3108 3107 3203 3205 3206 3112 3015 3376 3115 3209 3117 3016 3014 3213 3021 3020 2537 2670 2669 2534 2535 2247 2091 1752 1753 1571 1383 1185  980  767  545  546   80
 221  454  679  896 1105 1306  1684 1861 2030 2191 2344 2489 2626 2755 2876 2989 3094 3191 3280 3281 3282 3283 3284 3285 3287 3288 3202 3291 3204 3292 3372 3293 3207 3375 3374 3377 3210 3299 3300 3214 3216 3122 3024 3125 2913 2671 2538 2397 2248 2092 1924 1755 1572 1754 1186  981  768  547  317   81
 220  453  678  895 1104 1305  1683 1860 2029 2190 2343 2488 2625 2754 2875 2988 3093 3190 3279 3360 3361 3362 3363 3364 3365 3366 3437 3289 3368 3369 3370 3371 3294 3373 3446 3298 3448 3379 3380 3217 3303 3218 2795 3023 2672 2796 2539 2398 2249 2093 1927 1928 1384 1382 1187  982  769  549  318   82
 219  452  677  894 1103 1304  1682 1859 2028 2189 2342 2487 2624 2753 2874 2987 3092 3189 3278 3359 3432 3433 3434 3435 3436 3438 3367 3502 3290 3441 3442 3443 3508 3445 3447 3510 3511 3449 3378 3302 3123 3301 3124 3025 2798 2673 2540 2399 2250 2095 1926 1575 1573 1385 1188  983  770  319  548   83
 218  451  676  893 1102 1303  1681 1858 2027 2188 2341 2486 2623 2752 2873 2986 3091 3188 3277 3358 3431 3496 3497 3498 3499 3556 3439 3501 3440 3504 3505 3506 3444 3507 3566 3565 3611 3450 3381 3304 3126 2916 2914 3022 2799 2674 2542 2541 2400 2251 1929 1574 1756 1387 1189  984  771  551  320   84
 217  450  675  892 1101 1302  1680 1857 2026 2187 2340 2622 2621 2751 2872 2985 3090 3187 3276 3357 3430 3495 3552 3553 3554 3500 3555 3503 3558 3560 3608 3562 3648 3563 3509 3564 3451 3384 3382 3305 3027 3220 3028 2915 2800 2801 2675 2401 2254 2253 2094 1758 1578 1576 1190  985  772  325  550  322
 216  449  674  891 1100 1301  1679 1856 2025 2186 2485 2338 2750 2749 2871 2984 3089 3186 3275 3356 3429 3494 3551 3600 3601 3602 3603 3557 3604 3605 3559 3647 3609 3610 3612 3515 3512 3309 3383 3221 3026 3129 3219 2918 2802 2676 2543 2402 2252 2096 1757 1930 1386 1577 1191  774  987  553  321   85
 215  448  673  890 1099 1300  1678 1855 2024 2185 2339 2619 2484 2870 2982 2869 3088 3185 3354 3274 3428 3550 3599 3598 3640 3641 3642 3643 3606 3607 3561 3646 3679 3567 3513 3516 3452 3389 3455 3222 3127 3130 3128 2917 2919 2678 2677 2544 2097 1932 1931 1759 1389 1388  986 1192  552  773  323   86
 214  447  672  889 1098 1299  1677 1854 2023 2184 2337 2620 2335 2748 2983 3087 3184 2980 3273 3427 3492 3493 3549 3639 3638 3696 3672 3674 3644 3675 3645 3651 3680 3649 3614 3514 3453 3454 3307 3306 3131 3223 3029 2803 2804 2920 2545 2404 2403 1760 1933 1579 1762 1580 1193  989  988  324  775   88
 213  446  671  888 1097 1298  1676 1853 2022 2183 2336 2483 2617 2618 2981 2746 3182 3086 3353 3355 3425 3491 3548 3597 3637 3671 3673 3697 3698 3714 3677 3700 3701 3568 3650 3569 3518 3456 3386 3385 3133 3132 3030 3031 2680 2806 2679 2546 2255 2098 1934 1581 1582 1390 1195 1194  990  555  554   87
 212  445  670  887 1096 1297  1675 1852 2021 2182 2479 2334 2482 2747 2868 2979 2867 3272 3183 3426 3351 3490 3489 3596 3670 3669 3695 3712 3718 3678 3676 3702 3652 3682 3613 3571 3308 3310 3457 3226 3224 2922 2923 2921 2805 2681 2547 2101 2257 2256 1935 1763 1391 1392  992 1196  991  327  326   89
 211  444  669  886 1095 1296  1674 1851 2020 2180 2481 2480 2478 2745 2866 3085 3181 3271 3352 3350 3424 3546 3547 3595 3635 3694 3711 3699 3716 3715 3713 3681 3703 3654 3653 3572 3517 3387 3312 3388 3227 2925 3034 2926 2924 2548 2406 2405 2258 2099 2100 1936 1583 1761 1197  777  776  556  557   90
 210  443  668  885 1094 1295  1673 1850 2019 2333 2616 2181 2615 2743 2744 2978 3084 3180 3270 3269 3423 3488 3545 3594 3668 3636 3693 3720 3710 3719 3704 3686 3683 3684 3615 3617 3519 3458 3391 3311 3033 3032 2682 2808 2807 2550 2408 2102 1938 2259 1937 1764 1394 1393  329  779  328  778   92   91
 209  442  667  884 1093 1294  1672 1849 2018 2179 2332 2477 2614 2742 2977 2865 3083 3179 3268 3349 3422 3487 3544 3593 3634 3667 3692 3709 3707 3717 3706 3659 3655 3656 3521 3619 3574 3570 3392 3390 3314 3228 3134 2549 2409 2809 2551 2407 2261 1939 2103 1765 1584 1395 1198  993  780  558  559  330
 208  441  666  883 1092 1293  1671 1848 2017 2178 2331 2476 2613 2863 2864 3081 3082 3178 3267 3348 3421 3486 3543 3592 3633 3666 3691 3690 3708 3689 3688 3660 3705 3658 3618 3577 3620 3459 3520 3313 3225 3135 3137 3136 3035 2683 2553 2552 2410 1940 1766 2105 1585 1396 1199  994  781  560  333   93
 207  440  665  882 1091 1292  1670 1847 2016 2177 2330 2475 2612 2741 2862 2976 2975 3177 3266 3347 3420 3485 3542 3591 3632 3665 3664 3663 3662 3661 3687 3685 3624 3573 3616 3575 3461 3460 3315 3463 3230 3036 3229 2927 2812 2811 2684 2260 2107 2106 2104 1768 1586 1587 1200  995  561  332  334  331
 206  439  664  881 1090 1291  1669 1846 2015 2176 2329 2474 2611 2740 2861 2974 3080 3079 3265 3346 3419 3484 3541 3590 3631 3630 3629 3628 3627 3626 3625 3580 3623 3469 3657 3576 3523 3317 3522 3316 3231 3138 3139 3037 2810 2413 2411 2554 2263 2262 1941 1767 1770  997 1201  996  782  562   96   94
 205  438  663  880 1089 1290  1668 1845 2014 2175 2328 2473 2610 2739 2860 2973 3078 3176 3264 3345 3418 3483 3540 3589 3588 3587 3586 3585 3584 3532 3583 3581 3470 3527 3579 3578 3525 3394 3464 3396 3393 3232 2928 2686 2688 2685 2687 2109 2412 2264 1942 1398 1397 1399 1203  784  783  563   95   97
 204  437  662  879 1088 1289  1667 1844 2013 2174 2327 2472 2609 2738 2859 2972 3077 3175 3263 3344 3417 3482 3539 3538 3537 3536 3535 3534 3533 3473 3582 3531 3530 3622 3524 3401 3621 3462 3526 3319 3233 3140 3038 2929 2930 2556 2689 2814 2108 2267 1772 1400 1401 1202 1204  998  787  785  100  335
 203  436  661  878 1087 1288  1666 1843 2012 2173 2326 2471 2608 2737 2858 2971 3076 3174 3262 3343 3416 3481 3480 3479 3478 3477 3476 3408 3475 3406 3472 3403 3404 3468 3529 3325 3467 3318 3395 3234 3141 3040 3039 2813 2932 2690 2555 2414 2266 1589 1943 1769 1773 1205  786 1002  564  565  338   98
 202  435  660  877 1086 1287  1665 1842 2011 2172 2325 2470 2607 2736 2857 2970 3075 3173 3172 3261 3415 3414 3413 3412 3411 3410 3409 3333 3474 3331 3471 3405 3244 3528 3402 3326 3465 3398 3320 3324 3235 3142 2931 3041 2816 2815 2415 2110 1945 2111 1944 2265 1588 1590 1591  999 1001  566  337  336
 201  434  659  876 1085 1286  1664 1841 2010 2171 2324 2469 2606 2735 2856 2969 3074 3171 3260 3342 3340 3339 3338 3337 3336 3335 3334 3407 3060 3247 3332 3329 3327 3243 3400 3399 3151 3239 3238 3237 3321 3143 3042 2933 2691 2692 2416 2558 2268 1946 1771 1592 1402 1404 1000 1403  788  567  101  102
 200  433  658  875 1084 1285  1663 1840 2009 2170 2323 2468 2605 2734 2855 2968 3073 3170 3259 3341 3258 3166 3256 3253 3163 3252 3251 3250 3248 3330 3249 3156 3246 3053 3245 3054 3150 3397 3240 3145 3236 3144 2935 3043 2818 2559 2557 2417 2269 2113 1947 1774 1593 1405 1206 1003  790  568  340  339
 199  432  657  874 1083 1284  1662 1839 2008 2169 2322 2467 2604 2733 2854 2967 3072 3169 3168 3067 3068 3257 3165 3255 3162 3161 2954 3159 3158 3157 3058 3057 3328 3241 3242 3149 3152 3466 3147 3049 3146 3044 3045 2817 2934 2693 2560 2418 2270 1948 2112 1775 1595 1406 1207  789 1208   99  569  103
 198  431  656  873 1082 1283  1661 1838 2007 2168 2321 2466 2603 2732 2853 2966 3071 3070 3069 3167 3066 3064 3254 3065 3063 3160 2955 3061 2952 2950 3056 3155 3153 3052 3055 2831 2943 2709 3148 3322 3047 3046 2936 2819 2694 2695 2421 2419 2420 2114 1949 1594 1776 1209 1210 1004  791  570  341  104
 197  430  655  872 1081 1282  1660 1837 2006 2167 2320 2465 2602 2731 2852 2965 2964 2963 2962 2961 2960 2844 2958 3164 2957 3062 2839 2953 2951 3059 2832 2948 3154 2834 2944 2707 3323 3051 3048 2826 2941 2940 2939 2937 2820 2562 2272 2561 2271 2115 1950 1777 1597 1596 1407 1005  792  571  342  105
 196  429  654  871 1080 1281  1659 1836 2005 2166 2319 2464 2601 2730 2851 2850 2849 2848 2847 2846 2845 2843 2959 2842 2841 2717 2840 2838 2837 2836 2835 2708 2712 2946 2706 2830 2945 2828 2942 3050 2825 2824 2938 2822 2821 2696 2563 2422 2273 2116 1951 1598 1779 1408 1211 1006  793  572  343  106
 195  428  653  870 1079 1280  1658 1835 2004 2165 2318 2463 2600 2729 2728 2727 2726 2725 2724 2723 2722 2721 2720 2719 2956 2716 2585 2715 2714 2582 2713 2949 2577 2833 2947 2710 2829 2705 2827 2703 2702 2701 2823 2699 2698 2697 2564 2423 2274 2117 1952 1780 1778 1409 1212 1007  794  573  344  107
 194  427  652  869 1078 1279  1657 1834 2003 2164 2317 2462 2599 2598 2597 2596 2595 2594 2593 2592 2591 2590 2589 2588 2718 2587 2584 2447 2444 2581 2711 2580 2579 2578 2576 2574 2573 2575 2704 2572 2571 2570 2700 2568 2567 2566 2565 2424 2275 2118 1953 1599 1600 1410 1213 1008  795  574  345  108
 193  426  651  868 1077 1278  1656 1833 2002 2163 2316 2461 2460 2459 2458 2457 2456 2455 2454 2453 2452 2451 2450 2449 2448 2586 2446 2583 2445 2297 2442 2441 2440 2439 2438 2437 2436 2435 2434 2433 2432 2430 2569 2429 2428 2427 2426 2425 2120 2277 1782 2119 1954 1411 1214 1009  797  796  575  346
 192  425  650  867 1076 1277  1655 1832 2001 2162 2315 2314 2313 2312 2311 2310 2309 2308 2307 2306 2305 2304 2303 2302 2301 2300 2299 2298 2296 2443 2295 2294 2293 2292 2291 2290 2289 2288 2287 2286 2285 2431 2283 2282 2281 2125 2280 2279 2278 2121 1955 1601 1781 1412 1216 1010  798  576  347  109
 191  424  649  866 1075 1276  1654 1831 2000 2161 2160 2159 2158 2157 2156 2155 2154 2153 2152 2151 2150 2149 2148 2147 2146 2145 2144 2143 2142 2141 2140 2139 2138 2137 2136 2135 2134 2133 2132 2131 2130 2284 2128 2127 1964 2126 2124 2123 2276 1958 1956 1783 1602 1215 1413 1011  799  577  348  110
 190  423  648  865 1074 1275  1653 1830 1999 1998 1997 1996 1995 1994 1993 1992 1991 1990 1989 1988 1987 1986 1985 1984 1983 1982 1981 1980 1979 1978 1977 1976 1975 1974 1973 1972 1971 1970 1969 1968 1966 2129 1965 1613 1793 1962 1961 1960 2122 1959 1957 1784 1414 1415 1217 1014 1012  350  578  349
 189  422  647  864 1073 1274  1652 1829 1828 1827 1826 1825 1824 1823 1822 1821 1820 1819 1818 1817 1816 1815 1814 1813 1812 1811 1810 1809 1808 1807 1806 1805 1804 1803 1802 1801 1800 1799 1798 1797 1967 1795 1794 1427 1963 1792 1791 1790 1788 1785 1604 1603 1605 1416 1218  802  800 1013  579  113
 188  421  646  863 1072 1273  1651 1650 1649 1648 1647 1646 1645 1644 1643 1642 1641 1640 1639 1638 1637 1636 1635 1634 1633 1632 1631 1630 1629 1628 1627 1626 1625 1624 1623 1622 1621 1620 1619 1618 1796 1429 1616 1426 1614 1612 1611 1608 1787 1421 1786 1606 1417 1418 1015 1219  580  801  111  112
 187  420  645  862 1071 1272  1464 1463 1462 1461 1460 1459 1458 1457 1456 1455 1454 1453 1452 1451 1450 1449 1448 1447 1446 1445 1444 1443 1442 1441 1440 1439 1438 1437 1436 1435 1434 1433 1432 1431 1617 1430 1615 1428 1425 1230 1423 1789 1609 1422 1225 1420 1419 1222 1220  581  803  114  352  115
 186  419  644  861 1070 1271  1269 1268 1267 1266 1265 1264 1263 1262 1261 1260 1259 1258 1257 1256 1255 1254 1253 1252 1251 1250 1249 1248 1247 1246 1245 1244 1243 1242 1241 1240 1239 1238 1237 1236 1235 1234 1233 1232 1231 1027  815 1424 1610 1023 1226 1607 1223 1019 1221  583 1016  351  117  116
 185  418  643  860 1069 1068  1066 1065 1064 1063 1062 1061 1060 1059 1058 1057 1056 1055 1054 1053 1052 1051 1050 1049 1048 1047 1046 1045 1044 1043 1042 1041 1040 1039 1038 1037 1036 1035 1034 1033 1032 1031 1030 1029 1028 1026 1228 1227 1229 1024 1021 1224 1020  808 1017  806  804  582  118  119
 184  417  642  859  858  857   855  854  853  852  851  850  849  848  847  846  845  844  843  842  841  840  839  838  837  836  835  834  833  832  831  830  829  828  827  826  825  824  823  822  821  820  819  818  817  816  596 1025  813  812 1022  811  810  590  589 1018  361  122  353  585
 183  416  641  640  639  638   636  635  634  633  632  631  630  629  628  627  626  625  624  623  622  621  620  619  618  617  616  615  614  613  612  611  610  609  608  607  606  605  604  603  602  601  600  599  598  597  369  814  594  593  592  591  362  809  807  586  360  358  584  354
 182  415  414  413  412  411   409  408  407  406  405  404  403  402  401  400  399  398  397  396  395  394  393  392  391  390  389  388  387  386  385  384  383  382  381  380  379  378  377  376  375  374  373  372  371  370  134  595  367  366  365  364  127  128  359  357  124  125  355  356
 181  180  179  178  177  176   174  173  172  171  170  169  168  167  166  165  164  163  162  161  160  159  158  157  156  155  154  153  152  151  150  149  148  147  146  145  144  143  142  141  140  139  138  137  136  135  133  368  132  131  130  129  587  588  363  126  123  805  120  121
